,f0,f1,t0,t1,dB0,dB1,dist,utime,ufreq
0,68,193,0.9287981859410431,2.6238548752834467,27,28,145,2,125
1,68,165,0.9287981859410431,3.8312925170068026,27,35,158,3,97
2,68,247,0.9287981859410431,2.670294784580499,27,33,194,2,179
3,68,246,0.9287981859410431,3.7616326530612247,27,27,216,3,178
4,68,445,0.9287981859410431,2.670294784580499,27,20,384,2,377
5,68,485,0.9287981859410431,3.1579138321995464,27,16,428,2,417
6,201,193,1.1609977324263039,2.6238548752834467,27,28,64,1,8
7,201,165,1.1609977324263039,3.8312925170068026,27,35,121,3,36
8,201,247,1.1609977324263039,2.670294784580499,27,33,80,2,46
9,201,246,1.1609977324263039,3.7616326530612247,27,27,121,3,45
10,201,445,1.1609977324263039,2.670294784580499,27,20,253,2,244
11,201,485,1.1609977324263039,3.1579138321995464,27,16,297,2,284
12,193,165,2.6238548752834467,3.8312925170068026,28,35,59,1,28
13,193,185,2.6238548752834467,4.96907029478458,28,34,101,2,8
14,193,246,2.6238548752834467,3.7616326530612247,28,27,72,1,53
15,193,206,2.6238548752834467,4.179591836734694,28,32,68,2,13
16,165,185,3.8312925170068026,4.96907029478458,35,34,53,1,20
17,165,121,3.8312925170068026,5.944308390022676,35,40,101,2,44
18,165,18,3.8312925170068026,6.8034467120181406,35,48,195,3,147
19,165,243,3.8312925170068026,5.944308390022676,35,32,120,2,78
20,165,206,3.8312925170068026,6.15328798185941,35,33,108,2,41
21,165,482,3.8312925170068026,5.7817687074829935,35,15,328,2,317
22,185,18,4.96907029478458,6.8034467120181406,34,48,185,2,167
23,185,18,4.96907029478458,7.476825396825397,34,48,199,3,167
24,185,206,4.96907029478458,6.15328798185941,34,33,55,1,21
25,185,275,4.96907029478458,7.685804988662132,34,31,148,3,90
26,185,498,4.96907029478458,6.826666666666667,34,18,323,2,313
27,185,545,4.96907029478458,7.5232653061224495,34,17,376,3,360
28,121,18,5.944308390022676,7.476825396825397,40,48,122,2,103
29,121,6,5.944308390022676,8.359183673469389,40,50,155,2,115
30,121,275,5.944308390022676,7.685804988662132,40,31,171,2,154
31,121,246,5.944308390022676,8.382403628117913,40,30,163,2,125
32,121,545,5.944308390022676,7.5232653061224495,40,17,429,2,424
33,121,429,5.944308390022676,8.219863945578231,40,18,323,2,308
34,18,6,6.8034467120181406,8.359183673469389,48,50,68,2,12
35,18,6,6.8034467120181406,9.218321995464853,48,49,105,2,12
36,18,246,6.8034467120181406,8.382403628117913,48,30,238,2,228
37,18,206,6.8034467120181406,9.58984126984127,48,33,223,3,188
38,18,429,6.8034467120181406,8.219863945578231,48,18,416,1,411
39,18,446,6.8034467120181406,9.752380952380953,48,20,446,3,428
40,18,6,7.476825396825397,9.218321995464853,48,49,76,2,12
41,18,206,7.476825396825397,9.58984126984127,48,33,209,2,188
42,18,277,7.476825396825397,10.448979591836736,48,32,289,3,259
43,18,446,7.476825396825397,9.752380952380953,48,20,439,2,428
44,6,18,8.359183673469389,10.936598639455783,50,48,112,3,12
45,6,206,8.359183673469389,9.58984126984127,50,33,207,1,200
46,6,277,8.359183673469389,10.448979591836736,50,32,286,2,271
47,6,244,8.359183673469389,11.3081179138322,50,31,270,3,238
48,6,446,8.359183673469389,9.752380952380953,50,20,444,1,440
49,6,446,8.359183673469389,10.495419501133787,50,18,450,2,440
50,6,18,9.218321995464853,10.936598639455783,49,48,75,2,12
51,6,277,9.218321995464853,10.448979591836736,49,32,276,1,271
52,6,244,9.218321995464853,11.3081179138322,49,31,254,2,238
53,6,446,9.218321995464853,10.495419501133787,49,18,443,1,440
54,6,459,9.218321995464853,11.679637188208616,49,17,465,2,453
55,18,5,10.936598639455783,12.678095238095239,48,50,76,2,13
56,18,205,10.936598639455783,12.445895691609978,48,31,198,2,187
57,18,247,10.936598639455783,13.885532879818594,48,31,262,3,229
58,18,448,10.936598639455783,12.631655328798185,48,16,436,2,430
59,18,429,10.936598639455783,13.746213151927439,48,18,428,3,411
60,6,5,11.470657596371883,12.678095238095239,47,50,52,1,1
61,6,5,11.470657596371883,13.931972789115646,47,50,106,2,1
62,6,5,11.470657596371883,14.280272108843537,47,49,121,3,1
63,6,247,11.470657596371883,13.885532879818594,47,31,262,2,241
64,6,246,11.470657596371883,14.419591836734694,47,31,272,3,240
65,6,448,11.470657596371883,12.631655328798185,47,16,445,1,442
66,6,429,11.470657596371883,13.746213151927439,47,18,434,2,423
67,5,247,12.678095238095239,13.885532879818594,50,31,248,1,242
68,5,246,12.678095238095239,14.419591836734694,50,31,252,2,241
69,5,429,12.678095238095239,13.746213151927439,50,18,426,1,424
70,5,446,12.678095238095239,14.582131519274377,50,20,449,2,441
71,5,18,13.931972789115646,15.766349206349206,50,49,80,2,13
72,5,18,13.931972789115646,16.46294784580499,50,48,110,3,13
73,5,207,13.931972789115646,15.673469387755102,50,23,215,2,202
74,5,230,13.931972789115646,16.904126984126986,50,35,259,3,225
75,5,479,13.931972789115646,16.486167800453515,50,18,487,3,474
76,5,18,14.280272108843537,15.766349206349206,49,49,65,1,13
77,5,18,14.280272108843537,16.46294784580499,49,48,95,2,13
78,5,207,14.280272108843537,15.673469387755102,49,23,211,1,202
79,5,230,14.280272108843537,16.904126984126986,49,35,252,3,225
80,5,479,14.280272108843537,16.486167800453515,49,18,483,2,474
81,18,230,15.766349206349206,16.904126984126986,49,35,218,1,212
82,18,229,15.766349206349206,17.623945578231293,49,29,226,2,211
83,18,205,15.766349206349206,18.45986394557823,49,28,220,3,187
84,18,229,16.46294784580499,17.623945578231293,48,29,217,1,211
85,18,205,16.46294784580499,18.45986394557823,48,28,206,2,187
86,18,266,17.832925170068027,19.82984126984127,49,25,262,2,248
87,18,226,17.832925170068027,20.59609977324263,49,19,240,3,208
88,18,421,17.832925170068027,19.760181405895693,49,20,411,2,403
89,18,475,17.832925170068027,20.619319727891156,49,15,472,3,457
90,18,266,18.52952380952381,19.82984126984127,48,25,254,1,248
91,18,226,18.52952380952381,20.59609977324263,48,19,226,2,208
92,18,247,18.52952380952381,21.36235827664399,48,25,259,3,229
93,18,421,18.52952380952381,19.760181405895693,48,20,406,1,403
94,18,475,18.52952380952381,20.619319727891156,48,15,466,2,457
95,18,226,19.202902494331067,20.59609977324263,48,19,216,1,208
96,18,247,19.202902494331067,21.36235827664399,48,25,247,2,229
97,18,475,19.202902494331067,20.619319727891156,48,15,461,1,457
98,18,479,19.202902494331067,21.989297052154196,48,18,476,3,461
99,18,208,20.59609977324263,23.057414965986396,48,29,218,2,190
100,18,205,20.59609977324263,23.127074829931974,48,29,216,3,187
101,18,479,20.59609977324263,21.989297052154196,48,18,465,1,461
102,18,459,20.59609977324263,22.709115646258503,48,18,450,2,441
103,18,467,20.59609977324263,23.38249433106576,48,17,465,3,449
104,18,208,21.966077097505668,23.057414965986396,49,29,196,1,190
105,18,205,21.966077097505668,23.127074829931974,49,29,194,1,187
106,18,211,21.966077097505668,24.752471655328797,49,24,227,3,193
107,18,467,21.966077097505668,23.38249433106576,49,17,453,1,449
108,18,479,21.966077097505668,24.752471655328797,49,17,476,3,461
109,18,211,22.66267573696145,24.752471655328797,48,24,213,2,193
110,18,479,22.66267573696145,24.752471655328797,48,17,470,2,461
111,18,417,22.66267573696145,25.472290249433108,48,18,417,3,399
112,18,205,24.03265306122449,26.05278911564626,48,21,206,2,187
113,18,252,24.03265306122449,26.679727891156464,48,24,260,3,234
114,18,417,24.03265306122449,25.472290249433108,48,18,404,1,399
115,18,205,24.729251700680273,26.05278911564626,49,21,195,1,187
116,18,252,24.729251700680273,26.679727891156464,49,24,249,2,234
117,18,211,24.729251700680273,27.515646258503402,49,20,227,3,193
118,18,479,24.729251700680273,27.515646258503402,49,16,476,3,461
119,18,252,25.425850340136055,26.679727891156464,49,24,240,1,234
120,18,211,25.425850340136055,27.515646258503402,49,20,213,2,193
121,18,479,25.425850340136055,27.515646258503402,49,16,470,2,461
122,18,208,26.795827664399095,28.53732426303855,49,21,204,2,190
123,18,207,26.795827664399095,29.489342403628118,49,22,222,3,189
124,18,491,26.795827664399095,29.60544217687075,49,15,488,3,473
125,18,208,27.492426303854877,28.53732426303855,49,21,195,1,190
126,18,207,27.492426303854877,29.489342403628118,49,22,208,2,189
127,18,491,27.492426303854877,29.60544217687075,49,15,482,2,473
128,18,209,28.862403628117914,30.859319727891158,48,26,209,2,191
129,18,231,28.862403628117914,31.67201814058957,48,24,245,3,213
130,18,465,28.862403628117914,31.648798185941043,48,16,463,3,447
131,18,209,29.559002267573696,30.859319727891158,49,26,199,1,191
132,18,231,29.559002267573696,31.67201814058957,49,24,232,2,213
133,18,465,29.559002267573696,31.648798185941043,49,16,456,2,447
134,18,452,29.559002267573696,32.3221768707483,49,19,450,3,434
135,18,231,30.25560090702948,31.67201814058957,49,24,222,1,213
136,18,311,30.25560090702948,33.04199546485261,49,20,317,3,293
137,18,465,30.25560090702948,31.648798185941043,49,16,451,1,447
138,18,452,30.25560090702948,32.3221768707483,49,19,443,2,434
139,18,311,31.62557823129252,33.04199546485261,48,20,299,1,293
140,18,278,31.62557823129252,33.41351473922902,48,23,271,2,260
141,18,347,31.62557823129252,34.59773242630386,48,30,353,3,329
142,18,459,31.62557823129252,33.73859410430839,48,17,450,2,441
143,18,278,32.3221768707483,33.41351473922902,49,23,264,1,260
144,18,347,32.3221768707483,34.59773242630386,49,30,343,2,329
145,18,459,32.3221768707483,33.73859410430839,49,17,445,1,441
146,18,414,32.3221768707483,34.66739229024943,49,25,409,2,396
147,18,52,33.69215419501134,35.572970521541954,48,49,88,2,34
148,18,231,33.69215419501134,35.71229024943311,48,26,230,2,213
149,18,233,33.69215419501134,36.339229024943315,48,21,243,3,215
150,18,479,33.69215419501134,35.781950113378684,48,16,470,2,461
151,18,52,34.38875283446712,35.572970521541954,48,49,61,1,34
152,18,231,34.38875283446712,35.71229024943311,48,26,220,1,213
153,18,233,34.38875283446712,36.339229024943315,48,21,231,2,215
154,18,479,34.38875283446712,35.781950113378684,48,16,465,1,461
155,18,467,34.38875283446712,37.17514739229025,48,15,465,3,449
156,52,18,35.572970521541954,37.151927437641724,49,48,76,2,34
157,52,386,35.572970521541954,37.871746031746035,49,20,348,2,334
158,52,524,35.572970521541954,36.5946485260771,49,18,474,1,472
159,52,467,35.572970521541954,37.17514739229025,49,15,421,2,415
160,18,6,36.45532879818594,39.05596371882086,48,47,113,3,12
161,18,46,36.45532879818594,39.288163265306125,48,48,125,3,28
162,18,386,36.45532879818594,37.871746031746035,48,20,373,1,368
163,18,260,36.45532879818594,38.800544217687076,48,27,262,2,242
164,18,483,36.45532879818594,39.07918367346939,48,24,479,3,465
165,18,459,36.45532879818594,39.2649433106576,48,16,457,3,441
166,18,6,37.151927437641724,39.05596371882086,48,47,83,2,12
167,18,46,37.151927437641724,39.288163265306125,48,48,96,2,28
168,18,260,37.151927437641724,38.800544217687076,48,27,252,2,242
169,18,211,37.151927437641724,39.59002267573696,48,23,220,2,193
170,18,483,37.151927437641724,39.07918367346939,48,24,472,2,465
171,18,459,37.151927437641724,39.2649433106576,48,16,450,2,441
172,6,18,39.05596371882086,40.58848072562358,47,48,67,2,12
173,6,208,39.05596371882086,40.96,47,27,218,2,202
174,6,476,39.05596371882086,40.61170068027211,47,15,475,2,470
175,6,502,39.05596371882086,41.86557823129252,47,29,511,3,496
176,46,18,39.288163265306125,40.58848072562358,48,48,63,1,28
177,46,6,39.288163265306125,41.470839002267574,48,48,102,2,40
178,46,47,39.288163265306125,42.190657596371885,48,47,125,3,1
179,46,208,39.288163265306125,40.96,48,27,177,2,162
180,46,245,39.288163265306125,42.09777777777778,48,26,233,3,199
181,46,235,39.288163265306125,42.190657596371885,48,23,227,3,189
182,46,476,39.288163265306125,40.61170068027211,48,15,434,1,430
183,46,502,39.288163265306125,41.86557823129252,48,29,469,3,456
184,18,47,40.58848072562358,42.190657596371885,48,47,75,2,29
185,18,245,40.58848072562358,42.09777777777778,48,26,236,2,227
186,18,235,40.58848072562358,42.190657596371885,48,23,228,2,217
187,18,386,40.58848072562358,43.39809523809524,48,20,387,3,368
188,18,502,40.58848072562358,41.86557823129252,48,29,487,1,484
189,18,476,40.58848072562358,42.79437641723356,48,26,468,2,458
190,6,18,41.470839002267574,43.35165532879819,48,48,82,2,12
191,6,386,41.470839002267574,43.39809523809524,48,20,389,2,380
192,6,476,41.470839002267574,42.79437641723356,48,26,473,1,470
193,6,479,41.470839002267574,44.0714739229025,48,15,486,3,473
194,47,18,42.190657596371885,43.35165532879819,47,48,58,1,29
195,47,6,42.190657596371885,44.58231292517007,47,47,111,2,41
196,47,386,42.190657596371885,43.39809523809524,47,20,343,1,339
197,47,271,42.190657596371885,44.81451247165533,47,27,251,3,224
198,47,479,42.190657596371885,44.0714739229025,47,15,440,2,432
199,47,459,42.190657596371885,44.76807256235828,47,17,427,3,412
200,18,6,43.35165532879819,44.58231292517007,48,47,54,1,12
201,18,5,43.35165532879819,45.7665306122449,48,48,105,2,13
202,18,271,43.35165532879819,44.81451247165533,48,27,261,1,253
203,18,329,43.35165532879819,45.27891156462585,48,18,322,2,311
204,18,459,43.35165532879819,44.76807256235828,48,17,445,1,441
205,6,5,44.58231292517007,45.7665306122449,47,48,51,1,1
206,6,5,44.58231292517007,47.04362811791383,47,48,106,2,1
207,6,5,44.58231292517007,47.391927437641726,47,47,121,3,1
208,6,216,44.58231292517007,46.88108843537415,47,25,232,2,210
209,6,254,44.58231292517007,47.159727891156464,47,22,272,3,248
210,5,216,45.7665306122449,46.88108843537415,48,25,216,1,211
211,5,254,45.7665306122449,47.159727891156464,48,22,256,1,249
212,5,215,45.7665306122449,48.204625850340136,48,20,235,2,210
213,5,411,45.7665306122449,48.48326530612245,48,18,423,3,406
214,5,18,47.04362811791383,48.87800453514739,48,47,80,2,13
215,5,18,47.04362811791383,49.55138321995465,48,47,109,3,13
216,5,215,47.04362811791383,48.204625850340136,48,20,216,1,210
217,5,298,47.04362811791383,49.31918367346939,48,22,309,2,293
218,5,411,47.04362811791383,48.48326530612245,48,18,411,1,406
219,5,18,47.391927437641726,48.87800453514739,47,47,65,1,13
220,5,18,47.391927437641726,49.55138321995465,47,47,94,2,13
221,5,298,47.391927437641726,49.31918367346939,47,22,305,2,293
222,5,411,47.391927437641726,48.48326530612245,47,18,409,1,406
223,5,490,47.391927437641726,50.108662131519274,47,26,499,3,485
224,5,459,47.391927437641726,50.29442176870749,47,17,471,3,454
225,18,6,48.87800453514739,50.64272108843537,47,47,77,2,12
226,18,6,48.87800453514739,51.2928798185941,47,49,105,2,12
227,18,211,48.87800453514739,50.61950113378685,47,22,207,2,193
228,18,490,48.87800453514739,50.108662131519274,47,26,475,1,472
229,18,459,48.87800453514739,50.29442176870749,47,17,445,1,441
230,18,6,49.55138321995465,50.64272108843537,47,47,49,1,12
231,18,6,49.55138321995465,51.2928798185941,47,49,76,2,12
232,18,211,49.55138321995465,50.61950113378685,47,22,198,1,193
233,18,249,49.55138321995465,52.15201814058957,47,25,257,3,231
234,6,249,50.64272108843537,52.15201814058957,47,25,252,2,243
235,6,255,50.64272108843537,52.66285714285714,47,27,264,2,249
236,6,247,50.64272108843537,53.19691609977324,47,22,265,3,241
237,6,18,51.2928798185941,53.68453514739229,49,47,104,2,12
238,6,255,51.2928798185941,52.66285714285714,49,27,256,1,249
239,6,247,51.2928798185941,53.19691609977324,49,22,255,2,241
240,6,457,51.2928798185941,53.75419501133787,49,18,463,2,451
241,6,18,52.848616780045354,54.381133786848075,47,48,67,2,12
242,6,5,52.848616780045354,55.61179138321996,47,47,119,3,1
243,6,211,52.848616780045354,55.100952380952386,47,23,227,2,205
244,6,272,52.848616780045354,55.797551020408164,47,32,295,3,266
245,6,478,52.848616780045354,55.100952380952386,47,17,482,2,472
246,6,459,52.848616780045354,55.797551020408164,47,17,470,3,453
247,18,5,53.68453514739229,55.61179138321996,47,47,84,2,13
248,18,211,53.68453514739229,55.100952380952386,47,23,202,1,193
249,18,272,53.68453514739229,55.797551020408164,47,32,270,2,254
250,18,266,53.68453514739229,56.49414965986394,47,26,276,3,248
251,18,478,53.68453514739229,55.100952380952386,47,17,464,1,460
252,18,459,53.68453514739229,55.797551020408164,47,17,450,2,441
253,18,5,54.381133786848075,55.61179138321996,48,47,55,1,13
254,18,5,54.381133786848075,56.86566893424036,48,47,108,2,13
255,18,272,54.381133786848075,55.797551020408164,48,32,261,1,254
256,18,266,54.381133786848075,56.49414965986394,48,26,264,2,248
257,18,459,54.381133786848075,55.797551020408164,48,17,445,1,441
258,5,54,55.61179138321996,57.56226757369615,47,46,97,2,49
259,5,216,55.61179138321996,57.88734693877551,47,30,233,2,211
260,5,216,56.86566893424036,57.88734693877551,47,30,216,1,211
261,5,243,56.86566893424036,58.88580498866213,47,24,253,2,238
262,5,207,56.86566893424036,59.303764172335605,47,29,228,2,202
263,5,418,56.86566893424036,59.396643990929704,47,20,427,3,413
264,54,18,57.56226757369615,59.90748299319728,46,47,107,2,36
265,54,243,57.56226757369615,58.88580498866213,46,24,197,1,189
266,54,207,57.56226757369615,59.303764172335605,46,29,170,2,153
267,54,278,57.56226757369615,60.44154195011338,46,30,256,3,224
268,54,418,57.56226757369615,59.396643990929704,46,20,372,2,364
269,5,18,58.35174603174603,59.90748299319728,47,47,68,2,13
270,5,83,58.35174603174603,60.8130612244898,47,48,132,2,78
271,5,278,58.35174603174603,60.44154195011338,47,30,287,2,273
272,5,418,58.35174603174603,59.396643990929704,47,20,415,1,413
273,5,410,58.35174603174603,61.161360544217686,47,20,423,3,405
274,18,67,59.90748299319728,61.92761904761905,47,47,100,2,49
275,18,207,59.90748299319728,61.39356009070295,47,28,200,1,189
276,18,410,59.90748299319728,61.161360544217686,47,20,396,1,392
277,18,416,59.90748299319728,61.37034013605442,47,20,403,1,398
278,18,475,59.90748299319728,62.415238095238095,47,22,470,3,457
279,83,67,60.8130612244898,61.92761904761905,48,47,51,1,16
280,83,6,60.8130612244898,63.018956916099775,48,47,122,2,77
281,83,18,60.8130612244898,63.34403628117914,48,48,127,3,65
282,83,275,60.8130612244898,63.20471655328798,48,31,218,2,192
283,83,275,60.8130612244898,63.22793650793651,48,29,218,2,192
284,83,475,60.8130612244898,62.415238095238095,48,22,398,2,392
285,67,6,61.92761904761905,63.018956916099775,47,47,77,1,61
286,67,18,61.92761904761905,63.34403628117914,47,48,78,1,49
287,67,68,61.92761904761905,64.6443537414966,47,47,117,3,1
288,67,275,61.92761904761905,63.20471655328798,47,31,215,1,208
289,67,275,61.92761904761905,63.22793650793651,47,29,215,1,208
290,67,547,61.92761904761905,64.04063492063493,47,24,489,2,480
291,6,68,63.018956916099775,64.6443537414966,47,47,94,2,62
292,6,272,63.018956916099775,64.92299319727891,47,26,278,2,266
293,6,275,63.018956916099775,65.2712925170068,47,27,286,2,269
294,6,436,63.018956916099775,65.38739229024944,47,19,442,2,430
295,18,68,63.34403628117914,64.6443537414966,48,47,75,1,50
296,18,272,63.34403628117914,64.92299319727891,48,26,263,2,254
297,18,275,63.34403628117914,65.2712925170068,48,27,270,2,257
298,18,436,63.34403628117914,65.38739229024944,48,19,427,2,418
299,68,18,64.6443537414966,66.10721088435375,47,48,80,1,50
300,68,81,64.6443537414966,67.10566893424037,47,47,107,2,13
301,68,247,64.6443537414966,66.47873015873016,47,32,196,2,179
302,68,207,64.6443537414966,67.61650793650794,47,25,189,3,139
303,68,459,64.6443537414966,66.85024943310658,47,16,402,2,391
304,18,5,66.10721088435375,67.8487074829932,48,47,76,2,13
305,18,207,66.10721088435375,67.61650793650794,48,25,200,2,189
306,18,346,66.10721088435375,68.94004535147393,48,26,350,3,328
307,18,425,66.10721088435375,68.94004535147393,48,28,425,3,407
308,81,5,67.10566893424037,69.1025850340136,47,48,115,2,76
309,81,5,67.10566893424037,69.4508843537415,47,48,126,2,76
310,81,346,67.10566893424037,68.94004535147393,47,26,277,2,265
311,81,230,67.10566893424037,69.28834467120181,47,23,176,2,149
312,81,425,67.10566893424037,68.94004535147393,47,28,353,2,344
313,5,51,67.8487074829932,70.65832199546486,47,47,129,3,46
314,5,346,67.8487074829932,68.94004535147393,47,26,344,1,341
315,5,230,67.8487074829932,69.28834467120181,47,23,233,1,225
316,5,261,67.8487074829932,70.4261224489796,47,26,279,3,256
317,5,425,67.8487074829932,68.94004535147393,47,28,423,1,420
318,5,51,69.1025850340136,70.65832199546486,48,47,81,2,46
319,5,261,69.1025850340136,70.4261224489796,48,26,262,1,256
320,5,51,69.4508843537415,70.65832199546486,48,47,69,1,46
321,5,52,69.4508843537415,72.12117913832199,48,45,124,3,47
322,5,18,69.4508843537415,72.3069387755102,48,48,124,3,13
323,5,234,69.4508843537415,72.12117913832199,48,32,256,3,229
324,5,205,69.4508843537415,72.33015873015873,48,29,235,3,200
325,5,459,69.4508843537415,72.35337868480725,48,19,471,3,454
326,51,52,70.65832199546486,72.12117913832199,47,45,63,1,1
327,51,18,70.65832199546486,72.3069387755102,47,48,78,2,33
328,51,234,70.65832199546486,72.12117913832199,47,32,194,1,183
329,51,205,70.65832199546486,72.33015873015873,47,29,170,2,154
330,51,260,70.65832199546486,73.25895691609978,47,24,237,3,209
331,51,459,70.65832199546486,72.35337868480725,47,19,414,2,408
332,52,18,72.12117913832199,73.70013605442178,45,48,76,2,34
333,52,18,72.12117913832199,74.37351473922902,45,48,103,2,34
334,52,260,72.12117913832199,73.25895691609978,45,24,214,1,208
335,52,251,72.12117913832199,75.00045351473923,45,30,234,3,199
336,52,545,72.12117913832199,73.7233560090703,45,14,498,2,493
337,18,251,72.3069387755102,75.00045351473923,48,30,260,3,233
338,18,459,72.3069387755102,75.11655328798186,48,18,457,3,441
339,18,251,73.70013605442178,75.00045351473923,48,30,240,1,233
340,18,406,73.70013605442178,75.37197278911565,48,27,395,2,388
341,18,272,73.70013605442178,76.34721088435374,48,23,278,3,254
342,18,459,73.70013605442178,75.11655328798186,48,18,445,1,441
343,18,457,73.70013605442178,75.37197278911565,48,29,445,2,439
344,18,272,74.37351473922902,76.34721088435374,48,23,268,2,254
345,18,479,74.37351473922902,77.15990929705215,48,18,476,3,461
346,18,229,75.7667120181406,77.53142857142858,48,20,224,2,211
347,18,267,75.7667120181406,78.59954648526077,48,27,277,3,249
348,18,479,75.7667120181406,77.15990929705215,48,18,465,1,461
349,18,459,75.7667120181406,77.87972789115646,48,19,450,2,441
350,18,508,75.7667120181406,78.46022675736961,48,23,504,3,490
351,18,267,77.13668934240363,78.59954648526077,49,27,257,1,249
352,18,211,77.13668934240363,79.92308390022676,49,22,227,3,193
353,18,508,77.13668934240363,78.46022675736961,49,23,493,1,490
354,18,429,77.13668934240363,79.94630385487528,49,17,428,3,411
355,18,211,77.83328798185941,79.92308390022676,48,22,213,2,193
356,18,429,77.83328798185941,79.94630385487528,48,17,421,2,411
357,18,208,79.20326530612245,81.22340136054422,48,29,209,2,190
358,18,253,79.20326530612245,81.8271201814059,48,31,261,3,235
359,18,498,79.20326530612245,81.31628117913833,48,16,489,2,480
360,18,208,79.89986394557823,81.22340136054422,49,29,198,1,190
361,18,253,79.89986394557823,81.8271201814059,49,31,249,2,235
362,18,498,79.89986394557823,81.31628117913833,49,16,484,1,480
363,18,479,79.89986394557823,82.68625850340136,49,18,476,3,461
364,18,253,80.59646258503402,81.8271201814059,48,31,241,1,235
365,18,232,80.59646258503402,83.28997732426303,48,27,243,3,214
366,18,228,80.59646258503402,83.38285714285715,48,28,242,3,210
367,18,479,80.59646258503402,82.68625850340136,48,18,470,2,461
368,18,27,81.96643990929705,84.24199546485261,48,49,98,2,9
369,18,232,81.96643990929705,83.28997732426303,48,27,221,1,214
370,18,228,81.96643990929705,83.38285714285715,48,28,219,1,210
371,18,258,81.96643990929705,84.4045351473923,48,24,262,2,240
372,18,481,81.96643990929705,84.75283446712018,48,15,478,3,463
373,18,27,82.66303854875284,84.24199546485261,48,49,69,2,9
374,18,258,82.66303854875284,84.4045351473923,48,24,251,2,240
375,18,481,82.66303854875284,84.75283446712018,48,15,472,2,463
376,27,18,84.24199546485261,85.42621315192744,49,49,52,1,9
377,27,18,84.24199546485261,86.79619047619047,49,48,110,3,9
378,27,251,84.24199546485261,86.1924716553288,49,28,239,2,224
379,27,263,84.24199546485261,86.98195011337869,49,25,264,3,236
380,27,459,84.24199546485261,86.14603174603175,49,18,440,2,432
381,27,517,84.24199546485261,87.07482993197279,49,30,505,3,490
382,18,251,84.72961451247166,86.1924716553288,48,28,241,1,233
383,18,263,84.72961451247166,86.98195011337869,48,25,264,2,245
384,18,213,84.72961451247166,87.42312925170069,48,24,227,3,195
385,18,459,84.72961451247166,86.14603174603175,48,18,445,1,441
386,18,517,84.72961451247166,87.07482993197279,48,30,509,2,499
387,18,263,85.42621315192744,86.98195011337869,49,25,254,2,245
388,18,213,85.42621315192744,87.42312925170069,49,24,213,2,195
389,18,517,85.42621315192744,87.07482993197279,49,30,504,2,499
390,18,478,85.42621315192744,88.21260770975057,49,17,475,3,460
391,18,272,86.79619047619047,88.53768707482993,48,28,265,2,254
392,18,247,86.79619047619047,89.67546485260772,48,28,260,3,229
393,18,478,86.79619047619047,88.21260770975057,48,17,464,1,460
394,18,469,86.79619047619047,88.65378684807257,48,33,458,2,451
395,18,419,86.79619047619047,89.65224489795918,48,19,419,3,401
396,18,272,87.49278911564626,88.53768707482993,49,28,258,1,254
397,18,247,87.49278911564626,89.67546485260772,49,28,248,2,229
398,18,469,87.49278911564626,88.65378684807257,49,33,454,1,451
399,18,419,87.49278911564626,89.65224489795918,49,19,412,2,401
400,18,233,88.8627664399093,90.67392290249434,47,21,229,2,215
401,18,478,88.8627664399093,90.62748299319728,47,18,466,2,460
402,18,233,89.55936507936508,90.67392290249434,48,21,220,1,215
403,18,263,89.55936507936508,92.32253968253968,48,25,272,3,245
404,18,263,89.55936507936508,92.34575963718821,48,24,273,3,245
405,18,478,89.55936507936508,90.62748299319728,48,18,462,1,460
406,18,468,89.55936507936508,92.34575963718821,48,15,466,3,450
407,18,263,90.58104308390023,92.32253968253968,48,25,256,2,245
408,18,263,90.58104308390023,92.34575963718821,48,24,257,2,245
409,18,468,90.58104308390023,92.34575963718821,48,15,456,2,450
410,18,46,92.32253968253968,94.62131519274377,47,47,103,2,28
411,18,206,92.32253968253968,93.97115646258504,47,25,201,2,188
412,18,229,92.32253968253968,94.52843537414967,47,27,231,2,211
413,18,458,92.32253968253968,94.24979591836735,47,25,448,2,440
414,18,459,92.32253968253968,94.43555555555555,47,17,450,2,441
415,18,46,93.01913832199547,94.62131519274377,47,47,74,2,28
416,18,229,93.01913832199547,94.52843537414967,47,27,221,2,211
417,18,458,93.01913832199547,94.24979591836735,47,25,443,1,440
418,18,459,93.01913832199547,94.43555555555555,47,17,445,1,441
419,18,6,93.69251700680272,96.64145124716553,47,48,128,3,12
420,18,209,93.69251700680272,96.17705215419501,47,30,219,2,191
421,46,18,94.62131519274377,95.75909297052155,47,47,56,1,28
422,46,6,94.62131519274377,96.64145124716553,47,48,96,2,40
423,46,5,94.62131519274377,97.500589569161,47,47,131,3,41
424,46,209,94.62131519274377,96.17705215419501,47,30,176,2,163
425,46,251,94.62131519274377,97.22195011337868,47,27,234,3,205
426,46,249,94.62131519274377,97.43092970521542,47,23,236,3,203
427,46,545,94.62131519274377,95.8055328798186,47,15,502,1,499
428,46,502,94.62131519274377,97.03619047619048,47,29,468,2,456
429,18,5,95.75909297052155,97.500589569161,47,47,76,2,13
430,18,251,95.75909297052155,97.22195011337868,47,27,241,1,233
431,18,249,95.75909297052155,97.43092970521542,47,23,242,2,231
432,18,502,95.75909297052155,97.03619047619048,47,29,487,1,484
433,18,481,95.75909297052155,97.94176870748299,47,21,472,2,463
434,6,18,96.64145124716553,98.52226757369614,48,48,82,2,12
435,6,4,96.64145124716553,99.47428571428571,48,47,122,3,2
436,6,214,96.64145124716553,98.84734693877552,48,21,229,2,208
437,6,481,96.64145124716553,97.94176870748299,48,21,478,1,475
438,6,479,96.64145124716553,99.24208616780045,48,16,486,3,473
439,5,18,97.500589569161,98.52226757369614,47,48,46,1,13
440,5,4,97.500589569161,99.47428571428571,47,47,85,2,1
441,5,214,97.500589569161,98.84734693877552,47,21,217,1,209
442,5,270,97.500589569161,99.93868480725624,47,25,285,2,265
443,5,479,97.500589569161,99.24208616780045,47,16,480,2,474
444,5,459,97.500589569161,99.93868480725624,47,16,466,2,454
445,18,5,98.52226757369614,100.93714285714286,48,47,105,2,13
446,18,270,98.52226757369614,99.93868480725624,48,25,259,1,252
447,18,266,98.52226757369614,100.6120634920635,48,30,264,2,248
448,18,459,98.52226757369614,99.93868480725624,48,16,445,1,441
449,18,499,98.52226757369614,100.7978231292517,48,26,491,2,481
450,4,5,99.47428571428571,100.93714285714286,47,47,63,1,1
451,4,5,99.47428571428571,102.2142403628118,47,48,118,3,1
452,4,266,99.47428571428571,100.6120634920635,47,30,267,1,262
453,4,219,99.47428571428571,102.00526077097506,47,28,241,3,215
454,4,499,99.47428571428571,100.7978231292517,47,26,498,1,495
455,5,219,100.93714285714286,102.00526077097506,47,28,219,1,214
456,5,236,100.93714285714286,103.18947845804989,47,25,251,2,231
457,5,234,100.93714285714286,103.3752380952381,47,20,252,2,229
458,5,468,100.93714285714286,103.65387755102041,47,17,478,3,463
459,5,18,102.2142403628118,104.04861678004535,48,47,80,2,13
460,5,18,102.2142403628118,104.72199546485261,48,47,109,3,13
461,5,234,102.2142403628118,103.3752380952381,48,20,234,1,229
462,5,277,102.2142403628118,105.04707482993197,48,25,298,3,272
463,5,468,102.2142403628118,103.65387755102041,48,17,467,1,463
464,5,18,102.56253968253968,104.04861678004535,47,47,65,1,13
465,5,18,102.56253968253968,104.72199546485261,47,47,94,2,13
466,5,46,102.56253968253968,105.48825396825397,47,47,133,3,41
467,5,277,102.56253968253968,105.04707482993197,47,25,292,2,272
468,5,468,102.56253968253968,103.65387755102041,47,17,465,1,463
469,5,474,102.56253968253968,105.30249433106576,47,24,484,3,469
470,5,459,102.56253968253968,105.46503401360545,47,18,471,3,454
471,18,46,104.04861678004535,105.48825396825397,47,47,68,1,28
472,18,6,104.04861678004535,106.46349206349207,47,49,105,2,12
473,18,225,104.04861678004535,105.69723356009071,47,29,219,2,207
474,18,474,104.04861678004535,105.30249433106576,47,24,459,1,456
475,18,459,104.04861678004535,105.46503401360545,47,18,445,1,441
476,18,410,104.04861678004535,106.81179138321995,47,15,410,3,392
477,18,6,104.72199546485261,106.46349206349207,47,49,76,2,12
478,18,216,104.72199546485261,107.22975056689343,47,29,226,3,198
479,18,410,104.72199546485261,106.81179138321995,47,15,402,2,392
480,46,18,105.48825396825397,107.48517006802722,47,47,90,2,28
481,46,216,105.48825396825397,107.22975056689343,47,29,186,2,170
482,46,244,105.48825396825397,108.29786848072563,47,22,232,3,198
483,46,410,105.48825396825397,106.81179138321995,47,15,368,1,364
484,46,507,105.48825396825397,108.06566893424036,47,29,474,3,461
485,6,18,106.46349206349207,107.48517006802722,49,47,46,1,12
486,6,244,106.46349206349207,108.29786848072563,49,22,251,2,238
487,6,246,106.46349206349207,108.48362811791384,49,21,255,2,240
488,6,460,106.46349206349207,108.92480725623582,49,22,466,2,454
489,18,6,107.48517006802722,109.22666666666667,47,47,76,2,12
490,18,215,107.48517006802722,109.7839455782313,47,20,220,2,197
491,18,460,107.48517006802722,108.92480725623582,47,22,446,1,442
492,18,456,107.48517006802722,110.27156462585035,47,16,454,3,438
493,6,5,109.22666666666667,110.78240362811792,47,47,67,2,1
494,6,5,109.22666666666667,112.03628117913833,47,47,121,3,1
495,6,272,109.22666666666667,110.96816326530613,47,32,276,2,266
496,6,267,109.22666666666667,111.6647619047619,47,26,281,2,261
497,6,456,109.22666666666667,110.27156462585035,47,16,452,1,450
498,6,459,109.22666666666667,110.96816326530613,47,16,459,2,453
499,18,5,109.55174603174603,110.78240362811792,48,47,55,1,13
500,18,5,109.55174603174603,112.03628117913833,48,47,108,2,13
501,18,272,109.55174603174603,110.96816326530613,48,32,261,1,254
502,18,267,109.55174603174603,111.6647619047619,48,26,265,2,249
503,18,459,109.55174603174603,110.96816326530613,48,16,445,1,441
504,5,54,110.78240362811792,112.7328798185941,47,46,97,2,49
505,5,216,110.78240362811792,113.05795918367347,47,27,233,2,211
506,5,216,112.03628117913833,113.05795918367347,47,27,216,1,211
507,5,309,112.03628117913833,114.40471655328798,47,25,321,2,304
508,5,207,112.03628117913833,114.49759637188208,47,27,228,2,202
509,5,418,112.03628117913833,114.56725623582767,47,20,427,3,413
510,54,18,112.7328798185941,115.07809523809524,46,47,107,2,36
511,54,309,112.7328798185941,114.40471655328798,46,25,265,2,255
512,54,207,112.7328798185941,114.49759637188208,46,27,171,2,153
513,54,418,112.7328798185941,114.56725623582767,46,20,372,2,364
514,5,18,113.54557823129252,115.07809523809524,46,47,67,2,13
515,5,83,113.54557823129252,115.98367346938775,46,47,131,2,78
516,5,244,113.54557823129252,116.14621315192744,46,29,264,3,239
517,5,418,113.54557823129252,114.56725623582767,46,20,415,1,413
518,5,410,113.54557823129252,116.33197278911565,46,19,422,3,405
519,18,46,115.07809523809524,116.79637188208618,47,47,79,2,28
520,18,244,115.07809523809524,116.14621315192744,47,29,231,1,226
521,18,206,115.07809523809524,116.65705215419501,47,25,200,2,188
522,18,410,115.07809523809524,116.33197278911565,47,19,396,1,392
523,18,480,115.07809523809524,117.58585034013606,47,23,474,3,462
524,83,6,115.98367346938775,118.28244897959183,47,47,125,2,77
525,83,84,115.98367346938775,118.74684807256236,47,47,119,3,1
526,83,277,115.98367346938775,118.37532879818595,47,27,220,2,194
527,83,212,115.98367346938775,118.56108843537415,47,26,170,3,129
528,83,480,115.98367346938775,117.58585034013606,47,23,403,2,397
529,46,6,116.79637188208618,118.28244897959183,47,47,75,1,40
530,46,84,116.79637188208618,118.74684807256236,47,47,92,2,38
531,46,277,116.79637188208618,118.37532879818595,47,27,241,2,231
532,46,212,116.79637188208618,118.56108843537415,47,26,183,2,166
533,6,68,118.28244897959183,119.81496598639455,47,47,91,2,62
534,6,207,118.28244897959183,120.00072562358277,47,26,214,2,201
535,6,276,118.28244897959183,120.79020408163265,47,26,291,3,270
536,6,410,118.28244897959183,120.60444444444445,47,19,416,2,404
537,84,68,118.74684807256236,119.81496598639455,47,47,49,1,16
538,84,18,118.74684807256236,121.2778231292517,47,48,127,3,66
539,84,207,118.74684807256236,120.00072562358277,47,26,134,1,123
540,84,276,118.74684807256236,120.79020408163265,47,26,211,2,192
541,84,244,118.74684807256236,121.64934240362813,47,28,203,3,160
542,84,410,118.74684807256236,120.60444444444445,47,19,336,2,326
543,68,18,119.81496598639455,121.2778231292517,47,48,80,1,50
544,68,81,119.81496598639455,122.27628117913832,47,48,107,2,13
545,68,244,119.81496598639455,121.64934240362813,47,28,193,2,176
546,68,205,119.81496598639455,122.7871201814059,47,24,187,3,137
547,68,459,119.81496598639455,122.02086167800454,47,17,402,2,391
548,18,5,121.2778231292517,123.01931972789116,48,46,76,2,13
549,18,205,121.2778231292517,122.7871201814059,48,24,198,2,187
550,18,346,121.2778231292517,124.11065759637188,48,26,350,3,328
551,18,425,121.2778231292517,124.11065759637188,48,28,425,3,407
552,81,5,122.27628117913832,124.27319727891157,48,47,115,2,76
553,81,346,122.27628117913832,124.11065759637188,48,26,277,2,265
554,81,207,122.27628117913832,125.17877551020409,48,27,177,3,126
555,81,425,122.27628117913832,124.11065759637188,48,28,353,2,344
556,81,436,122.27628117913832,124.9233560090703,48,16,373,3,355
557,5,18,123.01931972789116,125.41097505668934,46,48,104,2,13
558,5,346,123.01931972789116,124.11065759637188,46,26,344,1,341
559,5,207,123.01931972789116,125.17877551020409,46,27,222,2,202
560,5,425,123.01931972789116,124.11065759637188,46,28,423,1,420
561,5,436,123.01931972789116,124.9233560090703,46,16,439,2,431
562,5,468,123.01931972789116,125.4574149659864,46,17,475,2,463
563,5,18,124.27319727891157,125.41097505668934,47,48,51,1,13
564,5,18,124.27319727891157,126.10757369614512,47,49,80,2,13
565,5,18,124.27319727891157,126.80417233560091,47,49,110,3,13
566,5,252,124.27319727891157,126.33977324263039,47,33,263,2,247
567,5,250,124.27319727891157,126.64163265306122,47,33,265,2,245
568,5,468,124.27319727891157,125.4574149659864,47,17,466,1,463
569,18,250,125.41097505668934,126.64163265306122,48,33,238,1,232
570,18,252,125.41097505668934,127.70975056689343,48,35,254,2,234
571,18,459,125.41097505668934,127.52399092970522,48,19,450,2,441
572,18,252,126.10757369614512,127.70975056689343,49,35,244,2,234
573,18,226,126.10757369614512,128.89396825396827,49,31,240,3,208
574,18,459,126.10757369614512,127.52399092970522,49,19,445,1,441
575,18,226,126.80417233560091,128.89396825396827,49,31,227,2,208
576,18,228,128.17414965986396,129.8227664399093,49,32,222,2,210
577,18,228,128.17414965986396,130.79800453514738,49,31,238,3,210
578,18,459,128.17414965986396,130.2871655328798,49,19,450,2,441
579,18,493,128.17414965986396,130.96054421768707,49,16,490,3,475
580,18,228,128.87074829931973,130.79800453514738,48,31,226,2,210
581,18,228,128.87074829931973,131.49460317460318,48,31,238,3,210
582,18,459,128.87074829931973,130.2871655328798,48,19,445,1,441
583,18,493,128.87074829931973,130.96054421768707,48,16,483,2,475
584,18,228,130.24072562358276,131.49460317460318,49,31,217,1,210
585,18,251,130.24072562358276,133.14321995464852,49,27,264,3,233
586,18,459,130.24072562358276,133.05034013605442,49,20,457,3,441
587,18,251,130.93732426303856,133.14321995464852,49,27,252,2,233
588,18,459,130.93732426303856,133.05034013605442,49,20,450,2,441
589,18,231,132.3073015873016,134.46675736961453,48,32,232,2,213
590,18,230,132.3073015873016,134.48997732426304,48,30,232,2,212
591,18,429,132.3073015873016,135.11691609977325,48,17,428,3,411
592,18,231,133.00390022675737,134.46675736961453,49,32,222,1,213
593,18,230,133.00390022675737,134.48997732426304,49,30,221,1,212
594,18,429,133.00390022675737,135.11691609977325,49,17,421,2,411
595,18,51,133.70049886621317,136.62621315192743,49,35,130,3,33
596,18,207,133.70049886621317,136.48689342403628,49,35,224,3,189
597,18,209,133.70049886621317,136.53333333333333,49,35,227,3,191
598,18,429,133.70049886621317,135.11691609977325,49,17,416,1,411
599,18,51,135.0704761904762,136.62621315192743,49,35,75,2,33
600,18,207,135.0704761904762,136.48689342403628,49,35,199,1,189
601,18,209,135.0704761904762,136.53333333333333,49,35,201,1,191
602,18,278,135.0704761904762,137.67111111111112,49,34,283,3,260
603,18,462,135.0704761904762,137.32281179138323,49,14,454,2,444
604,18,9,135.76707482993197,138.1819501133787,49,45,104,2,9
605,18,278,135.76707482993197,137.67111111111112,49,34,273,2,260
606,18,246,135.76707482993197,138.50702947845807,49,35,257,3,228
607,18,462,135.76707482993197,137.32281179138323,49,14,449,2,444
608,51,9,136.62621315192743,138.1819501133787,35,45,79,2,42
609,51,18,136.62621315192743,139.20362811791384,35,44,116,3,33
610,51,278,136.62621315192743,137.67111111111112,35,34,231,1,227
611,51,246,136.62621315192743,138.50702947845807,35,35,211,2,195
612,51,415,136.62621315192743,139.22684807256235,35,19,381,3,364
613,9,18,138.1819501133787,139.20362811791384,45,44,45,1,9
614,9,18,138.1819501133787,139.9002267573696,45,47,75,2,9
615,9,6,138.1819501133787,140.7825850340136,45,48,112,3,3
616,9,274,138.1819501133787,140.43428571428572,45,33,282,2,265
617,9,278,138.1819501133787,140.9451247165533,45,29,294,3,269
618,9,415,138.1819501133787,139.22684807256235,45,19,408,1,406
619,9,442,138.1819501133787,140.29496598639457,45,21,442,2,433
620,9,446,138.1819501133787,140.9683446712018,45,22,453,3,437
621,18,6,139.20362811791384,140.7825850340136,44,48,69,2,12
622,18,5,139.20362811791384,141.64172335600907,44,48,106,2,13
623,18,274,139.20362811791384,140.43428571428572,44,33,261,1,256
624,18,278,139.20362811791384,140.9451247165533,44,29,271,2,260
625,18,442,139.20362811791384,140.29496598639457,44,21,427,1,424
626,18,446,139.20362811791384,140.9683446712018,44,22,435,2,428
627,18,411,139.20362811791384,141.96680272108844,44,21,411,3,393
628,18,5,139.9002267573696,141.64172335600907,47,48,76,2,13
629,18,278,139.9002267573696,140.9451247165533,47,29,264,1,260
630,18,252,139.9002267573696,142.43120181405897,47,31,258,3,234
631,18,276,139.9002267573696,142.8259410430839,47,28,287,3,258
632,18,446,139.9002267573696,140.9683446712018,47,22,430,1,428
633,18,411,139.9002267573696,141.96680272108844,47,21,403,2,393
634,6,18,140.7825850340136,142.6634013605442,48,46,82,2,12
635,6,252,140.7825850340136,142.43120181405897,48,31,256,2,246
636,6,276,140.7825850340136,142.8259410430839,48,28,284,2,270
637,6,247,140.7825850340136,143.7082993197279,48,31,272,3,241
638,6,411,140.7825850340136,141.96680272108844,48,21,408,1,405
639,5,18,141.64172335600907,142.6634013605442,48,46,46,1,13
640,5,276,141.64172335600907,142.8259410430839,48,28,276,1,271
641,5,247,141.64172335600907,143.7082993197279,48,31,258,2,242
642,18,5,142.6634013605442,144.45133786848072,46,46,78,2,13
643,18,5,142.6634013605442,145.07827664399093,46,47,105,2,13
644,18,247,142.6634013605442,143.7082993197279,46,31,233,1,229
645,18,207,142.6634013605442,144.82285714285715,46,28,211,2,189
646,18,420,142.6634013605442,145.35691609977326,46,26,418,3,402
647,5,231,144.45133786848072,145.98385487528344,46,29,235,2,226
648,5,246,144.45133786848072,146.79655328798185,46,30,261,2,241
649,5,446,144.45133786848072,146.49469387755101,46,22,450,2,441
650,5,410,144.45133786848072,147.35383219954647,46,25,424,3,405
651,5,246,145.07827664399093,146.79655328798185,47,30,252,2,241
652,5,205,145.07827664399093,147.5395918367347,47,30,226,2,200
653,5,446,145.07827664399093,146.49469387755101,47,22,445,1,441
654,5,410,145.07827664399093,147.35383219954647,47,25,417,2,405
655,5,419,145.07827664399093,147.5395918367347,47,28,427,2,414
656,5,4,146.35537414965987,148.5380498866213,48,45,94,2,1
657,5,18,146.35537414965987,148.86312925170068,48,46,109,3,13
658,5,205,146.35537414965987,147.5395918367347,48,30,206,1,200
659,5,245,146.35537414965987,149.25786848072562,48,31,271,3,240
660,5,419,146.35537414965987,147.5395918367347,48,28,417,1,414
661,5,411,146.35537414965987,149.11854875283447,48,25,423,3,406
662,5,4,146.70367346938775,148.5380498866213,47,45,79,2,1
663,5,18,146.70367346938775,148.86312925170068,47,46,94,2,13
664,5,245,146.70367346938775,149.25786848072562,47,31,264,3,240
665,5,206,146.70367346938775,149.582947845805,47,32,236,3,201
666,5,411,146.70367346938775,149.11854875283447,47,25,419,2,406
667,4,6,148.5380498866213,149.95446712018142,45,45,61,1,2
668,4,6,148.5380498866213,151.32444444444445,45,47,120,3,2
669,4,206,148.5380498866213,149.582947845805,45,32,207,1,202
670,4,278,148.5380498866213,151.48698412698414,45,31,302,3,274
671,4,442,148.5380498866213,151.32444444444445,45,21,454,3,438
672,18,6,148.86312925170068,149.95446712018142,46,45,49,1,12
673,18,6,148.86312925170068,151.32444444444445,46,47,107,2,12
674,18,278,148.86312925170068,151.48698412698414,46,31,283,3,260
675,18,246,148.86312925170068,151.8120634920635,46,31,261,3,228
676,18,442,148.86312925170068,151.32444444444445,46,21,437,2,424
677,6,18,149.95446712018142,151.6263038548753,45,47,73,2,12
678,6,46,149.95446712018142,152.64798185941044,45,46,123,3,40
679,6,278,149.95446712018142,151.48698412698414,45,31,280,2,272
680,6,246,149.95446712018142,151.8120634920635,45,31,253,2,240
681,6,442,149.95446712018142,151.32444444444445,45,21,440,1,436
682,6,417,149.95446712018142,152.20680272108845,45,23,422,2,411
683,6,46,151.32444444444445,152.64798185941044,47,46,70,1,40
684,6,18,151.32444444444445,153.6928798185941,47,46,103,2,12
685,6,275,151.32444444444445,153.18204081632652,47,31,281,2,269
686,6,277,151.32444444444445,153.87863945578232,47,32,292,3,271
687,6,442,151.32444444444445,154.08761904761906,47,17,452,3,436
688,18,46,151.6263038548753,152.64798185941044,47,46,52,1,28
689,18,275,151.6263038548753,153.18204081632652,47,31,266,2,257
690,18,277,151.6263038548753,153.87863945578232,47,32,277,2,259
691,18,442,151.6263038548753,154.08761904761906,47,17,437,2,424
692,46,18,152.64798185941044,153.6928798185941,46,46,53,1,28
693,46,83,152.64798185941044,154.64489795918368,46,46,94,2,37
694,46,277,152.64798185941044,153.87863945578232,46,32,237,1,231
695,46,246,152.64798185941044,154.73777777777778,46,32,219,2,200
696,46,442,152.64798185941044,154.08761904761906,46,17,401,1,396
697,46,436,152.64798185941044,155.4575963718821,46,21,408,3,390
698,18,5,153.6928798185941,156.1774149659864,46,46,108,2,13
699,18,246,153.6928798185941,154.73777777777778,46,32,232,1,228
700,18,207,153.6928798185941,155.80589569160998,46,33,210,2,189
701,18,436,153.6928798185941,155.4575963718821,46,21,425,2,418
702,18,425,153.6928798185941,156.38639455782314,46,25,423,3,407
703,83,5,154.64489795918368,156.1774149659864,46,46,102,2,78
704,83,6,154.64489795918368,156.8043537414966,46,46,121,2,77
705,83,207,154.64489795918368,155.80589569160998,46,33,134,1,124
706,83,275,154.64489795918368,156.9901133786848,46,34,217,2,192
707,83,425,154.64489795918368,156.38639455782314,46,25,350,2,342
708,83,429,154.64489795918368,157.52417233560092,46,18,368,3,346
709,5,46,156.1774149659864,159.05668934240364,46,36,131,3,41
710,5,206,156.1774149659864,158.54585034013607,46,36,225,2,201
711,5,207,156.1774149659864,158.61551020408163,46,38,228,2,202
712,5,429,156.1774149659864,157.52417233560092,46,18,428,1,424
713,5,458,156.1774149659864,157.8724716553288,46,18,459,2,453
714,6,46,156.8043537414966,159.05668934240364,46,36,105,2,40
715,6,206,156.8043537414966,158.54585034013607,46,36,214,2,200
716,6,207,156.8043537414966,158.61551020408163,46,38,216,2,201
717,6,458,156.8043537414966,157.8724716553288,46,18,454,1,452
718,6,463,156.8043537414966,159.381768707483,46,14,470,3,457
719,5,46,157.68671201814058,159.05668934240364,48,36,72,1,41
720,5,122,157.68671201814058,160.47310657596373,48,44,168,3,117
721,5,246,157.68671201814058,160.2873469387755,48,38,266,3,241
722,5,245,157.68671201814058,160.58920634920636,48,35,271,3,240
723,5,463,157.68671201814058,159.381768707483,48,14,464,2,458
724,5,488,157.68671201814058,160.24090702947845,48,19,495,3,483
725,46,122,159.05668934240364,160.47310657596373,36,44,97,1,76
726,46,123,159.05668934240364,160.70530612244897,36,36,105,2,77
727,46,121,159.05668934240364,161.63410430839002,36,18,134,3,75
728,46,246,159.05668934240364,160.2873469387755,36,38,207,1,200
729,46,245,159.05668934240364,160.58920634920636,36,35,210,2,199
730,46,488,159.05668934240364,160.24090702947845,36,19,445,1,442
731,122,121,160.47310657596373,161.63410430839002,44,18,50,1,1
732,229,165,1.6253968253968254,3.8312925170068026,26,35,115,2,64
733,229,247,1.6253968253968254,2.670294784580499,26,33,48,1,18
734,229,246,1.6253968253968254,3.7616326530612247,26,27,94,2,17
735,229,206,1.6253968253968254,4.179591836734694,26,32,112,3,23
736,229,445,1.6253968253968254,2.670294784580499,26,20,221,1,216
737,229,485,1.6253968253968254,3.1579138321995464,26,16,264,2,256
738,247,165,2.670294784580499,3.8312925170068026,33,35,96,1,82
739,247,185,2.670294784580499,4.96907029478458,33,34,117,2,62
740,247,246,2.670294784580499,3.7616326530612247,33,27,47,1,1
741,247,206,2.670294784580499,4.179591836734694,33,32,77,2,41
742,246,185,3.7616326530612247,4.96907029478458,27,34,80,1,61
743,246,121,3.7616326530612247,5.944308390022676,27,40,156,2,125
744,246,243,3.7616326530612247,5.944308390022676,27,32,94,2,3
745,246,206,3.7616326530612247,6.15328798185941,27,33,110,2,40
746,246,482,3.7616326530612247,5.7817687074829935,27,15,252,2,236
747,246,693,3.7616326530612247,6.524807256235828,27,16,463,3,447
748,206,121,4.179591836734694,5.944308390022676,32,40,114,2,85
749,206,18,4.179591836734694,6.8034467120181406,32,48,219,3,188
750,206,243,4.179591836734694,5.944308390022676,32,32,85,2,37
751,206,482,4.179591836734694,5.7817687074829935,32,15,284,2,276
752,206,498,4.179591836734694,6.826666666666667,32,18,313,3,292
753,206,693,4.179591836734694,6.524807256235828,32,16,497,2,487
754,243,18,5.944308390022676,7.476825396825397,32,48,234,2,225
755,243,6,5.944308390022676,8.359183673469389,32,50,259,2,237
756,243,275,5.944308390022676,7.685804988662132,32,31,82,2,32
757,243,246,5.944308390022676,8.382403628117913,32,30,105,2,3
758,243,545,5.944308390022676,7.5232653061224495,32,17,310,2,302
759,243,429,5.944308390022676,8.219863945578231,32,18,210,2,186
760,243,727,5.944308390022676,7.5232653061224495,32,15,489,2,484
761,243,678,5.944308390022676,8.544943310657597,32,18,449,3,435
762,206,18,6.15328798185941,7.476825396825397,33,48,196,1,188
763,206,6,6.15328798185941,8.359183673469389,33,50,221,2,200
764,206,275,6.15328798185941,7.685804988662132,33,31,95,2,69
765,206,246,6.15328798185941,8.382403628117913,33,30,104,2,40
766,206,545,6.15328798185941,7.5232653061224495,33,17,344,1,339
767,206,429,6.15328798185941,8.219863945578231,33,18,240,2,223
768,206,678,6.15328798185941,8.544943310657597,33,18,483,2,472
769,275,6,7.685804988662132,9.218321995464853,31,49,277,2,269
770,275,206,7.685804988662132,9.58984126984127,31,33,107,2,69
771,275,277,7.685804988662132,10.448979591836736,31,32,119,3,2
772,275,446,7.685804988662132,9.752380952380953,31,20,193,2,171
773,275,446,7.685804988662132,10.495419501133787,31,18,209,3,171
774,275,678,7.685804988662132,9.752380952380953,31,18,413,2,403
775,246,18,8.382403628117913,10.936598639455783,30,48,253,3,228
776,246,206,8.382403628117913,9.58984126984127,30,33,66,1,40
777,246,277,8.382403628117913,10.448979591836736,30,32,94,2,31
778,246,244,8.382403628117913,11.3081179138322,30,31,126,3,2
779,246,446,8.382403628117913,9.752380952380953,30,20,209,1,200
780,246,446,8.382403628117913,10.495419501133787,30,18,220,2,200
781,246,678,8.382403628117913,9.752380952380953,30,18,436,1,432
782,246,693,8.382403628117913,10.797278911564627,30,18,459,2,447
783,206,18,9.58984126984127,10.936598639455783,33,48,197,1,188
784,206,6,9.58984126984127,11.470657596371883,33,47,216,2,200
785,206,244,9.58984126984127,11.3081179138322,33,31,83,2,38
786,206,205,9.58984126984127,12.445895691609978,33,31,123,3,1
787,206,459,9.58984126984127,11.679637188208616,33,17,269,2,253
788,206,693,9.58984126984127,10.797278911564627,33,18,490,1,487
789,206,693,9.58984126984127,12.051156462585034,33,15,498,2,487
790,277,6,10.448979591836736,11.470657596371883,32,47,275,1,271
791,277,5,10.448979591836736,12.678095238095239,32,50,288,2,272
792,277,205,10.448979591836736,12.445895691609978,32,31,112,2,72
793,277,459,10.448979591836736,11.679637188208616,32,17,190,1,182
794,277,448,10.448979591836736,12.631655328798185,32,16,195,2,171
795,277,693,10.448979591836736,12.051156462585034,32,15,422,2,416
796,244,5,11.3081179138322,12.678095238095239,31,50,246,1,239
797,244,5,11.3081179138322,13.931972789115646,31,50,264,3,239
798,244,5,11.3081179138322,14.280272108843537,31,49,271,3,239
799,244,205,11.3081179138322,12.445895691609978,31,31,63,1,39
800,244,247,11.3081179138322,13.885532879818594,31,31,111,3,3
801,244,448,11.3081179138322,12.631655328798185,31,16,212,1,204
802,244,429,11.3081179138322,13.746213151927439,31,18,213,2,185
803,244,678,11.3081179138322,14.02485260770975,31,14,449,3,434
804,244,678,11.3081179138322,14.048072562358277,31,17,450,3,434
805,205,5,12.445895691609978,13.931972789115646,31,50,210,1,200
806,205,5,12.445895691609978,14.280272108843537,31,49,215,2,200
807,205,247,12.445895691609978,13.885532879818594,31,31,75,1,42
808,205,246,12.445895691609978,14.419591836734694,31,31,94,2,41
809,205,429,12.445895691609978,13.746213151927439,31,18,231,1,224
810,205,446,12.445895691609978,14.582131519274377,31,20,258,2,241
811,205,678,12.445895691609978,14.02485260770975,31,14,478,2,473
812,205,678,12.445895691609978,14.048072562358277,31,17,478,2,473
813,247,18,13.885532879818594,15.766349206349206,31,49,243,2,229
814,247,18,13.885532879818594,16.46294784580499,31,48,254,3,229
815,247,207,13.885532879818594,15.673469387755102,31,23,87,2,40
816,247,545,13.885532879818594,15.789569160997733,31,16,309,2,298
817,247,479,13.885532879818594,16.486167800453515,31,18,258,3,232
818,247,643,13.885532879818594,16.857687074829933,31,14,416,3,396
819,246,18,14.419591836734694,15.766349206349206,31,49,235,1,228
820,246,18,14.419591836734694,16.46294784580499,31,48,244,2,228
821,246,207,14.419591836734694,15.673469387755102,31,23,67,1,39
822,246,230,14.419591836734694,16.904126984126986,31,35,108,2,16
823,246,545,14.419591836734694,15.789569160997733,31,16,305,1,299
824,246,479,14.419591836734694,16.486167800453515,31,18,249,2,233
825,246,643,14.419591836734694,16.857687074829933,31,14,411,2,397
826,207,18,15.673469387755102,17.832925170068027,23,49,211,2,189
827,207,18,15.673469387755102,18.52952380952381,23,48,225,3,189
828,207,230,15.673469387755102,16.904126984126986,23,35,58,1,23
829,207,229,15.673469387755102,17.623945578231293,23,29,87,2,22
830,207,205,15.673469387755102,18.45986394557823,23,28,120,3,2
831,207,551,15.673469387755102,17.438185941043084,23,23,352,2,344
832,207,545,15.673469387755102,18.552743764172337,23,15,360,3,338
833,207,643,15.673469387755102,16.857687074829933,23,14,439,1,436
834,207,677,15.673469387755102,17.438185941043084,23,19,476,2,470
835,230,18,16.904126984126986,18.52952380952381,35,48,223,2,212
836,230,18,16.904126984126986,19.202902494331067,35,48,234,2,212
837,230,205,16.904126984126986,18.45986394557823,35,28,72,2,25
838,230,266,16.904126984126986,19.82984126984127,35,25,131,3,36
839,230,545,16.904126984126986,18.552743764172337,35,15,323,2,315
840,230,421,16.904126984126986,19.760181405895693,35,20,227,3,191
841,229,18,17.623945578231293,19.202902494331067,29,48,222,2,211
842,229,18,17.623945578231293,20.59609977324263,29,48,247,3,211
843,229,266,17.623945578231293,19.82984126984127,29,25,102,2,37
844,229,226,17.623945578231293,20.59609977324263,29,19,128,3,3
845,229,421,17.623945578231293,19.760181405895693,29,20,213,2,192
846,205,18,18.45986394557823,20.59609977324263,28,48,208,2,187
847,205,266,18.45986394557823,19.82984126984127,28,25,85,1,61
848,205,226,18.45986394557823,20.59609977324263,28,19,94,2,21
849,205,247,18.45986394557823,21.36235827664399,28,25,132,3,42
850,205,421,18.45986394557823,19.760181405895693,28,20,223,1,216
851,205,475,18.45986394557823,20.619319727891156,28,15,286,2,270
852,266,18,19.82984126984127,21.966077097505668,25,49,265,2,248
853,266,18,19.82984126984127,22.66267573696145,25,48,276,3,248
854,266,247,19.82984126984127,21.36235827664399,25,25,69,2,19
855,266,479,19.82984126984127,21.989297052154196,25,18,232,2,213
856,266,459,19.82984126984127,22.709115646258503,25,18,229,3,193
857,266,617,19.82984126984127,22.407256235827663,25,18,368,3,351
858,226,18,20.59609977324263,21.966077097505668,19,49,216,1,208
859,226,18,20.59609977324263,22.66267573696145,19,48,226,2,208
860,226,208,20.59609977324263,23.057414965986396,19,29,108,2,18
861,226,205,20.59609977324263,23.127074829931974,19,29,111,3,21
862,226,479,20.59609977324263,21.989297052154196,19,18,260,1,253
863,226,459,20.59609977324263,22.709115646258503,19,18,250,2,233
864,226,467,20.59609977324263,23.38249433106576,19,17,269,3,241
865,226,617,20.59609977324263,22.407256235827663,19,18,399,2,391
866,247,18,21.36235827664399,22.66267573696145,25,48,236,1,229
867,247,18,21.36235827664399,24.03265306122449,25,48,256,3,229
868,247,208,21.36235827664399,23.057414965986396,25,29,83,2,39
869,247,205,21.36235827664399,23.127074829931974,25,29,87,2,42
870,247,459,21.36235827664399,22.709115646258503,25,18,220,1,212
871,247,467,21.36235827664399,23.38249433106576,25,17,237,2,220
872,247,617,21.36235827664399,22.407256235827663,25,18,373,1,370
873,208,18,23.057414965986396,24.729251700680273,29,49,203,2,190
874,208,18,23.057414965986396,25.425850340136055,29,49,216,2,190
875,208,211,23.057414965986396,24.752471655328797,29,24,73,2,3
876,208,479,23.057414965986396,24.752471655328797,29,17,281,2,271
877,208,417,23.057414965986396,25.472290249433108,29,18,233,2,209
878,205,18,23.127074829931974,24.729251700680273,29,49,199,2,187
879,205,18,23.127074829931974,25.425850340136055,29,49,212,2,187
880,205,211,23.127074829931974,24.752471655328797,29,24,70,2,6
881,205,479,23.127074829931974,24.752471655328797,29,17,283,2,274
882,205,417,23.127074829931974,25.472290249433108,29,18,235,2,212
883,211,18,24.752471655328797,26.795827664399095,24,49,212,2,193
884,211,18,24.752471655328797,27.492426303854877,24,49,226,3,193
885,211,205,24.752471655328797,26.05278911564626,24,21,56,1,6
886,211,252,24.752471655328797,26.679727891156464,24,24,93,2,41
887,211,522,24.752471655328797,26.424308390022677,24,31,319,2,311
888,211,479,24.752471655328797,27.515646258503402,24,16,293,3,268
889,211,684,24.752471655328797,26.424308390022677,24,26,478,2,473
890,205,18,26.05278911564626,27.492426303854877,21,49,197,1,187
891,205,18,26.05278911564626,28.862403628117914,21,48,223,3,187
892,205,211,26.05278911564626,27.515646258503402,21,20,63,1,6
893,205,208,26.05278911564626,28.53732426303855,21,21,107,2,3
894,205,479,26.05278911564626,27.515646258503402,21,16,281,1,274
895,205,540,26.05278911564626,28.76952380952381,21,27,355,3,335
896,205,633,26.05278911564626,28.76952380952381,21,22,444,3,428
897,252,18,26.679727891156464,28.862403628117914,24,48,252,2,234
898,252,18,26.679727891156464,29.559002267573696,24,49,265,3,234
899,252,208,26.679727891156464,28.53732426303855,24,21,91,2,44
900,252,207,26.679727891156464,29.489342403628118,24,22,129,3,45
901,252,540,26.679727891156464,28.76952380952381,24,27,302,2,288
902,252,491,26.679727891156464,29.60544217687075,24,15,270,3,239
903,252,633,26.679727891156464,28.76952380952381,24,22,391,2,381
904,211,18,27.515646258503402,28.862403628117914,20,48,202,1,193
905,211,18,27.515646258503402,29.559002267573696,20,49,212,2,193
906,211,18,27.515646258503402,30.25560090702948,20,49,226,3,193
907,211,208,27.515646258503402,28.53732426303855,20,21,44,1,3
908,211,207,27.515646258503402,29.489342403628118,20,22,85,2,4
909,211,540,27.515646258503402,28.76952380952381,20,27,333,1,329
910,211,491,27.515646258503402,29.60544217687075,20,15,294,2,280
911,211,524,27.515646258503402,30.48780045351474,20,32,338,3,313
912,211,633,27.515646258503402,28.76952380952381,20,22,425,1,422
913,208,18,28.53732426303855,29.559002267573696,21,49,195,1,190
914,208,18,28.53732426303855,30.25560090702948,21,49,204,2,190
915,208,209,28.53732426303855,30.859319727891158,21,26,100,2,1
916,208,491,28.53732426303855,29.60544217687075,21,15,287,1,283
917,208,524,28.53732426303855,30.48780045351474,21,32,327,2,316
918,207,18,29.489342403628118,31.62557823129252,22,48,210,2,189
919,207,18,29.489342403628118,32.3221768707483,22,49,225,3,189
920,207,209,29.489342403628118,30.859319727891158,22,26,59,1,2
921,207,231,29.489342403628118,31.67201814058957,22,24,97,2,24
922,207,465,29.489342403628118,31.648798185941043,22,16,274,2,258
923,207,452,29.489342403628118,32.3221768707483,22,19,274,3,245
924,209,18,30.859319727891158,32.3221768707483,26,49,201,1,191
925,209,18,30.859319727891158,33.69215419501134,26,48,227,3,191
926,209,311,30.859319727891158,33.04199546485261,26,20,139,2,102
927,209,278,30.859319727891158,33.41351473922902,26,23,130,3,69
928,209,452,30.859319727891158,32.3221768707483,26,19,251,1,243
929,209,459,30.859319727891158,33.73859410430839,26,17,279,3,250
930,209,679,30.859319727891158,33.04199546485261,26,15,479,2,470
931,209,691,30.859319727891158,33.73859410430839,26,16,498,3,482
932,231,18,31.67201814058957,33.69215419501134,24,48,230,2,213
933,231,18,31.67201814058957,34.38875283446712,24,48,243,3,213
934,231,311,31.67201814058957,33.04199546485261,24,20,99,1,80
935,231,278,31.67201814058957,33.41351473922902,24,23,89,2,47
936,231,347,31.67201814058957,34.59773242630386,24,30,171,3,116
937,231,459,31.67201814058957,33.73859410430839,24,17,245,2,228
938,231,679,31.67201814058957,33.04199546485261,24,15,452,1,448
939,231,691,31.67201814058957,33.73859410430839,24,16,469,2,460
940,311,18,33.04199546485261,34.38875283446712,20,48,299,1,293
941,311,52,33.04199546485261,35.572970521541954,20,49,281,3,259
942,311,347,33.04199546485261,34.59773242630386,20,30,76,2,36
943,311,231,33.04199546485261,35.71229024943311,20,26,140,3,80
944,311,414,33.04199546485261,34.66739229024943,20,25,125,2,103
945,311,479,33.04199546485261,35.781950113378684,20,16,205,3,168
946,278,52,33.41351473922902,35.572970521541954,23,49,244,2,226
947,278,347,33.41351473922902,34.59773242630386,23,30,86,1,69
948,278,231,33.41351473922902,35.71229024943311,23,26,110,2,47
949,278,233,33.41351473922902,36.339229024943315,23,21,134,3,45
950,278,414,33.41351473922902,34.66739229024943,23,25,146,1,136
951,278,479,33.41351473922902,35.781950113378684,23,16,225,2,201
952,347,18,34.59773242630386,36.45532879818594,30,48,339,2,329
953,347,18,34.59773242630386,37.151927437641724,30,48,347,3,329
954,347,231,34.59773242630386,35.71229024943311,30,26,126,1,116
955,347,233,34.59773242630386,36.339229024943315,30,21,136,2,114
956,347,479,34.59773242630386,35.781950113378684,30,16,142,1,132
957,347,524,34.59773242630386,36.5946485260771,30,18,197,2,177
958,347,467,34.59773242630386,37.17514739229025,30,15,163,3,120
959,347,817,34.59773242630386,36.617868480725626,30,18,478,2,470
960,347,839,34.59773242630386,35.80517006802721,30,14,495,1,492
961,231,18,35.71229024943311,37.151927437641724,26,48,222,1,213
962,231,386,35.71229024943311,37.871746031746035,26,20,181,2,155
963,231,467,35.71229024943311,37.17514739229025,26,15,244,1,236
964,233,6,36.339229024943315,39.05596371882086,21,47,255,3,227
965,233,46,36.339229024943315,39.288163265306125,21,48,226,3,187
966,233,386,36.339229024943315,37.871746031746035,21,20,167,2,153
967,233,260,36.339229024943315,38.800544217687076,21,27,109,2,27
968,233,483,36.339229024943315,39.07918367346939,21,24,276,3,250
969,233,459,36.339229024943315,39.2649433106576,21,16,259,3,226
970,386,6,37.871746031746035,39.05596371882086,20,47,383,1,380
971,386,46,37.871746031746035,39.288163265306125,20,48,345,1,340
972,386,18,37.871746031746035,40.58848072562358,20,48,386,3,368
973,386,211,37.871746031746035,39.59002267573696,20,23,190,2,175
974,386,483,37.871746031746035,39.07918367346939,20,24,110,1,97
975,386,459,37.871746031746035,39.2649433106576,20,16,94,1,73
976,386,476,37.871746031746035,40.61170068027211,20,15,148,3,90
977,386,808,37.871746031746035,39.07918367346939,20,18,425,1,422
978,386,799,37.871746031746035,39.125623582766444,20,14,417,1,413
979,386,865,37.871746031746035,39.07918367346939,20,22,482,1,479
980,260,18,38.800544217687076,40.58848072562358,27,48,254,2,242
981,260,6,38.800544217687076,41.470839002267574,27,48,279,3,254
982,260,208,38.800544217687076,40.96,27,27,107,2,52
983,260,476,38.800544217687076,40.61170068027211,27,15,230,2,216
984,260,661,38.800544217687076,41.35473922902494,27,25,416,3,401
985,211,6,39.59002267573696,41.470839002267574,23,48,220,2,205
986,211,47,39.59002267573696,42.190657596371885,23,47,199,3,164
987,211,208,39.59002267573696,40.96,23,27,59,1,3
988,211,245,39.59002267573696,42.09777777777778,23,26,113,3,34
989,211,235,39.59002267573696,42.190657596371885,23,23,115,3,24
990,211,476,39.59002267573696,40.61170068027211,23,15,269,1,265
991,211,502,39.59002267573696,41.86557823129252,23,29,307,2,291
992,211,661,39.59002267573696,41.35473922902494,23,25,456,2,450
993,208,47,40.96,42.190657596371885,27,47,169,1,161
994,208,18,40.96,43.35165532879819,27,48,216,2,190
995,208,245,40.96,42.09777777777778,27,26,61,1,37
996,208,235,40.96,42.190657596371885,27,23,59,1,27
997,208,386,40.96,43.39809523809524,27,20,207,2,178
998,208,476,40.96,42.79437641723356,27,26,279,2,268
999,208,674,40.96,42.74793650793651,27,16,472,2,466
1000,245,18,42.09777777777778,43.35165532879819,26,48,233,1,227
1001,245,6,42.09777777777778,44.58231292517007,26,47,262,2,239
1002,245,386,42.09777777777778,43.39809523809524,26,20,152,1,141
1003,245,271,42.09777777777778,44.81451247165533,26,27,120,3,26
1004,245,479,42.09777777777778,44.0714739229025,26,15,249,2,234
1005,245,459,42.09777777777778,44.76807256235828,26,17,243,3,214
1006,245,699,42.09777777777778,44.74485260770975,26,17,468,3,454
1007,235,18,42.190657596371885,43.35165532879819,23,48,223,1,217
1008,235,6,42.190657596371885,44.58231292517007,23,47,251,2,229
1009,235,386,42.190657596371885,43.39809523809524,23,20,160,1,151
1010,235,271,42.190657596371885,44.81451247165533,23,27,119,3,36
1011,235,479,42.190657596371885,44.0714739229025,23,15,257,2,244
1012,235,459,42.190657596371885,44.76807256235828,23,17,250,3,224
1013,235,699,42.190657596371885,44.74485260770975,23,17,477,3,464
1014,386,6,43.39809523809524,44.58231292517007,20,47,383,1,380
1015,386,5,43.39809523809524,45.7665306122449,20,48,394,2,381
1016,386,271,43.39809523809524,44.81451247165533,20,27,130,1,115
1017,386,329,43.39809523809524,45.27891156462585,20,18,99,2,57
1018,386,459,43.39809523809524,44.76807256235828,20,17,94,1,73
1019,386,553,43.39809523809524,45.65043083900227,20,26,193,2,167
1020,386,534,43.39809523809524,46.27736961451247,20,28,193,3,148
1021,386,699,43.39809523809524,44.74485260770975,20,17,318,1,313
1022,386,628,43.39809523809524,45.60399092970522,20,23,260,2,242
1023,386,694,43.39809523809524,46.34702947845805,20,24,333,3,308
1024,386,870,43.39809523809524,44.76807256235828,20,16,488,1,484
1025,386,853,43.39809523809524,46.300589569161,20,23,483,3,467
1026,271,5,44.81451247165533,47.04362811791383,27,48,283,2,266
1027,271,5,44.81451247165533,47.391927437641726,27,47,288,3,266
1028,271,216,44.81451247165533,46.88108843537415,27,25,105,2,55
1029,271,254,44.81451247165533,47.159727891156464,27,22,102,2,17
1030,271,534,44.81451247165533,46.27736961451247,27,28,270,1,263
1031,271,511,44.81451247165533,47.484807256235825,27,19,266,3,240
1032,271,694,44.81451247165533,46.34702947845805,27,24,428,2,423
1033,271,704,44.81451247165533,47.438367346938776,27,23,448,3,433
1034,329,5,45.27891156462585,47.04362811791383,18,48,333,2,324
1035,329,5,45.27891156462585,47.391927437641726,18,47,337,2,324
1036,329,216,45.27891156462585,46.88108843537415,18,25,132,2,113
1037,329,254,45.27891156462585,47.159727891156464,18,22,110,2,75
1038,329,215,45.27891156462585,48.204625850340136,18,20,170,3,114
1039,329,511,45.27891156462585,47.484807256235825,18,19,205,2,182
1040,329,694,45.27891156462585,46.34702947845805,18,24,368,1,365
1041,329,704,45.27891156462585,47.438367346938776,18,23,386,2,375
1042,329,826,45.27891156462585,47.438367346938776,18,20,506,2,497
1043,216,18,46.88108843537415,48.87800453514739,25,47,216,2,198
1044,216,18,46.88108843537415,49.55138321995465,25,47,229,3,198
1045,216,215,46.88108843537415,48.204625850340136,25,20,57,1,1
1046,216,298,46.88108843537415,49.31918367346939,25,22,133,2,82
1047,216,411,46.88108843537415,48.48326530612245,25,18,207,2,195
1048,254,18,47.159727891156464,48.87800453514739,22,47,247,2,236
1049,254,18,47.159727891156464,49.55138321995465,22,47,257,2,236
1050,254,215,47.159727891156464,48.204625850340136,22,20,60,1,39
1051,254,298,47.159727891156464,49.31918367346939,22,22,103,2,44
1052,254,411,47.159727891156464,48.48326530612245,22,18,167,1,157
1053,254,490,47.159727891156464,50.108662131519274,22,26,268,3,236
1054,215,18,48.204625850340136,49.55138321995465,20,47,205,1,197
1055,215,6,48.204625850340136,50.64272108843537,20,47,234,2,209
1056,215,298,48.204625850340136,49.31918367346939,20,22,96,1,83
1057,215,211,48.204625850340136,50.61950113378685,20,22,104,2,4
1058,215,490,48.204625850340136,50.108662131519274,20,26,287,2,275
1059,215,459,48.204625850340136,50.29442176870749,20,17,260,2,244
1060,298,6,49.31918367346939,50.64272108843537,22,47,298,1,292
1061,298,6,49.31918367346939,51.2928798185941,22,49,304,2,292
1062,298,211,49.31918367346939,50.61950113378685,22,22,103,1,87
1063,298,249,49.31918367346939,52.15201814058957,22,25,131,3,49
1064,298,545,49.31918367346939,51.66439909297052,22,14,267,2,247
1065,211,6,50.61950113378685,52.848616780045354,22,47,226,2,205
1066,211,249,50.61950113378685,52.15201814058957,22,25,76,2,38
1067,211,255,50.61950113378685,52.66285714285714,22,27,98,2,44
1068,211,247,50.61950113378685,53.19691609977324,22,22,117,3,36
1069,211,545,50.61950113378685,51.66439909297052,22,14,337,1,334
1070,211,512,50.61950113378685,52.91827664399093,22,29,317,2,301
1071,211,674,50.61950113378685,52.407437641723355,22,29,469,2,463
1072,249,18,52.15201814058957,53.68453514739229,25,47,240,2,231
1073,249,18,52.15201814058957,54.381133786848075,25,48,250,2,231
1074,249,247,52.15201814058957,53.19691609977324,25,22,45,1,2
1075,249,211,52.15201814058957,55.100952380952386,25,23,133,3,38
1076,249,457,52.15201814058957,53.75419501133787,25,18,219,2,208
1077,249,478,52.15201814058957,55.100952380952386,25,17,262,3,229
1078,249,679,52.15201814058957,55.12417233560091,25,14,449,3,430
1079,255,18,52.66285714285714,53.68453514739229,27,47,241,1,237
1080,255,18,52.66285714285714,54.381133786848075,27,48,248,2,237
1081,255,5,52.66285714285714,55.61179138321996,27,47,280,3,250
1082,255,211,52.66285714285714,55.100952380952386,27,23,114,2,44
1083,255,457,52.66285714285714,53.75419501133787,27,18,207,1,202
1084,255,478,52.66285714285714,55.100952380952386,27,17,246,2,223
1085,255,679,52.66285714285714,55.12417233560091,27,14,437,2,424
1086,247,18,53.19691609977324,54.381133786848075,22,48,235,1,229
1087,247,5,53.19691609977324,55.61179138321996,22,47,263,2,242
1088,247,211,53.19691609977324,55.100952380952386,22,23,90,2,36
1089,247,272,53.19691609977324,55.797551020408164,22,32,115,3,25
1090,247,478,53.19691609977324,55.100952380952386,22,17,245,2,231
1091,247,459,53.19691609977324,55.797551020408164,22,17,240,3,212
1092,247,679,53.19691609977324,55.12417233560091,22,14,440,2,432
1093,211,5,55.100952380952386,56.86566893424036,23,47,220,2,206
1094,211,54,55.100952380952386,57.56226757369615,23,46,189,2,157
1095,211,266,55.100952380952386,56.49414965986394,23,26,81,1,55
1096,211,216,55.100952380952386,57.88734693877551,23,30,120,3,5
1097,211,614,55.100952380952386,56.65668934240363,23,24,409,2,403
1098,211,521,55.100952380952386,57.399727891156466,23,30,325,2,310
1099,211,693,55.100952380952386,56.679909297052156,23,27,487,2,482
1100,272,5,55.797551020408164,56.86566893424036,32,47,271,1,267
1101,272,54,55.797551020408164,57.56226757369615,32,46,231,2,218
1102,272,5,55.797551020408164,58.35174603174603,32,47,289,3,267
1103,272,216,55.797551020408164,57.88734693877551,32,30,106,2,56
1104,272,521,55.797551020408164,57.399727891156466,32,30,258,2,249
1105,272,551,55.797551020408164,58.537505668934244,32,22,303,3,279
1106,272,705,55.797551020408164,58.51428571428571,32,22,449,3,433
1107,266,54,56.49414965986394,57.56226757369615,26,46,217,1,212
1108,266,5,56.49414965986394,58.35174603174603,26,47,273,2,261
1109,266,216,56.49414965986394,57.88734693877551,26,30,78,1,50
1110,266,243,56.49414965986394,58.88580498866213,26,24,106,2,23
1111,266,207,56.49414965986394,59.303764172335605,26,29,135,3,59
1112,266,551,56.49414965986394,58.537505668934244,26,22,298,2,285
1113,266,418,56.49414965986394,59.396643990929704,26,20,197,3,152
1114,266,705,56.49414965986394,58.51428571428571,26,22,448,2,439
1115,216,18,57.88734693877551,59.90748299319728,30,47,216,2,198
1116,216,83,57.88734693877551,60.8130612244898,30,48,183,3,133
1117,216,207,57.88734693877551,59.303764172335605,30,29,62,1,9
1118,216,278,57.88734693877551,60.44154195011338,30,30,126,3,62
1119,216,418,57.88734693877551,59.396643990929704,30,20,212,2,202
1120,243,18,58.88580498866213,59.90748299319728,24,47,229,1,225
1121,243,83,58.88580498866213,60.8130612244898,24,48,180,2,160
1122,243,278,58.88580498866213,60.44154195011338,24,30,76,2,35
1123,243,207,58.88580498866213,61.39356009070295,24,28,114,3,36
1124,243,410,58.88580498866213,61.161360544217686,24,20,194,2,167
1125,243,416,58.88580498866213,61.37034013605442,24,20,203,2,173
1126,243,722,58.88580498866213,60.65052154195011,24,14,485,2,479
1127,207,83,59.303764172335605,60.8130612244898,29,48,140,2,124
1128,207,67,59.303764172335605,61.92761904761905,29,47,180,3,140
1129,207,278,59.303764172335605,60.44154195011338,29,30,86,1,71
1130,207,410,59.303764172335605,61.161360544217686,29,20,218,2,203
1131,207,416,59.303764172335605,61.37034013605442,29,20,227,2,209
1132,278,67,60.44154195011338,61.92761904761905,30,47,220,1,211
1133,278,6,60.44154195011338,63.018956916099775,30,47,294,3,272
1134,278,18,60.44154195011338,63.34403628117914,30,48,288,3,260
1135,278,275,60.44154195011338,63.20471655328798,30,31,119,3,3
1136,278,275,60.44154195011338,63.22793650793651,30,29,120,3,3
1137,278,475,60.44154195011338,62.415238095238095,30,22,215,2,197
1138,278,727,60.44154195011338,62.71709750566894,30,16,460,2,449
1139,207,6,61.39356009070295,63.018956916099775,28,47,213,2,201
1140,207,18,61.39356009070295,63.34403628117914,28,48,207,2,189
1141,207,275,61.39356009070295,63.20471655328798,28,31,103,2,68
1142,207,275,61.39356009070295,63.22793650793651,28,29,104,2,68
1143,207,475,61.39356009070295,62.415238095238095,28,22,272,1,268
1144,207,547,61.39356009070295,64.04063492063493,28,24,359,3,340
1145,207,657,61.39356009070295,63.99419501133787,28,22,464,3,450
1146,275,68,63.20471655328798,64.6443537414966,31,47,216,1,207
1147,275,18,63.20471655328798,66.10721088435375,31,48,286,3,257
1148,275,272,63.20471655328798,64.92299319727891,31,26,74,2,3
1149,275,603,63.20471655328798,64.52825396825396,31,15,333,1,328
1150,275,436,63.20471655328798,65.38739229024944,31,19,186,2,161
1151,275,68,63.22793650793651,64.6443537414966,29,47,216,1,207
1152,275,18,63.22793650793651,66.10721088435375,29,48,285,3,257
1153,275,272,63.22793650793651,64.92299319727891,29,26,73,2,3
1154,275,603,63.22793650793651,64.52825396825396,29,15,333,1,328
1155,275,436,63.22793650793651,65.38739229024944,29,19,186,2,161
1156,272,18,64.92299319727891,66.10721088435375,26,48,259,1,254
1157,272,81,64.92299319727891,67.10566893424037,26,47,213,2,191
1158,272,5,64.92299319727891,67.8487074829932,26,47,295,3,267
1159,272,247,64.92299319727891,66.47873015873016,26,32,72,2,25
1160,272,207,64.92299319727891,67.61650793650794,26,25,133,3,65
1161,272,459,64.92299319727891,66.85024943310658,26,16,205,2,187
1162,272,553,64.92299319727891,67.73260770975057,26,27,306,3,281
1163,272,679,64.92299319727891,67.68616780045352,26,26,424,3,407
1164,275,81,65.2712925170068,67.10566893424037,27,47,209,2,194
1165,275,5,65.2712925170068,67.8487074829932,27,47,292,3,270
1166,275,247,65.2712925170068,66.47873015873016,27,32,59,1,28
1167,275,207,65.2712925170068,67.61650793650794,27,25,122,2,68
1168,275,459,65.2712925170068,66.85024943310658,27,16,196,2,184
1169,275,553,65.2712925170068,67.73260770975057,27,27,298,2,278
1170,275,679,65.2712925170068,67.68616780045352,27,26,417,2,404
1171,247,5,66.47873015873016,67.8487074829932,32,47,249,1,242
1172,247,5,66.47873015873016,69.1025850340136,32,48,267,3,242
1173,247,5,66.47873015873016,69.4508843537415,32,48,274,3,242
1174,247,207,66.47873015873016,67.61650793650794,32,25,63,1,40
1175,247,346,66.47873015873016,68.94004535147393,32,26,145,2,99
1176,247,230,66.47873015873016,69.28834467120181,32,23,122,3,17
1177,247,553,66.47873015873016,67.73260770975057,32,27,311,1,306
1178,247,425,66.47873015873016,68.94004535147393,32,28,207,2,178
1179,247,679,66.47873015873016,67.68616780045352,32,26,435,1,432
1180,247,621,66.47873015873016,68.35954648526078,32,25,383,2,374
1181,207,5,67.61650793650794,69.1025850340136,25,48,212,1,202
1182,207,5,67.61650793650794,69.4508843537415,25,48,217,2,202
1183,207,346,67.61650793650794,68.94004535147393,25,26,150,1,139
1184,207,230,67.61650793650794,69.28834467120181,25,23,76,2,23
1185,207,261,67.61650793650794,70.4261224489796,25,26,133,3,54
1186,207,425,67.61650793650794,68.94004535147393,25,28,225,1,218
1187,207,555,67.61650793650794,70.14748299319729,25,28,365,3,348
1188,207,525,67.61650793650794,70.58866213151927,25,18,343,3,318
1189,207,630,67.61650793650794,70.12426303854875,25,22,437,3,423
1190,207,621,67.61650793650794,70.54222222222222,25,16,433,3,414
1191,346,51,68.94004535147393,70.65832199546486,26,47,304,2,295
1192,346,261,68.94004535147393,70.4261224489796,26,26,106,1,85
1193,346,555,68.94004535147393,70.14748299319729,26,28,215,1,209
1194,346,525,68.94004535147393,70.58866213151927,26,18,193,2,179
1195,346,630,68.94004535147393,70.12426303854875,26,22,289,1,284
1196,346,621,68.94004535147393,70.54222222222222,26,16,284,2,275
1197,346,830,68.94004535147393,70.12426303854875,26,23,487,1,484
1198,230,51,69.28834467120181,70.65832199546486,23,47,188,1,179
1199,230,52,69.28834467120181,72.12117913832199,23,45,216,3,178
1200,230,261,69.28834467120181,70.4261224489796,23,26,58,1,31
1201,230,234,69.28834467120181,72.12117913832199,23,32,122,3,4
1202,230,525,69.28834467120181,70.58866213151927,23,18,300,1,295
1203,230,621,69.28834467120181,70.54222222222222,23,16,395,1,391
1204,230,625,69.28834467120181,72.05151927437642,23,14,413,3,395
1205,261,52,70.4261224489796,72.12117913832199,26,45,221,2,209
1206,261,18,70.4261224489796,72.3069387755102,26,48,256,2,243
1207,261,234,70.4261224489796,72.12117913832199,26,32,78,2,27
1208,261,205,70.4261224489796,72.33015873015873,26,29,99,2,56
1209,261,260,70.4261224489796,73.25895691609978,26,24,122,3,1
1210,261,459,70.4261224489796,72.35337868480725,26,19,215,2,198
1211,261,625,70.4261224489796,72.05151927437642,26,14,371,2,364
1212,261,737,70.4261224489796,73.07319727891156,26,15,489,3,476
1213,234,18,72.12117913832199,73.70013605442178,32,48,226,2,216
1214,234,18,72.12117913832199,74.37351473922902,32,48,237,2,216
1215,234,260,72.12117913832199,73.25895691609978,32,24,55,1,26
1216,234,251,72.12117913832199,75.00045351473923,32,30,125,3,17
1217,234,545,72.12117913832199,73.7233560090703,32,14,319,2,311
1218,234,703,72.12117913832199,73.7233560090703,32,14,474,2,469
1219,234,624,72.12117913832199,74.81469387755102,32,16,407,3,390
1220,205,18,72.33015873015873,73.70013605442178,29,48,196,1,187
1221,205,18,72.33015873015873,74.37351473922902,29,48,207,2,187
1222,205,251,72.33015873015873,75.00045351473923,29,30,124,3,46
1223,205,545,72.33015873015873,73.7233560090703,29,14,345,1,340
1224,205,459,72.33015873015873,75.11655328798186,29,18,281,3,254
1225,205,703,72.33015873015873,73.7233560090703,29,14,502,1,498
1226,205,624,72.33015873015873,74.81469387755102,29,16,432,2,419
1227,260,18,73.25895691609978,74.37351473922902,24,48,247,1,242
1228,260,18,73.25895691609978,75.7667120181406,24,48,265,3,242
1229,260,251,73.25895691609978,75.00045351473923,24,30,76,2,9
1230,260,406,73.25895691609978,75.37197278911565,24,27,172,2,146
1231,260,459,73.25895691609978,75.11655328798186,24,18,214,2,199
1232,260,457,73.25895691609978,75.37197278911565,24,29,217,2,197
1233,260,624,73.25895691609978,74.81469387755102,24,16,370,2,364
1234,260,639,73.25895691609978,75.39519274376417,24,23,390,2,379
1235,251,18,75.00045351473923,77.13668934240363,30,49,251,2,233
1236,251,18,75.00045351473923,77.83328798185941,30,48,263,3,233
1237,251,272,75.00045351473923,76.34721088435374,30,23,62,1,21
1238,251,229,75.00045351473923,77.53142857142858,30,20,111,3,22
1239,251,479,75.00045351473923,77.15990929705215,30,18,246,2,228
1240,251,459,75.00045351473923,77.87972789115646,30,19,242,3,208
1241,406,18,75.37197278911565,77.13668934240363,27,49,395,2,388
1242,406,18,75.37197278911565,77.83328798185941,27,48,402,2,388
1243,406,229,75.37197278911565,77.53142857142858,27,20,200,2,177
1244,406,479,75.37197278911565,77.15990929705215,27,18,106,2,73
1245,406,459,75.37197278911565,77.87972789115646,27,19,120,3,53
1246,406,839,75.37197278911565,77.18312925170068,27,16,440,2,433
1247,272,18,76.34721088435374,77.83328798185941,23,48,262,1,254
1248,272,18,76.34721088435374,79.20326530612245,23,48,282,3,254
1249,272,229,76.34721088435374,77.53142857142858,23,20,67,1,43
1250,272,267,76.34721088435374,78.59954648526077,23,27,97,2,5
1251,272,459,76.34721088435374,77.87972789115646,23,19,198,2,187
1252,272,508,76.34721088435374,78.46022675736961,23,23,253,2,236
1253,272,658,76.34721088435374,78.55310657596372,23,17,398,2,386
1254,229,18,77.53142857142858,79.20326530612245,20,48,223,2,211
1255,229,18,77.53142857142858,79.89986394557823,20,49,234,2,211
1256,229,267,77.53142857142858,78.59954648526077,20,27,60,1,38
1257,229,211,77.53142857142858,79.92308390022676,20,22,105,2,18
1258,229,429,77.53142857142858,79.94630385487528,20,17,225,2,200
1259,229,658,77.53142857142858,78.55310657596372,20,17,431,1,429
1260,267,18,78.59954648526077,79.89986394557823,27,49,255,1,249
1261,267,18,78.59954648526077,80.59646258503402,27,48,263,2,249
1262,267,211,78.59954648526077,79.92308390022676,27,22,80,1,56
1263,267,208,78.59954648526077,81.22340136054422,27,29,127,3,59
1264,267,429,78.59954648526077,79.94630385487528,27,17,172,1,162
1265,267,524,78.59954648526077,80.73578231292517,27,18,273,2,257
1266,267,498,78.59954648526077,81.31628117913833,27,16,259,3,231
1267,211,18,79.92308390022676,81.96643990929705,22,48,212,2,193
1268,211,18,79.92308390022676,82.66303854875284,22,48,226,3,193
1269,211,208,79.92308390022676,81.22340136054422,22,29,56,1,3
1270,211,253,79.92308390022676,81.8271201814059,22,31,92,2,42
1271,211,498,79.92308390022676,81.31628117913833,22,16,293,1,287
1272,211,479,79.92308390022676,82.68625850340136,22,18,293,3,268
1273,208,18,81.22340136054422,82.66303854875284,29,48,200,1,190
1274,208,232,81.22340136054422,83.28997732426303,29,27,92,2,24
1275,208,228,81.22340136054422,83.38285714285715,29,28,95,2,20
1276,208,479,81.22340136054422,82.68625850340136,29,18,278,1,271
1277,208,527,81.22340136054422,84.17233560090703,29,29,343,3,319
1278,208,648,81.22340136054422,84.12589569160998,29,24,457,3,440
1279,253,27,81.8271201814059,84.24199546485261,31,49,249,2,226
1280,253,18,81.8271201814059,84.72961451247166,31,48,266,3,235
1281,253,232,81.8271201814059,83.28997732426303,31,27,66,1,21
1282,253,228,81.8271201814059,83.38285714285715,31,28,72,2,25
1283,253,258,81.8271201814059,84.4045351473923,31,24,111,3,5
1284,253,527,81.8271201814059,84.17233560090703,31,29,292,2,274
1285,253,481,81.8271201814059,84.75283446712018,31,15,260,3,228
1286,253,648,81.8271201814059,84.12589569160998,31,24,407,2,395
1287,232,18,83.28997732426303,84.72961451247166,27,48,223,1,214
1288,232,18,83.28997732426303,85.42621315192744,27,49,233,2,214
1289,232,258,83.28997732426303,84.4045351473923,27,24,55,1,26
1290,232,251,83.28997732426303,86.1924716553288,27,28,126,3,19
1291,232,481,83.28997732426303,84.75283446712018,27,15,257,1,249
1292,232,459,83.28997732426303,86.14603174603175,27,18,258,3,227
1293,232,679,83.28997732426303,85.44943310657597,27,14,457,2,447
1294,228,18,83.38285714285715,84.72961451247166,28,48,218,1,210
1295,228,18,83.38285714285715,85.42621315192744,28,49,228,2,210
1296,228,258,83.38285714285715,84.4045351473923,28,24,53,1,30
1297,228,251,83.38285714285715,86.1924716553288,28,28,123,3,23
1298,228,481,83.38285714285715,84.75283446712018,28,15,260,1,253
1299,228,459,83.38285714285715,86.14603174603175,28,18,260,3,231
1300,228,679,83.38285714285715,85.44943310657597,28,14,460,2,451
1301,258,18,84.4045351473923,85.42621315192744,24,49,244,1,240
1302,258,18,84.4045351473923,86.79619047619047,24,48,261,2,240
1303,258,251,84.4045351473923,86.1924716553288,24,28,77,2,7
1304,258,263,84.4045351473923,86.98195011337869,24,25,111,3,5
1305,258,459,84.4045351473923,86.14603174603175,24,18,215,2,201
1306,258,517,84.4045351473923,87.07482993197279,24,30,283,3,259
1307,258,679,84.4045351473923,85.44943310657597,24,14,423,1,421
1308,258,653,84.4045351473923,86.6336507936508,24,16,406,2,395
1309,251,18,86.1924716553288,87.49278911564626,28,49,240,1,233
1310,251,18,86.1924716553288,88.8627664399093,28,47,260,3,233
1311,251,213,86.1924716553288,87.42312925170069,28,24,65,1,38
1312,251,272,86.1924716553288,88.53768707482993,28,28,103,2,21
1313,251,478,86.1924716553288,88.21260770975057,28,17,243,2,227
1314,251,469,86.1924716553288,88.65378684807257,28,33,242,2,218
1315,263,18,86.98195011337869,88.8627664399093,25,47,258,2,245
1316,263,18,86.98195011337869,89.55936507936508,25,48,269,3,245
1317,263,272,86.98195011337869,88.53768707482993,25,28,68,2,9
1318,263,247,86.98195011337869,89.67546485260772,25,28,117,3,16
1319,263,478,86.98195011337869,88.21260770975057,25,17,221,1,215
1320,263,469,86.98195011337869,88.65378684807257,25,33,218,2,206
1321,263,419,86.98195011337869,89.65224489795918,25,19,194,3,156
1322,213,18,87.42312925170069,88.8627664399093,24,47,205,1,195
1323,213,18,87.42312925170069,89.55936507936508,24,48,216,2,195
1324,213,272,87.42312925170069,88.53768707482993,24,28,76,1,59
1325,213,247,87.42312925170069,89.67546485260772,24,28,103,2,34
1326,213,469,87.42312925170069,88.65378684807257,24,33,261,1,256
1327,213,419,87.42312925170069,89.65224489795918,24,19,227,2,206
1328,272,18,88.53768707482993,89.55936507936508,28,48,258,1,254
1329,272,18,88.53768707482993,90.58104308390023,28,48,269,2,254
1330,272,247,88.53768707482993,89.67546485260772,28,28,55,1,25
1331,272,233,88.53768707482993,90.67392290249434,28,21,100,2,39
1332,272,419,88.53768707482993,89.65224489795918,28,19,155,1,147
1333,272,478,88.53768707482993,90.62748299319728,28,18,225,2,206
1334,247,18,89.67546485260772,92.32253968253968,28,47,256,3,229
1335,247,263,89.67546485260772,92.32253968253968,28,25,115,3,16
1336,247,263,89.67546485260772,92.34575963718821,28,24,116,3,16
1337,247,524,89.67546485260772,91.76526077097506,28,17,291,2,277
1338,247,468,89.67546485260772,92.34575963718821,28,15,249,3,221
1339,233,18,90.67392290249434,92.32253968253968,21,47,226,2,215
1340,233,18,90.67392290249434,93.01913832199547,21,47,238,2,215
1341,233,263,90.67392290249434,92.32253968253968,21,25,77,2,30
1342,233,263,90.67392290249434,92.34575963718821,21,24,78,2,30
1343,233,524,90.67392290249434,91.76526077097506,21,17,295,1,291
1344,233,468,90.67392290249434,92.34575963718821,21,15,246,2,235
1345,263,18,92.32253968253968,93.69251700680272,25,47,252,1,245
1346,263,46,92.32253968253968,94.62131519274377,25,47,239,2,217
1347,263,206,92.32253968253968,93.97115646258504,25,25,91,2,57
1348,263,229,92.32253968253968,94.52843537414967,25,27,101,2,34
1349,263,458,92.32253968253968,94.24979591836735,25,25,212,2,195
1350,263,459,92.32253968253968,94.43555555555555,25,17,216,2,196
1351,263,18,92.34575963718821,93.69251700680272,24,47,252,1,245
1352,263,46,92.34575963718821,94.62131519274377,24,47,238,2,217
1353,263,206,92.34575963718821,93.97115646258504,24,25,90,2,57
1354,263,229,92.34575963718821,94.52843537414967,24,27,100,2,34
1355,263,458,92.34575963718821,94.24979591836735,24,25,212,2,195
1356,263,459,92.34575963718821,94.43555555555555,24,17,216,2,196
1357,206,18,93.97115646258504,95.75909297052155,25,47,203,2,188
1358,206,6,93.97115646258504,96.64145124716553,25,48,231,3,200
1359,206,209,93.97115646258504,96.17705215419501,25,30,95,2,3
1360,206,545,93.97115646258504,95.8055328798186,25,15,348,2,339
1361,206,672,93.97115646258504,96.52535147392291,25,26,479,3,466
1362,229,18,94.52843537414967,95.75909297052155,27,47,218,1,211
1363,229,6,94.52843537414967,96.64145124716553,27,48,241,2,223
1364,229,5,94.52843537414967,97.500589569161,27,47,258,3,224
1365,229,209,94.52843537414967,96.17705215419501,27,30,74,2,20
1366,229,251,94.52843537414967,97.22195011337868,27,27,118,3,22
1367,229,249,94.52843537414967,97.43092970521542,27,23,127,3,20
1368,229,545,94.52843537414967,95.8055328798186,27,15,321,1,316
1369,229,502,94.52843537414967,97.03619047619048,27,29,294,3,273
1370,229,672,94.52843537414967,96.52535147392291,27,26,451,2,443
1371,209,5,96.17705215419501,97.500589569161,30,47,212,1,204
1372,209,18,96.17705215419501,98.52226757369614,30,48,216,2,191
1373,209,251,96.17705215419501,97.22195011337868,30,27,62,1,42
1374,209,249,96.17705215419501,97.43092970521542,30,23,67,1,40
1375,209,214,96.17705215419501,98.84734693877552,30,21,115,3,5
1376,209,481,96.17705215419501,97.94176870748299,30,21,282,2,272
1377,209,684,96.17705215419501,97.89532879818594,30,16,481,2,475
1378,251,18,97.22195011337868,98.52226757369614,27,48,240,1,233
1379,251,4,97.22195011337868,99.47428571428571,27,47,265,2,247
1380,251,214,97.22195011337868,98.84734693877552,27,21,79,2,37
1381,251,270,97.22195011337868,99.93868480725624,27,25,119,3,19
1382,251,479,97.22195011337868,99.24208616780045,27,16,244,2,228
1383,251,459,97.22195011337868,99.93868480725624,27,16,239,3,208
1384,249,18,97.43092970521542,98.52226757369614,23,48,236,1,231
1385,249,4,97.43092970521542,99.47428571428571,23,47,260,2,245
1386,249,214,97.43092970521542,98.84734693877552,23,21,70,1,35
1387,249,270,97.43092970521542,99.93868480725624,23,25,110,3,21
1388,249,479,97.43092970521542,99.24208616780045,23,16,243,2,230
1389,249,459,97.43092970521542,99.93868480725624,23,16,236,3,210
1390,214,5,98.84734693877552,100.93714285714286,21,47,228,2,209
1391,214,270,98.84734693877552,99.93868480725624,21,25,73,1,56
1392,214,266,98.84734693877552,100.6120634920635,21,30,92,2,52
1393,214,459,98.84734693877552,99.93868480725624,21,16,249,1,245
1394,214,499,98.84734693877552,100.7978231292517,21,26,297,2,285
1395,214,523,98.84734693877552,101.51764172335601,21,28,330,3,309
1396,214,664,98.84734693877552,100.77460317460317,21,28,458,2,450
1397,214,657,98.84734693877552,101.42476190476191,21,25,457,3,443
1398,270,5,99.93868480725624,102.2142403628118,25,48,283,2,265
1399,270,5,99.93868480725624,102.56253968253968,25,47,288,3,265
1400,270,219,99.93868480725624,102.00526077097506,25,28,103,2,51
1401,270,523,99.93868480725624,101.51764172335601,25,28,262,2,253
1402,270,506,99.93868480725624,102.63219954648527,25,24,263,3,236
1403,270,657,99.93868480725624,101.42476190476191,25,25,392,1,387
1404,270,702,99.93868480725624,102.63219954648527,25,20,447,3,432
1405,266,5,100.6120634920635,102.2142403628118,30,48,270,2,261
1406,266,5,100.6120634920635,102.56253968253968,30,47,274,2,261
1407,266,219,100.6120634920635,102.00526077097506,30,28,76,1,47
1408,266,236,100.6120634920635,103.18947845804989,30,25,115,3,30
1409,266,234,100.6120634920635,103.3752380952381,30,20,123,3,32
1410,266,506,100.6120634920635,102.63219954648527,30,24,255,2,240
1411,266,702,100.6120634920635,102.63219954648527,30,20,445,2,436
1412,219,18,102.00526077097506,104.04861678004535,28,47,219,2,201
1413,219,18,102.00526077097506,104.72199546485261,28,47,233,3,201
1414,219,236,102.00526077097506,103.18947845804989,28,25,54,1,17
1415,219,234,102.00526077097506,103.3752380952381,28,20,61,1,15
1416,219,468,102.00526077097506,103.65387755102041,28,17,259,2,249
1417,236,18,103.18947845804989,104.72199546485261,25,47,228,2,218
1418,236,46,103.18947845804989,105.48825396825397,25,47,214,2,190
1419,236,277,103.18947845804989,105.04707482993197,25,25,90,2,41
1420,236,225,103.18947845804989,105.69723356009071,25,29,109,3,11
1421,236,474,103.18947845804989,105.30249433106576,25,24,255,2,238
1422,236,459,103.18947845804989,105.46503401360545,25,18,244,2,223
1423,236,672,103.18947845804989,105.30249433106576,25,16,445,2,436
1424,234,18,103.3752380952381,104.72199546485261,20,47,224,1,216
1425,234,46,103.3752380952381,105.48825396825397,20,47,209,2,188
1426,234,277,103.3752380952381,105.04707482993197,20,25,84,2,43
1427,234,225,103.3752380952381,105.69723356009071,20,29,100,2,9
1428,234,474,103.3752380952381,105.30249433106576,20,24,254,2,240
1429,234,459,103.3752380952381,105.46503401360545,20,18,242,2,225
1430,234,672,103.3752380952381,105.30249433106576,20,16,446,2,438
1431,277,6,105.04707482993197,106.46349206349207,25,49,278,1,271
1432,277,18,105.04707482993197,107.48517006802722,25,47,279,2,259
1433,277,216,105.04707482993197,107.22975056689343,25,29,112,2,61
1434,277,410,105.04707482993197,106.81179138321995,25,15,153,2,133
1435,277,620,105.04707482993197,107.2065306122449,25,15,355,2,343
1436,277,674,105.04707482993197,107.55482993197279,25,30,411,3,397
1437,225,18,105.69723356009071,107.48517006802722,29,47,221,2,207
1438,225,216,105.69723356009071,107.22975056689343,29,29,67,2,9
1439,225,244,105.69723356009071,108.29786848072563,29,22,114,3,19
1440,225,246,105.69723356009071,108.48362811791384,29,21,122,3,21
1441,225,410,105.69723356009071,106.81179138321995,29,15,191,1,185
1442,225,507,105.69723356009071,108.06566893424036,29,29,300,2,282
1443,225,620,105.69723356009071,107.2065306122449,29,15,400,2,395
1444,225,674,105.69723356009071,107.55482993197279,29,30,456,2,449
1445,216,6,107.22975056689343,109.22666666666667,29,47,227,2,210
1446,216,18,107.22975056689343,109.55174603174603,29,48,222,2,198
1447,216,244,107.22975056689343,108.29786848072563,29,22,54,1,28
1448,216,246,107.22975056689343,108.48362811791384,29,21,62,1,30
1449,216,215,107.22975056689343,109.7839455782313,29,20,110,3,1
1450,216,460,107.22975056689343,108.92480725623582,29,22,255,2,244
1451,244,18,108.29786848072563,109.55174603174603,22,48,232,1,226
1452,244,5,108.29786848072563,110.78240362811792,22,47,262,2,239
1453,244,215,108.29786848072563,109.7839455782313,22,20,70,1,29
1454,244,272,108.29786848072563,110.96816326530613,22,32,118,3,28
1455,244,456,108.29786848072563,110.27156462585035,22,16,228,2,212
1456,244,459,108.29786848072563,110.96816326530613,22,16,244,3,215
1457,244,625,108.29786848072563,110.27156462585035,22,15,390,2,381
1458,246,18,108.48362811791384,109.55174603174603,21,48,233,1,228
1459,246,5,108.48362811791384,110.78240362811792,21,47,261,2,241
1460,246,215,108.48362811791384,109.7839455782313,21,20,64,1,31
1461,246,272,108.48362811791384,110.96816326530613,21,32,110,2,26
1462,246,456,108.48362811791384,110.27156462585035,21,16,224,2,210
1463,246,459,108.48362811791384,110.96816326530613,21,16,238,2,213
1464,246,625,108.48362811791384,110.27156462585035,21,15,387,2,379
1465,215,5,109.7839455782313,112.03628117913833,20,47,231,2,210
1466,215,54,109.7839455782313,112.7328798185941,20,46,205,3,161
1467,215,272,109.7839455782313,110.96816326530613,20,32,76,1,57
1468,215,267,109.7839455782313,111.6647619047619,20,26,96,2,52
1469,215,459,109.7839455782313,110.96816326530613,20,16,249,1,244
1470,215,606,109.7839455782313,111.85052154195012,20,28,401,2,391
1471,215,516,109.7839455782313,112.59356009070295,20,29,324,3,301
1472,215,693,109.7839455782313,111.85052154195012,20,27,486,2,478
1473,272,5,110.96816326530613,112.03628117913833,32,47,271,1,267
1474,272,54,110.96816326530613,112.7328798185941,32,46,231,2,218
1475,272,5,110.96816326530613,113.54557823129252,32,46,289,3,267
1476,272,216,110.96816326530613,113.05795918367347,32,27,106,2,56
1477,272,516,110.96816326530613,112.59356009070295,32,29,254,2,244
1478,272,523,110.96816326530613,113.66167800453515,32,20,277,3,251
1479,272,694,110.96816326530613,113.68489795918367,32,21,438,3,422
1480,267,54,111.6647619047619,112.7328798185941,26,46,218,1,213
1481,267,5,111.6647619047619,113.54557823129252,26,46,274,2,262
1482,267,216,111.6647619047619,113.05795918367347,26,27,79,1,51
1483,267,309,111.6647619047619,114.40471655328798,26,25,125,3,42
1484,267,207,111.6647619047619,114.49759637188208,26,27,136,3,60
1485,267,523,111.6647619047619,113.66167800453515,26,20,270,2,256
1486,267,418,111.6647619047619,114.56725623582767,26,20,196,3,151
1487,267,694,111.6647619047619,113.68489795918367,26,21,436,2,427
1488,216,18,113.05795918367347,115.07809523809524,27,47,216,2,198
1489,216,83,113.05795918367347,115.98367346938775,27,47,183,3,133
1490,216,309,113.05795918367347,114.40471655328798,27,25,110,1,93
1491,216,207,113.05795918367347,114.49759637188208,27,27,63,1,9
1492,216,418,113.05795918367347,114.56725623582767,27,20,212,2,202
1493,216,624,113.05795918367347,115.79791383219955,27,14,425,3,408
1494,309,83,114.40471655328798,115.98367346938775,25,47,236,2,226
1495,309,46,114.40471655328798,116.79637188208618,25,47,282,2,263
1496,309,244,114.40471655328798,116.14621315192744,25,29,99,2,65
1497,309,206,114.40471655328798,116.65705215419501,25,25,141,2,103
1498,309,410,114.40471655328798,116.33197278911565,25,19,131,2,101
1499,309,561,114.40471655328798,116.44807256235828,25,20,267,2,252
1500,309,624,114.40471655328798,115.79791383219955,25,14,321,1,315
1501,207,83,114.49759637188208,115.98367346938775,27,47,140,1,124
1502,207,46,114.49759637188208,116.79637188208618,27,47,189,2,161
1503,207,244,114.49759637188208,116.14621315192744,27,29,80,2,37
1504,207,206,114.49759637188208,116.65705215419501,27,25,93,2,1
1505,207,410,114.49759637188208,116.33197278911565,27,19,218,2,203
1506,207,561,114.49759637188208,116.44807256235828,27,20,364,2,354
1507,207,624,114.49759637188208,115.79791383219955,27,14,421,1,417
1508,244,6,116.14621315192744,118.28244897959183,29,47,255,2,238
1509,244,84,116.14621315192744,118.74684807256236,29,47,195,3,160
1510,244,277,116.14621315192744,118.37532879818595,29,27,102,2,33
1511,244,212,116.14621315192744,118.56108843537415,29,26,109,2,32
1512,244,480,116.14621315192744,117.58585034013606,29,23,244,1,236
1513,244,654,116.14621315192744,117.58585034013606,29,18,415,1,410
1514,206,6,116.65705215419501,118.28244897959183,25,47,212,2,200
1515,206,84,116.65705215419501,118.74684807256236,25,47,152,2,122
1516,206,277,116.65705215419501,118.37532879818595,25,27,103,2,71
1517,206,212,116.65705215419501,118.56108843537415,25,26,82,2,6
1518,206,562,116.65705215419501,119.16480725623583,25,23,372,3,356
1519,206,701,116.65705215419501,119.16480725623583,25,22,507,3,495
1520,277,68,118.37532879818595,119.81496598639455,27,47,218,1,209
1521,277,18,118.37532879818595,121.2778231292517,27,48,288,3,259
1522,277,207,118.37532879818595,120.00072562358277,27,26,99,2,70
1523,277,276,118.37532879818595,120.79020408163265,27,26,104,2,1
1524,277,603,118.37532879818595,119.69886621315193,27,16,331,1,326
1525,277,410,118.37532879818595,120.60444444444445,27,19,164,2,133
1526,212,68,118.56108843537415,119.81496598639455,26,47,154,1,144
1527,212,18,118.56108843537415,121.2778231292517,26,48,227,3,194
1528,212,207,118.56108843537415,120.00072562358277,26,26,62,1,5
1529,212,276,118.56108843537415,120.79020408163265,26,26,115,2,64
1530,212,603,118.56108843537415,119.69886621315193,26,16,394,1,391
1531,212,410,118.56108843537415,120.60444444444445,26,19,217,2,198
1532,207,18,120.00072562358277,121.2778231292517,26,48,197,1,189
1533,207,81,120.00072562358277,122.27628117913832,26,48,160,2,126
1534,207,244,120.00072562358277,121.64934240362813,26,28,80,2,37
1535,207,205,120.00072562358277,122.7871201814059,26,24,120,3,2
1536,207,459,120.00072562358277,122.02086167800454,26,17,267,2,252
1537,207,560,120.00072562358277,122.88,26,27,374,3,353
1538,207,679,120.00072562358277,122.85678004535147,26,26,488,3,472
1539,276,81,120.79020408163265,122.27628117913832,26,48,205,1,195
1540,276,5,120.79020408163265,123.01931972789116,26,46,288,2,271
1541,276,205,120.79020408163265,122.7871201814059,26,24,112,2,71
1542,276,459,120.79020408163265,122.02086167800454,26,17,191,1,183
1543,276,560,120.79020408163265,122.88,26,27,298,2,284
1544,276,679,120.79020408163265,122.85678004535147,26,26,413,2,403
1545,276,621,120.79020408163265,123.53015873015873,26,25,365,3,345
1546,244,5,121.64934240362813,123.01931972789116,28,46,246,1,239
1547,244,5,121.64934240362813,124.27319727891157,28,47,264,3,239
1548,244,205,121.64934240362813,122.7871201814059,28,24,63,1,39
1549,244,346,121.64934240362813,124.11065759637188,28,26,147,2,102
1550,244,560,121.64934240362813,122.88,28,27,320,1,316
1551,244,425,121.64934240362813,124.11065759637188,28,28,210,2,181
1552,244,679,121.64934240362813,122.85678004535147,28,26,438,1,435
1553,244,621,121.64934240362813,123.53015873015873,28,25,386,2,377
1554,205,5,122.7871201814059,124.27319727891157,24,47,210,1,200
1555,205,18,122.7871201814059,125.41097505668934,24,48,218,3,187
1556,205,346,122.7871201814059,124.11065759637188,24,26,152,1,141
1557,205,207,122.7871201814059,125.17877551020409,24,27,103,2,2
1558,205,425,122.7871201814059,124.11065759637188,24,28,227,1,220
1559,205,436,122.7871201814059,124.9233560090703,24,16,249,2,231
1560,205,468,122.7871201814059,125.4574149659864,24,17,287,3,263
1561,346,18,124.11065759637188,125.41097505668934,26,48,333,1,328
1562,346,18,124.11065759637188,126.10757369614512,26,49,339,2,328
1563,346,18,124.11065759637188,126.80417233560091,26,49,348,3,328
1564,346,207,124.11065759637188,125.17877551020409,26,27,146,1,139
1565,346,252,124.11065759637188,126.33977324263039,26,33,134,2,94
1566,346,250,124.11065759637188,126.64163265306122,26,33,145,3,96
1567,346,468,124.11065759637188,125.4574149659864,26,17,135,1,122
1568,346,530,124.11065759637188,126.75773242630386,26,23,216,3,184
1569,346,813,124.11065759637188,126.85061224489796,26,14,482,3,467
1570,346,839,124.11065759637188,126.85061224489796,26,16,507,3,493
1571,207,18,125.17877551020409,126.80417233560091,27,49,202,2,189
1572,207,252,125.17877551020409,126.33977324263039,27,33,67,1,45
1573,207,250,125.17877551020409,126.64163265306122,27,33,76,1,43
1574,207,252,125.17877551020409,127.70975056689343,27,35,118,3,45
1575,207,530,125.17877551020409,126.75773242630386,27,23,330,2,323
1576,207,459,125.17877551020409,127.52399092970522,27,19,271,2,252
1577,207,691,125.17877551020409,127.52399092970522,27,14,494,2,484
1578,252,18,126.33977324263039,128.17414965986396,33,49,247,2,234
1579,252,18,126.33977324263039,128.87074829931973,33,48,258,3,234
1580,252,226,126.33977324263039,128.89396825396827,33,31,113,3,26
1581,252,459,126.33977324263039,127.52399092970522,33,19,213,1,207
1582,252,526,126.33977324263039,128.4760090702948,33,20,289,2,274
1583,252,691,126.33977324263039,127.52399092970522,33,14,442,1,439
1584,250,18,126.64163265306122,128.17414965986396,33,49,241,2,232
1585,250,18,126.64163265306122,128.87074829931973,33,48,251,2,232
1586,250,252,126.64163265306122,127.70975056689343,33,35,46,1,2
1587,250,226,126.64163265306122,128.89396825396827,33,31,100,2,24
1588,250,526,126.64163265306122,128.4760090702948,33,20,287,2,276
1589,252,18,127.70975056689343,128.87074829931973,35,48,239,1,234
1590,252,18,127.70975056689343,130.24072562358276,35,49,258,3,234
1591,252,226,127.70975056689343,128.89396825396827,35,31,57,1,26
1592,252,228,127.70975056689343,129.8227664399093,35,32,94,2,24
1593,252,459,127.70975056689343,130.2871655328798,35,19,235,3,207
1594,252,691,127.70975056689343,130.2871655328798,35,15,453,3,439
1595,226,18,128.89396825396827,130.24072562358276,31,49,216,1,208
1596,226,18,128.89396825396827,130.93732426303856,31,49,226,2,208
1597,226,228,128.89396825396827,130.79800453514738,31,31,82,2,2
1598,226,228,128.89396825396827,131.49460317460318,31,31,112,3,2
1599,226,459,128.89396825396827,130.2871655328798,31,19,241,1,233
1600,226,493,128.89396825396827,130.96054421768707,31,16,281,2,267
1601,226,691,128.89396825396827,130.2871655328798,31,15,469,1,465
1602,228,18,129.8227664399093,130.93732426303856,32,49,215,1,210
1603,228,18,129.8227664399093,132.3073015873016,32,48,236,2,210
1604,228,493,129.8227664399093,130.96054421768707,32,16,269,1,265
1605,228,532,129.8227664399093,131.9590022675737,32,20,318,2,304
1606,228,18,130.79800453514738,132.3073015873016,31,48,220,2,210
1607,228,18,130.79800453514738,133.00390022675737,31,49,230,2,210
1608,228,18,130.79800453514738,133.70049886621317,31,49,244,3,210
1609,228,251,130.79800453514738,133.14321995464852,31,27,104,2,23
1610,228,532,130.79800453514738,131.9590022675737,31,20,308,1,304
1611,228,459,130.79800453514738,133.05034013605442,31,20,251,2,231
1612,228,641,130.79800453514738,133.72371882086168,31,14,432,3,413
1613,228,18,131.49460317460318,133.00390022675737,31,49,220,2,210
1614,228,18,131.49460317460318,133.70049886621317,31,49,230,2,210
1615,228,251,131.49460317460318,133.14321995464852,31,27,75,2,23
1616,228,231,131.49460317460318,134.46675736961453,31,32,128,3,3
1617,228,459,131.49460317460318,133.05034013605442,31,20,241,2,231
1618,228,532,131.49460317460318,134.002358276644,31,18,323,3,304
1619,228,641,131.49460317460318,133.72371882086168,31,14,424,2,413
1620,251,18,133.14321995464852,135.0704761904762,27,49,247,2,233
1621,251,18,133.14321995464852,135.76707482993197,27,49,259,3,233
1622,251,231,133.14321995464852,134.46675736961453,27,32,60,1,20
1623,251,230,133.14321995464852,134.48997732426304,27,30,62,1,21
1624,251,429,133.14321995464852,135.11691609977325,27,17,197,2,178
1625,251,524,133.14321995464852,135.90639455782312,27,17,298,3,273
1626,251,684,133.14321995464852,135.8831746031746,27,16,449,3,433
1627,231,18,134.46675736961453,135.76707482993197,32,49,220,1,213
1628,231,51,134.46675736961453,136.62621315192743,32,35,203,2,180
1629,231,207,134.46675736961453,136.48689342403628,32,35,90,2,24
1630,231,209,134.46675736961453,136.53333333333333,32,35,92,2,22
1631,231,524,134.46675736961453,135.90639455782312,32,17,299,1,293
1632,231,462,134.46675736961453,137.32281179138323,32,14,262,3,231
1633,231,684,134.46675736961453,135.8831746031746,32,16,457,1,453
1634,230,18,134.48997732426304,135.76707482993197,30,49,219,1,212
1635,230,51,134.48997732426304,136.62621315192743,30,35,201,2,179
1636,230,207,134.48997732426304,136.48689342403628,30,35,89,2,23
1637,230,209,134.48997732426304,136.53333333333333,30,35,90,2,21
1638,230,524,134.48997732426304,135.90639455782312,30,17,300,1,294
1639,230,462,134.48997732426304,137.32281179138323,30,14,262,3,232
1640,230,684,134.48997732426304,135.8831746031746,30,16,458,1,454
1641,207,9,136.48689342403628,138.1819501133787,35,45,211,2,198
1642,207,18,136.48689342403628,139.20362811791384,35,44,222,3,189
1643,207,278,136.48689342403628,137.67111111111112,35,34,87,1,71
1644,207,246,136.48689342403628,138.50702947845807,35,35,95,2,39
1645,207,563,136.48689342403628,137.69433106575963,35,18,360,1,356
1646,207,415,136.48689342403628,139.22684807256235,35,19,239,3,208
1647,207,689,136.48689342403628,137.76399092970522,35,15,485,1,482
1648,209,9,136.53333333333333,138.1819501133787,35,45,212,2,200
1649,209,18,136.53333333333333,139.20362811791384,35,44,223,3,191
1650,209,278,136.53333333333333,137.67111111111112,35,34,85,1,69
1651,209,246,136.53333333333333,138.50702947845807,35,35,93,2,37
1652,209,563,136.53333333333333,137.69433106575963,35,18,358,1,354
1653,209,415,136.53333333333333,139.22684807256235,35,19,236,3,206
1654,209,689,136.53333333333333,137.76399092970522,35,15,483,1,480
1655,278,18,137.67111111111112,139.20362811791384,34,44,268,2,260
1656,278,18,137.67111111111112,139.9002267573696,34,47,277,2,260
1657,278,274,137.67111111111112,140.43428571428572,34,33,119,3,4
1658,278,415,137.67111111111112,139.22684807256235,34,19,153,2,137
1659,278,442,137.67111111111112,140.29496598639457,34,21,199,3,164
1660,246,18,138.50702947845807,139.9002267573696,35,47,236,1,228
1661,246,6,138.50702947845807,140.7825850340136,35,48,259,2,240
1662,246,274,138.50702947845807,140.43428571428572,35,33,88,2,28
1663,246,278,138.50702947845807,140.9451247165533,35,29,110,2,32
1664,246,442,138.50702947845807,140.29496598639457,35,21,211,2,196
1665,246,446,138.50702947845807,140.9683446712018,35,22,226,2,200
1666,246,693,138.50702947845807,141.38630385487528,35,15,464,3,447
1667,274,5,140.43428571428572,141.64172335600907,33,48,274,1,269
1668,274,18,140.43428571428572,142.6634013605442,33,46,273,2,256
1669,274,252,140.43428571428572,142.43120181405897,33,31,89,2,22
1670,274,276,140.43428571428572,142.8259410430839,33,28,103,2,2
1671,274,411,140.43428571428572,141.96680272108844,33,21,152,2,137
1672,274,678,140.43428571428572,142.15256235827664,33,17,411,2,404
1673,274,678,140.43428571428572,142.84916099773244,33,17,417,2,404
1674,278,18,140.9451247165533,142.6634013605442,29,46,270,2,260
1675,278,252,140.9451247165533,142.43120181405897,29,31,69,1,26
1676,278,276,140.9451247165533,142.8259410430839,29,28,81,2,2
1677,278,247,140.9451247165533,143.7082993197279,29,31,123,3,31
1678,278,411,140.9451247165533,141.96680272108844,29,21,140,1,133
1679,278,578,140.9451247165533,143.49931972789116,29,18,320,3,300
1680,278,678,140.9451247165533,142.15256235827664,29,17,403,1,400
1681,278,678,140.9451247165533,142.84916099773244,29,17,408,2,400
1682,252,5,142.43120181405897,144.45133786848072,31,46,262,2,247
1683,252,5,142.43120181405897,145.07827664399093,31,47,272,3,247
1684,252,247,142.43120181405897,143.7082993197279,31,31,55,1,5
1685,252,207,142.43120181405897,144.82285714285715,31,28,112,2,45
1686,252,578,142.43120181405897,143.49931972789116,31,18,329,1,326
1687,252,557,142.43120181405897,144.01015873015874,31,20,312,2,305
1688,252,420,142.43120181405897,145.35691609977326,31,26,210,3,168
1689,252,733,142.43120181405897,144.01015873015874,31,25,486,2,481
1690,276,5,142.8259410430839,144.45133786848072,28,46,280,2,271
1691,276,5,142.8259410430839,145.07827664399093,28,47,288,2,271
1692,276,207,142.8259410430839,144.82285714285715,28,28,110,2,69
1693,276,557,142.8259410430839,144.01015873015874,28,20,286,1,281
1694,276,420,142.8259410430839,145.35691609977326,28,26,181,3,144
1695,276,733,142.8259410430839,144.01015873015874,28,25,460,1,457
1696,276,699,142.8259410430839,145.47301587301587,28,17,438,3,423
1697,247,5,143.7082993197279,145.07827664399093,31,47,249,1,242
1698,247,5,143.7082993197279,146.35537414965987,31,48,268,3,242
1699,247,207,143.7082993197279,144.82285714285715,31,28,62,1,40
1700,247,231,143.7082993197279,145.98385487528344,31,29,99,2,16
1701,247,420,143.7082993197279,145.35691609977326,31,26,187,2,173
1702,247,446,143.7082993197279,146.49469387755101,31,22,232,3,199
1703,247,699,143.7082993197279,145.47301587301587,31,17,458,2,452
1704,247,659,143.7082993197279,146.4714739229025,31,17,429,3,412
1705,207,5,144.82285714285715,146.35537414965987,28,48,213,2,202
1706,207,5,144.82285714285715,146.70367346938775,28,47,218,2,202
1707,207,231,144.82285714285715,145.98385487528344,28,29,55,1,24
1708,207,246,144.82285714285715,146.79655328798185,28,30,94,2,39
1709,207,205,144.82285714285715,147.5395918367347,28,30,117,3,2
1710,207,446,144.82285714285715,146.49469387755101,28,22,250,2,239
1711,207,410,144.82285714285715,147.35383219954647,28,25,230,3,203
1712,207,419,144.82285714285715,147.5395918367347,28,28,242,3,212
1713,207,659,144.82285714285715,146.4714739229025,28,17,458,2,452
1714,207,616,144.82285714285715,147.33061224489796,28,17,423,3,409
1715,231,4,145.98385487528344,148.5380498866213,29,45,252,3,227
1716,231,18,145.98385487528344,148.86312925170068,29,46,246,3,213
1717,231,205,145.98385487528344,147.5395918367347,29,30,72,2,26
1718,231,410,145.98385487528344,147.35383219954647,29,25,188,1,179
1719,231,419,145.98385487528344,147.5395918367347,29,28,200,2,188
1720,231,616,145.98385487528344,147.33061224489796,29,17,389,1,385
1721,231,700,145.98385487528344,148.3522902494331,29,27,480,2,469
1722,231,649,145.98385487528344,148.63092970521544,29,20,433,3,418
1723,246,4,146.79655328798185,148.5380498866213,30,45,253,2,242
1724,246,18,146.79655328798185,148.86312925170068,30,46,245,2,228
1725,246,245,146.79655328798185,149.25786848072562,30,31,106,2,1
1726,246,206,146.79655328798185,149.582947845805,30,32,126,3,40
1727,246,411,146.79655328798185,149.11854875283447,30,25,193,2,165
1728,246,514,146.79655328798185,149.582947845805,30,21,294,3,268
1729,246,700,146.79655328798185,148.3522902494331,30,27,459,2,454
1730,246,649,146.79655328798185,148.63092970521544,30,20,411,2,403
1731,246,638,146.79655328798185,149.55972789115646,30,21,410,3,392
1732,205,18,147.5395918367347,148.86312925170068,30,46,195,1,187
1733,205,6,147.5395918367347,149.95446712018142,30,45,225,2,199
1734,205,245,147.5395918367347,149.25786848072562,30,31,84,2,40
1735,205,206,147.5395918367347,149.582947845805,30,32,88,2,1
1736,205,411,147.5395918367347,149.11854875283447,30,25,217,2,206
1737,205,514,147.5395918367347,149.582947845805,30,21,321,2,309
1738,205,649,147.5395918367347,148.63092970521544,30,20,446,1,444
1739,205,638,147.5395918367347,149.55972789115646,30,21,442,2,433
1740,245,6,149.25786848072562,151.32444444444445,31,47,255,2,239
1741,245,18,149.25786848072562,151.6263038548753,31,47,249,2,227
1742,245,278,149.25786848072562,151.48698412698414,31,31,102,2,33
1743,245,246,149.25786848072562,151.8120634920635,31,31,110,3,1
1744,245,442,149.25786848072562,151.32444444444445,31,21,216,2,197
1745,245,417,149.25786848072562,152.20680272108845,31,23,214,3,172
1746,245,678,149.25786848072562,151.11546485260772,31,17,440,2,433
1747,206,6,149.582947845805,151.32444444444445,32,47,214,2,200
1748,206,18,149.582947845805,151.6263038548753,32,47,208,2,188
1749,206,278,149.582947845805,151.48698412698414,32,31,109,2,72
1750,206,246,149.582947845805,151.8120634920635,32,31,104,2,40
1751,206,442,149.582947845805,151.32444444444445,32,21,248,2,236
1752,206,417,149.582947845805,152.20680272108845,32,23,239,3,211
1753,206,678,149.582947845805,151.11546485260772,32,17,477,2,472
1754,206,669,149.582947845805,152.29968253968255,32,20,478,3,463
1755,278,46,151.48698412698414,152.64798185941044,31,46,237,1,232
1756,278,18,151.48698412698414,153.6928798185941,31,46,277,2,260
1757,278,275,151.48698412698414,153.18204081632652,31,31,73,2,3
1758,278,277,151.48698412698414,153.87863945578232,31,32,103,2,1
1759,278,596,151.48698412698414,153.18204081632652,31,23,326,2,318
1760,278,442,151.48698412698414,154.08761904761906,31,17,199,3,164
1761,278,620,151.48698412698414,153.18204081632652,31,18,350,2,342
1762,278,693,151.48698412698414,153.87863945578232,31,15,428,2,415
1763,246,18,151.8120634920635,153.6928798185941,31,46,242,2,228
1764,246,83,151.8120634920635,154.64489795918368,31,46,204,3,163
1765,246,275,151.8120634920635,153.18204081632652,31,31,66,1,29
1766,246,277,151.8120634920635,153.87863945578232,31,32,94,2,31
1767,246,596,151.8120634920635,153.18204081632652,31,23,355,1,350
1768,246,442,151.8120634920635,154.08761904761906,31,17,219,2,196
1769,246,620,151.8120634920635,153.18204081632652,31,18,379,1,374
1770,246,693,151.8120634920635,153.87863945578232,31,15,456,2,447
1771,275,83,153.18204081632652,154.64489795918368,31,46,202,1,192
1772,275,246,153.18204081632652,154.73777777777778,31,32,73,2,29
1773,275,207,153.18204081632652,155.80589569160998,31,33,132,3,68
1774,275,436,153.18204081632652,155.4575963718821,31,21,188,2,161
1775,275,645,153.18204081632652,155.06285714285715,31,18,379,2,370
1776,277,5,153.87863945578232,156.1774149659864,32,46,289,2,272
1777,277,6,153.87863945578232,156.8043537414966,32,46,299,3,271
1778,277,207,153.87863945578232,155.80589569160998,32,33,109,2,70
1779,277,436,153.87863945578232,155.4575963718821,32,21,173,2,159
1780,277,425,153.87863945578232,156.38639455782314,32,25,183,3,148
1781,277,645,153.87863945578232,155.06285714285715,32,18,372,1,368
1782,246,5,154.73777777777778,156.1774149659864,32,46,249,1,241
1783,246,6,154.73777777777778,156.8043537414966,32,46,256,2,240
1784,246,5,154.73777777777778,157.68671201814058,32,48,272,3,241
1785,246,207,154.73777777777778,155.80589569160998,32,33,60,1,39
1786,246,275,154.73777777777778,156.9901133786848,32,34,101,2,29
1787,246,425,154.73777777777778,156.38639455782314,32,25,193,2,179
1788,246,429,154.73777777777778,157.52417233560092,32,18,219,3,183
1789,246,631,154.73777777777778,157.2455328798186,32,14,400,3,385
1790,207,5,155.80589569160998,157.68671201814058,33,48,218,2,202
1791,207,275,155.80589569160998,156.9901133786848,33,34,85,1,68
1792,207,206,155.80589569160998,158.54585034013607,33,36,118,3,1
1793,207,429,155.80589569160998,157.52417233560092,33,18,234,2,222
1794,207,458,155.80589569160998,157.8724716553288,33,18,266,2,251
1795,207,631,155.80589569160998,157.2455328798186,33,14,429,1,424
1796,275,46,156.9901133786848,159.05668934240364,34,36,246,2,229
1797,275,206,156.9901133786848,158.54585034013607,34,36,96,2,69
1798,275,207,156.9901133786848,158.61551020408163,34,38,98,2,68
1799,275,463,156.9901133786848,159.381768707483,34,14,214,2,188
1800,206,122,158.54585034013607,160.47310657596373,36,44,118,2,84
1801,206,123,158.54585034013607,160.70530612244897,36,36,125,2,83
1802,206,246,158.54585034013607,160.2873469387755,36,38,85,2,40
1803,206,245,158.54585034013607,160.58920634920636,36,35,96,2,39
1804,206,488,158.54585034013607,160.24090702947845,36,19,291,2,282
1805,207,122,158.61551020408163,160.47310657596373,38,44,117,2,85
1806,207,123,158.61551020408163,160.70530612244897,38,36,123,2,84
1807,207,246,158.61551020408163,160.2873469387755,38,38,82,2,39
1808,207,245,158.61551020408163,160.58920634920636,38,35,93,2,38
1809,207,488,158.61551020408163,160.24090702947845,38,19,290,2,281
1810,246,121,160.2873469387755,161.63410430839002,38,18,138,1,125
1811,245,121,160.58920634920636,161.63410430839002,35,18,132,1,124
1812,550,165,1.6253968253968254,3.8312925170068026,15,35,397,2,385
1813,550,247,1.6253968253968254,2.670294784580499,15,33,306,1,303
1814,550,246,1.6253968253968254,3.7616326530612247,15,27,318,2,304
1815,550,206,1.6253968253968254,4.179591836734694,15,32,361,3,344
1816,550,445,1.6253968253968254,2.670294784580499,15,20,114,1,105
1817,550,485,1.6253968253968254,3.1579138321995464,15,16,93,2,65
1818,445,165,2.670294784580499,3.8312925170068026,20,35,284,1,280
1819,445,185,2.670294784580499,4.96907029478458,20,34,278,2,260
1820,445,246,2.670294784580499,3.7616326530612247,20,27,204,1,199
1821,445,206,2.670294784580499,4.179591836734694,20,32,248,2,239
1822,485,185,3.1579138321995464,4.96907029478458,16,34,310,2,300
1823,485,121,3.1579138321995464,5.944308390022676,16,40,383,3,364
1824,485,206,3.1579138321995464,4.179591836734694,16,32,282,1,279
1825,485,243,3.1579138321995464,5.944308390022676,16,32,270,3,242
1826,485,482,3.1579138321995464,5.7817687074829935,16,15,113,3,3
1827,482,18,5.7817687074829935,6.8034467120181406,15,48,466,1,464
1828,482,18,5.7817687074829935,7.476825396825397,15,48,470,2,464
1829,482,6,5.7817687074829935,8.359183673469389,15,50,489,3,476
1830,482,275,5.7817687074829935,7.685804988662132,15,31,223,2,207
1831,482,246,5.7817687074829935,8.382403628117913,15,30,261,3,236
1832,482,498,5.7817687074829935,6.826666666666667,15,18,48,1,16
1833,482,545,5.7817687074829935,7.5232653061224495,15,17,98,2,63
1834,482,429,5.7817687074829935,8.219863945578231,15,18,118,2,53
1835,482,727,5.7817687074829935,7.5232653061224495,15,15,256,2,245
1836,482,678,5.7817687074829935,8.544943310657597,15,18,229,3,196
1837,482,847,5.7817687074829935,6.9195464852607715,15,15,368,1,365
1838,482,847,5.7817687074829935,7.894784580498866,15,14,376,2,365
1839,482,839,5.7817687074829935,8.219863945578231,15,15,372,2,357
1840,498,6,6.826666666666667,8.359183673469389,18,50,496,2,492
1841,498,6,6.826666666666667,9.218321995464853,18,49,503,2,492
1842,498,246,6.826666666666667,8.382403628117913,18,30,261,2,252
1843,498,206,6.826666666666667,9.58984126984127,18,33,315,3,292
1844,498,429,6.826666666666667,8.219863945578231,18,18,91,1,69
1845,498,446,6.826666666666667,9.752380952380953,18,20,136,3,52
1846,498,678,6.826666666666667,8.544943310657597,18,18,195,2,180
1847,498,678,6.826666666666667,9.752380952380953,18,18,220,3,180
1848,498,847,6.826666666666667,7.894784580498866,18,14,352,1,349
1849,498,839,6.826666666666667,8.219863945578231,18,15,346,1,341
1850,498,967,6.826666666666667,9.729160997732427,18,16,485,3,469
1851,545,206,7.5232653061224495,9.58984126984127,17,33,350,2,339
1852,545,277,7.5232653061224495,10.448979591836736,17,32,296,3,268
1853,545,446,7.5232653061224495,9.752380952380953,17,20,138,2,99
1854,545,446,7.5232653061224495,10.495419501133787,17,18,162,3,99
1855,545,678,7.5232653061224495,8.544943310657597,17,18,140,1,133
1856,545,678,7.5232653061224495,9.752380952380953,17,18,164,2,133
1857,545,967,7.5232653061224495,9.729160997732427,17,16,433,2,422
1858,545,846,7.5232653061224495,10.100680272108844,17,16,321,3,301
1859,429,18,8.219863945578231,10.936598639455783,18,48,427,3,411
1860,429,206,8.219863945578231,9.58984126984127,18,33,231,1,223
1861,429,277,8.219863945578231,10.448979591836736,18,32,180,2,152
1862,429,446,8.219863945578231,9.752380952380953,18,20,68,2,17
1863,429,446,8.219863945578231,10.495419501133787,18,18,99,2,17
1864,429,678,8.219863945578231,9.752380952380953,18,18,258,2,249
1865,429,693,8.219863945578231,10.797278911564627,18,18,286,3,264
1866,429,846,8.219863945578231,10.100680272108844,18,16,425,2,417
1867,446,18,9.752380952380953,10.936598639455783,20,48,431,1,428
1868,446,6,9.752380952380953,11.470657596371883,20,47,446,2,440
1869,446,5,9.752380952380953,12.678095238095239,20,50,459,3,441
1870,446,244,9.752380952380953,11.3081179138322,20,31,213,2,202
1871,446,205,9.752380952380953,12.445895691609978,20,31,267,3,241
1872,446,459,9.752380952380953,11.679637188208616,20,17,84,2,13
1873,446,448,9.752380952380953,12.631655328798185,20,16,124,3,2
1874,446,693,9.752380952380953,10.797278911564627,20,18,251,1,247
1875,446,795,9.752380952380953,11.656417233560092,20,15,359,2,349
1876,446,693,9.752380952380953,12.051156462585034,20,15,266,2,247
1877,446,933,9.752380952380953,11.284897959183674,20,15,491,2,487
1878,446,847,9.752380952380953,12.422675736961452,20,17,417,3,401
1879,446,5,10.495419501133787,12.678095238095239,18,50,451,2,441
1880,446,205,10.495419501133787,12.445895691609978,18,31,255,2,241
1881,446,459,10.495419501133787,11.679637188208616,18,17,53,1,13
1882,446,448,10.495419501133787,12.631655328798185,18,16,92,2,2
1883,446,795,10.495419501133787,11.656417233560092,18,15,353,1,349
1884,446,693,10.495419501133787,12.051156462585034,18,15,256,2,247
1885,446,847,10.495419501133787,12.422675736961452,18,17,409,2,401
1886,459,5,11.679637188208616,13.931972789115646,17,50,464,2,454
1887,459,5,11.679637188208616,14.280272108843537,17,49,468,3,454
1888,459,247,11.679637188208616,13.885532879818594,17,31,232,2,212
1889,459,246,11.679637188208616,14.419591836734694,17,31,244,3,213
1890,459,429,11.679637188208616,13.746213151927439,17,18,94,2,30
1891,459,446,11.679637188208616,14.582131519274377,17,20,126,3,13
1892,459,678,11.679637188208616,14.02485260770975,17,14,241,2,219
1893,459,678,11.679637188208616,14.048072562358277,17,17,242,2,219
1894,459,840,11.679637188208616,13.722993197278912,17,14,391,2,381
1895,459,903,11.679637188208616,14.512471655328799,17,15,460,3,444
1896,448,5,12.631655328798185,13.931972789115646,16,50,447,1,443
1897,448,5,12.631655328798185,14.280272108843537,16,49,449,2,443
1898,448,247,12.631655328798185,13.885532879818594,16,31,208,1,201
1899,448,246,12.631655328798185,14.419591836734694,16,31,216,2,202
1900,448,429,12.631655328798185,13.746213151927439,16,18,52,1,19
1901,448,446,12.631655328798185,14.582131519274377,16,20,84,2,2
1902,448,678,12.631655328798185,14.02485260770975,16,14,238,1,230
1903,448,678,12.631655328798185,14.048072562358277,16,17,238,1,230
1904,448,840,12.631655328798185,13.722993197278912,16,14,395,1,392
1905,448,903,12.631655328798185,14.512471655328799,16,15,462,2,455
1906,448,824,12.631655328798185,15.116190476190477,16,14,391,2,376
1907,429,18,13.746213151927439,15.766349206349206,18,49,420,2,411
1908,429,18,13.746213151927439,16.46294784580499,18,48,427,3,411
1909,429,207,13.746213151927439,15.673469387755102,18,23,237,2,222
1910,429,545,13.746213151927439,15.789569160997733,18,16,146,2,116
1911,429,479,13.746213151927439,16.486167800453515,18,18,128,3,50
1912,429,824,13.746213151927439,15.116190476190477,18,14,399,1,395
1913,429,839,13.746213151927439,16.486167800453515,18,15,427,3,410
1914,446,18,14.582131519274377,15.766349206349206,20,49,431,1,428
1915,446,18,14.582131519274377,16.46294784580499,20,48,436,2,428
1916,446,207,14.582131519274377,15.673469387755102,20,23,244,1,239
1917,446,230,14.582131519274377,16.904126984126986,20,35,238,2,216
1918,446,545,14.582131519274377,15.789569160997733,20,16,112,1,99
1919,446,479,14.582131519274377,16.486167800453515,20,18,88,2,33
1920,446,551,14.582131519274377,17.438185941043084,20,23,162,3,105
1921,446,643,14.582131519274377,16.857687074829933,20,14,220,2,197
1922,446,677,14.582131519274377,17.438185941043084,20,19,262,3,231
1923,446,839,14.582131519274377,16.486167800453515,20,15,401,2,393
1924,545,230,15.789569160997733,16.904126984126986,16,35,319,1,315
1925,545,229,15.789569160997733,17.623945578231293,16,29,326,2,316
1926,545,205,15.789569160997733,18.45986394557823,16,28,359,3,340
1927,545,551,15.789569160997733,17.438185941043084,16,23,71,2,6
1928,545,643,15.789569160997733,16.857687074829933,16,14,108,1,98
1929,545,677,15.789569160997733,17.438185941043084,16,19,150,2,132
1930,545,731,15.789569160997733,18.552743764172337,16,14,221,3,186
1931,545,824,15.789569160997733,17.87936507936508,16,15,293,2,279
1932,479,18,16.486167800453515,17.832925170068027,18,49,465,1,461
1933,479,18,16.486167800453515,18.52952380952381,18,48,469,2,461
1934,479,18,16.486167800453515,19.202902494331067,18,48,476,3,461
1935,479,229,16.486167800453515,17.623945578231293,18,29,255,1,250
1936,479,205,16.486167800453515,18.45986394557823,18,28,287,2,274
1937,479,545,16.486167800453515,18.552743764172337,18,15,111,2,66
1938,479,731,16.486167800453515,18.552743764172337,18,14,267,2,252
1939,479,824,16.486167800453515,17.87936507936508,18,15,350,1,345
1940,551,205,17.438185941043084,18.45986394557823,23,28,349,1,346
1941,551,266,17.438185941043084,19.82984126984127,23,25,303,2,285
1942,551,545,17.438185941043084,18.552743764172337,23,15,48,1,6
1943,551,421,17.438185941043084,19.760181405895693,23,20,164,2,130
1944,551,731,17.438185941043084,18.552743764172337,23,14,186,1,180
1945,551,797,17.438185941043084,19.783401360544218,23,19,266,2,246
1946,551,854,17.438185941043084,19.760181405895693,23,19,319,2,303
1947,545,266,18.552743764172337,19.82984126984127,15,25,284,1,279
1948,545,226,18.552743764172337,20.59609977324263,15,19,331,2,319
1949,545,247,18.552743764172337,21.36235827664399,15,25,322,3,298
1950,545,421,18.552743764172337,19.760181405895693,15,20,134,1,124
1951,545,475,18.552743764172337,20.619319727891156,15,15,113,2,70
1952,545,797,18.552743764172337,19.783401360544218,15,19,258,1,252
1953,545,737,18.552743764172337,20.66575963718821,15,14,212,2,192
1954,545,854,18.552743764172337,19.760181405895693,15,19,313,1,309
1955,545,825,18.552743764172337,20.619319727891156,15,14,294,2,280
1956,421,18,19.760181405895693,21.966077097505668,20,49,414,2,403
1957,421,18,19.760181405895693,22.66267573696145,20,48,422,3,403
1958,421,247,19.760181405895693,21.36235827664399,20,25,187,2,174
1959,421,479,19.760181405895693,21.989297052154196,20,18,112,2,58
1960,421,459,19.760181405895693,22.709115646258503,20,18,133,3,38
1961,421,617,19.760181405895693,22.407256235827663,20,18,227,3,196
1962,475,18,20.619319727891156,21.966077097505668,15,49,461,1,457
1963,475,18,20.619319727891156,22.66267573696145,15,48,465,2,457
1964,475,208,20.619319727891156,23.057414965986396,15,29,287,2,267
1965,475,205,20.619319727891156,23.127074829931974,15,29,291,3,270
1966,475,479,20.619319727891156,21.989297052154196,15,18,59,1,4
1967,475,459,20.619319727891156,22.709115646258503,15,18,91,2,16
1968,475,467,20.619319727891156,23.38249433106576,15,17,119,3,8
1969,475,617,20.619319727891156,22.407256235827663,15,18,162,2,142
1970,475,824,20.619319727891156,23.38249433106576,15,15,369,3,349
1971,479,18,21.989297052154196,24.03265306122449,18,48,469,2,461
1972,479,18,21.989297052154196,24.729251700680273,18,49,476,3,461
1973,479,208,21.989297052154196,23.057414965986396,18,29,275,1,271
1974,479,205,21.989297052154196,23.127074829931974,18,29,278,1,274
1975,479,211,21.989297052154196,24.752471655328797,18,24,293,3,268
1976,479,467,21.989297052154196,23.38249433106576,18,17,61,1,12
1977,479,824,21.989297052154196,23.38249433106576,18,15,350,1,345
1978,479,839,21.989297052154196,24.775691609977326,18,15,379,3,360
1979,459,18,22.709115646258503,24.03265306122449,18,48,445,1,441
1980,459,18,22.709115646258503,24.729251700680273,18,49,449,2,441
1981,459,18,22.709115646258503,25.425850340136055,18,49,456,3,441
1982,459,211,22.709115646258503,24.752471655328797,18,24,263,2,248
1983,459,479,22.709115646258503,24.752471655328797,18,17,90,2,20
1984,459,417,22.709115646258503,25.472290249433108,18,18,126,3,42
1985,459,817,22.709115646258503,25.58839002267574,18,18,379,3,358
1986,459,839,22.709115646258503,24.775691609977326,18,15,390,2,380
1987,459,841,22.709115646258503,25.472290249433108,18,16,400,3,382
1988,467,18,23.38249433106576,24.729251700680273,17,49,453,1,449
1989,467,18,23.38249433106576,25.425850340136055,17,49,458,2,449
1990,467,211,23.38249433106576,24.752471655328797,17,24,263,1,256
1991,467,205,23.38249433106576,26.05278911564626,17,21,286,3,262
1992,467,479,23.38249433106576,24.752471655328797,17,17,60,1,12
1993,467,417,23.38249433106576,25.472290249433108,17,18,103,2,50
1994,467,817,23.38249433106576,25.58839002267574,17,18,363,2,350
1995,467,839,23.38249433106576,24.775691609977326,17,15,377,1,372
1996,467,841,23.38249433106576,25.472290249433108,17,16,385,2,374
1997,467,826,23.38249433106576,26.3546485260771,17,24,381,3,359
1998,479,18,24.752471655328797,26.795827664399095,17,49,469,2,461
1999,479,18,24.752471655328797,27.492426303854877,17,49,476,3,461
2000,479,205,24.752471655328797,26.05278911564626,17,21,280,1,274
2001,479,252,24.752471655328797,26.679727891156464,17,24,242,2,227
2002,479,211,24.752471655328797,27.515646258503402,17,20,293,3,268
2003,479,522,24.752471655328797,26.424308390022677,17,31,84,2,43
2004,479,684,24.752471655328797,26.424308390022677,17,26,217,2,205
2005,479,813,24.752471655328797,27.538866213151927,17,15,355,3,334
2006,479,826,24.752471655328797,26.3546485260771,17,24,354,2,347
2007,479,839,24.752471655328797,27.538866213151927,17,14,379,3,360
2008,417,18,25.472290249433108,26.795827664399095,18,49,403,1,399
2009,417,18,25.472290249433108,27.492426303854877,18,49,408,2,399
2010,417,252,25.472290249433108,26.679727891156464,18,24,173,1,165
2011,417,211,25.472290249433108,27.515646258503402,18,20,224,2,206
2012,417,479,25.472290249433108,27.515646258503402,18,16,108,2,62
2013,417,813,25.472290249433108,27.538866213151927,18,15,406,2,396
2014,417,839,25.472290249433108,27.538866213151927,18,14,431,2,422
2015,522,211,26.424308390022677,27.515646258503402,31,20,315,1,311
2016,522,208,26.424308390022677,28.53732426303855,31,21,327,2,314
2017,522,479,26.424308390022677,27.515646258503402,31,16,64,1,43
2018,522,540,26.424308390022677,28.76952380952381,31,27,103,2,18
2019,522,813,26.424308390022677,27.538866213151927,31,15,295,1,291
2020,522,633,26.424308390022677,28.76952380952381,31,22,150,2,111
2021,522,839,26.424308390022677,27.538866213151927,31,14,321,1,317
2022,522,839,26.424308390022677,28.792743764172336,31,18,333,2,317
2023,479,18,27.515646258503402,28.862403628117914,16,48,465,1,461
2024,479,18,27.515646258503402,29.559002267573696,16,49,469,2,461
2025,479,18,27.515646258503402,30.25560090702948,16,49,476,3,461
2026,479,208,27.515646258503402,28.53732426303855,16,21,275,1,271
2027,479,207,27.515646258503402,29.489342403628118,16,22,285,2,272
2028,479,540,27.515646258503402,28.76952380952381,16,27,81,1,61
2029,479,491,27.515646258503402,29.60544217687075,16,15,91,2,12
2030,479,524,27.515646258503402,30.48780045351474,16,32,136,3,45
2031,479,633,27.515646258503402,28.76952380952381,16,22,163,1,154
2032,479,839,27.515646258503402,28.792743764172336,16,18,364,1,360
2033,479,836,27.515646258503402,30.48780045351474,16,23,379,3,357
2034,540,209,28.76952380952381,30.859319727891158,27,26,343,2,331
2035,540,231,28.76952380952381,31.67201814058957,27,24,333,3,309
2036,540,524,28.76952380952381,30.48780045351474,27,32,76,2,16
2037,540,465,28.76952380952381,31.648798185941043,27,16,145,3,75
2038,540,812,28.76952380952381,30.511020408163265,27,23,282,2,272
2039,540,836,28.76952380952381,30.48780045351474,27,23,305,2,296
2040,540,824,28.76952380952381,31.67201814058957,27,14,310,3,284
2041,491,18,29.60544217687075,31.62557823129252,15,48,481,2,473
2042,491,18,29.60544217687075,32.3221768707483,15,49,487,3,473
2043,491,209,29.60544217687075,30.859319727891158,15,26,287,1,282
2044,491,231,29.60544217687075,31.67201814058957,15,24,275,2,260
2045,491,465,29.60544217687075,31.648798185941043,15,16,92,2,26
2046,491,452,29.60544217687075,32.3221768707483,15,19,123,3,39
2047,491,824,29.60544217687075,31.67201814058957,15,14,345,2,333
2048,524,231,30.48780045351474,31.67201814058957,32,24,297,1,293
2049,524,311,30.48780045351474,33.04199546485261,32,20,240,3,213
2050,524,278,30.48780045351474,33.41351473922902,32,23,276,3,246
2051,524,465,30.48780045351474,31.648798185941043,32,16,77,1,59
2052,524,452,30.48780045351474,32.3221768707483,32,19,107,2,72
2053,524,679,30.48780045351474,33.04199546485261,32,15,190,3,155
2054,524,824,30.48780045351474,31.67201814058957,32,14,304,1,300
2055,524,839,30.48780045351474,33.04199546485261,32,14,334,3,315
2056,465,18,31.648798185941043,33.69215419501134,16,48,456,2,447
2057,465,18,31.648798185941043,34.38875283446712,16,48,462,3,447
2058,465,311,31.648798185941043,33.04199546485261,16,20,165,1,154
2059,465,278,31.648798185941043,33.41351473922902,16,23,202,2,187
2060,465,347,31.648798185941043,34.59773242630386,16,30,173,3,118
2061,465,459,31.648798185941043,33.73859410430839,16,17,90,2,6
2062,465,679,31.648798185941043,33.04199546485261,16,15,222,1,214
2063,465,691,31.648798185941043,33.73859410430839,16,16,243,2,226
2064,465,819,31.648798185941043,34.62095238095238,16,21,376,3,354
2065,465,839,31.648798185941043,33.04199546485261,16,14,379,1,374
2066,452,18,32.3221768707483,33.69215419501134,19,48,438,1,434
2067,452,18,32.3221768707483,34.38875283446712,19,48,443,2,434
2068,452,278,32.3221768707483,33.41351473922902,19,23,180,1,174
2069,452,347,32.3221768707483,34.59773242630386,19,30,144,2,105
2070,452,459,32.3221768707483,33.73859410430839,19,17,61,1,7
2071,452,414,32.3221768707483,34.66739229024943,19,25,108,2,38
2072,452,691,32.3221768707483,33.73859410430839,19,16,247,1,239
2073,452,819,32.3221768707483,34.62095238095238,19,21,380,2,367
2074,452,888,32.3221768707483,34.644172335600906,19,26,447,2,436
2075,459,52,33.73859410430839,35.572970521541954,17,49,415,2,407
2076,459,18,33.73859410430839,36.45532879818594,17,48,456,3,441
2077,459,231,33.73859410430839,35.71229024943311,17,26,243,2,228
2078,459,233,33.73859410430839,36.339229024943315,17,21,252,3,226
2079,459,479,33.73859410430839,35.781950113378684,17,16,90,2,20
2080,459,524,33.73859410430839,36.5946485260771,17,18,139,3,65
2081,459,817,33.73859410430839,36.617868480725626,17,18,379,3,358
2082,459,839,33.73859410430839,35.80517006802721,17,14,390,2,380
2083,459,920,33.73859410430839,36.548208616780045,17,16,477,3,461
2084,414,18,34.66739229024943,36.45532879818594,25,48,403,2,396
2085,414,18,34.66739229024943,37.151927437641724,25,48,410,2,396
2086,414,231,34.66739229024943,35.71229024943311,25,26,188,1,183
2087,414,233,34.66739229024943,36.339229024943315,25,21,195,2,181
2088,414,479,34.66739229024943,35.781950113378684,25,16,81,1,65
2089,414,524,34.66739229024943,36.5946485260771,25,18,138,2,110
2090,414,467,34.66739229024943,37.17514739229025,25,15,120,3,53
2091,414,817,34.66739229024943,36.617868480725626,25,18,412,2,403
2092,414,839,34.66739229024943,35.80517006802721,25,14,428,1,425
2093,479,18,35.781950113378684,37.151927437641724,16,48,465,1,461
2094,479,386,35.781950113378684,37.871746031746035,16,20,129,2,93
2095,479,467,35.781950113378684,37.17514739229025,16,15,61,1,12
2096,524,46,36.5946485260771,39.288163265306125,18,48,492,3,478
2097,524,386,36.5946485260771,37.871746031746035,18,20,149,1,138
2098,524,260,36.5946485260771,38.800544217687076,18,27,281,2,264
2099,524,483,36.5946485260771,39.07918367346939,18,24,115,2,41
2100,524,459,36.5946485260771,39.2649433106576,18,16,132,3,65
2101,524,808,36.5946485260771,39.07918367346939,18,18,303,2,284
2102,524,799,36.5946485260771,39.125623582766444,18,14,296,3,275
2103,524,865,36.5946485260771,39.07918367346939,18,22,357,2,341
2104,524,902,36.5946485260771,39.125623582766444,18,19,393,3,378
2105,467,6,37.17514739229025,39.05596371882086,15,47,468,2,461
2106,467,46,37.17514739229025,39.288163265306125,15,48,431,2,421
2107,467,260,37.17514739229025,38.800544217687076,15,27,219,2,207
2108,467,211,37.17514739229025,39.59002267573696,15,23,276,2,256
2109,467,483,37.17514739229025,39.07918367346939,15,24,84,2,16
2110,467,459,37.17514739229025,39.2649433106576,15,16,90,2,8
2111,467,808,37.17514739229025,39.07918367346939,15,18,351,2,341
2112,467,799,37.17514739229025,39.125623582766444,15,14,342,2,332
2113,467,865,37.17514739229025,39.07918367346939,15,22,406,2,398
2114,467,902,37.17514739229025,39.125623582766444,15,19,443,2,435
2115,483,18,39.07918367346939,40.58848072562358,24,48,470,2,465
2116,483,6,39.07918367346939,41.470839002267574,24,48,488,2,477
2117,483,208,39.07918367346939,40.96,24,27,287,2,275
2118,483,476,39.07918367346939,40.61170068027211,24,15,66,2,7
2119,483,502,39.07918367346939,41.86557823129252,24,29,121,3,19
2120,483,661,39.07918367346939,41.35473922902494,24,25,203,2,178
2121,483,958,39.07918367346939,41.33151927437642,24,27,485,2,475
2122,459,18,39.2649433106576,40.58848072562358,16,48,445,1,441
2123,459,6,39.2649433106576,41.470839002267574,16,48,463,2,453
2124,459,47,39.2649433106576,42.190657596371885,16,47,431,3,412
2125,459,208,39.2649433106576,40.96,16,27,261,2,251
2126,459,245,39.2649433106576,42.09777777777778,16,26,246,3,214
2127,459,235,39.2649433106576,42.190657596371885,16,23,257,3,224
2128,459,476,39.2649433106576,40.61170068027211,16,15,60,1,17
2129,459,502,39.2649433106576,41.86557823129252,16,29,120,3,43
2130,459,661,39.2649433106576,41.35473922902494,16,25,221,2,202
2131,459,958,39.2649433106576,41.33151927437642,16,27,507,2,499
2132,476,47,40.61170068027211,42.190657596371885,15,47,434,2,429
2133,476,18,40.61170068027211,43.35165532879819,15,48,473,3,458
2134,476,245,40.61170068027211,42.09777777777778,15,26,240,1,231
2135,476,235,40.61170068027211,42.190657596371885,15,23,250,2,241
2136,476,386,40.61170068027211,43.39809523809524,15,20,150,3,90
2137,476,502,40.61170068027211,41.86557823129252,15,29,60,1,26
2138,476,674,40.61170068027211,42.74793650793651,15,16,218,2,198
2139,476,944,40.61170068027211,42.74793650793651,15,14,477,2,468
2140,502,18,41.86557823129252,43.35165532879819,29,48,488,1,484
2141,502,6,41.86557823129252,44.58231292517007,29,47,510,3,496
2142,502,386,41.86557823129252,43.39809523809524,29,20,133,2,116
2143,502,271,41.86557823129252,44.81451247165533,29,27,264,3,231
2144,502,479,41.86557823129252,44.0714739229025,29,15,98,2,23
2145,502,459,41.86557823129252,44.76807256235828,29,17,132,3,43
2146,502,699,41.86557823129252,44.74485260770975,29,17,233,3,197
2147,502,870,41.86557823129252,44.76807256235828,29,16,389,3,368
2148,476,6,42.79437641723356,44.58231292517007,26,47,476,2,470
2149,476,5,42.79437641723356,45.7665306122449,26,48,488,3,471
2150,476,271,42.79437641723356,44.81451247165533,26,27,223,2,205
2151,476,329,42.79437641723356,45.27891156462585,26,18,182,2,147
2152,476,479,42.79437641723356,44.0714739229025,26,15,55,1,3
2153,476,459,42.79437641723356,44.76807256235828,26,17,87,2,17
2154,476,553,42.79437641723356,45.65043083900227,26,26,145,3,77
2155,476,699,42.79437641723356,44.74485260770975,26,17,238,2,223
2156,476,628,42.79437641723356,45.60399092970522,26,23,194,3,152
2157,476,870,42.79437641723356,44.76807256235828,26,16,403,2,394
2158,476,943,42.79437641723356,45.58077097505669,26,27,482,3,467
2159,479,5,44.0714739229025,45.7665306122449,15,48,480,2,474
2160,479,5,44.0714739229025,47.04362811791383,15,48,491,3,474
2161,479,329,44.0714739229025,45.27891156462585,15,18,159,1,150
2162,479,216,44.0714739229025,46.88108843537415,15,25,289,3,263
2163,479,553,44.0714739229025,45.65043083900227,15,26,100,2,74
2164,479,534,44.0714739229025,46.27736961451247,15,28,110,2,55
2165,479,628,44.0714739229025,45.60399092970522,15,23,163,2,149
2166,479,694,44.0714739229025,46.34702947845805,15,24,236,2,215
2167,479,943,44.0714739229025,45.58077097505669,15,27,469,2,464
2168,479,853,44.0714739229025,46.300589569161,15,23,386,2,374
2169,459,5,44.76807256235828,47.04362811791383,17,48,464,2,454
2170,459,5,44.76807256235828,47.391927437641726,17,47,468,3,454
2171,459,216,44.76807256235828,46.88108843537415,17,25,259,2,243
2172,459,254,44.76807256235828,47.159727891156464,17,22,229,2,205
2173,459,534,44.76807256235828,46.27736961451247,17,28,99,2,75
2174,459,511,44.76807256235828,47.484807256235825,17,19,128,3,52
2175,459,694,44.76807256235828,46.34702947845805,17,24,245,2,235
2176,459,704,44.76807256235828,47.438367346938776,17,23,271,3,245
2177,459,853,44.76807256235828,46.300589569161,17,23,399,2,394
2178,459,826,44.76807256235828,47.438367346938776,17,20,385,3,367
2179,553,216,45.65043083900227,46.88108843537415,26,25,341,1,337
2180,553,254,45.65043083900227,47.159727891156464,26,22,306,2,299
2181,553,215,45.65043083900227,48.204625850340136,26,20,355,3,338
2182,553,511,45.65043083900227,47.484807256235825,26,19,89,2,42
2183,553,411,45.65043083900227,48.48326530612245,26,18,187,3,142
2184,553,704,45.65043083900227,47.438367346938776,26,23,169,2,151
2185,553,813,45.65043083900227,48.39038548752835,26,14,286,3,260
2186,553,826,45.65043083900227,47.438367346938776,26,20,284,2,273
2187,553,887,45.65043083900227,48.41360544217687,26,18,355,3,334
2188,534,215,46.27736961451247,48.204625850340136,28,20,330,2,319
2189,534,511,46.27736961451247,47.484807256235825,28,19,57,1,23
2190,534,411,46.27736961451247,48.48326530612245,28,18,155,2,123
2191,534,704,46.27736961451247,47.438367346938776,28,23,177,1,170
2192,534,813,46.27736961451247,48.39038548752835,28,14,293,2,279
2193,534,826,46.27736961451247,47.438367346938776,28,20,296,1,292
2194,534,887,46.27736961451247,48.41360544217687,28,18,365,2,353
2195,511,18,47.484807256235825,48.87800453514739,19,47,497,1,493
2196,511,18,47.484807256235825,49.55138321995465,19,47,501,2,493
2197,511,298,47.484807256235825,49.31918367346939,19,22,227,2,213
2198,511,490,47.484807256235825,50.108662131519274,19,26,115,3,21
2199,511,459,47.484807256235825,50.29442176870749,19,17,132,3,52
2200,511,818,47.484807256235825,50.108662131519274,19,19,327,3,307
2201,511,908,47.484807256235825,50.108662131519274,19,20,413,3,397
2202,511,875,47.484807256235825,50.178321995464856,19,14,382,3,364
2203,411,18,48.48326530612245,49.55138321995465,18,47,396,1,393
2204,411,6,48.48326530612245,50.64272108843537,18,47,416,2,405
2205,411,6,48.48326530612245,51.2928798185941,18,49,423,3,405
2206,411,211,48.48326530612245,50.61950113378685,18,22,220,2,200
2207,411,490,48.48326530612245,50.108662131519274,18,26,106,2,79
2208,411,459,48.48326530612245,50.29442176870749,18,17,92,2,48
2209,411,818,48.48326530612245,50.108662131519274,18,19,413,2,407
2210,411,908,48.48326530612245,50.108662131519274,18,20,502,2,497
2211,411,875,48.48326530612245,50.178321995464856,18,14,470,2,464
2212,490,6,50.108662131519274,51.2928798185941,26,49,487,1,484
2213,490,6,50.108662131519274,52.848616780045354,26,47,498,3,484
2214,490,249,50.108662131519274,52.15201814058957,26,25,257,2,241
2215,490,255,50.108662131519274,52.66285714285714,26,27,259,3,235
2216,490,545,50.108662131519274,51.66439909297052,26,14,87,2,55
2217,490,512,50.108662131519274,52.91827664399093,26,29,123,3,22
2218,490,674,50.108662131519274,52.407437641723355,26,29,209,2,184
2219,490,874,50.108662131519274,52.360997732426306,26,22,396,2,384
2220,459,6,50.29442176870749,52.848616780045354,17,47,466,3,453
2221,459,249,50.29442176870749,52.15201814058957,17,25,225,2,210
2222,459,255,50.29442176870749,52.66285714285714,17,27,228,2,204
2223,459,247,50.29442176870749,53.19691609977324,17,22,246,3,212
2224,459,545,50.29442176870749,51.66439909297052,17,14,104,1,86
2225,459,512,50.29442176870749,52.91827664399093,17,29,125,3,53
2226,459,674,50.29442176870749,52.407437641723355,17,29,233,2,215
2227,459,874,50.29442176870749,52.360997732426306,17,22,424,2,415
2228,545,247,51.66439909297052,53.19691609977324,14,22,305,2,298
2229,545,512,51.66439909297052,52.91827664399093,14,29,63,1,33
2230,545,457,51.66439909297052,53.75419501133787,14,18,126,2,88
2231,545,809,51.66439909297052,53.75419501133787,14,16,279,2,264
2232,545,932,51.66439909297052,53.777414965986395,14,17,398,2,387
2233,512,18,52.91827664399093,54.381133786848075,29,48,498,1,494
2234,512,211,52.91827664399093,55.100952380952386,29,23,315,2,301
2235,512,272,52.91827664399093,55.797551020408164,29,32,270,3,240
2236,512,478,52.91827664399093,55.100952380952386,29,17,100,2,34
2237,512,459,52.91827664399093,55.797551020408164,29,17,135,3,53
2238,512,679,52.91827664399093,55.12417233560091,29,14,192,2,167
2239,512,816,52.91827664399093,55.797551020408164,29,14,328,3,304
2240,512,839,52.91827664399093,55.12417233560091,29,15,341,2,327
2241,512,930,52.91827664399093,55.797551020408164,29,16,436,3,418
2242,457,5,53.75419501133787,55.61179138321996,18,47,459,2,452
2243,457,211,53.75419501133787,55.100952380952386,18,23,253,1,246
2244,457,272,53.75419501133787,55.797551020408164,18,32,205,2,185
2245,457,266,53.75419501133787,56.49414965986394,18,26,225,3,191
2246,457,478,53.75419501133787,55.100952380952386,18,17,62,1,21
2247,457,459,53.75419501133787,55.797551020408164,18,17,88,2,2
2248,457,614,53.75419501133787,56.65668934240363,18,24,201,3,157
2249,457,679,53.75419501133787,55.12417233560091,18,14,230,1,222
2250,457,816,53.75419501133787,55.797551020408164,18,14,370,2,359
2251,457,693,53.75419501133787,56.679909297052156,18,27,268,3,236
2252,457,839,53.75419501133787,55.12417233560091,18,15,387,1,382
2253,457,930,53.75419501133787,55.797551020408164,18,16,481,2,473
2254,457,838,53.75419501133787,56.65668934240363,18,25,401,3,381
2255,478,5,55.100952380952386,56.86566893424036,17,47,479,2,473
2256,478,54,55.100952380952386,57.56226757369615,17,46,437,2,424
2257,478,266,55.100952380952386,56.49414965986394,17,26,220,1,212
2258,478,216,55.100952380952386,57.88734693877551,17,30,288,3,262
2259,478,614,55.100952380952386,56.65668934240363,17,24,152,2,136
2260,478,521,55.100952380952386,57.399727891156466,17,30,108,2,43
2261,478,693,55.100952380952386,56.679909297052156,17,27,225,2,215
2262,478,819,55.100952380952386,57.446167800453516,17,25,356,2,341
2263,478,838,55.100952380952386,56.65668934240363,17,25,366,2,360
2264,478,887,55.100952380952386,57.30684807256236,17,27,420,2,409
2265,459,5,55.797551020408164,56.86566893424036,17,47,456,1,454
2266,459,54,55.797551020408164,57.56226757369615,17,46,412,2,405
2267,459,5,55.797551020408164,58.35174603174603,17,47,467,3,454
2268,459,216,55.797551020408164,57.88734693877551,17,30,259,2,243
2269,459,521,55.797551020408164,57.399727891156466,17,30,93,2,62
2270,459,551,55.797551020408164,58.537505668934244,17,22,150,3,92
2271,459,819,55.797551020408164,57.446167800453516,17,25,367,2,360
2272,459,705,55.797551020408164,58.51428571428571,17,22,272,3,246
2273,459,887,55.797551020408164,57.30684807256236,17,27,433,2,428
2274,459,875,55.797551020408164,58.51428571428571,17,19,432,3,416
2275,614,216,56.65668934240363,57.88734693877551,24,30,402,1,398
2276,614,243,56.65668934240363,58.88580498866213,24,24,383,2,371
2277,614,207,56.65668934240363,59.303764172335605,24,29,423,3,407
2278,614,551,56.65668934240363,58.537505668934244,24,22,103,2,63
2279,614,418,56.65668934240363,59.396643990929704,24,20,229,3,196
2280,614,705,56.65668934240363,58.51428571428571,24,22,121,2,91
2281,614,819,56.65668934240363,59.55918367346939,24,17,240,3,205
2282,614,875,56.65668934240363,58.51428571428571,24,19,273,2,261
2283,614,847,56.65668934240363,59.582403628117916,24,17,265,3,233
2284,521,243,57.399727891156466,58.88580498866213,30,24,285,1,278
2285,521,207,57.399727891156466,59.303764172335605,30,29,325,2,314
2286,521,551,57.399727891156466,58.537505668934244,30,22,57,1,30
2287,521,418,57.399727891156466,59.396643990929704,30,20,134,2,103
2288,521,705,57.399727891156466,58.51428571428571,30,22,190,1,184
2289,521,819,57.399727891156466,59.55918367346939,30,17,312,2,298
2290,521,875,57.399727891156466,58.51428571428571,30,19,357,1,354
2291,521,847,57.399727891156466,59.582403628117916,30,17,339,2,326
2292,551,83,58.537505668934244,60.8130612244898,22,48,478,2,468
2293,551,278,58.537505668934244,60.44154195011338,22,30,285,2,273
2294,551,207,58.537505668934244,61.39356009070295,22,28,365,3,344
2295,551,410,58.537505668934244,61.161360544217686,22,20,181,3,141
2296,551,416,58.537505668934244,61.37034013605442,22,20,182,3,135
2297,551,819,58.537505668934244,59.55918367346939,22,17,272,1,268
2298,551,722,58.537505668934244,60.65052154195011,22,14,194,2,171
2299,551,783,58.537505668934244,61.30068027210884,22,22,261,3,232
2300,551,847,58.537505668934244,59.582403628117916,22,17,299,1,296
2301,551,839,58.537505668934244,60.62730158730159,22,15,302,2,288
2302,551,824,58.537505668934244,61.30068027210884,22,26,298,3,273
2303,418,83,59.396643990929704,60.8130612244898,20,48,341,1,335
2304,418,67,59.396643990929704,61.92761904761905,20,47,368,3,351
2305,418,278,59.396643990929704,60.44154195011338,20,30,147,1,140
2306,418,207,59.396643990929704,61.39356009070295,20,28,228,2,211
2307,418,410,59.396643990929704,61.161360544217686,20,20,76,2,8
2308,418,416,59.396643990929704,61.37034013605442,20,20,85,2,2
2309,418,722,59.396643990929704,60.65052154195011,20,14,309,1,304
2310,418,783,59.396643990929704,61.30068027210884,20,22,374,2,365
2311,418,839,59.396643990929704,60.62730158730159,20,15,424,1,421
2312,418,824,59.396643990929704,61.30068027210884,20,26,414,2,406
2313,410,6,61.161360544217686,63.018956916099775,20,47,412,2,404
2314,410,18,61.161360544217686,63.34403628117914,20,48,403,2,392
2315,410,275,61.161360544217686,63.20471655328798,20,31,161,2,135
2316,410,275,61.161360544217686,63.22793650793651,20,29,162,2,135
2317,410,475,61.161360544217686,62.415238095238095,20,22,85,1,65
2318,410,547,61.161360544217686,64.04063492063493,20,24,185,3,137
2319,410,727,61.161360544217686,62.71709750566894,20,16,324,2,317
2320,410,657,61.161360544217686,63.99419501133787,20,22,275,3,247
2321,410,896,61.161360544217686,64.01741496598639,20,22,501,3,486
2322,416,6,61.37034013605442,63.018956916099775,20,47,416,2,410
2323,416,18,61.37034013605442,63.34403628117914,20,48,407,2,398
2324,416,275,61.37034013605442,63.20471655328798,20,31,162,2,141
2325,416,275,61.37034013605442,63.22793650793651,20,29,162,2,141
2326,416,475,61.37034013605442,62.415238095238095,20,22,74,1,59
2327,416,547,61.37034013605442,64.04063492063493,20,24,174,3,131
2328,416,727,61.37034013605442,62.71709750566894,20,16,316,1,311
2329,416,657,61.37034013605442,63.99419501133787,20,22,266,3,241
2330,416,896,61.37034013605442,64.01741496598639,20,22,493,3,480
2331,475,68,62.415238095238095,64.6443537414966,22,47,418,2,407
2332,475,272,62.415238095238095,64.92299319727891,22,26,230,3,203
2333,475,275,62.415238095238095,65.2712925170068,22,27,235,3,200
2334,475,547,62.415238095238095,64.04063492063493,22,24,100,2,72
2335,475,603,62.415238095238095,64.52825396825396,22,15,157,2,128
2336,475,436,62.415238095238095,65.38739229024944,22,19,134,3,39
2337,475,657,62.415238095238095,63.99419501133787,22,22,194,2,182
2338,475,896,62.415238095238095,64.01741496598639,22,22,427,2,421
2339,475,824,62.415238095238095,64.76045351473923,22,15,363,2,349
2340,547,275,64.04063492063493,65.2712925170068,24,27,277,1,272
2341,547,247,64.04063492063493,66.47873015873016,24,32,318,2,300
2342,547,436,64.04063492063493,65.38739229024944,24,19,125,1,111
2343,547,459,64.04063492063493,66.85024943310658,24,16,150,3,88
2344,547,813,64.04063492063493,66.1536507936508,24,15,281,2,266
2345,547,941,64.04063492063493,65.52671201814059,24,14,399,1,394
2346,547,899,64.04063492063493,66.82702947845804,24,15,372,3,352
2347,603,247,64.52825396825396,66.47873015873016,15,32,366,2,356
2348,603,459,64.52825396825396,66.85024943310658,15,16,175,2,144
2349,603,813,64.52825396825396,66.1536507936508,15,15,221,2,210
2350,603,899,64.52825396825396,66.82702947845804,15,15,312,2,296
2351,436,81,65.38739229024944,67.10566893424037,19,47,363,2,355
2352,436,5,65.38739229024944,67.8487074829932,19,47,444,2,431
2353,436,247,65.38739229024944,66.47873015873016,19,32,195,1,189
2354,436,207,65.38739229024944,67.61650793650794,19,25,248,2,229
2355,436,459,65.38739229024944,66.85024943310658,19,16,67,1,23
2356,436,553,65.38739229024944,67.73260770975057,19,27,155,2,117
2357,436,679,65.38739229024944,67.68616780045352,19,26,262,2,243
2358,436,621,65.38739229024944,68.35954648526078,19,25,225,3,185
2359,436,899,65.38739229024944,66.82702947845804,19,15,467,1,463
2360,436,822,65.38739229024944,67.68616780045352,19,24,398,2,386
2361,436,843,65.38739229024944,68.35954648526078,19,26,427,3,407
2362,459,5,66.85024943310658,69.1025850340136,16,48,464,2,454
2363,459,5,66.85024943310658,69.4508843537415,16,48,468,3,454
2364,459,346,66.85024943310658,68.94004535147393,16,26,144,2,113
2365,459,230,66.85024943310658,69.28834467120181,16,23,252,2,229
2366,459,425,66.85024943310658,68.94004535147393,16,28,96,2,34
2367,459,621,66.85024943310658,68.35954648526078,16,25,175,2,162
2368,459,843,66.85024943310658,68.35954648526078,16,26,389,2,384
2369,553,346,67.73260770975057,68.94004535147393,27,26,213,1,207
2370,553,230,67.73260770975057,69.28834467120181,27,23,330,2,323
2371,553,261,67.73260770975057,70.4261224489796,27,26,314,3,292
2372,553,425,67.73260770975057,68.94004535147393,27,28,138,1,128
2373,553,555,67.73260770975057,70.14748299319729,27,28,104,2,2
2374,553,525,67.73260770975057,70.58866213151927,27,18,126,3,28
2375,553,630,67.73260770975057,70.12426303854875,27,22,129,2,77
2376,553,621,67.73260770975057,70.54222222222222,27,16,139,3,68
2377,553,830,67.73260770975057,70.12426303854875,27,23,296,2,277
2378,553,959,67.73260770975057,70.56544217687075,27,25,424,3,406
2379,425,51,68.94004535147393,70.65832199546486,28,47,381,2,374
2380,425,261,68.94004535147393,70.4261224489796,28,26,176,1,164
2381,425,555,68.94004535147393,70.14748299319729,28,28,140,1,130
2382,425,525,68.94004535147393,70.58866213151927,28,18,123,2,100
2383,425,630,68.94004535147393,70.12426303854875,28,22,211,1,205
2384,425,621,68.94004535147393,70.54222222222222,28,16,208,2,196
2385,425,830,68.94004535147393,70.12426303854875,28,23,408,1,405
2386,555,234,70.14748299319729,72.12117913832199,28,32,332,2,321
2387,555,205,70.14748299319729,72.33015873015873,28,29,362,2,350
2388,555,459,70.14748299319729,72.35337868480725,28,19,135,2,96
2389,555,625,70.14748299319729,72.05151927437642,28,14,108,2,70
2390,555,737,70.14748299319729,73.07319727891156,28,15,221,3,182
2391,525,52,70.58866213151927,72.12117913832199,18,45,478,2,473
2392,525,234,70.58866213151927,72.12117913832199,18,32,298,2,291
2393,525,205,70.58866213151927,72.33015873015873,18,29,329,2,320
2394,525,260,70.58866213151927,73.25895691609978,18,24,289,3,265
2395,525,459,70.58866213151927,72.35337868480725,18,19,101,2,66
2396,525,625,70.58866213151927,72.05151927437642,18,14,118,1,100
2397,525,737,70.58866213151927,73.07319727891156,18,15,237,2,212
2398,459,18,72.35337868480725,73.70013605442178,19,48,445,1,441
2399,459,18,72.35337868480725,74.37351473922902,19,48,449,2,441
2400,459,251,72.35337868480725,75.00045351473923,19,30,237,3,208
2401,459,545,72.35337868480725,73.7233560090703,19,14,104,1,86
2402,459,703,72.35337868480725,73.7233560090703,19,14,251,1,244
2403,459,624,72.35337868480725,74.81469387755102,19,16,196,2,165
2404,459,852,72.35337868480725,75.3255328798186,19,21,413,3,393
2405,545,251,73.7233560090703,75.00045351473923,14,30,299,1,294
2406,545,406,73.7233560090703,75.37197278911565,14,27,156,2,139
2407,545,272,73.7233560090703,76.34721088435374,14,23,295,3,273
2408,545,459,73.7233560090703,75.11655328798186,14,18,105,1,86
2409,545,457,73.7233560090703,75.37197278911565,14,29,113,2,88
2410,545,624,73.7233560090703,74.81469387755102,14,16,92,1,79
2411,545,639,73.7233560090703,75.39519274376417,14,23,118,2,94
2412,545,852,73.7233560090703,75.3255328798186,14,21,315,2,307
2413,459,18,75.11655328798186,77.13668934240363,18,49,449,2,441
2414,459,18,75.11655328798186,77.83328798185941,18,48,456,3,441
2415,459,272,75.11655328798186,76.34721088435374,18,23,194,1,187
2416,459,229,75.11655328798186,77.53142857142858,18,20,252,2,230
2417,459,479,75.11655328798186,77.15990929705215,18,18,90,2,20
2418,459,839,75.11655328798186,77.18312925170068,18,16,390,2,380
2419,457,18,75.37197278911565,77.13668934240363,29,49,446,2,439
2420,457,18,75.37197278911565,77.83328798185941,29,48,452,2,439
2421,457,229,75.37197278911565,77.53142857142858,29,20,246,2,228
2422,457,479,75.37197278911565,77.15990929705215,29,18,80,2,22
2423,457,459,75.37197278911565,77.87972789115646,29,19,108,3,2
2424,457,839,75.37197278911565,77.18312925170068,29,16,390,2,382
2425,479,18,77.15990929705215,79.20326530612245,18,48,469,2,461
2426,479,18,77.15990929705215,79.89986394557823,18,49,476,3,461
2427,479,267,77.15990929705215,78.59954648526077,18,27,221,1,212
2428,479,211,77.15990929705215,79.92308390022676,18,22,293,3,268
2429,479,508,77.15990929705215,78.46022675736961,18,23,63,1,29
2430,479,429,77.15990929705215,79.94630385487528,18,17,130,3,50
2431,479,658,77.15990929705215,78.55310657596372,18,17,189,1,179
2432,479,813,77.15990929705215,79.94630385487528,18,14,355,3,334
2433,479,824,77.15990929705215,78.55310657596372,18,14,350,1,345
2434,479,839,77.15990929705215,79.94630385487528,18,14,379,3,360
2435,459,18,77.87972789115646,79.20326530612245,19,48,445,1,441
2436,459,18,77.87972789115646,79.89986394557823,19,49,449,2,441
2437,459,18,77.87972789115646,80.59646258503402,19,48,456,3,441
2438,459,211,77.87972789115646,79.92308390022676,19,22,263,2,248
2439,459,429,77.87972789115646,79.94630385487528,19,17,94,2,30
2440,459,524,77.87972789115646,80.73578231292517,19,18,139,3,65
2441,459,813,77.87972789115646,79.94630385487528,19,14,365,2,354
2442,459,817,77.87972789115646,80.75900226757369,19,18,379,3,358
2443,459,839,77.87972789115646,79.94630385487528,19,14,390,2,380
2444,459,831,77.87972789115646,80.66612244897959,19,15,391,3,372
2445,508,18,78.46022675736961,79.89986394557823,23,49,494,1,490
2446,508,18,78.46022675736961,80.59646258503402,23,48,499,2,490
2447,508,211,78.46022675736961,79.92308390022676,23,22,304,1,297
2448,508,208,78.46022675736961,81.22340136054422,23,29,323,3,300
2449,508,429,78.46022675736961,79.94630385487528,23,17,102,1,79
2450,508,524,78.46022675736961,80.73578231292517,23,18,99,2,16
2451,508,498,78.46022675736961,81.31628117913833,23,16,123,3,10
2452,508,813,78.46022675736961,79.94630385487528,23,14,312,1,305
2453,508,817,78.46022675736961,80.75900226757369,23,18,324,2,309
2454,508,839,78.46022675736961,79.94630385487528,23,14,337,1,331
2455,508,831,78.46022675736961,80.66612244897959,23,15,337,2,323
2456,429,18,79.94630385487528,81.96643990929705,17,48,420,2,411
2457,429,18,79.94630385487528,82.66303854875284,17,48,427,3,411
2458,429,208,79.94630385487528,81.22340136054422,17,29,228,1,221
2459,429,253,79.94630385487528,81.8271201814059,17,31,194,2,176
2460,429,498,79.94630385487528,81.31628117913833,17,16,91,1,69
2461,429,479,79.94630385487528,82.68625850340136,17,18,128,3,50
2462,429,813,79.94630385487528,82.70947845804989,17,13,402,3,384
2463,524,253,80.73578231292517,81.8271201814059,18,31,275,1,271
2464,524,232,80.73578231292517,83.28997732426303,18,27,312,3,292
2465,524,228,80.73578231292517,83.38285714285715,18,28,317,3,296
2466,524,479,80.73578231292517,82.68625850340136,18,18,95,2,45
2467,524,813,80.73578231292517,82.70947845804989,18,13,301,2,289
2468,498,18,81.31628117913833,82.66303854875284,16,48,483,1,480
2469,498,27,81.31628117913833,84.24199546485261,16,49,488,3,471
2470,498,232,81.31628117913833,83.28997732426303,16,27,279,2,266
2471,498,228,81.31628117913833,83.38285714285715,16,28,284,2,270
2472,498,479,81.31628117913833,82.68625850340136,16,18,62,1,19
2473,498,527,81.31628117913833,84.17233560090703,16,29,126,3,29
2474,498,813,81.31628117913833,82.70947845804989,16,13,321,1,315
2475,498,648,81.31628117913833,84.12589569160998,16,24,193,3,150
2476,498,887,81.31628117913833,84.14911564625851,16,24,408,3,389
2477,479,27,82.68625850340136,84.24199546485261,18,49,457,2,452
2478,479,18,82.68625850340136,84.72961451247166,18,48,469,2,461
2479,479,18,82.68625850340136,85.42621315192744,18,49,476,3,461
2480,479,258,82.68625850340136,84.4045351473923,18,24,233,2,221
2481,479,527,82.68625850340136,84.17233560090703,18,29,80,1,48
2482,479,481,82.68625850340136,84.75283446712018,18,15,89,2,2
2483,479,648,82.68625850340136,84.12589569160998,18,24,180,1,169
2484,479,679,82.68625850340136,85.44943310657597,18,14,233,3,200
2485,479,887,82.68625850340136,84.14911564625851,18,24,413,1,408
2486,479,905,82.68625850340136,85.44943310657597,18,15,442,3,426
2487,527,251,84.17233560090703,86.1924716553288,29,28,289,2,276
2488,527,263,84.17233560090703,86.98195011337869,29,25,290,3,264
2489,527,459,84.17233560090703,86.14603174603175,29,18,109,2,68
2490,527,517,84.17233560090703,87.07482993197279,29,30,125,3,10
2491,527,679,84.17233560090703,85.44943310657597,29,14,162,1,152
2492,527,653,84.17233560090703,86.6336507936508,29,16,165,2,126
2493,527,905,84.17233560090703,85.44943310657597,29,15,382,1,378
2494,527,944,84.17233560090703,86.61043083900226,29,17,430,2,417
2495,481,18,84.75283446712018,86.79619047619047,15,48,471,2,463
2496,481,18,84.75283446712018,87.49278911564626,15,49,478,3,463
2497,481,251,84.75283446712018,86.1924716553288,15,28,238,1,230
2498,481,263,84.75283446712018,86.98195011337869,15,25,238,2,218
2499,481,213,84.75283446712018,87.42312925170069,15,24,292,3,268
2500,481,459,84.75283446712018,86.14603174603175,15,18,64,1,22
2501,481,517,84.75283446712018,87.07482993197279,15,30,106,2,36
2502,481,653,84.75283446712018,86.6336507936508,15,16,190,2,172
2503,481,944,84.75283446712018,86.61043083900226,15,17,470,2,463
2504,459,18,86.14603174603175,87.49278911564626,18,49,445,1,441
2505,459,18,86.14603174603175,88.8627664399093,18,47,456,3,441
2506,459,213,86.14603174603175,87.42312925170069,18,24,252,1,246
2507,459,272,86.14603174603175,88.53768707482993,18,28,213,2,187
2508,459,478,86.14603174603175,88.21260770975057,18,17,91,2,19
2509,459,469,86.14603174603175,88.65378684807257,18,33,108,3,10
2510,459,813,86.14603174603175,88.2358276643991,18,15,365,2,354
2511,459,799,86.14603174603175,88.6770068027211,18,20,357,3,340
2512,459,896,86.14603174603175,88.6770068027211,18,25,450,3,437
2513,517,18,87.07482993197279,88.8627664399093,30,47,505,2,499
2514,517,18,87.07482993197279,89.55936507936508,30,48,510,2,499
2515,517,272,87.07482993197279,88.53768707482993,30,28,253,1,245
2516,517,247,87.07482993197279,89.67546485260772,30,28,292,3,270
2517,517,478,87.07482993197279,88.21260770975057,30,17,63,1,39
2518,517,469,87.07482993197279,88.65378684807257,30,33,83,2,48
2519,517,419,87.07482993197279,89.65224489795918,30,19,148,3,98
2520,517,813,87.07482993197279,88.2358276643991,30,15,300,1,296
2521,517,799,87.07482993197279,88.6770068027211,30,20,290,2,282
2522,517,791,87.07482993197279,89.67546485260772,30,17,296,3,274
2523,517,896,87.07482993197279,88.6770068027211,30,25,385,2,379
2524,517,892,87.07482993197279,89.65224489795918,30,19,391,3,375
2525,478,18,88.21260770975057,89.55936507936508,17,48,464,1,460
2526,478,18,88.21260770975057,90.58104308390023,17,48,471,2,460
2527,478,247,88.21260770975057,89.67546485260772,17,28,239,1,231
2528,478,233,88.21260770975057,90.67392290249434,17,21,267,2,245
2529,478,419,88.21260770975057,89.65224489795918,17,19,86,1,59
2530,478,791,88.21260770975057,89.67546485260772,17,17,319,1,313
2531,478,892,88.21260770975057,89.65224489795918,17,19,419,1,414
2532,478,839,88.21260770975057,91.16154195011337,17,14,383,3,361
2533,469,18,88.65378684807257,90.58104308390023,33,48,459,2,451
2534,469,247,88.65378684807257,89.67546485260772,33,28,226,1,222
2535,469,233,88.65378684807257,90.67392290249434,33,21,252,2,236
2536,469,478,88.65378684807257,90.62748299319728,33,18,85,2,9
2537,469,791,88.65378684807257,89.67546485260772,33,17,325,1,322
2538,469,839,88.65378684807257,91.16154195011337,33,14,385,3,370
2539,419,18,89.65224489795918,92.32253968253968,19,47,417,3,401
2540,419,233,89.65224489795918,90.67392290249434,19,21,191,1,186
2541,419,263,89.65224489795918,92.32253968253968,19,25,194,3,156
2542,419,263,89.65224489795918,92.34575963718821,19,24,194,3,156
2543,419,524,89.65224489795918,91.76526077097506,19,17,139,2,105
2544,419,468,89.65224489795918,92.34575963718821,19,15,126,3,49
2545,419,817,89.65224489795918,91.78848072562359,19,16,408,2,398
2546,419,839,89.65224489795918,91.16154195011337,19,14,425,2,420
2547,478,18,90.62748299319728,92.32253968253968,18,47,466,2,460
2548,478,18,90.62748299319728,93.01913832199547,18,47,471,2,460
2549,478,263,90.62748299319728,92.32253968253968,18,25,227,2,215
2550,478,263,90.62748299319728,92.34575963718821,18,24,227,2,215
2551,478,524,90.62748299319728,91.76526077097506,18,17,67,1,46
2552,478,468,90.62748299319728,92.34575963718821,18,15,75,2,10
2553,478,817,90.62748299319728,91.78848072562359,18,16,343,1,339
2554,478,920,90.62748299319728,91.71882086167801,18,14,444,1,442
2555,524,46,91.76526077097506,94.62131519274377,17,47,494,3,478
2556,524,206,91.76526077097506,93.97115646258504,17,25,332,2,318
2557,524,229,91.76526077097506,94.52843537414967,17,27,318,3,295
2558,524,458,91.76526077097506,94.24979591836735,17,25,126,2,66
2559,524,459,91.76526077097506,94.43555555555555,17,17,132,3,65
2560,524,816,91.76526077097506,94.2962358276644,17,15,312,3,292
2561,524,902,91.76526077097506,94.27301587301588,17,22,393,3,378
2562,468,18,92.34575963718821,93.69251700680272,15,47,454,1,450
2563,468,46,92.34575963718821,94.62131519274377,15,47,433,2,422
2564,468,206,92.34575963718821,93.97115646258504,15,25,271,2,262
2565,468,229,92.34575963718821,94.52843537414967,15,27,257,2,239
2566,468,458,92.34575963718821,94.24979591836735,15,25,83,2,10
2567,468,459,92.34575963718821,94.43555555555555,15,17,90,2,9
2568,468,816,92.34575963718821,94.2962358276644,15,15,358,2,348
2569,468,902,92.34575963718821,94.27301587301588,15,22,442,2,434
2570,458,18,94.24979591836735,95.75909297052155,25,47,445,2,440
2571,458,6,94.24979591836735,96.64145124716553,25,48,464,2,452
2572,458,209,94.24979591836735,96.17705215419501,25,30,262,2,249
2573,458,251,94.24979591836735,97.22195011337868,25,27,243,3,207
2574,458,545,94.24979591836735,95.8055328798186,25,15,110,2,87
2575,458,502,94.24979591836735,97.03619047619048,25,29,128,3,44
2576,458,810,94.24979591836735,96.15383219954649,25,16,361,2,352
2577,458,672,94.24979591836735,96.52535147392291,25,26,235,2,214
2578,458,932,94.24979591836735,96.47891156462585,25,23,484,2,474
2579,459,18,94.43555555555555,95.75909297052155,17,47,445,1,441
2580,459,6,94.43555555555555,96.64145124716553,17,48,463,2,453
2581,459,209,94.43555555555555,96.17705215419501,17,30,261,2,250
2582,459,251,94.43555555555555,97.22195011337868,17,27,240,3,208
2583,459,545,94.43555555555555,95.8055328798186,17,15,104,1,86
2584,459,502,94.43555555555555,97.03619047619048,17,29,120,3,43
2585,459,810,94.43555555555555,96.15383219954649,17,16,359,2,351
2586,459,672,94.43555555555555,96.52535147392291,17,26,231,2,213
2587,459,932,94.43555555555555,96.47891156462585,17,23,481,2,473
2588,545,251,95.8055328798186,97.22195011337868,15,27,300,1,294
2589,545,249,95.8055328798186,97.43092970521542,15,23,304,2,296
2590,545,502,95.8055328798186,97.03619047619048,15,29,68,1,43
2591,545,481,95.8055328798186,97.94176870748299,15,21,112,2,64
2592,545,684,95.8055328798186,97.89532879818594,15,16,166,2,139
2593,545,873,95.8055328798186,97.91854875283447,15,14,340,2,328
2594,502,18,97.03619047619048,98.52226757369614,29,48,488,1,484
2595,502,4,97.03619047619048,99.47428571428571,29,47,509,2,498
2596,502,214,97.03619047619048,98.84734693877552,29,21,298,2,288
2597,502,270,97.03619047619048,99.93868480725624,29,25,264,3,232
2598,502,479,97.03619047619048,99.24208616780045,29,16,98,2,23
2599,502,459,97.03619047619048,99.93868480725624,29,16,132,3,43
2600,502,934,97.03619047619048,99.24208616780045,29,13,442,2,432
2601,502,917,97.03619047619048,99.96190476190476,29,15,434,3,415
2602,481,4,97.94176870748299,99.47428571428571,21,47,482,2,477
2603,481,270,97.94176870748299,99.93868480725624,21,25,228,2,211
2604,481,266,97.94176870748299,100.6120634920635,21,30,244,3,215
2605,481,479,97.94176870748299,99.24208616780045,21,16,56,1,2
2606,481,459,97.94176870748299,99.93868480725624,21,16,89,2,22
2607,481,499,97.94176870748299,100.7978231292517,21,26,124,3,18
2608,481,664,97.94176870748299,100.77460317460317,21,28,220,3,183
2609,481,934,97.94176870748299,99.24208616780045,21,13,456,1,453
2610,481,917,97.94176870748299,99.96190476190476,21,15,445,2,436
2611,481,944,97.94176870748299,100.7978231292517,21,23,479,3,463
2612,479,5,99.24208616780045,100.93714285714286,16,47,480,2,474
2613,479,5,99.24208616780045,102.2142403628118,16,48,491,3,474
2614,479,266,99.24208616780045,100.6120634920635,16,30,221,1,213
2615,479,219,99.24208616780045,102.00526077097506,16,28,286,3,260
2616,479,499,99.24208616780045,100.7978231292517,16,26,70,2,20
2617,479,523,99.24208616780045,101.51764172335601,16,28,107,2,44
2618,479,664,99.24208616780045,100.77460317460317,16,28,196,2,185
2619,479,657,99.24208616780045,101.42476190476191,16,25,201,2,178
2620,479,944,99.24208616780045,100.7978231292517,16,23,470,2,465
2621,479,946,99.24208616780045,101.49442176870748,16,24,477,2,467
2622,459,5,99.93868480725624,102.2142403628118,16,48,464,2,454
2623,459,5,99.93868480725624,102.56253968253968,16,47,468,3,454
2624,459,219,99.93868480725624,102.00526077097506,16,28,256,2,240
2625,459,523,99.93868480725624,101.51764172335601,16,28,93,2,64
2626,459,506,99.93868480725624,102.63219954648527,16,24,125,3,47
2627,459,657,99.93868480725624,101.42476190476191,16,25,208,1,198
2628,459,702,99.93868480725624,102.63219954648527,16,20,269,3,243
2629,459,946,99.93868480725624,101.49442176870748,16,24,492,2,487
2630,459,935,99.93868480725624,102.60897959183674,16,20,490,3,476
2631,499,5,100.7978231292517,102.2142403628118,26,48,498,1,494
2632,499,5,100.7978231292517,102.56253968253968,26,47,500,2,494
2633,499,219,100.7978231292517,102.00526077097506,26,28,285,1,280
2634,499,236,100.7978231292517,103.18947845804989,26,25,282,2,263
2635,499,234,100.7978231292517,103.3752380952381,26,20,287,3,265
2636,499,506,100.7978231292517,102.63219954648527,26,24,79,2,7
2637,499,468,100.7978231292517,103.65387755102041,26,17,127,3,31
2638,499,702,100.7978231292517,102.63219954648527,26,20,218,2,203
2639,499,808,100.7978231292517,103.5609977324263,26,15,331,3,309
2640,499,935,100.7978231292517,102.60897959183674,26,20,443,2,436
2641,499,925,100.7978231292517,103.5609977324263,26,15,442,3,426
2642,523,236,101.51764172335601,103.18947845804989,28,25,296,2,287
2643,523,234,101.51764172335601,103.3752380952381,28,20,300,2,289
2644,523,506,101.51764172335601,102.63219954648527,28,24,51,1,17
2645,523,468,101.51764172335601,103.65387755102041,28,17,107,2,55
2646,523,702,101.51764172335601,102.63219954648527,28,20,185,1,179
2647,523,808,101.51764172335601,103.5609977324263,28,15,298,2,285
2648,523,935,101.51764172335601,102.60897959183674,28,20,415,1,412
2649,523,925,101.51764172335601,103.5609977324263,28,15,412,2,402
2650,506,18,102.63219954648527,104.04861678004535,24,47,492,1,488
2651,506,18,102.63219954648527,104.72199546485261,24,47,496,2,488
2652,506,46,102.63219954648527,105.48825396825397,24,47,476,3,460
2653,506,277,102.63219954648527,105.04707482993197,24,25,252,2,229
2654,506,468,102.63219954648527,103.65387755102041,24,17,58,1,38
2655,506,474,102.63219954648527,105.30249433106576,24,24,119,3,32
2656,506,459,102.63219954648527,105.46503401360545,24,18,131,3,47
2657,506,672,102.63219954648527,105.30249433106576,24,16,202,3,166
2658,506,927,102.63219954648527,105.27927437641723,24,20,436,3,421
2659,468,18,103.65387755102041,104.72199546485261,17,47,452,1,450
2660,468,46,103.65387755102041,105.48825396825397,17,47,429,2,422
2661,468,6,103.65387755102041,106.46349206349207,17,49,478,3,462
2662,468,277,103.65387755102041,105.04707482993197,17,25,200,1,191
2663,468,225,103.65387755102041,105.69723356009071,17,29,258,2,243
2664,468,474,103.65387755102041,105.30249433106576,17,24,71,2,6
2665,468,459,103.65387755102041,105.46503401360545,17,18,79,2,9
2666,468,672,103.65387755102041,105.30249433106576,17,16,216,2,204
2667,468,927,103.65387755102041,105.27927437641723,17,20,464,2,459
2668,474,6,105.30249433106576,106.46349206349207,24,49,471,1,468
2669,474,18,105.30249433106576,107.48517006802722,24,47,466,2,456
2670,474,216,105.30249433106576,107.22975056689343,24,29,271,2,258
2671,474,410,105.30249433106576,106.81179138321995,24,15,91,2,64
2672,474,507,105.30249433106576,108.06566893424036,24,29,123,3,33
2673,474,620,105.30249433106576,107.2065306122449,24,15,167,2,146
2674,474,674,105.30249433106576,107.55482993197279,24,30,222,2,200
2675,474,891,105.30249433106576,107.34585034013605,24,14,426,2,417
2676,474,822,105.30249433106576,107.55482993197279,24,22,361,2,348
2677,459,18,105.46503401360545,107.48517006802722,18,47,449,2,441
2678,459,216,105.46503401360545,107.22975056689343,18,29,255,2,243
2679,459,244,105.46503401360545,108.29786848072563,18,22,247,3,215
2680,459,410,105.46503401360545,106.81179138321995,18,15,76,1,49
2681,459,507,105.46503401360545,108.06566893424036,18,29,122,3,48
2682,459,620,105.46503401360545,107.2065306122449,18,15,178,2,161
2683,459,674,105.46503401360545,107.55482993197279,18,30,233,2,215
2684,459,891,105.46503401360545,107.34585034013605,18,14,440,2,432
2685,459,822,105.46503401360545,107.55482993197279,18,22,374,2,363
2686,410,6,106.81179138321995,109.22666666666667,15,47,417,2,404
2687,410,18,106.81179138321995,109.55174603174603,15,48,409,3,392
2688,410,244,106.81179138321995,108.29786848072563,15,22,178,1,166
2689,410,246,106.81179138321995,108.48362811791384,15,21,179,2,164
2690,410,215,106.81179138321995,109.7839455782313,15,20,233,3,195
2691,410,507,106.81179138321995,108.06566893424036,15,29,111,1,97
2692,410,460,106.81179138321995,108.92480725623582,15,22,104,2,50
2693,410,810,106.81179138321995,108.92480725623582,15,14,410,2,400
2694,507,18,108.06566893424036,109.55174603174603,29,48,493,1,489
2695,507,215,108.06566893424036,109.7839455782313,29,20,301,2,292
2696,507,272,108.06566893424036,110.96816326530613,29,32,266,3,235
2697,507,456,108.06566893424036,110.27156462585035,29,16,108,2,51
2698,507,459,108.06566893424036,110.96816326530613,29,16,134,3,48
2699,507,625,108.06566893424036,110.27156462585035,29,15,151,2,118
2700,507,812,108.06566893424036,110.92172335600907,29,15,329,3,305
2701,507,958,108.06566893424036,110.89850340136054,29,15,467,3,451
2702,460,5,108.92480725623582,110.78240362811792,22,47,462,2,455
2703,460,272,108.92480725623582,110.96816326530613,22,32,208,2,188
2704,460,267,108.92480725623582,111.6647619047619,22,26,226,3,193
2705,460,456,108.92480725623582,110.27156462585035,22,16,58,1,4
2706,460,459,108.92480725623582,110.96816326530613,22,16,88,2,1
2707,460,606,108.92480725623582,111.85052154195012,22,28,193,3,146
2708,460,625,108.92480725623582,110.27156462585035,22,15,175,1,165
2709,460,812,108.92480725623582,110.92172335600907,22,15,362,2,352
2710,460,693,108.92480725623582,111.85052154195012,22,27,265,3,233
2711,460,958,108.92480725623582,110.89850340136054,22,15,505,2,498
2712,460,870,108.92480725623582,111.82730158730159,22,27,429,3,410
2713,456,5,110.27156462585035,112.03628117913833,16,47,457,2,451
2714,456,54,110.27156462585035,112.7328798185941,16,46,416,2,402
2715,456,267,110.27156462585035,111.6647619047619,16,26,198,1,189
2716,456,216,110.27156462585035,113.05795918367347,16,27,268,3,240
2717,456,606,110.27156462585035,111.85052154195012,16,28,165,2,150
2718,456,516,110.27156462585035,112.59356009070295,16,29,117,2,60
2719,456,693,110.27156462585035,111.85052154195012,16,27,247,2,237
2720,456,817,110.27156462585035,112.50068027210885,16,24,374,2,361
2721,456,870,110.27156462585035,111.82730158730159,16,27,419,2,414
2722,456,876,110.27156462585035,112.5471201814059,16,24,431,2,420
2723,459,5,110.96816326530613,112.03628117913833,16,47,456,1,454
2724,459,54,110.96816326530613,112.7328798185941,16,46,412,2,405
2725,459,5,110.96816326530613,113.54557823129252,16,46,467,3,454
2726,459,216,110.96816326530613,113.05795918367347,16,27,259,2,243
2727,459,516,110.96816326530613,112.59356009070295,16,29,90,2,57
2728,459,523,110.96816326530613,113.66167800453515,16,20,132,3,64
2729,459,817,110.96816326530613,112.50068027210885,16,24,364,2,358
2730,459,694,110.96816326530613,113.68489795918367,16,21,263,3,235
2731,459,876,110.96816326530613,112.5471201814059,16,24,423,2,417
2732,459,943,110.96816326530613,113.7081179138322,16,19,498,3,484
2733,606,216,111.85052154195012,113.05795918367347,28,27,393,1,390
2734,606,309,111.85052154195012,114.40471655328798,28,25,317,3,297
2735,606,207,111.85052154195012,114.49759637188208,28,27,415,3,399
2736,606,523,111.85052154195012,113.66167800453515,28,20,114,2,83
2737,606,418,111.85052154195012,114.56725623582767,28,20,221,3,188
2738,606,694,111.85052154195012,113.68489795918367,28,21,118,2,88
2739,606,943,111.85052154195012,113.7081179138322,28,19,346,2,337
2740,606,826,111.85052154195012,114.72979591836734,28,16,253,3,220
2741,516,18,112.59356009070295,115.07809523809524,29,47,509,2,498
2742,516,309,112.59356009070295,114.40471655328798,29,25,221,2,207
2743,516,207,112.59356009070295,114.49759637188208,29,27,320,2,309
2744,516,523,112.59356009070295,113.66167800453515,29,20,47,1,7
2745,516,418,112.59356009070295,114.56725623582767,29,20,130,2,98
2746,516,694,112.59356009070295,113.68489795918367,29,21,184,1,178
2747,516,727,112.59356009070295,115.1245351473923,29,16,237,3,211
2748,516,943,112.59356009070295,113.7081179138322,29,19,430,1,427
2749,516,826,112.59356009070295,114.72979591836734,29,16,323,2,310
2750,523,83,113.66167800453515,115.98367346938775,20,47,451,2,440
2751,523,244,113.66167800453515,116.14621315192744,20,29,299,2,279
2752,523,410,113.66167800453515,116.33197278911565,20,19,161,3,113
2753,523,561,113.66167800453515,116.44807256235828,20,20,126,3,38
2754,523,727,113.66167800453515,115.1245351473923,20,16,214,1,204
2755,523,624,113.66167800453515,115.79791383219955,20,14,137,2,101
2756,523,815,113.66167800453515,116.4712925170068,20,23,316,3,292
2757,523,826,113.66167800453515,114.72979591836734,20,16,306,1,303
2758,523,924,113.66167800453515,116.40163265306123,20,17,418,3,401
2759,523,929,113.66167800453515,116.4712925170068,20,23,424,3,406
2760,418,83,114.56725623582767,115.98367346938775,20,47,341,1,335
2761,418,46,114.56725623582767,116.79637188208618,20,47,384,2,372
2762,418,244,114.56725623582767,116.14621315192744,20,29,187,2,174
2763,418,206,114.56725623582767,116.65705215419501,20,25,230,2,212
2764,418,410,114.56725623582767,116.33197278911565,20,19,76,2,8
2765,418,561,114.56725623582767,116.44807256235828,20,20,164,2,143
2766,418,624,114.56725623582767,115.79791383219955,20,14,213,1,206
2767,418,815,114.56725623582767,116.4712925170068,20,23,405,2,397
2768,410,6,116.33197278911565,118.28244897959183,19,47,413,2,404
2769,410,84,116.33197278911565,118.74684807256236,19,47,342,2,326
2770,410,277,116.33197278911565,118.37532879818595,19,27,159,2,133
2771,410,212,116.33197278911565,118.56108843537415,19,26,220,2,198
2772,410,480,116.33197278911565,117.58585034013606,19,23,88,1,70
2773,410,562,116.33197278911565,119.16480725623583,19,23,195,3,152
2774,410,654,116.33197278911565,117.58585034013606,19,18,250,1,244
2775,410,701,116.33197278911565,119.16480725623583,19,22,316,3,291
2776,561,84,116.44807256235828,118.74684807256236,20,47,487,2,477
2777,561,277,116.44807256235828,118.37532879818595,20,27,296,2,284
2778,561,212,116.44807256235828,118.56108843537415,20,26,361,2,349
2779,561,480,116.44807256235828,117.58585034013606,20,23,95,1,81
2780,561,562,116.44807256235828,119.16480725623583,20,23,117,3,1
2781,561,654,116.44807256235828,117.58585034013606,20,18,105,1,93
2782,561,701,116.44807256235828,119.16480725623583,20,22,182,3,140
2783,561,936,116.44807256235828,117.56263038548754,20,22,378,1,375
2784,561,936,116.44807256235828,119.18802721088436,20,23,393,3,375
2785,480,84,117.58585034013606,118.74684807256236,23,47,399,1,396
2786,480,68,117.58585034013606,119.81496598639455,23,47,423,2,412
2787,480,207,117.58585034013606,120.00072562358277,23,26,292,2,273
2788,480,562,117.58585034013606,119.16480725623583,23,23,107,2,82
2789,480,603,117.58585034013606,119.69886621315193,23,16,153,2,123
2790,480,701,117.58585034013606,119.16480725623583,23,22,231,2,221
2791,480,936,117.58585034013606,119.18802721088436,23,23,461,2,456
2792,480,842,117.58585034013606,120.55800453514739,23,15,384,3,362
2793,562,276,119.16480725623583,120.79020408163265,23,26,294,2,286
2794,562,244,119.16480725623583,121.64934240362813,23,28,336,2,318
2795,562,410,119.16480725623583,120.60444444444445,23,19,164,1,152
2796,562,459,119.16480725623583,122.02086167800454,23,17,160,3,103
2797,562,817,119.16480725623583,121.34748299319727,23,13,272,2,255
2798,562,815,119.16480725623583,121.99764172335601,23,15,281,3,253
2799,562,842,119.16480725623583,120.55800453514739,23,15,286,1,280
2800,562,918,119.16480725623583,122.02086167800454,23,15,377,3,356
2801,603,276,119.69886621315193,120.79020408163265,16,26,330,1,327
2802,603,244,119.69886621315193,121.64934240362813,16,28,369,2,359
2803,603,459,119.69886621315193,122.02086167800454,16,17,175,2,144
2804,603,817,119.69886621315193,121.34748299319727,16,13,225,2,214
2805,603,815,119.69886621315193,121.99764172335601,16,15,234,2,212
2806,603,918,119.69886621315193,122.02086167800454,16,15,330,2,315
2807,410,81,120.60444444444445,122.27628117913832,19,48,337,2,329
2808,410,5,120.60444444444445,123.01931972789116,19,46,418,2,405
2809,410,244,120.60444444444445,121.64934240362813,19,28,172,1,166
2810,410,205,120.60444444444445,122.7871201814059,19,24,226,2,205
2811,410,459,120.60444444444445,122.02086167800454,19,17,78,1,49
2812,410,560,120.60444444444445,122.88,19,27,179,2,150
2813,410,815,120.60444444444445,121.99764172335601,19,15,409,1,405
2814,410,679,120.60444444444445,122.85678004535147,19,26,286,2,269
2815,410,621,120.60444444444445,123.53015873015873,19,25,246,3,211
2816,410,836,120.60444444444445,122.83356009070295,19,25,437,2,426
2817,410,898,120.60444444444445,123.53015873015873,19,26,504,3,488
2818,459,5,122.02086167800454,124.27319727891157,17,47,464,2,454
2819,459,346,122.02086167800454,124.11065759637188,17,26,144,2,113
2820,459,425,122.02086167800454,124.11065759637188,17,28,96,2,34
2821,459,436,122.02086167800454,124.9233560090703,17,16,127,3,23
2822,459,621,122.02086167800454,123.53015873015873,17,25,175,2,162
2823,459,817,122.02086167800454,124.90013605442176,17,18,379,3,358
2824,459,898,122.02086167800454,123.53015873015873,17,26,444,2,439
2825,459,857,122.02086167800454,124.90013605442176,17,14,417,3,398
2826,560,346,122.88,124.11065759637188,27,26,220,1,214
2827,560,207,122.88,125.17877551020409,27,27,367,2,353
2828,560,425,122.88,124.11065759637188,27,28,145,1,135
2829,560,436,122.88,124.9233560090703,27,16,152,2,124
2830,560,468,122.88,125.4574149659864,27,17,144,3,92
2831,560,817,122.88,124.90013605442176,27,18,271,2,257
2832,560,857,122.88,124.90013605442176,27,14,309,2,297
2833,425,18,124.11065759637188,125.41097505668934,28,48,411,1,407
2834,425,18,124.11065759637188,126.10757369614512,28,49,416,2,407
2835,425,18,124.11065759637188,126.80417233560091,28,49,423,3,407
2836,425,207,124.11065759637188,125.17877551020409,28,27,223,1,218
2837,425,252,124.11065759637188,126.33977324263039,28,33,198,2,173
2838,425,250,124.11065759637188,126.64163265306122,28,33,206,3,175
2839,425,468,124.11065759637188,125.4574149659864,28,17,72,1,43
2840,425,530,124.11065759637188,126.75773242630386,28,23,155,3,105
2841,425,813,124.11065759637188,126.85061224489796,28,14,406,3,388
2842,425,839,124.11065759637188,126.85061224489796,28,16,430,3,414
2843,436,18,124.9233560090703,126.10757369614512,16,49,421,1,418
2844,436,18,124.9233560090703,126.80417233560091,16,49,426,2,418
2845,436,252,124.9233560090703,126.33977324263039,16,33,194,1,184
2846,436,250,124.9233560090703,126.64163265306122,16,33,200,2,186
2847,436,252,124.9233560090703,127.70975056689343,16,35,220,3,184
2848,436,530,124.9233560090703,126.75773242630386,16,23,123,2,94
2849,436,459,124.9233560090703,127.52399092970522,16,19,114,3,23
2850,436,813,124.9233560090703,126.85061224489796,16,14,386,2,377
2851,436,691,124.9233560090703,127.52399092970522,16,14,279,3,255
2852,436,839,124.9233560090703,126.85061224489796,16,16,411,2,403
2853,468,18,125.4574149659864,126.80417233560091,17,49,454,1,450
2854,468,18,125.4574149659864,128.17414965986396,17,49,465,3,450
2855,468,250,125.4574149659864,126.64163265306122,17,33,224,1,218
2856,468,252,125.4574149659864,127.70975056689343,17,35,237,2,216
2857,468,530,125.4574149659864,126.75773242630386,17,23,84,1,62
2858,468,459,125.4574149659864,127.52399092970522,17,19,89,2,9
2859,468,813,125.4574149659864,126.85061224489796,17,14,350,1,345
2860,468,691,125.4574149659864,127.52399092970522,17,14,240,2,223
2861,468,839,125.4574149659864,126.85061224489796,17,16,376,1,371
2862,468,824,125.4574149659864,128.220589569161,17,15,375,3,356
2863,530,226,126.75773242630386,128.89396825396827,23,31,318,2,304
2864,530,526,126.75773242630386,128.4760090702948,23,20,74,2,4
2865,530,801,126.75773242630386,128.91718820861678,23,14,287,2,271
2866,530,824,126.75773242630386,128.220589569161,23,15,301,1,294
2867,459,18,127.52399092970522,128.87074829931973,19,48,445,1,441
2868,459,18,127.52399092970522,130.24072562358276,19,49,456,3,441
2869,459,226,127.52399092970522,128.89396825396827,19,31,240,1,233
2870,459,228,127.52399092970522,129.8227664399093,19,32,251,2,231
2871,459,801,127.52399092970522,128.91718820861678,19,14,347,1,342
2872,459,691,127.52399092970522,130.2871655328798,19,15,261,3,232
2873,526,228,128.4760090702948,129.8227664399093,20,32,304,1,298
2874,526,228,128.4760090702948,130.79800453514738,20,31,314,2,298
2875,526,459,128.4760090702948,130.2871655328798,20,19,103,2,67
2876,526,493,128.4760090702948,130.96054421768707,20,16,112,2,33
2877,526,691,128.4760090702948,130.2871655328798,20,15,183,2,165
2878,459,18,130.2871655328798,132.3073015873016,19,48,449,2,441
2879,459,18,130.2871655328798,133.00390022675737,19,49,456,3,441
2880,459,228,130.2871655328798,131.49460317460318,19,31,237,1,231
2881,459,251,130.2871655328798,133.14321995464852,19,27,242,3,208
2882,459,532,130.2871655328798,131.9590022675737,19,20,103,2,73
2883,459,839,130.2871655328798,132.35374149659864,19,14,390,2,380
2884,493,18,130.96054421768707,132.3073015873016,16,48,479,1,475
2885,493,18,130.96054421768707,133.00390022675737,16,49,483,2,475
2886,493,18,130.96054421768707,133.70049886621317,16,49,489,3,475
2887,493,251,130.96054421768707,133.14321995464852,16,27,260,2,242
2888,493,459,130.96054421768707,133.05034013605442,16,20,96,2,34
2889,493,641,130.96054421768707,133.72371882086168,16,14,190,3,148
2890,493,839,130.96054421768707,132.35374149659864,16,14,351,1,346
2891,493,824,130.96054421768707,133.74693877551022,16,14,352,3,331
2892,532,251,131.9590022675737,133.14321995464852,20,27,286,1,281
2893,532,231,131.9590022675737,134.46675736961453,20,32,320,3,301
2894,532,230,131.9590022675737,134.48997732426304,20,30,321,3,302
2895,532,459,131.9590022675737,133.05034013605442,20,20,87,1,73
2896,532,641,131.9590022675737,133.72371882086168,20,14,133,2,109
2897,532,824,131.9590022675737,133.74693877551022,20,14,302,2,292
2898,459,18,133.05034013605442,135.0704761904762,20,49,449,2,441
2899,459,18,133.05034013605442,135.76707482993197,20,49,456,3,441
2900,459,231,133.05034013605442,134.46675736961453,20,32,236,1,228
2901,459,230,133.05034013605442,134.48997732426304,20,30,237,1,229
2902,459,429,133.05034013605442,135.11691609977325,20,17,94,2,30
2903,459,524,133.05034013605442,135.90639455782312,20,17,139,3,65
2904,459,684,133.05034013605442,135.8831746031746,20,16,256,3,225
2905,459,839,133.05034013605442,135.11691609977325,20,15,390,2,380
2906,459,823,133.05034013605442,136.02249433106576,20,14,386,3,364
2907,532,51,134.002358276644,136.62621315192743,18,35,494,3,481
2908,532,207,134.002358276644,136.48689342403628,18,35,342,2,325
2909,532,209,134.002358276644,136.53333333333333,18,35,341,3,323
2910,532,429,134.002358276644,135.11691609977325,18,17,114,1,103
2911,532,524,134.002358276644,135.90639455782312,18,17,82,2,8
2912,532,684,134.002358276644,135.8831746031746,18,16,172,2,152
2913,532,839,134.002358276644,135.11691609977325,18,15,311,1,307
2914,532,823,134.002358276644,136.02249433106576,18,14,304,2,291
2915,429,51,135.11691609977325,136.62621315192743,17,35,384,2,378
2916,429,207,135.11691609977325,136.48689342403628,17,35,230,1,222
2917,429,209,135.11691609977325,136.53333333333333,17,35,228,1,220
2918,429,278,135.11691609977325,137.67111111111112,17,34,187,3,151
2919,429,462,135.11691609977325,137.32281179138323,17,14,101,2,33
2920,429,563,135.11691609977325,137.69433106575963,17,18,174,3,134
2921,429,689,135.11691609977325,137.76399092970522,17,15,284,3,260
2922,524,278,135.90639455782312,137.67111111111112,17,34,257,2,246
2923,524,246,135.90639455782312,138.50702947845807,17,35,300,3,278
2924,524,462,135.90639455782312,137.32281179138323,17,14,87,1,62
2925,524,563,135.90639455782312,137.69433106575963,17,18,86,2,39
2926,524,689,135.90639455782312,137.76399092970522,17,15,183,2,165
2927,462,18,137.32281179138323,139.20362811791384,14,44,451,2,444
2928,462,18,137.32281179138323,139.9002267573696,14,47,458,3,444
2929,462,246,137.32281179138323,138.50702947845807,14,35,222,1,216
2930,462,415,137.32281179138323,139.22684807256235,14,19,95,2,47
2931,462,442,137.32281179138323,140.29496598639457,14,21,130,3,20
2932,462,788,137.32281179138323,139.01786848072564,14,16,334,2,326
2933,462,779,137.32281179138323,139.57514739229026,14,14,332,2,317
2934,462,929,137.32281179138323,138.901768707483,14,16,472,2,467
2935,563,274,137.69433106575963,140.43428571428572,18,33,312,3,289
2936,563,415,137.69433106575963,139.22684807256235,18,19,162,2,148
2937,563,442,137.69433106575963,140.29496598639457,18,21,165,3,121
2938,563,788,137.69433106575963,139.01786848072564,18,16,232,1,225
2939,563,779,137.69433106575963,139.57514739229026,18,14,231,2,216
2940,563,929,137.69433106575963,138.901768707483,18,16,370,1,366
2941,563,841,137.69433106575963,140.43428571428572,18,14,302,3,278
2942,415,6,139.22684807256235,140.7825850340136,19,48,414,2,409
2943,415,5,139.22684807256235,141.64172335600907,19,48,423,2,410
2944,415,274,139.22684807256235,140.43428571428572,19,33,150,1,141
2945,415,278,139.22684807256235,140.9451247165533,19,29,156,2,137
2946,415,442,139.22684807256235,140.29496598639457,19,21,53,1,27
2947,415,446,139.22684807256235,140.9683446712018,19,22,81,2,31
2948,415,411,139.22684807256235,141.96680272108844,19,21,118,3,4
2949,415,693,139.22684807256235,141.38630385487528,19,15,293,2,278
2950,415,678,139.22684807256235,142.15256235827664,19,17,292,3,263
2951,415,841,139.22684807256235,140.43428571428572,19,14,429,1,426
2952,415,903,139.22684807256235,141.40952380952382,19,14,497,2,488
2953,442,5,140.29496598639457,141.64172335600907,21,48,441,1,437
2954,442,18,140.29496598639457,142.6634013605442,21,46,436,2,424
2955,442,252,140.29496598639457,142.43120181405897,21,31,211,2,190
2956,442,276,140.29496598639457,142.8259410430839,21,28,199,3,166
2957,442,411,140.29496598639457,141.96680272108844,21,21,78,2,31
2958,442,693,140.29496598639457,141.38630385487528,21,15,255,1,251
2959,442,678,140.29496598639457,142.15256235827664,21,17,249,2,236
2960,442,678,140.29496598639457,142.84916099773244,21,17,260,3,236
2961,442,903,140.29496598639457,141.40952380952382,21,14,463,1,461
2962,442,896,140.29496598639457,142.29188208616782,21,17,462,2,454
2963,442,903,140.29496598639457,142.84916099773244,21,17,474,3,461
2964,446,18,140.9683446712018,142.6634013605442,22,46,434,2,428
2965,446,252,140.9683446712018,142.43120181405897,22,31,204,1,194
2966,446,276,140.9683446712018,142.8259410430839,22,28,188,2,170
2967,446,247,140.9683446712018,143.7082993197279,22,31,231,3,199
2968,446,578,140.9683446712018,143.49931972789116,22,18,171,3,132
2969,446,678,140.9683446712018,142.15256235827664,22,17,238,1,232
2970,446,678,140.9683446712018,142.84916099773244,22,17,246,2,232
2971,446,896,140.9683446712018,142.29188208616782,22,17,454,1,450
2972,446,903,140.9683446712018,142.84916099773244,22,17,464,2,457
2973,411,5,141.96680272108844,144.45133786848072,21,46,420,2,406
2974,411,247,141.96680272108844,143.7082993197279,21,31,180,2,164
2975,411,207,141.96680272108844,144.82285714285715,21,28,238,3,204
2976,411,578,141.96680272108844,143.49931972789116,21,18,180,2,167
2977,411,557,141.96680272108844,144.01015873015874,21,20,170,2,146
2978,411,733,141.96680272108844,144.01015873015874,21,25,334,2,322
2979,411,848,141.96680272108844,144.01015873015874,21,16,446,2,437
2980,578,207,143.49931972789116,144.82285714285715,18,28,375,1,371
2981,578,231,143.49931972789116,145.98385487528344,18,29,363,2,347
2982,578,420,143.49931972789116,145.35691609977326,18,26,177,2,158
2983,578,699,143.49931972789116,145.47301587301587,18,17,148,2,121
2984,578,659,143.49931972789116,146.4714739229025,18,17,151,3,81
2985,578,892,143.49931972789116,145.4962358276644,18,24,326,2,314
2986,578,839,143.49931972789116,146.14639455782313,18,14,285,3,261
2987,557,231,144.01015873015874,145.98385487528344,20,29,337,2,326
2988,557,246,144.01015873015874,146.79655328798185,20,30,333,3,311
2989,557,420,144.01015873015874,145.35691609977326,20,26,149,1,137
2990,557,446,144.01015873015874,146.49469387755101,20,22,154,2,111
2991,557,699,144.01015873015874,145.47301587301587,20,17,155,1,142
2992,557,659,144.01015873015874,146.4714739229025,20,17,147,2,102
2993,557,892,144.01015873015874,145.4962358276644,20,24,341,1,335
2994,557,839,144.01015873015874,146.14639455782313,20,14,297,2,282
2995,557,820,144.01015873015874,146.8429931972789,20,16,290,3,263
2996,420,5,145.35691609977326,146.70367346938775,26,47,419,1,415
2997,420,246,145.35691609977326,146.79655328798185,26,30,185,1,174
2998,420,205,145.35691609977326,147.5395918367347,26,30,235,2,215
2999,420,446,145.35691609977326,146.49469387755101,26,22,55,1,26
3000,420,410,145.35691609977326,147.35383219954647,26,25,87,2,10
3001,420,419,145.35691609977326,147.5395918367347,26,28,94,2,1
3002,420,659,145.35691609977326,146.4714739229025,26,17,244,1,239
3003,420,616,145.35691609977326,147.33061224489796,26,17,214,2,196
3004,420,820,145.35691609977326,146.8429931972789,26,16,405,1,400
3005,446,4,146.49469387755101,148.5380498866213,22,45,451,2,442
3006,446,18,146.49469387755101,148.86312925170068,22,46,440,2,428
3007,446,205,146.49469387755101,147.5395918367347,22,30,245,1,241
3008,446,245,146.49469387755101,149.25786848072562,22,31,234,3,201
3009,446,419,146.49469387755101,147.5395918367347,22,28,52,1,27
3010,446,411,146.49469387755101,149.11854875283447,22,25,118,3,35
3011,446,700,146.49469387755101,148.3522902494331,22,27,266,2,254
3012,446,649,146.49469387755101,148.63092970521544,22,20,223,2,203
3013,446,827,146.49469387755101,148.3522902494331,22,23,389,2,381
3014,446,838,146.49469387755101,148.95600907029478,22,16,406,2,392
3015,410,4,147.35383219954647,148.5380498866213,25,45,409,1,406
3016,410,18,147.35383219954647,148.86312925170068,25,46,397,2,392
3017,410,6,147.35383219954647,149.95446712018142,25,45,419,3,404
3018,410,245,147.35383219954647,149.25786848072562,25,31,184,2,165
3019,410,206,147.35383219954647,149.582947845805,25,32,225,2,204
3020,410,411,147.35383219954647,149.11854875283447,25,25,76,2,1
3021,410,514,147.35383219954647,149.582947845805,25,21,142,2,104
3022,410,649,147.35383219954647,148.63092970521544,25,20,245,1,239
3023,410,638,147.35383219954647,149.55972789115646,25,21,247,2,228
3024,410,838,147.35383219954647,148.95600907029478,25,16,434,2,428
3025,410,894,147.35383219954647,149.55972789115646,25,18,493,2,484
3026,419,18,147.5395918367347,148.86312925170068,28,46,405,1,401
3027,419,6,147.5395918367347,149.95446712018142,28,45,426,2,413
3028,419,245,147.5395918367347,149.25786848072562,28,31,189,2,174
3029,419,206,147.5395918367347,149.582947845805,28,32,230,2,213
3030,419,411,147.5395918367347,149.11854875283447,28,25,68,2,8
3031,419,514,147.5395918367347,149.582947845805,28,21,129,2,95
3032,419,649,147.5395918367347,148.63092970521544,28,20,235,1,230
3033,419,638,147.5395918367347,149.55972789115646,28,21,236,2,219
3034,419,838,147.5395918367347,148.95600907029478,28,16,423,1,419
3035,419,894,147.5395918367347,149.55972789115646,28,18,483,2,475
3036,411,6,149.11854875283447,151.32444444444445,25,47,416,2,405
3037,411,18,149.11854875283447,151.6263038548753,25,47,408,3,393
3038,411,278,149.11854875283447,151.48698412698414,25,31,168,2,133
3039,411,246,149.11854875283447,151.8120634920635,25,31,202,3,165
3040,411,442,149.11854875283447,151.32444444444445,25,21,100,2,31
3041,411,678,149.11854875283447,151.11546485260772,25,17,281,2,267
3042,411,846,149.11854875283447,151.13868480725623,25,14,444,2,435
3043,411,848,149.11854875283447,151.67274376417234,25,16,451,3,437
3044,514,18,149.582947845805,151.6263038548753,21,47,504,2,496
3045,514,278,149.582947845805,151.48698412698414,21,31,250,2,236
3046,514,246,149.582947845805,151.8120634920635,21,31,285,2,268
3047,514,442,149.582947845805,151.32444444444445,21,21,104,2,72
3048,514,417,149.582947845805,152.20680272108845,21,23,149,3,97
3049,514,678,149.582947845805,151.11546485260772,21,17,177,2,164
3050,514,669,149.582947845805,152.29968253968255,21,20,194,3,155
3051,514,846,149.582947845805,151.13868480725623,21,14,339,2,332
3052,514,848,149.582947845805,151.67274376417234,21,16,346,2,334
3053,442,46,151.32444444444445,152.64798185941044,21,46,400,1,396
3054,442,18,151.32444444444445,153.6928798185941,21,46,436,2,424
3055,442,275,151.32444444444445,153.18204081632652,21,31,185,2,167
3056,442,277,151.32444444444445,153.87863945578232,21,32,198,3,165
3057,442,596,151.32444444444445,153.18204081632652,21,23,174,2,154
3058,442,620,151.32444444444445,153.18204081632652,21,18,195,2,178
3059,442,693,151.32444444444445,153.87863945578232,21,15,274,3,251
3060,417,18,152.20680272108845,153.6928798185941,23,46,404,1,399
3061,417,83,152.20680272108845,154.64489795918368,23,46,350,2,334
3062,417,277,152.20680272108845,153.87863945578232,23,32,157,2,140
3063,417,246,152.20680272108845,154.73777777777778,23,32,203,3,171
3064,417,442,152.20680272108845,154.08761904761906,23,17,85,2,25
3065,417,693,152.20680272108845,153.87863945578232,23,15,285,2,276
3066,417,645,152.20680272108845,155.06285714285715,23,18,259,3,228
3067,417,912,152.20680272108845,155.06285714285715,23,15,510,3,495
3068,596,246,153.18204081632652,154.73777777777778,23,32,356,2,350
3069,596,207,153.18204081632652,155.80589569160998,23,33,405,3,389
3070,596,436,153.18204081632652,155.4575963718821,23,21,188,2,160
3071,596,645,153.18204081632652,155.06285714285715,23,18,95,2,49
3072,596,912,153.18204081632652,155.06285714285715,23,15,326,2,316
3073,442,5,154.08761904761906,156.1774149659864,17,46,446,2,437
3074,442,6,154.08761904761906,156.8043537414966,17,46,451,3,436
3075,442,207,154.08761904761906,155.80589569160998,17,33,246,2,235
3076,442,275,154.08761904761906,156.9901133786848,17,34,209,3,167
3077,442,436,154.08761904761906,155.4575963718821,17,21,59,1,6
3078,442,425,154.08761904761906,156.38639455782314,17,25,100,2,17
3079,442,789,154.08761904761906,156.2702947845805,17,16,360,2,347
3080,442,861,154.08761904761906,156.5257142857143,17,16,432,2,419
3081,436,6,155.4575963718821,156.8043537414966,21,46,434,1,430
3082,436,5,155.4575963718821,157.68671201814058,21,48,442,2,431
3083,436,275,155.4575963718821,156.9901133786848,21,34,174,2,161
3084,436,429,155.4575963718821,157.52417233560092,21,18,89,2,7
3085,436,458,155.4575963718821,157.8724716553288,21,18,106,2,22
3086,436,631,155.4575963718821,157.2455328798186,21,14,210,2,195
3087,436,750,155.4575963718821,157.84925170068027,21,14,330,2,314
3088,436,861,155.4575963718821,156.5257142857143,21,16,427,1,425
3089,436,839,155.4575963718821,157.52417233560092,21,14,413,2,403
3090,425,5,156.38639455782314,157.68671201814058,25,48,424,1,420
3091,425,46,156.38639455782314,159.05668934240364,25,36,396,3,379
3092,425,206,156.38639455782314,158.54585034013607,25,36,238,2,219
3093,425,207,156.38639455782314,158.61551020408163,25,38,238,2,218
3094,425,429,156.38639455782314,157.52417233560092,25,18,49,1,4
3095,425,458,156.38639455782314,157.8724716553288,25,18,72,1,33
3096,425,750,156.38639455782314,157.84925170068027,25,14,331,1,325
3097,425,839,156.38639455782314,157.52417233560092,25,14,417,1,414
3098,429,46,157.52417233560092,159.05668934240364,18,36,389,2,383
3099,429,122,157.52417233560092,160.47310657596373,18,44,332,3,307
3100,429,206,157.52417233560092,158.54585034013607,18,36,227,1,223
3101,429,207,157.52417233560092,158.61551020408163,18,38,227,1,222
3102,429,246,157.52417233560092,160.2873469387755,18,38,218,3,183
3103,429,463,157.52417233560092,159.381768707483,18,14,87,2,34
3104,429,488,157.52417233560092,160.24090702947845,18,19,131,3,59
3105,458,46,157.8724716553288,159.05668934240364,18,36,415,1,412
3106,458,122,157.8724716553288,160.47310657596373,18,44,354,3,336
3107,458,123,157.8724716553288,160.70530612244897,18,36,357,3,335
3108,458,246,157.8724716553288,160.2873469387755,18,38,236,2,212
3109,458,245,157.8724716553288,160.58920634920636,18,35,243,3,213
3110,458,463,157.8724716553288,159.381768707483,18,14,65,2,5
3111,458,488,157.8724716553288,160.24090702947845,18,19,106,2,30
3112,463,122,159.381768707483,160.47310657596373,14,44,344,1,341
3113,463,123,159.381768707483,160.70530612244897,14,36,345,1,340
3114,463,121,159.381768707483,161.63410430839002,14,18,355,2,342
3115,463,245,159.381768707483,160.58920634920636,14,35,224,1,218
3116,488,121,160.24090702947845,161.63410430839002,19,18,372,1,367
3117,693,275,6.524807256235828,7.685804988662132,16,31,421,1,418
3118,693,246,6.524807256235828,8.382403628117913,16,30,454,2,447
3119,693,429,6.524807256235828,8.219863945578231,16,18,274,2,264
3120,693,678,6.524807256235828,8.544943310657597,16,18,88,2,15
3121,693,847,6.524807256235828,7.894784580498866,16,14,165,1,154
3122,693,839,6.524807256235828,8.219863945578231,16,15,163,2,146
3123,727,277,7.5232653061224495,10.448979591836736,15,32,467,3,450
3124,727,446,7.5232653061224495,9.752380952380953,15,20,297,2,281
3125,727,446,7.5232653061224495,10.495419501133787,15,18,309,3,281
3126,727,678,7.5232653061224495,8.544943310657597,15,18,66,1,49
3127,727,678,7.5232653061224495,9.752380952380953,15,18,108,2,49
3128,727,967,7.5232653061224495,9.729160997732427,15,16,258,2,240
3129,727,846,7.5232653061224495,10.100680272108844,15,16,163,3,119
3130,678,206,8.544943310657597,9.58984126984127,18,33,474,1,472
3131,678,277,8.544943310657597,10.448979591836736,18,32,409,2,401
3132,678,244,8.544943310657597,11.3081179138322,18,31,450,3,434
3133,678,446,8.544943310657597,9.752380952380953,18,20,238,1,232
3134,678,446,8.544943310657597,10.495419501133787,18,18,247,2,232
3135,678,693,8.544943310657597,10.797278911564627,18,18,98,2,15
3136,678,967,8.544943310657597,9.729160997732427,18,16,293,1,289
3137,678,846,8.544943310657597,10.100680272108844,18,16,181,2,168
3138,678,933,8.544943310657597,11.284897959183674,18,15,281,3,255
3139,678,244,9.752380952380953,11.3081179138322,18,31,439,2,434
3140,678,205,9.752380952380953,12.445895691609978,18,31,487,3,473
3141,678,459,9.752380952380953,11.679637188208616,18,17,234,2,219
3142,678,448,9.752380952380953,12.631655328798185,18,16,261,3,230
3143,678,693,9.752380952380953,10.797278911564627,18,18,47,1,15
3144,678,795,9.752380952380953,11.656417233560092,18,15,143,2,117
3145,678,693,9.752380952380953,12.051156462585034,18,15,100,2,15
3146,678,933,9.752380952380953,11.284897959183674,18,15,263,2,255
3147,678,847,9.752380952380953,12.422675736961452,18,17,204,3,169
3148,693,205,10.797278911564627,12.445895691609978,18,31,493,2,488
3149,693,448,10.797278911564627,12.631655328798185,18,16,257,2,245
3150,693,429,10.797278911564627,13.746213151927439,18,18,293,3,264
3151,693,847,10.797278911564627,12.422675736961452,18,17,169,2,154
3152,693,840,10.797278911564627,13.722993197278912,18,14,194,3,147
3153,795,429,11.656417233560092,13.746213151927439,15,18,377,2,366
3154,795,446,11.656417233560092,14.582131519274377,15,20,371,3,349
3155,795,678,11.656417233560092,14.02485260770975,15,14,155,2,117
3156,795,678,11.656417233560092,14.048072562358277,15,17,156,2,117
3157,795,840,11.656417233560092,13.722993197278912,15,14,100,2,45
3158,795,903,11.656417233560092,14.512471655328799,15,15,164,3,108
3159,693,247,12.051156462585034,13.885532879818594,15,31,453,2,446
3160,693,246,12.051156462585034,14.419591836734694,15,31,458,2,447
3161,693,429,12.051156462585034,13.746213151927439,15,18,274,2,264
3162,693,446,12.051156462585034,14.582131519274377,15,20,270,3,247
3163,693,678,12.051156462585034,14.02485260770975,15,14,86,2,15
3164,693,678,12.051156462585034,14.048072562358277,15,17,87,2,15
3165,693,840,12.051156462585034,13.722993197278912,15,14,164,2,147
3166,693,903,12.051156462585034,14.512471655328799,15,15,235,2,210
3167,678,207,14.02485260770975,15.673469387755102,14,23,476,2,471
3168,678,230,14.02485260770975,16.904126984126986,14,35,465,3,448
3169,678,545,14.02485260770975,15.789569160997733,14,16,153,2,133
3170,678,479,14.02485260770975,16.486167800453515,14,18,225,2,199
3171,678,643,14.02485260770975,16.857687074829933,14,14,127,3,35
3172,678,824,14.02485260770975,15.116190476190477,14,14,153,1,146
3173,678,839,14.02485260770975,16.486167800453515,14,15,193,2,161
3174,678,207,14.048072562358277,15.673469387755102,17,23,476,2,471
3175,678,230,14.048072562358277,16.904126984126986,17,35,465,3,448
3176,678,545,14.048072562358277,15.789569160997733,17,16,153,2,133
3177,678,479,14.048072562358277,16.486167800453515,17,18,225,2,199
3178,678,643,14.048072562358277,16.857687074829933,17,14,126,3,35
3179,678,824,14.048072562358277,15.116190476190477,17,14,153,1,146
3180,678,839,14.048072562358277,16.486167800453515,17,15,192,2,161
3181,643,205,16.857687074829933,18.45986394557823,14,28,443,2,438
3182,643,266,16.857687074829933,19.82984126984127,14,25,398,3,377
3183,643,545,16.857687074829933,18.552743764172337,14,15,122,2,98
3184,643,421,16.857687074829933,19.760181405895693,14,20,255,3,222
3185,643,731,16.857687074829933,18.552743764172337,14,14,114,2,88
3186,643,797,16.857687074829933,19.783401360544218,14,19,199,3,154
3187,643,824,16.857687074829933,17.87936507936508,14,15,186,1,181
3188,643,854,16.857687074829933,19.760181405895693,14,19,245,3,211
3189,677,205,17.438185941043084,18.45986394557823,19,28,474,1,472
3190,677,266,17.438185941043084,19.82984126984127,19,25,424,2,411
3191,677,545,17.438185941043084,18.552743764172337,19,15,140,1,132
3192,677,421,17.438185941043084,19.760181405895693,19,20,275,2,256
3193,677,731,17.438185941043084,18.552743764172337,19,14,72,1,54
3194,677,797,17.438185941043084,19.783401360544218,19,19,157,2,120
3195,677,854,17.438185941043084,19.760181405895693,19,19,203,2,177
3196,731,266,18.552743764172337,19.82984126984127,14,25,468,1,465
3197,731,247,18.552743764172337,21.36235827664399,14,25,499,3,484
3198,731,421,18.552743764172337,19.760181405895693,14,20,314,1,310
3199,731,475,18.552743764172337,20.619319727891156,14,15,271,2,256
3200,731,797,18.552743764172337,19.783401360544218,14,19,85,1,66
3201,731,737,18.552743764172337,20.66575963718821,14,14,91,2,6
3202,731,854,18.552743764172337,19.760181405895693,14,19,134,1,123
3203,731,825,18.552743764172337,20.619319727891156,14,14,129,2,94
3204,797,479,19.783401360544218,21.989297052154196,19,18,332,2,318
3205,797,459,19.783401360544218,22.709115646258503,19,18,361,3,338
3206,797,617,19.783401360544218,22.407256235827663,19,18,213,3,180
3207,737,479,20.66575963718821,21.989297052154196,14,18,264,1,258
3208,737,459,20.66575963718821,22.709115646258503,14,18,292,2,278
3209,737,467,20.66575963718821,23.38249433106576,14,17,294,3,270
3210,737,617,20.66575963718821,22.407256235827663,14,18,142,2,120
3211,737,824,20.66575963718821,23.38249433106576,14,15,146,3,87
3212,617,211,22.407256235827663,24.752471655328797,18,24,418,2,406
3213,617,479,22.407256235827663,24.752471655328797,18,17,171,2,138
3214,617,839,22.407256235827663,24.775691609977326,18,15,244,2,222
3215,817,479,25.58839002267574,27.515646258503402,18,16,348,2,338
3216,817,813,25.58839002267574,27.538866213151927,18,15,84,2,4
3217,817,839,25.58839002267574,27.538866213151927,18,14,87,2,22
3218,684,211,26.424308390022677,27.515646258503402,26,20,475,1,473
3219,684,208,26.424308390022677,28.53732426303855,26,21,485,2,476
3220,684,479,26.424308390022677,27.515646258503402,26,16,210,1,205
3221,684,540,26.424308390022677,28.76952380952381,26,27,176,2,144
3222,684,813,26.424308390022677,27.538866213151927,26,15,138,1,129
3223,684,633,26.424308390022677,28.76952380952381,26,22,113,2,51
3224,684,839,26.424308390022677,27.538866213151927,26,14,162,1,155
3225,684,839,26.424308390022677,28.792743764172336,26,18,186,2,155
3226,813,540,27.538866213151927,28.76952380952381,15,27,278,1,273
3227,813,491,27.538866213151927,29.60544217687075,15,15,334,2,322
3228,813,524,27.538866213151927,30.48780045351474,15,32,316,3,289
3229,813,633,27.538866213151927,28.76952380952381,15,22,188,1,180
3230,813,812,27.538866213151927,30.511020408163265,15,23,128,3,1
3231,813,839,27.538866213151927,28.792743764172336,15,18,60,1,26
3232,813,836,27.538866213151927,30.48780045351474,15,23,129,3,23
3233,633,209,28.76952380952381,30.859319727891158,22,26,433,2,424
3234,633,231,28.76952380952381,31.67201814058957,22,24,421,3,402
3235,633,524,28.76952380952381,30.48780045351474,22,32,132,2,109
3236,633,465,28.76952380952381,31.648798185941043,22,16,209,3,168
3237,633,812,28.76952380952381,30.511020408163265,22,23,194,2,179
3238,633,836,28.76952380952381,30.48780045351474,22,23,216,2,203
3239,633,824,28.76952380952381,31.67201814058957,22,14,228,3,191
3240,812,465,30.511020408163265,31.648798185941043,23,16,350,1,347
3241,812,452,30.511020408163265,32.3221768707483,23,19,368,2,360
3242,812,679,30.511020408163265,33.04199546485261,23,15,172,3,133
3243,812,824,30.511020408163265,31.67201814058957,23,14,51,1,12
3244,812,839,30.511020408163265,33.04199546485261,23,14,112,3,27
3245,679,347,33.04199546485261,34.59773242630386,15,30,339,2,332
3246,679,231,33.04199546485261,35.71229024943311,15,26,463,3,448
3247,679,414,33.04199546485261,34.66739229024943,15,25,274,2,265
3248,679,479,33.04199546485261,35.781950113378684,15,16,232,3,200
3249,679,819,33.04199546485261,34.62095238095238,15,21,156,2,140
3250,679,888,33.04199546485261,34.644172335600906,15,26,220,2,209
3251,679,839,33.04199546485261,35.80517006802721,15,14,199,3,160
3252,691,231,33.73859410430839,35.71229024943311,16,26,468,2,460
3253,691,233,33.73859410430839,36.339229024943315,16,21,471,3,458
3254,691,479,33.73859410430839,35.781950113378684,16,16,230,2,212
3255,691,524,33.73859410430839,36.5946485260771,16,18,207,3,167
3256,691,817,33.73859410430839,36.617868480725626,16,18,177,3,126
3257,691,839,33.73859410430839,35.80517006802721,16,14,173,2,148
3258,691,920,33.73859410430839,36.548208616780045,16,16,259,3,229
3259,819,479,34.62095238095238,35.781950113378684,21,16,344,1,340
3260,819,524,34.62095238095238,36.5946485260771,21,18,307,2,295
3261,819,467,34.62095238095238,37.17514739229025,21,15,369,3,352
3262,819,817,34.62095238095238,36.617868480725626,21,18,86,2,2
3263,819,839,34.62095238095238,35.80517006802721,21,14,55,1,20
3264,819,920,34.62095238095238,36.548208616780045,21,16,131,2,101
3265,817,386,36.617868480725626,37.871746031746035,18,20,434,1,431
3266,817,483,36.617868480725626,39.07918367346939,18,24,350,2,334
3267,817,459,36.617868480725626,39.2649433106576,18,16,376,3,358
3268,817,808,36.617868480725626,39.07918367346939,18,18,106,2,9
3269,817,799,36.617868480725626,39.125623582766444,18,14,109,3,18
3270,817,865,36.617868480725626,39.07918367346939,18,22,116,2,48
3271,817,902,36.617868480725626,39.125623582766444,18,19,137,3,85
3272,808,476,39.07918367346939,40.61170068027211,18,15,338,2,332
3273,808,502,39.07918367346939,41.86557823129252,18,29,329,3,306
3274,808,661,39.07918367346939,41.35473922902494,18,25,177,2,147
3275,808,958,39.07918367346939,41.33151927437642,18,27,179,2,150
3276,799,476,39.125623582766444,40.61170068027211,14,15,329,1,323
3277,799,502,39.125623582766444,41.86557823129252,14,29,320,3,297
3278,799,661,39.125623582766444,41.35473922902494,14,25,168,2,138
3279,799,958,39.125623582766444,41.33151927437642,14,27,185,2,159
3280,661,386,41.35473922902494,43.39809523809524,25,20,289,2,275
3281,661,476,41.35473922902494,42.79437641723356,25,26,195,1,185
3282,661,479,41.35473922902494,44.0714739229025,25,15,216,3,182
3283,661,674,41.35473922902494,42.74793650793651,25,16,61,1,13
3284,661,944,41.35473922902494,42.74793650793651,25,14,289,1,283
3285,674,271,42.74793650793651,44.81451247165533,16,27,413,2,403
3286,674,329,42.74793650793651,45.27891156462585,16,18,362,3,345
3287,674,479,42.74793650793651,44.0714739229025,16,15,203,1,195
3288,674,459,42.74793650793651,44.76807256235828,16,17,232,2,215
3289,674,553,42.74793650793651,45.65043083900227,16,26,174,3,121
3290,674,699,42.74793650793651,44.74485260770975,16,17,90,2,25
3291,674,628,42.74793650793651,45.60399092970522,16,23,131,3,46
3292,674,870,42.74793650793651,44.76807256235828,16,16,214,2,196
3293,674,943,42.74793650793651,45.58077097505669,16,27,295,3,269
3294,699,216,44.74485260770975,46.88108843537415,17,25,492,2,483
3295,699,254,44.74485260770975,47.159727891156464,17,22,457,2,445
3296,699,534,44.74485260770975,46.27736961451247,17,28,178,2,165
3297,699,511,44.74485260770975,47.484807256235825,17,19,222,3,188
3298,699,694,44.74485260770975,46.34702947845805,17,24,69,2,5
3299,699,704,44.74485260770975,47.438367346938776,17,23,116,3,5
3300,699,853,44.74485260770975,46.300589569161,17,23,168,2,154
3301,699,826,44.74485260770975,47.438367346938776,17,20,172,3,127
3302,628,216,45.60399092970522,46.88108843537415,23,25,416,1,412
3303,628,254,45.60399092970522,47.159727891156464,23,22,380,2,374
3304,628,215,45.60399092970522,48.204625850340136,23,20,428,3,413
3305,628,511,45.60399092970522,47.484807256235825,23,19,142,2,117
3306,628,411,45.60399092970522,48.48326530612245,23,18,250,3,217
3307,628,704,45.60399092970522,47.438367346938776,23,23,110,2,76
3308,628,813,45.60399092970522,48.39038548752835,23,14,221,3,185
3309,628,826,45.60399092970522,47.438367346938776,23,20,213,2,198
3310,628,887,45.60399092970522,48.41360544217687,23,18,286,3,259
3311,694,215,46.34702947845805,48.204625850340136,24,20,486,2,479
3312,694,298,46.34702947845805,49.31918367346939,24,22,416,3,396
3313,694,511,46.34702947845805,47.484807256235825,24,19,189,1,183
3314,694,411,46.34702947845805,48.48326530612245,24,18,298,2,283
3315,694,704,46.34702947845805,47.438367346938776,24,23,48,1,10
3316,694,813,46.34702947845805,48.39038548752835,24,14,148,2,119
3317,694,826,46.34702947845805,47.438367346938776,24,20,140,1,132
3318,694,887,46.34702947845805,48.41360544217687,24,18,213,2,193
3319,704,298,47.438367346938776,49.31918367346939,23,22,414,2,406
3320,704,411,47.438367346938776,48.48326530612245,23,18,296,1,293
3321,704,490,47.438367346938776,50.108662131519274,23,26,243,3,214
3322,704,459,47.438367346938776,50.29442176870749,23,17,274,3,245
3323,704,818,47.438367346938776,50.108662131519274,23,19,162,3,114
3324,704,908,47.438367346938776,50.108662131519274,23,20,234,3,204
3325,704,875,47.438367346938776,50.178321995464856,23,14,208,3,171
3326,813,490,48.39038548752835,50.108662131519274,14,26,331,2,323
3327,813,459,48.39038548752835,50.29442176870749,14,17,363,2,354
3328,813,818,48.39038548752835,50.108662131519274,14,19,74,2,5
3329,813,908,48.39038548752835,50.108662131519274,14,20,120,2,95
3330,813,875,48.39038548752835,50.178321995464856,14,14,99,2,62
3331,818,545,50.108662131519274,51.66439909297052,19,14,281,2,273
3332,818,512,50.108662131519274,52.91827664399093,19,29,329,3,306
3333,818,674,50.108662131519274,52.407437641723355,19,29,175,2,144
3334,818,874,50.108662131519274,52.360997732426306,19,22,112,2,56
3335,674,211,52.407437641723355,55.100952380952386,29,23,477,3,463
3336,674,457,52.407437641723355,53.75419501133787,29,18,225,1,217
3337,674,478,52.407437641723355,55.100952380952386,29,17,228,3,196
3338,674,809,52.407437641723355,53.75419501133787,29,16,147,1,135
3339,674,679,52.407437641723355,55.12417233560091,29,14,117,3,5
3340,674,932,52.407437641723355,53.777414965986395,29,17,265,1,258
3341,674,839,52.407437641723355,55.12417233560091,29,15,202,3,165
3342,809,478,53.75419501133787,55.100952380952386,16,17,336,1,331
3343,809,459,53.75419501133787,55.797551020408164,16,17,361,2,350
3344,809,614,53.75419501133787,56.65668934240363,16,24,232,3,195
3345,809,679,53.75419501133787,55.12417233560091,16,14,143,1,130
3346,809,816,53.75419501133787,55.797551020408164,16,14,88,2,7
3347,809,693,53.75419501133787,56.679909297052156,16,27,171,3,116
3348,809,839,53.75419501133787,55.12417233560091,16,15,66,1,30
3349,809,930,53.75419501133787,55.797551020408164,16,16,150,2,121
3350,809,838,53.75419501133787,56.65668934240363,16,25,128,3,29
3351,679,266,55.12417233560091,56.49414965986394,14,26,417,1,413
3352,679,216,55.12417233560091,57.88734693877551,14,30,478,3,463
3353,679,614,55.12417233560091,56.65668934240363,14,24,93,2,65
3354,679,521,55.12417233560091,57.399727891156466,14,30,186,2,158
3355,679,693,55.12417233560091,56.679909297052156,14,27,68,2,14
3356,679,819,55.12417233560091,57.446167800453516,14,25,172,2,140
3357,679,838,55.12417233560091,56.65668934240363,14,25,172,2,159
3358,679,887,55.12417233560091,57.30684807256236,14,27,228,2,208
3359,816,521,55.797551020408164,57.399727891156466,14,30,303,2,295
3360,816,551,55.797551020408164,58.537505668934244,14,22,290,3,265
3361,816,819,55.797551020408164,57.446167800453516,14,25,71,2,3
3362,816,705,55.797551020408164,58.51428571428571,14,22,161,3,111
3363,816,887,55.797551020408164,57.30684807256236,14,27,96,2,71
3364,816,875,55.797551020408164,58.51428571428571,14,19,131,3,59
3365,693,216,56.679909297052156,57.88734693877551,27,30,480,1,477
3366,693,243,56.679909297052156,58.88580498866213,27,24,460,2,450
3367,693,207,56.679909297052156,59.303764172335605,27,29,499,3,486
3368,693,551,56.679909297052156,58.537505668934244,27,22,163,2,142
3369,693,418,56.679909297052156,59.396643990929704,27,20,299,3,275
3370,693,705,56.679909297052156,58.51428571428571,27,22,80,2,12
3371,693,819,56.679909297052156,59.55918367346939,27,17,177,3,126
3372,693,875,56.679909297052156,58.51428571428571,27,19,198,2,182
3373,693,847,56.679909297052156,59.582403628117916,27,17,198,3,154
3374,819,551,57.446167800453516,58.537505668934244,25,22,272,1,268
3375,819,418,57.446167800453516,59.396643990929704,25,20,410,2,401
3376,819,705,57.446167800453516,58.51428571428571,25,22,123,1,114
3377,819,875,57.446167800453516,58.51428571428571,25,19,72,1,56
3378,819,847,57.446167800453516,59.582403628117916,25,17,96,2,28
3379,705,278,58.51428571428571,60.44154195011338,22,30,435,2,427
3380,705,207,58.51428571428571,61.39356009070295,22,28,513,3,498
3381,705,410,58.51428571428571,61.161360544217686,22,20,316,3,295
3382,705,416,58.51428571428571,61.37034013605442,22,20,314,3,289
3383,705,819,58.51428571428571,59.55918367346939,22,17,123,1,114
3384,705,722,58.51428571428571,60.65052154195011,22,14,94,2,17
3385,705,783,58.51428571428571,61.30068027210884,22,22,143,3,78
3386,705,847,58.51428571428571,59.582403628117916,22,17,149,1,142
3387,705,839,58.51428571428571,60.62730158730159,22,15,162,2,134
3388,705,824,58.51428571428571,61.30068027210884,22,26,169,3,119
3389,819,410,59.55918367346939,61.161360544217686,17,20,415,2,409
3390,819,416,59.55918367346939,61.37034013605442,17,20,410,2,403
3391,819,475,59.55918367346939,62.415238095238095,17,22,365,3,344
3392,819,722,59.55918367346939,60.65052154195011,17,14,108,1,97
3393,819,783,59.55918367346939,61.30068027210884,17,22,83,2,36
3394,819,839,59.55918367346939,60.62730158730159,17,15,50,1,20
3395,819,824,59.55918367346939,61.30068027210884,17,26,75,2,5
3396,819,934,59.55918367346939,62.39201814058957,17,21,168,3,115
3397,722,275,60.65052154195011,63.20471655328798,14,31,460,3,447
3398,722,275,60.65052154195011,63.22793650793651,14,29,461,3,447
3399,722,475,60.65052154195011,62.415238095238095,14,22,258,2,247
3400,722,727,60.65052154195011,62.71709750566894,14,16,89,2,5
3401,722,934,60.65052154195011,62.39201814058957,14,21,225,2,212
3402,783,475,61.30068027210884,62.415238095238095,22,22,312,1,308
3403,783,547,61.30068027210884,64.04063492063493,22,24,264,3,236
3404,783,727,61.30068027210884,62.71709750566894,22,16,83,1,56
3405,783,657,61.30068027210884,63.99419501133787,22,22,171,3,126
3406,783,934,61.30068027210884,62.39201814058957,22,21,158,1,151
3407,783,896,61.30068027210884,64.01741496598639,22,22,163,3,113
3408,727,272,62.71709750566894,64.92299319727891,16,26,465,2,455
3409,727,275,62.71709750566894,65.2712925170068,16,27,465,3,452
3410,727,547,62.71709750566894,64.04063492063493,16,24,189,1,180
3411,727,603,62.71709750566894,64.52825396825396,16,15,146,2,124
3412,727,436,62.71709750566894,65.38739229024944,16,19,313,3,291
3413,727,657,62.71709750566894,63.99419501133787,16,22,89,1,70
3414,727,896,62.71709750566894,64.01741496598639,16,22,178,1,169
3415,727,824,62.71709750566894,64.76045351473923,16,15,131,2,97
3416,727,941,62.71709750566894,65.52671201814059,16,14,246,3,214
3417,657,275,63.99419501133787,65.2712925170068,22,27,386,1,382
3418,657,247,63.99419501133787,66.47873015873016,22,32,424,2,410
3419,657,436,63.99419501133787,65.38739229024944,22,19,229,1,221
3420,657,459,63.99419501133787,66.85024943310658,22,16,233,3,198
3421,657,813,63.99419501133787,66.1536507936508,22,15,182,2,156
3422,657,941,63.99419501133787,65.52671201814059,22,14,292,2,284
3423,657,899,63.99419501133787,66.82702947845804,22,15,271,3,242
3424,813,346,66.1536507936508,68.94004535147393,15,26,482,3,467
3425,813,553,66.1536507936508,67.73260770975057,15,27,269,2,260
3426,813,425,66.1536507936508,68.94004535147393,15,28,406,3,388
3427,813,679,66.1536507936508,67.68616780045352,15,26,149,2,134
3428,813,621,66.1536507936508,68.35954648526078,15,25,214,2,192
3429,813,822,66.1536507936508,67.68616780045352,15,24,67,2,9
3430,813,843,66.1536507936508,68.35954648526078,15,26,100,2,30
3431,679,346,67.68616780045352,68.94004535147393,26,26,337,1,333
3432,679,230,67.68616780045352,69.28834467120181,26,23,454,2,449
3433,679,261,67.68616780045352,70.4261224489796,26,26,434,3,418
3434,679,425,67.68616780045352,68.94004535147393,26,28,260,1,254
3435,679,555,67.68616780045352,70.14748299319729,26,28,163,2,124
3436,679,525,67.68616780045352,70.58866213151927,26,18,198,3,154
3437,679,630,67.68616780045352,70.12426303854875,26,22,116,2,49
3438,679,621,67.68616780045352,70.54222222222222,26,16,136,3,58
3439,679,830,67.68616780045352,70.12426303854875,26,23,184,2,151
3440,679,959,67.68616780045352,70.56544217687075,26,25,306,3,280
3441,621,261,68.35954648526078,70.4261224489796,25,26,371,2,360
3442,621,555,68.35954648526078,70.14748299319729,25,28,101,2,66
3443,621,525,68.35954648526078,70.58866213151927,25,18,136,2,96
3444,621,630,68.35954648526078,70.12426303854875,25,22,77,2,9
3445,621,830,68.35954648526078,70.12426303854875,25,23,222,2,209
3446,621,959,68.35954648526078,70.56544217687075,25,25,351,2,338
3447,630,234,70.12426303854875,72.12117913832199,22,32,405,2,396
3448,630,205,70.12426303854875,72.33015873015873,22,29,435,2,425
3449,630,459,70.12426303854875,72.35337868480725,22,19,196,2,171
3450,630,625,70.12426303854875,72.05151927437642,22,14,83,2,5
3451,630,737,70.12426303854875,73.07319727891156,22,15,166,3,107
3452,621,234,70.54222222222222,72.12117913832199,16,32,393,2,387
3453,621,205,70.54222222222222,72.33015873015873,16,29,423,2,416
3454,621,260,70.54222222222222,73.25895691609978,16,24,379,3,361
3455,621,459,70.54222222222222,72.35337868480725,16,19,180,2,162
3456,621,625,70.54222222222222,72.05151927437642,16,14,65,2,4
3457,621,737,70.54222222222222,73.07319727891156,16,15,159,3,116
3458,625,260,72.05151927437642,73.25895691609978,14,24,369,1,365
3459,625,251,72.05151927437642,75.00045351473923,14,30,395,3,374
3460,625,545,72.05151927437642,73.7233560090703,14,14,108,2,80
3461,625,737,72.05151927437642,73.07319727891156,14,15,120,1,112
3462,625,703,72.05151927437642,73.7233560090703,14,14,106,2,78
3463,625,624,72.05151927437642,74.81469387755102,14,16,119,3,1
3464,737,251,73.07319727891156,75.00045351473923,15,30,493,2,486
3465,737,406,73.07319727891156,75.37197278911565,15,27,345,2,331
3466,737,459,73.07319727891156,75.11655328798186,15,18,292,2,278
3467,737,457,73.07319727891156,75.37197278911565,15,29,297,2,280
3468,737,624,73.07319727891156,74.81469387755102,15,16,136,2,113
3469,737,639,73.07319727891156,75.39519274376417,15,23,140,2,98
3470,737,852,73.07319727891156,75.3255328798186,15,21,150,2,115
3471,703,251,73.7233560090703,75.00045351473923,14,30,455,1,452
3472,703,406,73.7233560090703,75.37197278911565,14,27,305,2,297
3473,703,272,73.7233560090703,76.34721088435374,14,23,446,3,431
3474,703,459,73.7233560090703,75.11655328798186,14,18,251,1,244
3475,703,457,73.7233560090703,75.37197278911565,14,29,256,2,246
3476,703,624,73.7233560090703,74.81469387755102,14,16,92,1,79
3477,703,639,73.7233560090703,75.39519274376417,14,23,96,2,64
3478,703,852,73.7233560090703,75.3255328798186,14,21,164,2,149
3479,624,272,74.81469387755102,76.34721088435374,16,23,358,2,352
3480,624,229,74.81469387755102,77.53142857142858,16,20,412,3,395
3481,624,479,74.81469387755102,77.15990929705215,16,18,177,2,145
3482,624,839,74.81469387755102,77.18312925170068,16,16,238,2,215
3483,639,229,75.39519274376417,77.53142857142858,23,20,420,2,410
3484,639,479,75.39519274376417,77.15990929705215,23,18,177,2,160
3485,639,459,75.39519274376417,77.87972789115646,23,19,209,2,180
3486,639,839,75.39519274376417,77.18312925170068,23,16,214,2,200
3487,658,211,78.55310657596372,79.92308390022676,17,22,451,1,447
3488,658,208,78.55310657596372,81.22340136054422,17,29,464,3,450
3489,658,429,78.55310657596372,79.94630385487528,17,17,237,1,229
3490,658,524,78.55310657596372,80.73578231292517,17,18,164,2,134
3491,658,498,78.55310657596372,81.31628117913833,17,16,199,3,160
3492,658,813,78.55310657596372,79.94630385487528,17,14,166,1,155
3493,658,817,78.55310657596372,80.75900226757369,17,18,185,2,159
3494,658,839,78.55310657596372,79.94630385487528,17,14,191,1,181
3495,658,831,78.55310657596372,80.66612244897959,17,15,195,2,173
3496,813,498,79.94630385487528,81.31628117913833,14,16,320,1,315
3497,813,479,79.94630385487528,82.68625850340136,14,18,354,3,334
3498,817,479,80.75900226757369,82.68625850340136,18,18,348,2,338
3499,817,813,80.75900226757369,82.70947845804989,18,13,84,2,4
3500,813,527,82.70947845804989,84.17233560090703,13,29,293,1,286
3501,813,481,82.70947845804989,84.75283446712018,13,15,343,2,332
3502,813,648,82.70947845804989,84.12589569160998,13,24,176,1,165
3503,813,679,82.70947845804989,85.44943310657597,13,14,179,3,134
3504,813,887,82.70947845804989,84.14911564625851,13,24,97,1,74
3505,813,905,82.70947845804989,85.44943310657597,13,15,150,3,92
3506,648,251,84.12589569160998,86.1924716553288,24,28,407,2,397
3507,648,263,84.12589569160998,86.98195011337869,24,25,404,3,385
3508,648,459,84.12589569160998,86.14603174603175,24,18,208,2,189
3509,648,517,84.12589569160998,87.07482993197279,24,30,182,3,131
3510,648,679,84.12589569160998,85.44943310657597,24,14,65,1,31
3511,648,653,84.12589569160998,86.6336507936508,24,16,108,3,5
3512,648,905,84.12589569160998,85.44943310657597,24,15,263,1,257
3513,648,944,84.12589569160998,86.61043083900226,24,17,315,2,296
3514,679,263,85.44943310657597,86.98195011337869,14,25,421,2,416
3515,679,213,85.44943310657597,87.42312925170069,14,24,474,2,466
3516,679,517,85.44943310657597,87.07482993197279,14,30,176,2,162
3517,679,478,85.44943310657597,88.21260770975057,14,17,234,3,201
3518,679,653,85.44943310657597,86.6336507936508,14,16,57,1,26
3519,679,813,85.44943310657597,88.2358276643991,14,15,180,3,134
3520,679,944,85.44943310657597,86.61043083900226,14,17,270,1,265
3521,653,272,86.6336507936508,88.53768707482993,16,28,390,2,381
3522,653,478,86.6336507936508,88.21260770975057,16,17,188,2,175
3523,653,469,86.6336507936508,88.65378684807257,16,33,204,2,184
3524,653,813,86.6336507936508,88.2358276643991,16,15,174,2,160
3525,653,799,86.6336507936508,88.6770068027211,16,20,170,2,146
3526,653,896,86.6336507936508,88.6770068027211,16,25,258,2,243
3527,813,419,88.2358276643991,89.65224489795918,15,19,399,1,394
3528,813,478,88.2358276643991,90.62748299319728,15,18,350,2,335
3529,813,791,88.2358276643991,89.67546485260772,15,17,66,1,22
3530,813,892,88.2358276643991,89.65224489795918,15,19,100,1,79
3531,813,839,88.2358276643991,91.16154195011337,15,14,129,3,26
3532,799,478,88.6770068027211,90.62748299319728,20,18,332,2,321
3533,799,839,88.6770068027211,91.16154195011337,20,14,114,2,40
3534,791,524,89.67546485260772,91.76526077097506,17,17,282,2,267
3535,791,468,89.67546485260772,92.34575963718821,17,15,343,3,323
3536,791,817,89.67546485260772,91.78848072562359,17,16,95,2,26
3537,791,839,89.67546485260772,91.16154195011337,17,14,80,1,48
3538,791,920,89.67546485260772,91.71882086167801,17,14,156,2,129
3539,817,458,91.78848072562359,94.24979591836735,16,25,374,2,359
3540,817,459,91.78848072562359,94.43555555555555,16,17,376,3,358
3541,817,816,91.78848072562359,94.2962358276644,16,15,108,3,1
3542,817,902,91.78848072562359,94.27301587301588,16,22,137,2,85
3543,816,545,94.2962358276644,95.8055328798186,15,15,279,2,271
3544,816,502,94.2962358276644,97.03619047619048,15,29,335,3,314
3545,816,810,94.2962358276644,96.15383219954649,15,16,80,2,6
3546,816,672,94.2962358276644,96.52535147392291,15,26,173,2,144
3547,816,932,94.2962358276644,96.47891156462585,15,23,149,2,116
3548,810,481,96.15383219954649,97.94176870748299,16,21,338,2,329
3549,810,684,96.15383219954649,97.89532879818594,16,16,147,2,126
3550,810,873,96.15383219954649,97.91854875283447,16,14,99,2,63
3551,672,214,96.52535147392291,98.84734693877552,26,21,469,2,458
3552,672,481,96.52535147392291,97.94176870748299,26,21,201,1,191
3553,672,479,96.52535147392291,99.24208616780045,26,16,226,3,193
3554,672,684,96.52535147392291,97.89532879818594,26,16,60,1,12
3555,672,873,96.52535147392291,97.91854875283447,26,14,210,1,201
3556,672,934,96.52535147392291,99.24208616780045,26,13,287,3,262
3557,684,270,97.89532879818594,99.93868480725624,16,25,423,2,414
3558,684,266,97.89532879818594,100.6120634920635,16,30,434,3,418
3559,684,479,97.89532879818594,99.24208616780045,16,16,213,1,205
3560,684,459,97.89532879818594,99.93868480725624,16,16,242,2,225
3561,684,499,97.89532879818594,100.7978231292517,16,26,223,3,185
3562,684,664,97.89532879818594,100.77460317460317,16,28,126,3,20
3563,684,934,97.89532879818594,99.24208616780045,16,13,257,1,250
3564,684,917,97.89532879818594,99.96190476190476,16,15,249,2,233
3565,684,944,97.89532879818594,100.7978231292517,16,23,288,3,260
3566,664,219,100.77460317460317,102.00526077097506,28,28,448,1,445
3567,664,236,100.77460317460317,103.18947845804989,28,25,440,2,428
3568,664,234,100.77460317460317,103.3752380952381,28,20,444,3,430
3569,664,506,100.77460317460317,102.63219954648527,28,24,177,2,158
3570,664,468,100.77460317460317,103.65387755102041,28,17,232,3,196
3571,664,702,100.77460317460317,102.63219954648527,28,20,89,2,38
3572,664,808,100.77460317460317,103.5609977324263,28,15,187,3,144
3573,664,935,100.77460317460317,102.60897959183674,28,20,282,2,271
3574,664,925,100.77460317460317,103.5609977324263,28,15,287,3,261
3575,657,236,101.42476190476191,103.18947845804989,25,25,428,2,421
3576,657,234,101.42476190476191,103.3752380952381,25,20,431,2,423
3577,657,506,101.42476190476191,102.63219954648527,25,24,160,1,151
3578,657,468,101.42476190476191,103.65387755102041,25,17,212,2,189
3579,657,702,101.42476190476191,102.63219954648527,25,20,69,1,45
3580,657,808,101.42476190476191,103.5609977324263,25,15,177,2,151
3581,657,935,101.42476190476191,102.60897959183674,25,20,283,1,278
3582,657,925,101.42476190476191,103.5609977324263,25,15,283,2,268
3583,702,277,102.63219954648527,105.04707482993197,20,25,438,2,425
3584,702,468,102.63219954648527,103.65387755102041,20,17,238,1,234
3585,702,474,102.63219954648527,105.30249433106576,20,24,255,3,228
3586,702,459,102.63219954648527,105.46503401360545,20,18,272,3,243
3587,702,672,102.63219954648527,105.30249433106576,20,16,119,3,30
3588,702,927,102.63219954648527,105.27927437641723,20,20,252,3,225
3589,808,474,103.5609977324263,105.30249433106576,15,24,342,2,334
3590,808,459,103.5609977324263,105.46503401360545,15,18,359,2,349
3591,808,672,103.5609977324263,105.30249433106576,15,16,155,2,136
3592,808,927,103.5609977324263,105.27927437641723,15,20,140,2,119
3593,672,216,105.30249433106576,107.22975056689343,16,29,463,2,456
3594,672,410,105.30249433106576,106.81179138321995,16,15,270,2,262
3595,672,507,105.30249433106576,108.06566893424036,16,29,203,3,165
3596,672,620,105.30249433106576,107.2065306122449,16,15,97,2,52
3597,672,674,105.30249433106576,107.55482993197279,16,30,97,2,2
3598,672,891,105.30249433106576,107.34585034013605,16,14,236,2,219
3599,672,822,105.30249433106576,107.55482993197279,16,22,179,2,150
3600,620,244,107.2065306122449,108.29786848072563,15,22,379,1,376
3601,620,246,107.2065306122449,108.48362811791384,15,21,378,1,374
3602,620,215,107.2065306122449,109.7839455782313,15,20,420,3,405
3603,620,460,107.2065306122449,108.92480725623582,15,22,176,2,160
3604,620,810,107.2065306122449,108.92480725623582,15,14,204,2,190
3605,620,912,107.2065306122449,108.94802721088436,15,15,301,2,292
3606,674,215,107.55482993197279,109.7839455782313,30,20,469,2,459
3607,674,460,107.55482993197279,108.92480725623582,30,22,222,1,214
3608,674,456,107.55482993197279,110.27156462585035,30,16,247,3,218
3609,674,810,107.55482993197279,108.92480725623582,30,14,148,1,136
3610,674,625,107.55482993197279,110.27156462585035,30,15,127,3,49
3611,674,912,107.55482993197279,108.94802721088436,30,15,245,1,238
3612,810,456,108.92480725623582,110.27156462585035,14,16,359,1,354
3613,810,459,108.92480725623582,110.96816326530613,14,16,362,2,351
3614,810,606,108.92480725623582,111.85052154195012,14,28,240,3,204
3615,810,625,108.92480725623582,110.27156462585035,14,15,194,1,185
3616,810,812,108.92480725623582,110.92172335600907,14,15,86,2,2
3617,810,693,108.92480725623582,111.85052154195012,14,27,172,3,117
3618,810,958,108.92480725623582,110.89850340136054,14,15,171,2,148
3619,810,870,108.92480725623582,111.82730158730159,14,27,139,3,60
3620,625,267,110.27156462585035,111.6647619047619,15,26,363,1,358
3621,625,216,110.27156462585035,113.05795918367347,15,27,426,3,409
3622,625,606,110.27156462585035,111.85052154195012,15,28,71,2,19
3623,625,516,110.27156462585035,112.59356009070295,15,29,148,2,109
3624,625,693,110.27156462585035,111.85052154195012,15,27,96,2,68
3625,625,817,110.27156462585035,112.50068027210885,15,24,215,2,192
3626,625,870,110.27156462585035,111.82730158730159,15,27,254,2,245
3627,625,876,110.27156462585035,112.5471201814059,15,24,269,2,251
3628,812,516,110.92172335600907,112.59356009070295,15,29,305,2,296
3629,812,523,110.92172335600907,113.66167800453515,15,20,312,3,289
3630,812,817,110.92172335600907,112.50068027210885,15,24,68,2,5
3631,812,694,110.92172335600907,113.68489795918367,15,21,168,3,118
3632,812,876,110.92172335600907,112.5471201814059,15,24,95,2,64
3633,812,943,110.92172335600907,113.7081179138322,15,19,178,3,131
3634,693,216,111.85052154195012,113.05795918367347,27,27,480,1,477
3635,693,309,111.85052154195012,114.40471655328798,27,25,399,3,384
3636,693,207,111.85052154195012,114.49759637188208,27,27,499,3,486
3637,693,523,111.85052154195012,113.66167800453515,27,20,187,2,170
3638,693,418,111.85052154195012,114.56725623582767,27,20,299,3,275
3639,693,694,111.85052154195012,113.68489795918367,27,21,79,2,1
3640,693,943,111.85052154195012,113.7081179138322,27,19,262,2,250
3641,693,826,111.85052154195012,114.72979591836734,27,16,182,3,133
3642,817,523,112.50068027210885,113.66167800453515,24,20,298,1,294
3643,817,418,112.50068027210885,114.56725623582767,24,20,409,2,399
3644,817,694,112.50068027210885,113.68489795918367,24,21,133,1,123
3645,817,727,112.50068027210885,115.1245351473923,24,16,144,3,90
3646,817,943,112.50068027210885,113.7081179138322,24,19,136,1,126
3647,817,826,112.50068027210885,114.72979591836734,24,16,96,2,9
3648,694,244,113.68489795918367,116.14621315192744,21,29,462,2,450
3649,694,206,113.68489795918367,116.65705215419501,21,25,505,3,488
3650,694,410,113.68489795918367,116.33197278911565,21,19,306,3,284
3651,694,561,113.68489795918367,116.44807256235828,21,20,178,3,133
3652,694,727,113.68489795918367,115.1245351473923,21,16,70,1,33
3653,694,624,113.68489795918367,115.79791383219955,21,14,115,2,70
3654,694,815,113.68489795918367,116.4712925170068,21,23,170,3,121
3655,694,826,113.68489795918367,114.72979591836734,21,16,139,1,132
3656,694,924,113.68489795918367,116.40163265306123,21,17,258,3,230
3657,694,929,113.68489795918367,116.4712925170068,21,23,264,3,235
3658,727,244,115.1245351473923,116.14621315192744,16,29,485,1,483
3659,727,410,115.1245351473923,116.33197278911565,16,19,321,1,317
3660,727,561,115.1245351473923,116.44807256235828,16,20,176,1,166
3661,727,480,115.1245351473923,117.58585034013606,16,23,269,2,247
3662,727,815,115.1245351473923,116.4712925170068,16,23,105,1,88
3663,727,654,115.1245351473923,117.58585034013606,16,18,129,2,73
3664,727,924,115.1245351473923,116.40163265306123,16,17,205,1,197
3665,727,929,115.1245351473923,116.4712925170068,16,23,210,1,202
3666,727,936,115.1245351473923,117.56263038548754,16,22,234,2,209
3667,624,277,115.79791383219955,118.37532879818595,14,27,364,3,347
3668,624,212,115.79791383219955,118.56108843537415,14,26,429,3,412
3669,624,480,115.79791383219955,117.58585034013606,14,23,163,2,144
3670,624,654,115.79791383219955,117.58585034013606,14,18,83,2,30
3671,624,936,115.79791383219955,117.56263038548754,14,22,321,2,312
3672,815,480,116.4712925170068,117.58585034013606,23,23,338,1,335
3673,815,562,116.4712925170068,119.16480725623583,23,23,278,3,253
3674,815,654,116.4712925170068,117.58585034013606,23,18,168,1,161
3675,815,701,116.4712925170068,119.16480725623583,23,22,163,3,114
3676,815,936,116.4712925170068,117.56263038548754,23,22,130,1,121
3677,815,936,116.4712925170068,119.18802721088436,23,23,168,3,121
3678,654,207,117.58585034013606,120.00072562358277,18,26,459,2,447
3679,654,562,117.58585034013606,119.16480725623583,18,23,114,2,92
3680,654,603,117.58585034013606,119.69886621315193,18,16,104,2,51
3681,654,701,117.58585034013606,119.16480725623583,18,22,83,2,47
3682,654,936,117.58585034013606,119.18802721088436,18,23,290,2,282
3683,654,842,117.58585034013606,120.55800453514739,18,15,227,3,188
3684,701,276,119.16480725623583,120.79020408163265,22,26,431,2,425
3685,701,244,119.16480725623583,121.64934240362813,22,28,469,2,457
3686,701,410,119.16480725623583,120.60444444444445,22,19,298,1,291
3687,701,459,119.16480725623583,122.02086167800454,22,17,271,3,242
3688,701,817,119.16480725623583,121.34748299319727,22,13,149,2,116
3689,701,815,119.16480725623583,121.99764172335601,22,15,167,3,114
3690,701,842,119.16480725623583,120.55800453514739,22,15,153,1,141
3691,701,918,119.16480725623583,122.02086167800454,22,15,249,3,217
3692,817,346,121.34748299319727,124.11065759637188,13,26,486,3,471
3693,817,560,121.34748299319727,122.88,13,27,265,2,257
3694,817,425,121.34748299319727,124.11065759637188,13,28,410,3,392
3695,817,679,121.34748299319727,122.85678004535147,13,26,153,2,138
3696,817,621,121.34748299319727,123.53015873015873,13,25,217,2,196
3697,817,836,121.34748299319727,122.83356009070295,13,25,67,1,19
3698,817,898,121.34748299319727,123.53015873015873,13,26,124,2,81
3699,815,346,121.99764172335601,124.11065759637188,15,26,478,2,469
3700,815,425,121.99764172335601,124.11065759637188,15,28,400,2,390
3701,815,436,121.99764172335601,124.9233560090703,15,16,399,3,379
3702,815,621,121.99764172335601,123.53015873015873,15,25,205,2,194
3703,815,817,121.99764172335601,124.90013605442176,15,18,125,3,2
3704,815,898,121.99764172335601,123.53015873015873,15,26,106,2,83
3705,815,857,121.99764172335601,124.90013605442176,15,14,132,3,42
3706,679,346,122.85678004535147,124.11065759637188,26,26,337,1,333
3707,679,207,122.85678004535147,125.17877551020409,26,27,482,2,472
3708,679,425,122.85678004535147,124.11065759637188,26,28,260,1,254
3709,679,436,122.85678004535147,124.9233560090703,26,16,259,2,243
3710,679,468,122.85678004535147,125.4574149659864,26,17,239,3,211
3711,679,817,122.85678004535147,124.90013605442176,26,18,164,2,138
3712,679,857,122.85678004535147,124.90013605442176,26,14,199,2,178
3713,621,207,123.53015873015873,125.17877551020409,25,27,420,2,414
3714,621,252,123.53015873015873,126.33977324263039,25,33,388,3,369
3715,621,436,123.53015873015873,124.9233560090703,25,16,194,1,185
3716,621,468,123.53015873015873,125.4574149659864,25,17,174,2,153
3717,621,817,123.53015873015873,124.90013605442176,25,18,205,1,196
3718,621,857,123.53015873015873,124.90013605442176,25,14,243,1,236
3719,817,530,124.90013605442176,126.75773242630386,18,23,298,2,287
3720,817,459,124.90013605442176,127.52399092970522,18,19,375,3,358
3721,817,813,124.90013605442176,126.85061224489796,18,14,84,2,4
3722,817,691,124.90013605442176,127.52399092970522,18,14,169,3,126
3723,817,839,124.90013605442176,126.85061224489796,18,16,87,2,22
3724,813,526,126.85061224489796,128.4760090702948,14,20,295,2,287
3725,813,801,126.85061224489796,128.91718820861678,14,14,90,2,12
3726,813,824,126.85061224489796,128.220589569161,14,15,60,1,11
3727,691,226,127.52399092970522,128.89396825396827,14,31,469,1,465
3728,691,228,127.52399092970522,129.8227664399093,14,32,473,2,463
3729,691,459,127.52399092970522,130.2871655328798,14,19,261,3,232
3730,691,801,127.52399092970522,128.91718820861678,14,14,125,1,110
3731,801,459,128.91718820861678,130.2871655328798,14,19,347,1,342
3732,801,493,128.91718820861678,130.96054421768707,14,16,320,2,308
3733,801,691,128.91718820861678,130.2871655328798,14,15,125,1,110
3734,691,228,130.2871655328798,131.49460317460318,15,31,466,1,463
3735,691,251,130.2871655328798,133.14321995464852,15,27,457,3,440
3736,691,532,130.2871655328798,131.9590022675737,15,20,175,2,159
3737,691,459,130.2871655328798,133.05034013605442,15,20,261,3,232
3738,691,839,130.2871655328798,132.35374149659864,15,14,173,2,148
3739,641,207,133.72371882086168,136.48689342403628,14,35,450,3,434
3740,641,209,133.72371882086168,136.53333333333333,14,35,449,3,432
3741,641,429,133.72371882086168,135.11691609977325,14,17,220,1,212
3742,641,524,133.72371882086168,135.90639455782312,14,17,150,2,117
3743,641,684,133.72371882086168,135.8831746031746,14,16,102,2,43
3744,641,839,133.72371882086168,135.11691609977325,14,15,207,1,198
3745,641,823,133.72371882086168,136.02249433106576,14,14,207,2,182
3746,684,278,135.8831746031746,137.67111111111112,16,34,413,2,406
3747,684,246,135.8831746031746,138.50702947845807,16,35,452,3,438
3748,684,462,135.8831746031746,137.32281179138323,16,14,230,1,222
3749,684,563,135.8831746031746,137.69433106575963,16,18,144,2,121
3750,684,689,135.8831746031746,137.76399092970522,16,15,81,2,5
3751,689,274,137.76399092970522,140.43428571428572,15,33,431,3,415
3752,689,415,137.76399092970522,139.22684807256235,15,19,281,1,274
3753,689,442,137.76399092970522,140.29496598639457,15,21,270,3,247
3754,689,788,137.76399092970522,139.01786848072564,15,16,113,1,99
3755,689,779,137.76399092970522,139.57514739229026,15,14,119,2,90
3756,689,929,137.76399092970522,138.901768707483,15,16,245,1,240
3757,689,841,137.76399092970522,140.43428571428572,15,14,191,3,152
3758,788,442,139.01786848072564,140.29496598639457,16,21,350,1,346
3759,788,446,139.01786848072564,140.9683446712018,16,22,352,2,342
3760,788,411,139.01786848072564,141.96680272108844,16,21,398,3,377
3761,788,693,139.01786848072564,141.38630385487528,16,15,139,2,95
3762,788,841,139.01786848072564,140.43428571428572,16,14,81,1,53
3763,788,903,139.01786848072564,141.40952380952382,16,14,154,2,115
3764,779,446,139.57514739229026,140.9683446712018,14,22,338,1,333
3765,779,411,139.57514739229026,141.96680272108844,14,21,382,2,368
3766,779,693,139.57514739229026,141.38630385487528,14,15,116,2,86
3767,779,678,139.57514739229026,142.15256235827664,14,17,150,3,101
3768,779,903,139.57514739229026,141.40952380952382,14,14,147,2,124
3769,779,896,139.57514739229026,142.29188208616782,14,17,165,3,117
3770,693,252,141.38630385487528,142.43120181405897,15,31,443,1,441
3771,693,276,141.38630385487528,142.8259410430839,15,28,422,1,417
3772,693,247,141.38630385487528,143.7082993197279,15,31,457,2,446
3773,693,578,141.38630385487528,143.49931972789116,15,18,147,2,115
3774,693,557,141.38630385487528,144.01015873015874,15,20,177,3,136
3775,693,678,141.38630385487528,142.84916099773244,15,17,65,1,15
3776,693,733,141.38630385487528,144.01015873015874,15,25,120,3,40
3777,693,903,141.38630385487528,142.84916099773244,15,17,219,1,210
3778,693,848,141.38630385487528,144.01015873015874,15,16,192,3,155
3779,678,247,142.15256235827664,143.7082993197279,17,31,436,2,431
3780,678,207,142.15256235827664,144.82285714285715,17,28,485,3,471
3781,678,578,142.15256235827664,143.49931972789116,17,18,116,1,100
3782,678,557,142.15256235827664,144.01015873015874,17,20,145,2,121
3783,678,733,142.15256235827664,144.01015873015874,17,25,97,2,55
3784,678,848,142.15256235827664,144.01015873015874,17,16,188,2,170
3785,678,207,142.84916099773244,144.82285714285715,17,28,479,2,471
3786,678,557,142.84916099773244,144.01015873015874,17,20,131,1,121
3787,678,420,142.84916099773244,145.35691609977326,17,26,280,3,258
3788,678,733,142.84916099773244,144.01015873015874,17,25,74,1,55
3789,678,699,142.84916099773244,145.47301587301587,17,17,115,3,21
3790,678,848,142.84916099773244,144.01015873015874,17,16,177,1,170
3791,678,892,142.84916099773244,145.4962358276644,17,24,242,3,214
3792,733,246,144.01015873015874,146.79655328798185,25,30,502,3,487
3793,733,420,144.01015873015874,145.35691609977326,25,26,318,1,313
3794,733,446,144.01015873015874,146.49469387755101,25,22,306,2,287
3795,733,699,144.01015873015874,145.47301587301587,25,17,72,1,34
3796,733,659,144.01015873015874,146.4714739229025,25,17,129,2,74
3797,733,892,144.01015873015874,145.4962358276644,25,24,171,1,159
3798,733,839,144.01015873015874,146.14639455782313,25,14,140,2,106
3799,733,820,144.01015873015874,146.8429931972789,25,16,150,3,87
3800,699,246,145.47301587301587,146.79655328798185,17,30,457,1,453
3801,699,205,145.47301587301587,147.5395918367347,17,30,502,2,494
3802,699,446,145.47301587301587,146.49469387755101,17,22,257,1,253
3803,699,410,145.47301587301587,147.35383219954647,17,25,300,2,289
3804,699,419,145.47301587301587,147.5395918367347,17,28,294,2,280
3805,699,616,145.47301587301587,147.33061224489796,17,17,115,2,83
3806,699,700,145.47301587301587,148.3522902494331,17,27,124,3,1
3807,699,820,145.47301587301587,146.8429931972789,17,16,135,1,121
3808,699,827,145.47301587301587,148.3522902494331,17,23,178,3,128
3809,659,205,146.4714739229025,147.5395918367347,17,30,456,1,454
3810,659,245,146.4714739229025,149.25786848072562,17,31,431,3,414
3811,659,419,146.4714739229025,147.5395918367347,17,28,244,1,240
3812,659,411,146.4714739229025,149.11854875283447,17,25,273,3,248
3813,659,700,146.4714739229025,148.3522902494331,17,27,91,2,41
3814,659,649,146.4714739229025,148.63092970521544,17,20,94,2,10
3815,659,827,146.4714739229025,148.3522902494331,17,23,187,2,168
3816,659,838,146.4714739229025,148.95600907029478,17,16,209,2,179
3817,616,245,147.33061224489796,149.25786848072562,17,31,380,2,371
3818,616,206,147.33061224489796,149.582947845805,17,32,421,2,410
3819,616,411,147.33061224489796,149.11854875283447,17,25,219,2,205
3820,616,514,147.33061224489796,149.582947845805,17,21,141,2,102
3821,616,700,147.33061224489796,148.3522902494331,17,27,95,1,84
3822,616,649,147.33061224489796,148.63092970521544,17,20,65,1,33
3823,616,638,147.33061224489796,149.55972789115646,17,21,98,2,22
3824,616,827,147.33061224489796,148.3522902494331,17,23,216,1,211
3825,616,838,147.33061224489796,148.95600907029478,17,16,233,2,222
3826,616,894,147.33061224489796,149.55972789115646,17,18,294,2,278
3827,700,206,148.3522902494331,149.582947845805,27,32,497,1,494
3828,700,514,148.3522902494331,149.582947845805,27,21,193,1,186
3829,700,442,148.3522902494331,151.32444444444445,27,21,288,3,258
3830,700,638,148.3522902494331,149.55972789115646,27,21,81,1,62
3831,700,678,148.3522902494331,151.11546485260772,27,17,121,3,22
3832,700,894,148.3522902494331,149.55972789115646,27,18,201,1,194
3833,700,846,148.3522902494331,151.13868480725623,27,14,189,3,146
3834,649,278,148.63092970521544,151.48698412698414,20,31,391,3,371
3835,649,442,148.63092970521544,151.32444444444445,20,21,237,3,207
3836,649,678,148.63092970521544,151.11546485260772,20,17,111,2,29
3837,649,846,148.63092970521544,151.13868480725623,20,14,225,3,197
3838,638,278,149.55972789115646,151.48698412698414,21,31,369,2,360
3839,638,246,149.55972789115646,151.8120634920635,21,31,404,2,392
3840,638,442,149.55972789115646,151.32444444444445,21,21,210,2,196
3841,638,417,149.55972789115646,152.20680272108845,21,23,249,3,221
3842,638,678,149.55972789115646,151.11546485260772,21,17,78,2,40
3843,638,669,149.55972789115646,152.29968253968255,21,20,122,3,31
3844,638,846,149.55972789115646,151.13868480725623,21,14,219,2,208
3845,638,848,149.55972789115646,151.67274376417234,21,16,229,2,210
3846,678,275,151.11546485260772,153.18204081632652,17,31,413,2,403
3847,678,277,151.11546485260772,153.87863945578232,17,32,418,3,401
3848,678,417,151.11546485260772,152.20680272108845,17,23,265,1,261
3849,678,596,151.11546485260772,153.18204081632652,17,23,121,2,82
3850,678,442,151.11546485260772,154.08761904761906,17,17,268,3,236
3851,678,669,151.11546485260772,152.29968253968255,17,20,52,1,9
3852,678,620,151.11546485260772,153.18204081632652,17,18,106,2,58
3853,678,693,151.11546485260772,153.87863945578232,17,15,120,3,15
3854,678,946,151.11546485260772,153.4374603174603,17,16,286,2,268
3855,669,277,152.29968253968255,153.87863945578232,20,32,398,2,392
3856,669,246,152.29968253968255,154.73777777777778,20,32,436,2,423
3857,669,442,152.29968253968255,154.08761904761906,20,17,240,2,227
3858,669,693,152.29968253968255,153.87863945578232,20,15,72,2,24
3859,669,645,152.29968253968255,155.06285714285715,20,18,121,3,24
3860,669,946,152.29968253968255,153.4374603174603,20,16,281,1,277
3861,669,912,152.29968253968255,155.06285714285715,20,15,271,3,243
3862,620,246,153.18204081632652,154.73777777777778,18,32,380,2,374
3863,620,207,153.18204081632652,155.80589569160998,18,33,428,3,413
3864,620,436,153.18204081632652,155.4575963718821,18,21,208,2,184
3865,620,645,153.18204081632652,155.06285714285715,18,18,85,2,25
3866,620,912,153.18204081632652,155.06285714285715,18,15,303,2,292
3867,693,207,153.87863945578232,155.80589569160998,15,33,493,2,486
3868,693,436,153.87863945578232,155.4575963718821,15,21,266,2,257
3869,693,425,153.87863945578232,156.38639455782314,15,25,289,3,268
3870,693,645,153.87863945578232,155.06285714285715,15,18,70,1,48
3871,693,789,153.87863945578232,156.2702947845805,15,16,141,2,96
3872,693,912,153.87863945578232,155.06285714285715,15,15,225,1,219
3873,693,861,153.87863945578232,156.5257142857143,15,16,203,3,168
3874,645,275,155.06285714285715,156.9901133786848,18,34,379,2,370
3875,645,425,155.06285714285715,156.38639455782314,18,25,227,1,220
3876,645,429,155.06285714285715,157.52417233560092,18,18,241,2,216
3877,645,458,155.06285714285715,157.8724716553288,18,18,223,3,187
3878,645,789,155.06285714285715,156.2702947845805,18,16,153,1,144
3879,645,631,155.06285714285715,157.2455328798186,18,14,95,2,14
3880,645,750,155.06285714285715,157.84925170068027,18,14,159,3,105
3881,645,861,155.06285714285715,156.5257142857143,18,16,225,1,216
3882,645,839,155.06285714285715,157.52417233560092,18,14,221,2,194
3883,789,429,156.2702947845805,157.52417233560092,16,18,364,1,360
3884,789,458,156.2702947845805,157.8724716553288,16,18,338,2,331
3885,789,750,156.2702947845805,157.84925170068027,16,14,78,2,39
3886,789,839,156.2702947845805,157.52417233560092,16,14,74,1,50
3887,631,206,157.2455328798186,158.54585034013607,14,36,429,1,425
3888,631,207,157.2455328798186,158.61551020408163,14,38,428,1,424
3889,631,463,157.2455328798186,159.381768707483,14,14,192,2,168
3890,750,463,157.84925170068027,159.381768707483,14,14,294,2,287
3891,750,488,157.84925170068027,160.24090702947845,14,19,282,2,262
3892,847,429,6.9195464852607715,8.219863945578231,15,18,422,1,418
3893,847,446,6.9195464852607715,9.752380952380953,15,20,419,3,401
3894,847,678,6.9195464852607715,8.544943310657597,15,18,183,2,169
3895,847,678,6.9195464852607715,9.752380952380953,15,18,208,3,169
3896,847,839,6.9195464852607715,8.219863945578231,15,15,57,1,8
3897,847,967,6.9195464852607715,9.729160997732427,15,16,170,3,120
3898,847,446,7.894784580498866,9.752380952380953,14,20,409,2,401
3899,847,446,7.894784580498866,10.495419501133787,14,18,416,3,401
3900,847,678,7.894784580498866,9.752380952380953,14,18,187,2,169
3901,847,693,7.894784580498866,10.797278911564627,14,18,198,3,154
3902,847,967,7.894784580498866,9.729160997732427,14,16,144,2,120
3903,847,846,7.894784580498866,10.100680272108844,14,16,95,2,1
3904,839,446,8.219863945578231,9.752380952380953,15,20,399,2,393
3905,839,446,8.219863945578231,10.495419501133787,15,18,405,2,393
3906,839,678,8.219863945578231,9.752380952380953,15,18,174,2,161
3907,839,693,8.219863945578231,10.797278911564627,15,18,183,3,146
3908,839,967,8.219863945578231,9.729160997732427,15,16,144,2,128
3909,839,846,8.219863945578231,10.100680272108844,15,16,81,2,7
3910,967,693,9.729160997732427,10.797278911564627,16,18,278,1,274
3911,967,795,9.729160997732427,11.656417233560092,16,15,191,2,172
3912,967,693,9.729160997732427,12.051156462585034,16,15,292,2,274
3913,967,933,9.729160997732427,11.284897959183674,16,15,75,2,34
3914,967,847,9.729160997732427,12.422675736961452,16,17,167,3,120
3915,846,459,10.100680272108844,11.679637188208616,16,17,393,2,387
3916,846,448,10.100680272108844,12.631655328798185,16,16,413,3,398
3917,846,795,10.100680272108844,11.656417233560092,16,15,84,2,51
3918,846,693,10.100680272108844,12.051156462585034,16,15,175,2,153
3919,846,933,10.100680272108844,11.284897959183674,16,15,101,1,87
3920,846,847,10.100680272108844,12.422675736961452,16,17,100,2,1
3921,933,448,11.284897959183674,12.631655328798185,15,16,488,1,485
3922,933,678,11.284897959183674,14.02485260770975,15,14,281,3,255
3923,933,678,11.284897959183674,14.048072562358277,15,17,281,3,255
3924,933,847,11.284897959183674,12.422675736961452,15,17,99,1,86
3925,933,840,11.284897959183674,13.722993197278912,15,14,140,2,93
3926,847,429,12.422675736961452,13.746213151927439,17,18,422,1,418
3927,847,446,12.422675736961452,14.582131519274377,17,20,412,2,401
3928,847,678,12.422675736961452,14.02485260770975,17,14,183,2,169
3929,847,678,12.422675736961452,14.048072562358277,17,17,183,2,169
3930,847,840,12.422675736961452,13.722993197278912,17,14,56,1,7
3931,847,903,12.422675736961452,14.512471655328799,17,15,106,2,56
3932,847,824,12.422675736961452,15.116190476190477,17,14,118,3,23
3933,840,545,13.722993197278912,15.789569160997733,14,16,308,2,295
3934,840,479,13.722993197278912,16.486167800453515,14,18,380,3,361
3935,840,824,13.722993197278912,15.116190476190477,14,14,62,1,16
3936,840,839,13.722993197278912,16.486167800453515,14,15,119,3,1
3937,903,545,14.512471655328799,15.789569160997733,15,16,362,1,358
3938,903,479,14.512471655328799,16.486167800453515,15,18,432,2,424
3939,903,551,14.512471655328799,17.438185941043084,15,23,374,3,352
3940,903,643,14.512471655328799,16.857687074829933,15,14,279,2,260
3941,903,677,14.512471655328799,17.438185941043084,15,19,259,3,226
3942,903,839,14.512471655328799,16.486167800453515,15,15,106,2,64
3943,824,479,15.116190476190477,16.486167800453515,14,18,350,1,345
3944,824,551,15.116190476190477,17.438185941043084,14,23,291,2,273
3945,824,643,15.116190476190477,16.857687074829933,14,14,196,2,181
3946,824,677,15.116190476190477,17.438185941043084,14,19,178,2,147
3947,824,839,15.116190476190477,16.486167800453515,14,15,61,1,15
3948,839,545,16.486167800453515,18.552743764172337,15,15,307,2,294
3949,839,731,16.486167800453515,18.552743764172337,15,14,140,2,108
3950,839,824,16.486167800453515,17.87936507936508,15,15,62,1,15
3951,824,421,17.87936507936508,19.760181405895693,15,20,411,2,403
3952,824,475,17.87936507936508,20.619319727891156,15,15,368,3,349
3953,824,797,17.87936507936508,19.783401360544218,15,19,86,2,27
3954,824,737,17.87936507936508,20.66575963718821,15,14,148,3,87
3955,824,854,17.87936507936508,19.760181405895693,15,19,86,2,30
3956,824,825,17.87936507936508,20.619319727891156,15,14,118,3,1
3957,854,479,19.760181405895693,21.989297052154196,19,18,387,2,375
3958,854,459,19.760181405895693,22.709115646258503,19,18,415,3,395
3959,854,617,19.760181405895693,22.407256235827663,19,18,263,3,237
3960,825,479,20.619319727891156,21.989297052154196,14,18,351,1,346
3961,825,459,20.619319727891156,22.709115646258503,14,18,377,2,366
3962,825,467,20.619319727891156,23.38249433106576,14,17,377,3,358
3963,825,617,20.619319727891156,22.407256235827663,14,18,222,2,208
3964,825,824,20.619319727891156,23.38249433106576,14,15,119,3,1
3965,824,479,23.38249433106576,24.752471655328797,15,17,350,1,345
3966,824,417,23.38249433106576,25.472290249433108,15,18,417,2,407
3967,824,817,23.38249433106576,25.58839002267574,15,18,95,2,7
3968,824,839,23.38249433106576,24.775691609977326,15,15,62,1,15
3969,824,841,23.38249433106576,25.472290249433108,15,16,92,2,17
3970,824,826,23.38249433106576,26.3546485260771,15,24,128,3,2
3971,839,522,24.775691609977326,26.424308390022677,15,31,325,2,317
3972,839,479,24.775691609977326,27.515646258503402,15,16,379,3,360
3973,839,684,24.775691609977326,26.424308390022677,15,26,170,2,155
3974,839,813,24.775691609977326,27.538866213151927,15,15,122,3,26
3975,839,826,24.775691609977326,26.3546485260771,15,24,69,2,13
3976,841,479,25.472290249433108,27.515646258503402,16,16,373,2,362
3977,841,813,25.472290249433108,27.538866213151927,16,15,93,2,28
3978,841,839,25.472290249433108,27.538866213151927,16,14,89,2,2
3979,826,479,26.3546485260771,27.515646258503402,24,16,351,1,347
3980,826,540,26.3546485260771,28.76952380952381,24,27,304,2,286
3981,826,813,26.3546485260771,27.538866213151927,24,15,53,1,13
3982,826,633,26.3546485260771,28.76952380952381,24,22,219,2,193
3983,826,839,26.3546485260771,27.538866213151927,24,14,53,1,13
3984,826,839,26.3546485260771,28.792743764172336,24,18,106,2,13
3985,839,540,27.538866213151927,28.76952380952381,14,27,304,1,299
3986,839,491,27.538866213151927,29.60544217687075,14,15,359,2,348
3987,839,524,27.538866213151927,30.48780045351474,14,32,340,3,315
3988,839,633,27.538866213151927,28.76952380952381,14,22,213,1,206
3989,839,812,27.538866213151927,30.511020408163265,14,23,131,3,27
3990,839,836,27.538866213151927,30.48780045351474,14,23,127,3,3
3991,839,524,28.792743764172336,30.48780045351474,18,32,323,2,315
3992,839,465,28.792743764172336,31.648798185941043,18,16,394,3,374
3993,839,812,28.792743764172336,30.511020408163265,18,23,79,2,27
3994,839,836,28.792743764172336,30.48780045351474,18,23,73,2,3
3995,839,824,28.792743764172336,31.67201814058957,18,14,125,3,15
3996,836,465,30.48780045351474,31.648798185941043,23,16,374,1,371
3997,836,452,30.48780045351474,32.3221768707483,23,19,392,2,384
3998,836,679,30.48780045351474,33.04199546485261,23,15,192,3,157
3999,836,824,30.48780045351474,31.67201814058957,23,14,52,1,12
4000,836,839,30.48780045351474,33.04199546485261,23,14,110,3,3
4001,824,347,31.67201814058957,34.59773242630386,14,30,493,3,477
4002,824,459,31.67201814058957,33.73859410430839,14,17,376,2,365
4003,824,679,31.67201814058957,33.04199546485261,14,15,157,1,145
4004,824,691,31.67201814058957,33.73859410430839,14,16,160,2,133
4005,824,819,31.67201814058957,34.62095238095238,14,21,127,3,5
4006,824,839,31.67201814058957,33.04199546485261,14,14,61,1,15
4007,824,888,31.67201814058957,34.644172335600906,14,26,143,3,64
4008,839,347,33.04199546485261,34.59773242630386,14,30,497,2,492
4009,839,414,33.04199546485261,34.66739229024943,14,25,431,2,425
4010,839,479,33.04199546485261,35.781950113378684,14,16,379,3,360
4011,839,819,33.04199546485261,34.62095238095238,14,21,71,2,20
4012,839,888,33.04199546485261,34.644172335600906,14,26,85,2,49
4013,888,479,34.644172335600906,35.781950113378684,26,16,412,1,409
4014,888,524,34.644172335600906,36.5946485260771,26,18,374,2,364
4015,888,467,34.644172335600906,37.17514739229025,26,15,435,3,421
4016,888,817,34.644172335600906,36.617868480725626,26,18,111,2,71
4017,888,839,34.644172335600906,35.80517006802721,26,14,70,1,49
4018,888,920,34.644172335600906,36.548208616780045,26,16,88,2,32
4019,839,386,35.80517006802721,37.871746031746035,14,20,462,2,453
4020,839,467,35.80517006802721,37.17514739229025,14,15,377,1,372
4021,920,483,36.548208616780045,39.07918367346939,16,24,450,3,437
4022,920,459,36.548208616780045,39.2649433106576,16,16,476,3,461
4023,920,808,36.548208616780045,39.07918367346939,16,18,156,3,112
4024,920,799,36.548208616780045,39.125623582766444,16,14,164,3,121
4025,920,865,36.548208616780045,39.07918367346939,16,22,122,3,55
4026,920,902,36.548208616780045,39.125623582766444,16,19,112,3,18
4027,865,476,39.07918367346939,40.61170068027211,22,15,395,2,389
4028,865,502,39.07918367346939,41.86557823129252,22,29,382,3,363
4029,865,661,39.07918367346939,41.35473922902494,22,25,226,2,204
4030,865,958,39.07918367346939,41.33151927437642,22,27,134,2,93
4031,902,476,39.125623582766444,40.61170068027211,19,15,431,1,426
4032,902,502,39.125623582766444,41.86557823129252,19,29,417,3,400
4033,902,661,39.125623582766444,41.35473922902494,19,25,259,2,241
4034,902,958,39.125623582766444,41.33151927437642,19,27,110,2,56
4035,958,476,41.33151927437642,42.79437641723356,27,26,486,1,482
4036,958,479,41.33151927437642,44.0714739229025,27,15,493,3,479
4037,958,674,41.33151927437642,42.74793650793651,27,16,290,1,284
4038,958,944,41.33151927437642,42.74793650793651,27,14,63,1,14
4039,944,479,42.74793650793651,44.0714739229025,14,15,468,1,465
4040,944,459,42.74793650793651,44.76807256235828,14,17,493,2,485
4041,944,553,42.74793650793651,45.65043083900227,14,26,410,3,391
4042,944,699,42.74793650793651,44.74485260770975,14,17,260,2,245
4043,944,628,42.74793650793651,45.60399092970522,14,23,339,3,316
4044,944,870,42.74793650793651,44.76807256235828,14,16,114,2,74
4045,944,943,42.74793650793651,45.58077097505669,14,27,122,3,1
4046,870,534,44.76807256235828,46.27736961451247,16,28,342,2,336
4047,870,511,44.76807256235828,47.484807256235825,16,19,378,3,359
4048,870,694,44.76807256235828,46.34702947845805,16,24,189,2,176
4049,870,704,44.76807256235828,47.438367346938776,16,23,202,3,166
4050,870,853,44.76807256235828,46.300589569161,16,23,68,2,17
4051,870,826,44.76807256235828,47.438367346938776,16,20,123,3,44
4052,943,511,45.58077097505669,47.484807256235825,27,19,440,2,432
4053,943,704,45.58077097505669,47.438367346938776,27,23,252,2,239
4054,943,813,45.58077097505669,48.39038548752835,27,14,178,3,130
4055,943,826,45.58077097505669,47.438367346938776,27,20,142,2,117
4056,943,887,45.58077097505669,48.41360544217687,27,18,134,3,56
4057,853,511,46.300589569161,47.484807256235825,23,19,346,1,342
4058,853,411,46.300589569161,48.48326530612245,23,18,452,2,442
4059,853,704,46.300589569161,47.438367346938776,23,23,157,1,149
4060,853,813,46.300589569161,48.39038548752835,23,14,98,2,40
4061,853,826,46.300589569161,47.438367346938776,23,20,56,1,27
4062,853,887,46.300589569161,48.41360544217687,23,18,97,2,34
4063,826,411,47.438367346938776,48.48326530612245,20,18,417,1,415
4064,826,490,47.438367346938776,50.108662131519274,20,26,355,3,336
4065,826,459,47.438367346938776,50.29442176870749,20,17,387,3,367
4066,826,818,47.438367346938776,50.108662131519274,20,19,115,3,8
4067,826,908,47.438367346938776,50.108662131519274,20,20,141,3,82
4068,826,875,47.438367346938776,50.178321995464856,20,14,128,3,49
4069,887,490,48.41360544217687,50.108662131519274,18,26,404,2,397
4070,887,459,48.41360544217687,50.29442176870749,18,17,436,2,428
4071,887,818,48.41360544217687,50.108662131519274,18,19,100,2,69
4072,887,908,48.41360544217687,50.108662131519274,18,20,76,2,21
4073,887,875,48.41360544217687,50.178321995464856,18,14,77,2,12
4074,908,545,50.108662131519274,51.66439909297052,20,14,369,2,363
4075,908,512,50.108662131519274,52.91827664399093,20,29,414,3,396
4076,908,674,50.108662131519274,52.407437641723355,20,29,254,2,234
4077,908,874,50.108662131519274,52.360997732426306,20,22,103,2,34
4078,875,545,50.178321995464856,51.66439909297052,14,14,336,1,330
4079,875,512,50.178321995464856,52.91827664399093,14,29,382,3,363
4080,875,674,50.178321995464856,52.407437641723355,14,29,223,2,201
4081,875,874,50.178321995464856,52.360997732426306,14,22,94,2,1
4082,874,457,52.360997732426306,53.75419501133787,22,18,421,1,417
4083,874,478,52.360997732426306,55.100952380952386,22,17,413,3,396
4084,874,809,52.360997732426306,53.75419501133787,22,16,88,1,65
4085,874,679,52.360997732426306,55.12417233560091,22,14,228,3,195
4086,874,932,52.360997732426306,53.777414965986395,22,17,84,1,58
4087,874,839,52.360997732426306,55.12417233560091,22,15,124,3,35
4088,932,478,53.777414965986395,55.100952380952386,17,17,458,1,454
4089,932,459,53.777414965986395,55.797551020408164,17,17,481,2,473
4090,932,614,53.777414965986395,56.65668934240363,17,24,341,3,318
4091,932,679,53.777414965986395,55.12417233560091,17,14,260,1,253
4092,932,816,53.777414965986395,55.797551020408164,17,14,145,2,116
4093,932,693,53.777414965986395,56.679909297052156,17,27,270,3,239
4094,932,839,53.777414965986395,55.12417233560091,17,15,110,1,93
4095,932,930,53.777414965986395,55.797551020408164,17,16,87,2,2
4096,932,838,53.777414965986395,56.65668934240363,17,25,156,3,94
4097,839,614,55.12417233560091,56.65668934240363,15,24,234,2,225
4098,839,521,55.12417233560091,57.399727891156466,15,30,333,2,318
4099,839,693,55.12417233560091,56.679909297052156,15,27,161,2,146
4100,839,819,55.12417233560091,57.446167800453516,15,25,102,2,20
4101,839,838,55.12417233560091,56.65668934240363,15,25,66,2,1
4102,839,887,55.12417233560091,57.30684807256236,15,27,106,2,48
4103,930,521,55.797551020408164,57.399727891156466,16,30,415,2,409
4104,930,551,55.797551020408164,58.537505668934244,16,22,397,3,379
4105,930,819,55.797551020408164,57.446167800453516,16,25,132,2,111
4106,930,705,55.797551020408164,58.51428571428571,16,22,254,3,225
4107,930,887,55.797551020408164,57.30684807256236,16,27,78,2,43
4108,930,875,55.797551020408164,58.51428571428571,16,19,129,3,55
4109,838,551,56.65668934240363,58.537505668934244,25,22,298,2,287
4110,838,418,56.65668934240363,59.396643990929704,25,20,436,3,420
4111,838,705,56.65668934240363,58.51428571428571,25,22,155,2,133
4112,838,819,56.65668934240363,59.55918367346939,25,17,126,3,19
4113,838,875,56.65668934240363,58.51428571428571,25,19,88,2,37
4114,838,847,56.65668934240363,59.582403628117916,25,17,126,3,9
4115,887,551,57.30684807256236,58.537505668934244,27,22,340,1,336
4116,887,418,57.30684807256236,59.396643990929704,27,20,478,2,469
4117,887,705,57.30684807256236,58.51428571428571,27,22,189,1,182
4118,887,819,57.30684807256236,59.55918367346939,27,17,118,2,68
4119,887,875,57.30684807256236,58.51428571428571,27,19,53,1,12
4120,887,847,57.30684807256236,59.582403628117916,27,17,106,2,40
4121,875,410,58.51428571428571,61.161360544217686,19,20,479,3,465
4122,875,416,58.51428571428571,61.37034013605442,19,20,475,3,459
4123,875,819,58.51428571428571,59.55918367346939,19,17,72,1,56
4124,875,722,58.51428571428571,60.65052154195011,19,14,179,2,153
4125,875,783,58.51428571428571,61.30068027210884,19,22,151,3,92
4126,875,847,58.51428571428571,59.582403628117916,19,17,54,1,28
4127,875,839,58.51428571428571,60.62730158730159,19,15,98,2,36
4128,875,824,58.51428571428571,61.30068027210884,19,26,130,3,51
4129,847,410,59.582403628117916,61.161360544217686,17,20,442,2,437
4130,847,416,59.582403628117916,61.37034013605442,17,20,438,2,431
4131,847,475,59.582403628117916,62.415238095238095,17,22,391,3,372
4132,847,722,59.582403628117916,60.65052154195011,17,14,133,1,125
4133,847,783,59.582403628117916,61.30068027210884,17,22,98,2,64
4134,847,839,59.582403628117916,60.62730158730159,17,15,46,1,8
4135,847,824,59.582403628117916,61.30068027210884,17,26,77,2,23
4136,847,934,59.582403628117916,62.39201814058957,17,21,149,3,87
4137,839,475,60.62730158730159,62.415238095238095,15,22,372,2,364
4138,839,727,60.62730158730159,62.71709750566894,15,16,144,2,112
4139,839,934,60.62730158730159,62.39201814058957,15,21,122,2,95
4140,824,475,61.30068027210884,62.415238095238095,26,22,352,1,349
4141,824,547,61.30068027210884,64.04063492063493,26,24,301,3,277
4142,824,727,61.30068027210884,62.71709750566894,26,16,115,1,97
4143,824,657,61.30068027210884,63.99419501133787,26,22,203,3,167
4144,824,934,61.30068027210884,62.39201814058957,26,21,120,1,110
4145,824,896,61.30068027210884,64.01741496598639,26,22,137,3,72
4146,934,547,62.39201814058957,64.04063492063493,21,24,393,2,387
4147,934,603,62.39201814058957,64.52825396825396,21,15,344,2,331
4148,934,657,62.39201814058957,63.99419501133787,21,22,285,2,277
4149,934,896,62.39201814058957,64.01741496598639,21,22,80,2,38
4150,934,824,62.39201814058957,64.76045351473923,21,15,150,2,110
4151,896,436,64.01741496598639,65.38739229024944,22,19,464,1,460
4152,896,459,64.01741496598639,66.85024943310658,22,16,454,3,437
4153,896,813,64.01741496598639,66.1536507936508,22,15,124,2,83
4154,896,941,64.01741496598639,65.52671201814059,22,14,79,2,45
4155,896,899,64.01741496598639,66.82702947845804,22,15,121,3,3
4156,824,459,64.76045351473923,66.85024943310658,15,16,376,2,365
4157,824,553,64.76045351473923,67.73260770975057,15,27,300,3,271
4158,824,813,64.76045351473923,66.1536507936508,15,15,61,1,11
4159,824,679,64.76045351473923,67.68616780045352,15,26,192,3,145
4160,824,899,64.76045351473923,66.82702947845804,15,15,116,2,75
4161,824,822,64.76045351473923,67.68616780045352,15,24,126,3,2
4162,941,459,65.52671201814059,66.85024943310658,14,16,485,1,482
4163,941,553,65.52671201814059,67.73260770975057,14,27,399,2,388
4164,941,679,65.52671201814059,67.68616780045352,14,26,278,2,262
4165,941,621,65.52671201814059,68.35954648526078,14,25,342,3,320
4166,941,899,65.52671201814059,66.82702947845804,14,15,70,1,42
4167,941,822,65.52671201814059,67.68616780045352,14,24,151,2,119
4168,941,843,65.52671201814059,68.35954648526078,14,26,156,3,98
4169,899,425,66.82702947845804,68.94004535147393,15,28,483,2,474
4170,899,621,66.82702947845804,68.35954648526078,15,25,286,2,278
4171,899,843,66.82702947845804,68.35954648526078,15,26,87,2,56
4172,822,346,67.68616780045352,68.94004535147393,24,26,479,1,476
4173,822,425,67.68616780045352,68.94004535147393,24,28,401,1,397
4174,822,555,67.68616780045352,70.14748299319729,24,28,287,2,267
4175,822,525,67.68616780045352,70.58866213151927,24,18,322,3,297
4176,822,630,67.68616780045352,70.12426303854875,24,22,219,2,192
4177,822,621,67.68616780045352,70.54222222222222,24,16,236,3,201
4178,822,830,67.68616780045352,70.12426303854875,24,23,105,2,8
4179,822,959,67.68616780045352,70.56544217687075,24,25,185,3,137
4180,843,555,68.35954648526078,70.14748299319729,26,28,298,2,288
4181,843,525,68.35954648526078,70.58866213151927,26,18,332,2,318
4182,843,630,68.35954648526078,70.12426303854875,26,22,226,2,213
4183,843,621,68.35954648526078,70.54222222222222,26,16,241,2,222
4184,843,830,68.35954648526078,70.12426303854875,26,23,77,2,13
4185,843,959,68.35954648526078,70.56544217687075,26,25,150,2,116
4186,830,459,70.12426303854875,72.35337868480725,23,19,383,2,371
4187,830,625,70.12426303854875,72.05151927437642,23,14,221,2,205
4188,830,737,70.12426303854875,73.07319727891156,23,15,157,3,93
4189,959,625,70.56544217687075,72.05151927437642,25,14,340,1,334
4190,959,737,70.56544217687075,73.07319727891156,25,15,247,3,222
4191,852,479,75.3255328798186,77.15990929705215,21,18,381,2,373
4192,852,459,75.3255328798186,77.87972789115646,21,19,408,3,393
4193,852,839,75.3255328798186,77.18312925170068,21,16,81,2,13
4194,839,508,77.18312925170068,78.46022675736961,16,23,336,1,331
4195,839,429,77.18312925170068,79.94630385487528,16,17,427,3,410
4196,839,658,77.18312925170068,78.55310657596372,16,17,190,1,181
4197,839,813,77.18312925170068,79.94630385487528,16,14,122,3,26
4198,839,824,77.18312925170068,78.55310657596372,16,14,61,1,15
4199,824,429,78.55310657596372,79.94630385487528,14,17,400,1,395
4200,824,524,78.55310657596372,80.73578231292517,14,18,314,2,300
4201,824,498,78.55310657596372,81.31628117913833,14,16,347,3,326
4202,824,813,78.55310657596372,79.94630385487528,14,14,61,1,11
4203,824,817,78.55310657596372,80.75900226757369,14,18,95,2,7
4204,824,839,78.55310657596372,79.94630385487528,14,14,62,1,15
4205,824,831,78.55310657596372,80.66612244897959,14,15,91,2,7
4206,839,498,79.94630385487528,81.31628117913833,14,16,346,1,341
4207,839,479,79.94630385487528,82.68625850340136,14,18,379,3,360
4208,839,813,79.94630385487528,82.70947845804989,14,13,122,3,26
4209,831,479,80.66612244897959,82.68625850340136,15,18,363,2,352
4210,831,813,80.66612244897959,82.70947845804989,15,13,90,2,18
4211,887,459,84.14911564625851,86.14603174603175,24,18,437,2,428
4212,887,517,84.14911564625851,87.07482993197279,24,30,391,3,370
4213,887,679,84.14911564625851,85.44943310657597,24,14,215,1,208
4214,887,653,84.14911564625851,86.6336507936508,24,16,257,2,234
4215,887,905,84.14911564625851,85.44943310657597,24,15,59,1,18
4216,887,944,84.14911564625851,86.61043083900226,24,17,120,2,57
4217,905,517,85.44943310657597,87.07482993197279,15,30,394,2,388
4218,905,478,85.44943310657597,88.21260770975057,15,17,443,3,427
4219,905,653,85.44943310657597,86.6336507936508,15,16,257,1,252
4220,905,813,85.44943310657597,88.2358276643991,15,15,151,3,92
4221,905,944,85.44943310657597,86.61043083900226,15,17,63,1,39
4222,944,478,86.61043083900226,88.21260770975057,17,17,471,2,466
4223,944,469,86.61043083900226,88.65378684807257,17,33,483,2,475
4224,944,813,86.61043083900226,88.2358276643991,17,15,149,2,131
4225,944,799,86.61043083900226,88.6770068027211,17,20,170,2,145
4226,944,896,86.61043083900226,88.6770068027211,17,25,101,2,48
4227,896,478,88.6770068027211,90.62748299319728,25,18,426,2,418
4228,896,839,88.6770068027211,91.16154195011337,25,14,121,2,57
4229,892,524,89.65224489795918,91.76526077097506,19,17,379,2,368
4230,892,468,89.65224489795918,92.34575963718821,19,15,440,3,424
4231,892,817,89.65224489795918,91.78848072562359,19,16,119,2,75
4232,892,839,89.65224489795918,91.16154195011337,19,14,84,2,53
4233,892,920,89.65224489795918,91.71882086167801,19,14,93,2,28
4234,839,468,91.16154195011337,92.34575963718821,14,15,374,1,371
4235,920,458,91.71882086167801,94.24979591836735,14,25,475,3,462
4236,920,459,91.71882086167801,94.43555555555555,14,17,476,3,461
4237,920,816,91.71882086167801,94.2962358276644,14,15,152,3,104
4238,920,902,91.71882086167801,94.27301587301588,14,22,111,3,18
4239,902,545,94.27301587301588,95.8055328798186,22,15,363,2,357
4240,902,502,94.27301587301588,97.03619047619048,22,29,417,3,400
4241,902,810,94.27301587301588,96.15383219954649,22,16,123,2,92
4242,902,672,94.27301587301588,96.52535147392291,22,26,250,2,230
4243,902,932,94.27301587301588,96.47891156462585,22,23,100,2,30
4244,932,481,96.47891156462585,97.94176870748299,23,21,455,1,451
4245,932,479,96.47891156462585,99.24208616780045,23,16,468,3,453
4246,932,684,96.47891156462585,97.89532879818594,23,16,255,1,248
4247,932,873,96.47891156462585,97.91854875283447,23,14,86,1,59
4248,932,934,96.47891156462585,99.24208616780045,23,13,119,3,2
4249,873,479,97.91854875283447,99.24208616780045,14,16,398,1,394
4250,873,459,97.91854875283447,99.93868480725624,14,16,423,2,414
4251,873,499,97.91854875283447,100.7978231292517,14,26,394,3,374
4252,873,664,97.91854875283447,100.77460317460317,14,28,243,3,209
4253,873,934,97.91854875283447,99.24208616780045,14,13,83,1,61
4254,873,917,97.91854875283447,99.96190476190476,14,15,98,2,44
4255,873,944,97.91854875283447,100.7978231292517,14,23,143,3,71
4256,934,499,99.24208616780045,100.7978231292517,13,26,440,2,435
4257,934,523,99.24208616780045,101.51764172335601,13,28,423,2,411
4258,934,664,99.24208616780045,100.77460317460317,13,28,278,2,270
4259,934,657,99.24208616780045,101.42476190476191,13,25,293,2,277
4260,934,944,99.24208616780045,100.7978231292517,13,23,68,2,10
4261,934,946,99.24208616780045,101.49442176870748,13,24,98,2,12
4262,917,523,99.96190476190476,101.51764172335601,15,28,400,2,394
4263,917,506,99.96190476190476,102.63219954648527,15,24,427,3,411
4264,917,657,99.96190476190476,101.42476190476191,15,25,268,1,260
4265,917,702,99.96190476190476,102.63219954648527,15,20,244,3,215
4266,917,946,99.96190476190476,101.49442176870748,15,24,72,2,29
4267,917,935,99.96190476190476,102.60897959183674,15,20,115,3,18
4268,944,506,100.7978231292517,102.63219954648527,23,24,445,2,438
4269,944,468,100.7978231292517,103.65387755102041,23,17,492,3,476
4270,944,702,100.7978231292517,102.63219954648527,23,20,255,2,242
4271,944,808,100.7978231292517,103.5609977324263,23,15,181,3,136
4272,944,935,100.7978231292517,102.60897959183674,23,20,79,2,9
4273,944,925,100.7978231292517,103.5609977324263,23,15,121,3,19
4274,946,506,101.49442176870748,102.63219954648527,24,24,443,1,440
4275,946,468,101.49442176870748,103.65387755102041,24,17,487,2,478
4276,946,702,101.49442176870748,102.63219954648527,24,20,249,1,244
4277,946,808,101.49442176870748,103.5609977324263,24,15,164,2,138
4278,946,935,101.49442176870748,102.60897959183674,24,20,49,1,11
4279,946,925,101.49442176870748,103.5609977324263,24,15,91,2,21
4280,935,468,102.60897959183674,103.65387755102041,20,17,469,1,467
4281,935,474,102.60897959183674,105.30249433106576,20,24,475,3,461
4282,935,459,102.60897959183674,105.46503401360545,20,18,492,3,476
4283,935,672,102.60897959183674,105.30249433106576,20,16,287,3,263
4284,935,927,102.60897959183674,105.27927437641723,20,20,115,3,8
4285,925,474,103.5609977324263,105.30249433106576,15,24,457,2,451
4286,925,459,103.5609977324263,105.46503401360545,15,18,473,2,466
4287,925,672,103.5609977324263,105.30249433106576,15,16,264,2,253
4288,925,927,103.5609977324263,105.27927437641723,15,20,74,2,2
4289,927,507,105.27927437641723,108.06566893424036,20,29,437,3,420
4290,927,620,105.27927437641723,107.2065306122449,20,15,318,2,307
4291,927,674,105.27927437641723,107.55482993197279,20,30,271,2,253
4292,927,891,105.27927437641723,107.34585034013605,20,14,96,2,36
4293,927,822,105.27927437641723,107.55482993197279,20,22,144,2,105
4294,891,460,107.34585034013605,108.92480725623582,14,22,436,2,431
4295,891,456,107.34585034013605,110.27156462585035,14,16,453,3,435
4296,891,810,107.34585034013605,108.92480725623582,14,14,106,2,81
4297,891,625,107.34585034013605,110.27156462585035,14,15,294,3,266
4298,891,912,107.34585034013605,108.94802721088436,14,15,72,2,21
4299,822,460,107.55482993197279,108.92480725623582,22,22,367,1,362
4300,822,456,107.55482993197279,110.27156462585035,22,16,384,3,366
4301,822,810,107.55482993197279,108.92480725623582,22,14,60,1,12
4302,822,625,107.55482993197279,110.27156462585035,22,15,229,3,197
4303,822,912,107.55482993197279,108.94802721088436,22,15,108,1,90
4304,912,456,108.94802721088436,110.27156462585035,15,16,460,1,456
4305,912,459,108.94802721088436,110.96816326530613,15,16,461,2,453
4306,912,606,108.94802721088436,111.85052154195012,15,28,331,3,306
4307,912,625,108.94802721088436,110.27156462585035,15,15,293,1,287
4308,912,812,108.94802721088436,110.92172335600907,15,15,131,2,100
4309,912,693,108.94802721088436,111.85052154195012,15,27,252,3,219
4310,912,958,108.94802721088436,110.89850340136054,15,15,96,2,46
4311,912,870,108.94802721088436,111.82730158730159,15,27,131,3,42
4312,958,516,110.89850340136054,112.59356009070295,15,29,448,2,442
4313,958,523,110.89850340136054,113.66167800453515,15,20,451,3,435
4314,958,817,110.89850340136054,112.50068027210885,15,24,157,2,141
4315,958,694,110.89850340136054,113.68489795918367,15,21,290,3,264
4316,958,876,110.89850340136054,112.5471201814059,15,24,108,2,82
4317,958,943,110.89850340136054,113.7081179138322,15,19,122,3,15
4318,870,523,111.82730158730159,113.66167800453515,27,20,356,2,347
4319,870,418,111.82730158730159,114.56725623582767,27,20,467,3,452
4320,870,694,111.82730158730159,113.68489795918367,27,21,193,2,176
4321,870,943,111.82730158730159,113.7081179138322,27,19,109,2,73
4322,870,826,111.82730158730159,114.72979591836734,27,16,133,3,44
4323,876,523,112.5471201814059,113.66167800453515,24,20,356,1,353
4324,876,418,112.5471201814059,114.56725623582767,24,20,466,2,458
4325,876,694,112.5471201814059,113.68489795918367,24,21,188,1,182
4326,876,727,112.5471201814059,115.1245351473923,24,16,186,3,149
4327,876,943,112.5471201814059,113.7081179138322,24,19,84,1,67
4328,876,826,112.5471201814059,114.72979591836734,24,16,106,2,50
4329,943,561,113.7081179138322,116.44807256235828,19,20,400,3,382
4330,943,727,113.7081179138322,115.1245351473923,19,16,224,1,216
4331,943,624,113.7081179138322,115.79791383219955,19,14,331,2,319
4332,943,815,113.7081179138322,116.4712925170068,19,23,175,3,128
4333,943,826,113.7081179138322,114.72979591836734,19,16,125,1,117
4334,943,924,113.7081179138322,116.40163265306123,19,17,118,3,19
4335,943,929,113.7081179138322,116.4712925170068,19,23,120,3,14
4336,826,410,114.72979591836734,116.33197278911565,16,19,422,2,416
4337,826,561,114.72979591836734,116.44807256235828,16,20,275,2,265
4338,826,480,114.72979591836734,117.58585034013606,16,23,367,3,346
4339,826,624,114.72979591836734,115.79791383219955,16,14,207,1,202
4340,826,815,114.72979591836734,116.4712925170068,16,23,76,2,11
4341,826,654,114.72979591836734,117.58585034013606,16,18,211,3,172
4342,826,924,114.72979591836734,116.40163265306123,16,17,122,2,98
4343,826,929,114.72979591836734,116.4712925170068,16,23,127,2,103
4344,826,936,114.72979591836734,117.56263038548754,16,22,164,3,110
4345,924,480,116.40163265306123,117.58585034013606,17,23,447,1,444
4346,924,562,116.40163265306123,119.16480725623583,17,23,381,3,362
4347,924,654,116.40163265306123,117.58585034013606,17,18,275,1,270
4348,924,701,116.40163265306123,119.16480725623583,17,22,253,3,223
4349,924,936,116.40163265306123,117.56263038548754,17,22,51,1,12
4350,924,936,116.40163265306123,119.18802721088436,17,23,121,3,12
4351,929,480,116.4712925170068,117.58585034013606,23,23,452,1,449
4352,929,562,116.4712925170068,119.16480725623583,23,23,385,3,367
4353,929,654,116.4712925170068,117.58585034013606,23,18,279,1,275
4354,929,701,116.4712925170068,119.16480725623583,23,22,256,3,228
4355,929,936,116.4712925170068,117.56263038548754,23,22,48,1,7
4356,929,936,116.4712925170068,119.18802721088436,23,23,117,3,7
4357,936,562,117.56263038548754,119.16480725623583,22,23,380,2,374
4358,936,603,117.56263038548754,119.69886621315193,22,16,345,2,333
4359,936,701,117.56263038548754,119.16480725623583,22,22,245,2,235
4360,936,459,119.18802721088436,122.02086167800454,23,17,492,3,477
4361,936,817,119.18802721088436,121.34748299319727,23,13,151,2,119
4362,936,815,119.18802721088436,121.99764172335601,23,15,171,3,121
4363,936,842,119.18802721088436,120.55800453514739,23,15,111,1,94
4364,936,918,119.18802721088436,122.02086167800454,23,15,123,3,18
4365,842,459,120.55800453514739,122.02086167800454,15,17,388,1,383
4366,842,560,120.55800453514739,122.88,15,27,299,2,282
4367,842,815,120.55800453514739,121.99764172335601,15,15,68,1,27
4368,842,679,120.55800453514739,122.85678004535147,15,26,191,2,163
4369,842,621,120.55800453514739,123.53015873015873,15,25,255,3,221
4370,842,918,120.55800453514739,122.02086167800454,15,15,99,1,76
4371,842,836,120.55800453514739,122.83356009070295,15,25,98,2,6
4372,842,898,120.55800453514739,123.53015873015873,15,26,140,3,56
4373,918,425,122.02086167800454,124.11065759637188,15,28,501,2,493
4374,918,436,122.02086167800454,124.9233560090703,15,16,498,3,482
4375,918,621,122.02086167800454,123.53015873015873,15,25,304,2,297
4376,918,817,122.02086167800454,124.90013605442176,15,18,160,3,101
4377,918,898,122.02086167800454,123.53015873015873,15,26,68,2,20
4378,918,857,122.02086167800454,124.90013605442176,15,14,138,3,61
4379,836,346,122.83356009070295,124.11065759637188,25,26,493,1,490
4380,836,425,122.83356009070295,124.11065759637188,25,28,415,1,411
4381,836,436,122.83356009070295,124.9233560090703,25,16,410,2,400
4382,836,468,122.83356009070295,125.4574149659864,25,17,385,3,368
4383,836,817,122.83356009070295,124.90013605442176,25,18,91,2,19
4384,836,857,122.83356009070295,124.90013605442176,25,14,91,2,21
4385,898,436,123.53015873015873,124.9233560090703,26,16,466,1,462
4386,898,468,123.53015873015873,125.4574149659864,26,17,438,2,430
4387,898,817,123.53015873015873,124.90013605442176,26,18,100,1,81
4388,898,857,123.53015873015873,124.90013605442176,26,14,72,1,41
4389,857,530,124.90013605442176,126.75773242630386,14,23,337,2,327
4390,857,459,124.90013605442176,127.52399092970522,14,19,414,3,398
4391,857,813,124.90013605442176,126.85061224489796,14,14,95,2,44
4392,857,691,124.90013605442176,127.52399092970522,14,14,201,3,166
4393,857,839,124.90013605442176,126.85061224489796,14,16,86,2,18
4394,839,526,126.85061224489796,128.4760090702948,16,20,321,2,313
4395,839,801,126.85061224489796,128.91718820861678,16,14,97,2,38
4396,839,824,126.85061224489796,128.220589569161,16,15,61,1,15
4397,824,459,128.220589569161,130.2871655328798,15,19,376,2,365
4398,824,493,128.220589569161,130.96054421768707,15,16,351,3,331
4399,824,691,128.220589569161,130.2871655328798,15,15,160,2,133
4400,839,532,132.35374149659864,134.002358276644,14,18,315,2,307
4401,839,429,132.35374149659864,135.11691609977325,14,17,427,3,410
4402,839,641,132.35374149659864,133.72371882086168,14,14,207,1,198
4403,839,824,132.35374149659864,133.74693877551022,14,14,62,1,15
4404,824,429,133.74693877551022,135.11691609977325,14,17,399,1,395
4405,824,524,133.74693877551022,135.90639455782312,14,17,314,2,300
4406,824,684,133.74693877551022,135.8831746031746,14,16,168,2,140
4407,824,839,133.74693877551022,135.11691609977325,14,15,61,1,15
4408,824,823,133.74693877551022,136.02249433106576,14,14,98,2,1
4409,839,462,135.11691609977325,137.32281179138323,15,14,389,2,377
4410,839,563,135.11691609977325,137.69433106575963,15,18,297,3,276
4411,839,689,135.11691609977325,137.76399092970522,15,15,188,3,150
4412,823,462,136.02249433106576,137.32281179138323,14,14,365,1,361
4413,823,563,136.02249433106576,137.69433106575963,14,18,270,2,260
4414,823,689,136.02249433106576,137.76399092970522,14,15,154,2,134
4415,823,929,136.02249433106576,138.901768707483,14,16,163,3,106
4416,929,442,138.901768707483,140.29496598639457,16,21,491,1,487
4417,929,446,138.901768707483,140.9683446712018,16,22,491,2,483
4418,929,693,138.901768707483,141.38630385487528,16,15,259,2,236
4419,929,841,138.901768707483,140.43428571428572,16,14,110,2,88
4420,929,903,138.901768707483,141.40952380952382,16,14,111,3,26
4421,841,411,140.43428571428572,141.96680272108844,14,21,435,2,430
4422,841,678,140.43428571428572,142.15256235827664,14,17,179,2,163
4423,841,678,140.43428571428572,142.84916099773244,14,17,193,2,163
4424,841,896,140.43428571428572,142.29188208616782,14,17,97,2,55
4425,841,903,140.43428571428572,142.84916099773244,14,17,121,2,62
4426,903,578,141.40952380952382,143.49931972789116,14,18,337,2,325
4427,903,557,141.40952380952382,144.01015873015874,14,20,364,3,346
4428,903,678,141.40952380952382,142.84916099773244,14,17,233,1,225
4429,903,733,141.40952380952382,144.01015873015874,14,25,204,3,170
4430,903,848,141.40952380952382,144.01015873015874,14,16,125,3,55
4431,896,578,142.29188208616782,143.49931972789116,17,18,322,1,318
4432,896,557,142.29188208616782,144.01015873015874,17,20,347,2,339
4433,896,733,142.29188208616782,144.01015873015874,17,25,179,2,163
4434,896,848,142.29188208616782,144.01015873015874,17,16,88,2,48
4435,903,557,142.84916099773244,144.01015873015874,17,20,350,1,346
4436,903,420,142.84916099773244,145.35691609977326,17,26,495,3,483
4437,903,733,142.84916099773244,144.01015873015874,17,25,177,1,170
4438,903,699,142.84916099773244,145.47301587301587,17,17,233,3,204
4439,903,848,142.84916099773244,144.01015873015874,17,16,74,1,55
4440,903,892,142.84916099773244,145.4962358276644,17,24,115,3,11
4441,848,420,144.01015873015874,145.35691609977326,16,26,432,1,428
4442,848,446,144.01015873015874,146.49469387755101,16,22,416,2,402
4443,848,699,144.01015873015874,145.47301587301587,16,17,162,1,149
4444,848,659,144.01015873015874,146.4714739229025,16,17,217,2,189
4445,848,892,144.01015873015874,145.4962358276644,16,24,78,1,44
4446,848,839,144.01015873015874,146.14639455782313,16,14,92,2,9
4447,848,820,144.01015873015874,146.8429931972789,16,16,125,3,28
4448,892,410,145.4962358276644,147.35383219954647,24,25,489,2,482
4449,892,419,145.4962358276644,147.5395918367347,24,28,481,2,473
4450,892,616,145.4962358276644,147.33061224489796,24,17,287,2,276
4451,892,700,145.4962358276644,148.3522902494331,24,27,228,3,192
4452,892,820,145.4962358276644,146.8429931972789,24,16,92,1,72
4453,892,827,145.4962358276644,148.3522902494331,24,23,139,3,65
4454,839,410,146.14639455782313,147.35383219954647,14,25,432,1,429
4455,839,419,146.14639455782313,147.5395918367347,14,28,424,1,420
4456,839,411,146.14639455782313,149.11854875283447,14,25,447,3,428
4457,839,616,146.14639455782313,147.33061224489796,14,17,229,1,223
4458,839,700,146.14639455782313,148.3522902494331,14,27,168,2,139
4459,839,649,146.14639455782313,148.63092970521544,14,20,218,2,190
4460,839,827,146.14639455782313,148.3522902494331,14,23,96,2,12
4461,839,838,146.14639455782313,148.95600907029478,14,16,121,3,1
4462,820,411,146.8429931972789,149.11854875283447,16,25,421,2,409
4463,820,514,146.8429931972789,149.582947845805,16,21,328,3,306
4464,820,700,146.8429931972789,148.3522902494331,16,27,136,2,120
4465,820,649,146.8429931972789,148.63092970521544,16,20,188,2,171
4466,820,638,146.8429931972789,149.55972789115646,16,21,216,3,182
4467,820,827,146.8429931972789,148.3522902494331,16,23,65,2,7
4468,820,838,146.8429931972789,148.95600907029478,16,16,93,2,18
4469,820,894,146.8429931972789,149.55972789115646,16,18,138,3,74
4470,827,514,148.3522902494331,149.582947845805,23,21,317,1,313
4471,827,442,148.3522902494331,151.32444444444445,23,21,406,3,385
4472,827,638,148.3522902494331,149.55972789115646,23,21,196,1,189
4473,827,678,148.3522902494331,151.11546485260772,23,17,191,3,149
4474,827,894,148.3522902494331,149.55972789115646,23,18,85,1,67
4475,827,846,148.3522902494331,151.13868480725623,23,14,121,3,19
4476,838,442,148.95600907029478,151.32444444444445,16,21,409,2,396
4477,838,678,148.95600907029478,151.11546485260772,16,17,185,2,160
4478,838,846,148.95600907029478,151.13868480725623,16,14,94,2,8
4479,838,848,148.95600907029478,151.67274376417234,16,16,117,3,10
4480,894,442,149.55972789115646,151.32444444444445,18,21,458,2,452
4481,894,417,149.55972789115646,152.20680272108845,18,23,490,3,477
4482,894,678,149.55972789115646,151.11546485260772,18,17,226,2,216
4483,894,669,149.55972789115646,152.29968253968255,18,20,254,3,225
4484,894,846,149.55972789115646,151.13868480725623,18,14,83,2,48
4485,894,848,149.55972789115646,151.67274376417234,18,16,102,2,46
4486,846,417,151.13868480725623,152.20680272108845,14,23,431,1,429
4487,846,596,151.13868480725623,153.18204081632652,14,23,265,2,250
4488,846,442,151.13868480725623,154.08761904761906,14,17,423,3,404
4489,846,669,151.13868480725623,152.29968253968255,14,20,184,1,177
4490,846,620,151.13868480725623,153.18204081632652,14,18,243,2,226
4491,846,693,151.13868480725623,153.87863945578232,14,15,193,3,153
4492,846,946,151.13868480725623,153.4374603174603,14,16,141,2,100
4493,848,596,151.67274376417234,153.18204081632652,16,23,260,2,252
4494,848,442,151.67274376417234,154.08761904761906,16,17,419,2,406
4495,848,620,151.67274376417234,153.18204081632652,16,18,237,2,228
4496,848,693,151.67274376417234,153.87863945578232,16,15,182,2,155
4497,848,946,151.67274376417234,153.4374603174603,16,16,124,2,98
4498,946,645,153.4374603174603,155.06285714285715,16,18,309,2,301
4499,946,789,153.4374603174603,156.2702947845805,16,16,199,3,157
4500,946,912,153.4374603174603,155.06285714285715,16,15,78,2,34
4501,912,425,155.06285714285715,156.38639455782314,15,25,490,1,487
4502,912,429,155.06285714285715,157.52417233560092,15,18,494,2,483
4503,912,458,155.06285714285715,157.8724716553288,15,18,470,3,454
4504,912,789,155.06285714285715,156.2702947845805,15,16,134,1,123
4505,912,631,155.06285714285715,157.2455328798186,15,14,296,2,281
4506,912,750,155.06285714285715,157.84925170068027,15,14,202,3,162
4507,912,861,155.06285714285715,156.5257142857143,15,16,81,1,51
4508,912,839,155.06285714285715,157.52417233560092,15,14,129,2,73
4509,861,458,156.5257142857143,157.8724716553288,16,18,407,1,403
4510,861,463,156.5257142857143,159.381768707483,16,14,417,3,398
4511,861,750,156.5257142857143,157.84925170068027,16,14,125,1,111
4512,839,463,157.52417233560092,159.381768707483,14,14,384,2,376
4513,839,488,157.52417233560092,160.24090702947845,14,19,370,3,351
