,f0,f1,t0,t1,dB0,dB1,dist,utime,ufreq
0,18,19,0.7662585034013606,2.7399546485260773,45,43,85,2,1
1,18,293,0.7662585034013606,2.7631746031746034,45,17,288,2,275
2,18,306,0.7662585034013606,3.3668934240362813,45,19,309,3,288
3,18,446,0.7662585034013606,2.670294784580499,45,19,436,2,428
4,18,444,0.7662585034013606,3.3668934240362813,45,18,440,3,426
5,35,19,1.6021768707482993,2.7399546485260773,42,43,52,1,16
6,35,18,1.6021768707482993,3.4133333333333336,42,42,80,2,17
7,35,34,1.6021768707482993,4.272471655328799,42,43,115,3,1
8,35,293,1.6021768707482993,2.7631746031746034,42,17,263,1,258
9,35,306,1.6021768707482993,3.3668934240362813,42,19,281,2,271
10,35,446,1.6021768707482993,2.670294784580499,42,19,414,1,411
11,35,444,1.6021768707482993,3.3668934240362813,42,18,416,2,409
12,35,427,1.6021768707482993,4.040272108843538,42,20,406,2,392
13,19,34,2.7399546485260773,4.272471655328799,43,43,68,2,15
14,19,28,2.7399546485260773,5.596009070294785,43,45,123,3,9
15,19,297,2.7399546485260773,4.713650793650793,43,16,291,2,278
16,19,210,2.7399546485260773,5.410249433106576,43,29,223,3,191
17,19,427,2.7399546485260773,4.040272108843538,43,20,412,1,408
18,19,427,2.7399546485260773,5.38702947845805,43,22,424,3,408
19,18,28,3.4133333333333336,5.596009070294785,42,45,95,2,10
20,18,297,3.4133333333333336,4.713650793650793,42,16,285,1,279
21,18,210,3.4133333333333336,5.410249433106576,42,29,210,2,192
22,18,274,3.4133333333333336,6.130068027210885,42,23,281,3,256
23,18,427,3.4133333333333336,5.38702947845805,42,22,418,2,409
24,34,28,4.272471655328799,5.596009070294785,43,45,57,1,6
25,34,61,4.272471655328799,6.524807256235828,43,43,101,2,27
26,34,210,4.272471655328799,5.410249433106576,43,29,183,1,176
27,34,274,4.272471655328799,6.130068027210885,43,23,253,2,240
28,34,427,4.272471655328799,5.38702947845805,43,22,396,1,393
29,28,61,5.596009070294785,7.500045351473923,45,44,88,2,33
30,28,281,5.596009070294785,7.801904761904762,45,32,270,2,253
31,28,217,5.596009070294785,8.52172335600907,45,35,227,3,189
32,28,414,5.596009070294785,7.430385487528345,45,17,394,2,386
33,61,31,6.524807256235828,8.70748299319728,43,44,99,2,30
34,61,18,6.524807256235828,9.47374149659864,43,44,134,3,43
35,61,281,6.524807256235828,7.801904761904762,43,32,227,1,220
36,61,217,6.524807256235828,8.52172335600907,43,35,178,2,156
37,61,342,6.524807256235828,9.427301587301587,43,19,308,3,281
38,61,531,6.524807256235828,8.150204081632653,43,23,475,2,470
39,61,445,6.524807256235828,9.427301587301587,43,20,404,3,384
40,61,31,7.500045351473923,8.70748299319728,44,44,60,1,30
41,61,18,7.500045351473923,9.47374149659864,44,44,95,2,43
42,61,217,7.500045351473923,8.52172335600907,44,35,162,1,156
43,61,342,7.500045351473923,9.427301587301587,44,19,293,2,281
44,61,445,7.500045351473923,9.427301587301587,44,20,393,2,384
45,31,82,8.70748299319728,10.797278911564627,44,43,103,2,51
46,31,61,8.70748299319728,11.261678004535147,44,46,114,3,30
47,31,395,8.70748299319728,10.95981859410431,44,23,377,2,364
48,31,292,8.70748299319728,11.052698412698414,44,24,280,2,261
49,31,505,8.70748299319728,10.95981859410431,44,26,484,2,474
50,31,443,8.70748299319728,11.470657596371883,44,18,429,3,412
51,18,82,9.47374149659864,10.797278911564627,44,43,86,1,64
52,18,61,9.47374149659864,11.261678004535147,44,46,88,2,43
53,18,20,9.47374149659864,12.283356009070294,44,43,121,3,2
54,18,395,9.47374149659864,10.95981859410431,44,23,382,1,377
55,18,292,9.47374149659864,11.052698412698414,44,24,282,2,274
56,18,505,9.47374149659864,10.95981859410431,44,26,491,1,487
57,18,443,9.47374149659864,11.470657596371883,44,18,434,2,425
58,18,427,9.47374149659864,12.120816326530612,44,20,425,3,409
59,82,20,10.797278911564627,12.283356009070294,43,43,89,1,62
60,82,18,10.797278911564627,13.514013605442177,43,45,133,3,64
61,82,219,10.797278911564627,12.84063492063492,43,16,163,2,137
62,82,268,10.797278911564627,13.746213151927439,43,22,225,3,186
63,82,427,10.797278911564627,12.120816326530612,43,20,350,1,345
64,82,541,10.797278911564627,13.467573696145125,43,23,473,3,459
65,61,20,11.261678004535147,12.283356009070294,46,43,60,1,41
66,61,18,11.261678004535147,13.514013605442177,46,45,106,2,43
67,61,219,11.261678004535147,12.84063492063492,46,16,172,2,158
68,61,268,11.261678004535147,13.746213151927439,46,22,233,2,207
69,61,268,11.261678004535147,14.09451247165533,46,20,240,3,207
70,61,541,11.261678004535147,13.467573696145125,46,23,489,2,480
71,20,18,12.283356009070294,13.514013605442177,43,45,53,1,2
72,20,24,12.283356009070294,14.280272108843537,43,43,86,2,4
73,20,35,12.283356009070294,15.069750566893424,43,38,121,3,15
74,20,268,12.283356009070294,13.746213151927439,43,22,256,1,248
75,20,268,12.283356009070294,14.09451247165533,43,20,260,2,248
76,20,436,12.283356009070294,14.814331065759637,43,20,430,3,416
77,18,35,13.514013605442177,15.069750566893424,45,38,69,2,17
78,18,264,13.514013605442177,15.905668934240364,45,18,267,2,246
79,18,274,13.514013605442177,16.23074829931973,45,30,281,3,256
80,18,436,13.514013605442177,14.814331065759637,45,20,422,1,418
81,18,443,13.514013605442177,15.51092970521542,45,18,434,2,425
82,18,427,13.514013605442177,16.16108843537415,45,21,425,3,409
83,24,61,14.280272108843537,16.532607709750568,43,46,104,2,37
84,24,264,14.280272108843537,15.905668934240364,43,18,250,2,240
85,24,274,14.280272108843537,16.23074829931973,43,30,264,2,250
86,24,443,14.280272108843537,15.51092970521542,43,18,422,1,419
87,24,427,14.280272108843537,16.16108843537415,43,21,411,2,403
88,35,61,15.069750566893424,16.532607709750568,38,46,68,1,26
89,35,61,15.069750566893424,17.34530612244898,38,45,101,2,26
90,35,274,15.069750566893424,16.23074829931973,38,30,244,1,239
91,35,277,15.069750566893424,17.902585034013605,38,29,271,3,242
92,35,427,15.069750566893424,16.16108843537415,38,21,395,1,392
93,35,436,15.069750566893424,17.507845804988662,38,21,415,2,401
94,61,31,16.532607709750568,18.52952380952381,46,45,91,2,30
95,61,277,16.532607709750568,17.902585034013605,46,29,224,1,216
96,61,218,16.532607709750568,18.83138321995465,46,32,186,2,157
97,61,216,16.532607709750568,19.272562358276645,46,34,195,3,155
98,61,416,16.532607709750568,18.784943310657596,46,24,368,2,355
99,61,31,17.34530612244898,18.52952380952381,45,45,59,1,30
100,61,31,17.34530612244898,19.644081632653062,45,44,103,2,30
101,61,18,17.34530612244898,20.24780045351474,45,43,132,3,43
102,61,218,17.34530612244898,18.83138321995465,45,32,170,1,157
103,61,216,17.34530612244898,19.272562358276645,45,34,176,2,155
104,61,342,17.34530612244898,20.224580498866214,45,18,307,3,281
105,61,416,17.34530612244898,18.784943310657596,45,24,360,1,355
106,61,445,17.34530612244898,20.20136054421769,45,21,403,3,384
107,31,18,18.52952380952381,20.24780045351474,45,43,75,2,13
108,31,342,18.52952380952381,20.224580498866214,45,18,319,2,311
109,31,445,18.52952380952381,20.20136054421769,45,21,420,2,414
110,31,28,19.644081632653062,21.826757369614512,44,46,94,2,3
111,31,24,19.644081632653062,22.430476190476192,44,46,120,3,7
112,31,276,19.644081632653062,22.03573696145125,44,35,266,2,245
113,31,276,19.644081632653062,22.105396825396827,44,35,267,2,245
114,31,428,19.644081632653062,21.5481179138322,44,20,405,2,397
115,18,28,20.24780045351474,21.826757369614512,43,46,69,2,10
116,18,24,20.24780045351474,22.430476190476192,43,46,94,2,6
117,18,35,20.24780045351474,23.1502947845805,43,42,126,3,17
118,18,276,20.24780045351474,22.03573696145125,43,35,269,2,258
119,18,276,20.24780045351474,22.105396825396827,43,35,270,2,258
120,18,428,20.24780045351474,21.5481179138322,43,20,414,1,410
121,18,427,20.24780045351474,22.918095238095237,43,20,425,3,409
122,28,35,21.826757369614512,23.1502947845805,46,42,57,1,7
123,28,82,21.826757369614512,24.61315192743764,46,45,132,3,54
124,28,219,21.826757369614512,23.61469387755102,46,16,206,2,191
125,28,206,21.826757369614512,24.473832199546486,46,27,211,3,178
126,28,427,21.826757369614512,22.918095238095237,46,20,402,1,399
127,28,444,21.826757369614512,23.591473922902495,46,18,423,2,416
128,28,489,21.826757369614512,24.264852607709752,46,23,473,2,461
129,24,82,22.430476190476192,24.61315192743764,46,45,110,2,58
130,24,25,22.430476190476192,25.240090702947846,46,44,121,3,1
131,24,219,22.430476190476192,23.61469387755102,46,16,202,1,195
132,24,206,22.430476190476192,24.473832199546486,46,27,202,2,182
133,24,444,22.430476190476192,23.591473922902495,46,18,423,1,420
134,24,489,22.430476190476192,24.264852607709752,46,23,472,2,465
135,35,82,23.1502947845805,24.61315192743764,42,45,79,1,47
136,35,25,23.1502947845805,25.240090702947846,42,44,91,2,10
137,35,206,23.1502947845805,24.473832199546486,42,27,180,1,171
138,35,219,23.1502947845805,25.658049886621317,42,14,213,3,184
139,35,489,23.1502947845805,24.264852607709752,42,23,457,1,454
140,35,427,23.1502947845805,25.611609977324264,42,20,406,2,392
141,82,20,24.61315192743764,27.028027210884353,45,41,121,2,62
142,82,219,24.61315192743764,25.658049886621317,45,14,144,1,137
143,82,305,24.61315192743764,26.28498866213152,45,14,234,2,223
144,82,427,24.61315192743764,26.958367346938775,45,20,359,2,345
145,25,20,25.240090702947846,27.028027210884353,44,41,77,2,5
146,25,20,25.240090702947846,27.678185941043086,44,42,105,2,5
147,25,305,25.240090702947846,26.28498866213152,44,14,284,1,280
148,25,225,25.240090702947846,27.654965986394558,44,15,225,2,200
149,25,427,25.240090702947846,26.958367346938775,44,20,409,2,402
150,25,443,25.240090702947846,27.654965986394558,44,17,431,2,418
151,20,64,27.028027210884353,28.76952380952381,41,45,87,2,44
152,20,72,27.028027210884353,29.23392290249433,41,44,108,2,52
153,20,260,27.028027210884353,28.93206349206349,41,23,254,2,240
154,20,422,27.028027210884353,28.93206349206349,41,24,410,2,402
155,20,427,27.028027210884353,29.651882086167802,41,20,422,3,407
156,20,64,27.678185941043086,28.76952380952381,42,45,64,1,44
157,20,72,27.678185941043086,29.23392290249433,42,44,85,2,52
158,20,260,27.678185941043086,28.93206349206349,42,23,246,1,240
159,20,258,27.678185941043086,30.02340136054422,42,30,259,2,238
160,20,275,27.678185941043086,30.394920634920634,42,28,281,3,255
161,20,422,27.678185941043086,28.93206349206349,42,24,406,1,402
162,20,427,27.678185941043086,29.651882086167802,42,20,416,2,407
163,64,61,28.76952380952381,30.78965986394558,45,48,87,2,3
164,64,19,28.76952380952381,31.71845804988662,45,45,135,3,45
165,64,258,28.76952380952381,30.02340136054422,45,30,201,1,194
166,64,275,28.76952380952381,30.394920634920634,45,28,222,2,211
167,64,275,28.76952380952381,31.207619047619048,45,18,236,2,211
168,64,436,28.76952380952381,30.998639455782314,45,21,384,2,372
169,64,443,28.76952380952381,31.695238095238096,45,18,399,3,379
170,72,61,29.23392290249433,30.78965986394558,44,48,68,2,11
171,72,19,29.23392290249433,31.71845804988662,44,45,119,2,53
172,72,275,29.23392290249433,30.394920634920634,44,28,209,1,203
173,72,275,29.23392290249433,31.207619047619048,44,18,220,2,203
174,72,436,29.23392290249433,30.998639455782314,44,21,372,2,364
175,72,443,29.23392290249433,31.695238095238096,44,18,386,2,371
176,61,31,30.78965986394558,32.55437641723356,48,46,82,2,30
177,61,261,30.78965986394558,32.76335600907029,48,36,217,2,200
178,61,427,30.78965986394558,32.345396825396826,48,21,372,2,366
179,61,445,30.78965986394558,33.69215419501134,48,21,404,3,384
180,19,66,31.71845804988662,34.11011337868481,45,45,113,2,47
181,19,261,31.71845804988662,32.76335600907029,45,36,246,1,242
182,19,264,31.71845804988662,34.04045351473923,45,25,265,2,245
183,19,221,31.71845804988662,34.644172335600906,45,26,238,3,202
184,19,445,31.71845804988662,33.69215419501134,45,21,434,2,426
185,31,66,32.55437641723356,34.11011337868481,46,45,76,2,35
186,31,24,32.55437641723356,35.10857142857143,46,48,110,3,7
187,31,24,32.55437641723356,35.15501133786848,46,47,112,3,7
188,31,264,32.55437641723356,34.04045351473923,46,25,242,1,233
189,31,221,32.55437641723356,34.644172335600906,46,26,210,2,190
190,31,219,32.55437641723356,35.294331065759636,46,24,222,3,188
191,31,445,32.55437641723356,33.69215419501134,46,21,417,1,414
192,31,462,32.55437641723356,34.89959183673469,46,21,443,2,431
193,31,432,32.55437641723356,35.20145124716554,46,24,417,3,401
194,66,24,34.11011337868481,35.15501133786848,45,47,62,1,42
195,66,28,34.11011337868481,36.17668934240363,45,43,97,2,38
196,66,219,34.11011337868481,35.294331065759636,45,24,161,1,153
197,66,432,34.11011337868481,35.20145124716554,45,24,369,1,366
198,24,28,35.10857142857143,36.17668934240363,48,43,46,1,4
199,24,62,35.10857142857143,37.802086167800454,48,47,122,3,38
200,24,221,35.10857142857143,37.151927437641724,48,14,216,2,197
201,24,248,35.10857142857143,37.755646258503404,48,27,251,3,224
202,24,443,35.10857142857143,37.73242630385488,48,19,434,3,419
203,24,28,35.15501133786848,36.17668934240363,47,43,44,1,4
204,24,62,35.15501133786848,37.802086167800454,47,47,120,3,38
205,24,221,35.15501133786848,37.151927437641724,47,14,215,2,197
206,24,248,35.15501133786848,37.755646258503404,47,27,250,3,224
207,24,443,35.15501133786848,37.73242630385488,47,19,433,3,419
208,28,62,36.17668934240363,37.802086167800454,43,47,78,2,34
209,28,61,36.17668934240363,39.14884353741497,43,45,132,3,33
210,28,248,36.17668934240363,37.755646258503404,43,27,230,2,220
211,28,276,36.17668934240363,39.14884353741497,43,21,279,3,248
212,28,443,36.17668934240363,37.73242630385488,43,19,420,2,415
213,28,428,36.17668934240363,39.07918367346939,43,19,419,3,400
214,62,61,37.802086167800454,39.14884353741497,47,45,58,1,1
215,62,61,37.802086167800454,39.19528344671202,47,46,60,1,1
216,62,276,37.802086167800454,39.14884353741497,47,21,222,1,214
217,62,218,37.802086167800454,39.72934240362812,47,38,177,2,156
218,62,306,37.802086167800454,40.51882086167801,47,18,271,3,244
219,62,428,37.802086167800454,39.07918367346939,47,19,370,1,366
220,62,512,37.802086167800454,39.65968253968254,47,20,457,2,450
221,62,428,37.802086167800454,40.4259410430839,47,20,383,3,366
222,61,18,39.14884353741497,41.145759637188206,45,45,96,2,43
223,61,31,39.14884353741497,41.81913832199547,45,45,119,3,30
224,61,306,39.14884353741497,40.51882086167801,45,18,252,1,245
225,61,271,39.14884353741497,41.86557823129252,45,19,240,3,210
226,61,428,39.14884353741497,40.4259410430839,45,20,371,1,367
227,61,489,39.14884353741497,41.40117913832199,45,25,439,2,428
228,61,18,39.19528344671202,41.145759637188206,46,45,94,2,43
229,61,31,39.19528344671202,41.81913832199547,46,45,117,3,30
230,61,306,39.19528344671202,40.51882086167801,46,18,252,1,245
231,61,271,39.19528344671202,41.86557823129252,46,19,239,3,210
232,61,428,39.19528344671202,40.4259410430839,46,20,371,1,367
233,61,489,39.19528344671202,41.40117913832199,46,25,438,2,428
234,18,83,41.145759637188206,42.956916099773245,45,44,102,2,65
235,18,23,41.145759637188206,43.46775510204082,45,44,100,2,5
236,18,219,41.145759637188206,42.49251700680272,45,35,209,1,201
237,18,229,41.145759637188206,43.6302947845805,45,30,237,2,211
238,18,427,41.145759637188206,43.14267573696145,45,20,418,2,409
239,18,425,41.145759637188206,43.83927437641724,45,17,423,3,407
240,31,83,41.81913832199547,42.956916099773245,45,44,71,1,52
241,31,23,41.81913832199547,43.46775510204082,45,44,71,2,8
242,31,20,41.81913832199547,44.210793650793654,45,45,104,2,11
243,31,229,41.81913832199547,43.6302947845805,45,30,213,2,198
244,31,312,41.81913832199547,44.489433106575966,45,16,304,3,281
245,31,427,41.81913832199547,43.14267573696145,45,20,400,1,396
246,31,425,41.81913832199547,43.83927437641724,45,17,403,2,394
247,31,427,41.81913832199547,44.489433106575966,45,20,412,3,396
248,83,20,42.956916099773245,44.210793650793654,44,45,83,1,63
249,83,18,42.956916099773245,45.88263038548753,44,46,142,3,65
250,83,312,42.956916099773245,44.489433106575966,44,16,238,2,229
251,83,267,42.956916099773245,45.81297052154195,44,21,221,3,184
252,83,427,42.956916099773245,44.489433106575966,44,20,350,2,344
253,83,438,42.956916099773245,45.81297052154195,44,20,376,3,355
254,23,18,43.46775510204082,45.88263038548753,44,46,104,2,5
255,23,312,43.46775510204082,44.489433106575966,44,16,292,1,289
256,23,267,43.46775510204082,45.81297052154195,44,21,264,2,244
257,23,261,43.46775510204082,46.34702947845805,44,29,268,3,238
258,23,427,43.46775510204082,44.489433106575966,44,20,406,1,404
259,23,438,43.46775510204082,45.81297052154195,44,20,427,2,415
260,20,18,44.210793650793654,45.88263038548753,45,46,72,2,2
261,20,61,44.210793650793654,46.672108843537416,45,47,114,2,41
262,20,267,44.210793650793654,45.81297052154195,45,21,256,2,247
263,20,261,44.210793650793654,46.34702947845805,45,29,258,2,241
264,20,438,44.210793650793654,45.81297052154195,45,20,424,2,418
265,20,427,44.210793650793654,47.18294784580499,45,21,427,3,407
266,18,25,45.88263038548753,47.484807256235825,46,45,69,2,7
267,18,81,45.88263038548753,48.29750566893424,46,46,122,2,63
268,18,263,45.88263038548753,47.71700680272109,46,35,257,2,245
269,18,243,45.88263038548753,48.29750566893424,46,23,248,2,225
270,18,427,45.88263038548753,47.18294784580499,46,21,413,1,409
271,18,444,45.88263038548753,47.85632653061224,46,17,434,2,426
272,18,427,45.88263038548753,48.529705215419504,46,20,425,3,409
273,61,81,46.672108843537416,48.29750566893424,47,46,73,2,20
274,61,263,46.672108843537416,47.71700680272109,47,35,207,1,202
275,61,243,46.672108843537416,48.29750566893424,47,23,195,2,182
276,61,444,46.672108843537416,47.85632653061224,47,17,386,1,383
277,61,427,46.672108843537416,48.529705215419504,47,20,375,2,366
278,25,31,47.484807256235825,50.178321995464856,45,46,116,3,6
279,25,214,47.484807256235825,50.178321995464856,45,27,222,3,189
280,25,254,47.484807256235825,50.24798185941043,45,33,258,3,229
281,25,427,47.484807256235825,48.529705215419504,45,20,405,1,402
282,25,445,47.484807256235825,49.87646258503401,45,21,432,2,420
283,81,31,48.29750566893424,50.178321995464856,46,46,95,2,50
284,81,109,48.29750566893424,50.59628117913832,46,46,103,2,28
285,81,18,48.29750566893424,51.26965986394558,46,44,143,3,63
286,81,214,48.29750566893424,50.178321995464856,46,27,156,2,133
287,81,254,48.29750566893424,50.24798185941043,46,33,192,2,173
288,81,445,48.29750566893424,49.87646258503401,46,21,370,2,364
289,81,445,48.29750566893424,51.22321995464853,46,21,385,3,364
290,81,556,48.29750566893424,51.24643990929705,46,19,492,3,475
291,31,18,50.178321995464856,51.26965986394558,46,44,49,1,13
292,31,18,50.178321995464856,52.61641723356009,46,45,106,2,13
293,31,264,50.178321995464856,51.316099773242634,46,24,238,1,233
294,31,218,50.178321995464856,52.45387755102041,46,37,211,2,187
295,31,445,50.178321995464856,51.22321995464853,46,21,416,1,414
296,31,486,50.178321995464856,52.895056689342404,46,22,470,3,455
297,109,18,50.59628117913832,52.61641723356009,46,45,126,2,91
298,109,218,50.59628117913832,52.45387755102041,46,37,135,2,109
299,109,486,50.59628117913832,52.895056689342404,46,22,390,2,377
300,18,41,51.26965986394558,53.68453514739229,44,47,107,2,23
301,18,218,51.26965986394558,52.45387755102041,44,37,206,1,200
302,18,231,51.26965986394558,54.218594104308394,44,31,248,3,213
303,18,230,51.26965986394558,54.24181405895692,44,33,248,3,212
304,18,486,51.26965986394558,52.895056689342404,44,22,473,2,468
305,18,445,51.26965986394558,53.91673469387755,44,21,442,3,427
306,18,41,52.61641723356009,53.68453514739229,45,47,51,1,23
307,18,20,52.61641723356009,55.00807256235828,45,45,103,2,2
308,18,34,52.61641723356009,55.49569160997733,45,44,125,3,16
309,18,231,52.61641723356009,54.218594104308394,45,31,224,2,213
310,18,230,52.61641723356009,54.24181405895692,45,33,223,2,212
311,18,445,52.61641723356009,53.91673469387755,45,21,431,1,427
312,18,427,52.61641723356009,55.263492063492066,45,22,425,3,409
313,41,20,53.68453514739229,55.00807256235828,47,45,61,1,21
314,41,34,53.68453514739229,55.49569160997733,47,44,78,2,7
315,41,219,53.68453514739229,55.98331065759637,47,17,204,2,178
316,41,427,53.68453514739229,55.263492063492066,47,22,392,2,386
317,20,18,55.00807256235828,56.679909297052156,45,46,72,2,2
318,20,404,55.00807256235828,56.86566893424036,45,25,392,2,384
319,20,215,55.00807256235828,57.58548752834467,45,24,224,3,195
320,20,419,55.00807256235828,56.93532879818594,45,24,408,2,399
321,34,18,55.49569160997733,56.679909297052156,44,46,53,1,16
322,34,65,55.49569160997733,58.258866213151926,44,47,123,3,31
323,34,65,55.49569160997733,58.28208616780046,44,45,124,3,31
324,34,404,55.49569160997733,56.86566893424036,44,25,375,1,370
325,34,215,55.49569160997733,57.58548752834467,44,24,202,2,181
326,34,419,55.49569160997733,56.93532879818594,44,24,390,1,385
327,34,462,55.49569160997733,58.049886621315196,44,22,442,3,428
328,18,65,56.679909297052156,58.258866213151926,46,47,83,2,47
329,18,65,56.679909297052156,58.28208616780046,46,45,83,2,47
330,18,81,56.679909297052156,59.32698412698413,46,43,130,3,63
331,18,271,56.679909297052156,58.90902494331066,46,28,271,2,253
332,18,217,56.679909297052156,59.53596371882086,46,23,234,3,199
333,18,462,56.679909297052156,58.049886621315196,46,22,448,1,444
334,18,445,56.679909297052156,59.303764172335605,46,21,442,3,427
335,65,81,58.258866213151926,59.32698412698413,47,43,49,1,16
336,65,23,58.258866213151926,61.02204081632653,47,43,126,3,42
337,65,217,58.258866213151926,59.53596371882086,47,23,162,1,152
338,65,350,58.258866213151926,60.67374149659864,47,18,303,2,285
339,65,445,58.258866213151926,59.303764172335605,47,21,383,1,380
340,65,446,58.258866213151926,60.65052154195011,47,20,395,2,381
341,65,81,58.28208616780046,59.32698412698413,45,43,48,1,16
342,65,23,58.28208616780046,61.02204081632653,45,43,125,3,42
343,65,217,58.28208616780046,59.53596371882086,45,23,161,1,152
344,65,350,58.28208616780046,60.67374149659864,45,18,303,2,285
345,65,445,58.28208616780046,59.303764172335605,45,21,383,1,380
346,65,446,58.28208616780046,60.65052154195011,45,20,394,2,381
347,81,23,59.32698412698413,61.02204081632653,43,43,93,2,58
348,81,49,59.32698412698413,62.15981859410431,43,48,126,3,32
349,81,350,59.32698412698413,60.67374149659864,43,18,275,1,269
350,81,286,59.32698412698413,61.69541950113379,43,25,229,2,205
351,81,446,59.32698412698413,60.65052154195011,43,20,369,1,365
352,81,445,59.32698412698413,61.99727891156463,43,20,382,3,364
353,23,49,61.02204081632653,62.15981859410431,43,48,55,1,26
354,23,46,61.02204081632653,62.69387755102041,43,48,76,2,23
355,23,18,61.02204081632653,63.41369614512472,43,45,103,2,5
356,23,206,61.02204081632653,62.78675736961451,43,18,198,2,183
357,23,310,61.02204081632653,63.36725623582767,43,19,304,2,287
358,23,443,61.02204081632653,62.69387755102041,43,19,426,2,420
359,23,445,61.02204081632653,63.36725623582767,43,20,434,2,422
360,49,18,62.15981859410431,63.41369614512472,48,45,62,1,31
361,49,310,62.15981859410431,63.36725623582767,48,19,266,1,261
362,49,276,62.15981859410431,64.38893424036281,48,22,246,2,227
363,49,445,62.15981859410431,63.36725623582767,48,20,399,1,396
364,49,427,62.15981859410431,64.71401360544218,48,20,394,3,378
365,46,41,62.69387755102041,65.2712925170068,48,47,111,3,5
366,46,276,62.69387755102041,64.38893424036281,48,22,241,2,230
367,46,427,62.69387755102041,64.71401360544218,48,20,391,2,381
368,18,41,63.41369614512472,65.2712925170068,45,47,83,2,23
369,18,41,63.41369614512472,65.89823129251701,45,48,109,2,23
370,18,286,63.41369614512472,66.06077097505668,45,17,291,3,268
371,18,427,63.41369614512472,64.71401360544218,45,20,413,1,409
372,18,427,63.41369614512472,66.06077097505668,45,20,425,3,409
373,41,36,65.2712925170068,66.85024943310658,47,45,68,2,5
374,41,18,65.2712925170068,67.45396825396826,47,45,97,2,23
375,41,219,65.2712925170068,66.80380952380952,47,15,190,2,178
376,41,261,65.2712925170068,67.91836734693878,47,20,248,3,220
377,41,443,65.2712925170068,66.75736961451247,47,17,407,1,402
378,41,427,65.2712925170068,67.4075283446712,47,21,397,2,386
379,41,18,65.89823129251701,67.45396825396826,48,45,71,2,23
380,41,64,65.89823129251701,68.3827664399093,48,45,109,2,23
381,41,261,65.89823129251701,67.91836734693878,48,20,237,2,220
382,41,427,65.89823129251701,67.4075283446712,48,21,391,2,386
383,41,427,65.89823129251701,68.75428571428571,48,21,405,3,386
384,36,64,66.85024943310658,68.3827664399093,45,45,72,2,28
385,36,261,66.85024943310658,67.91836734693878,45,20,230,1,225
386,36,213,66.85024943310658,69.07936507936508,45,27,201,2,177
387,36,427,66.85024943310658,68.75428571428571,45,21,400,2,391
388,18,49,67.45396825396826,70.12426303854875,45,42,119,3,31
389,18,213,67.45396825396826,69.07936507936508,45,27,207,2,195
390,18,207,67.45396825396826,70.14748299319729,45,30,222,3,189
391,18,427,67.45396825396826,68.75428571428571,45,21,413,1,409
392,18,427,67.45396825396826,70.10104308390022,45,21,425,3,409
393,64,49,68.3827664399093,70.12426303854875,45,42,76,2,15
394,64,61,68.3827664399093,70.82086167800453,45,45,105,2,3
395,64,207,68.3827664399093,70.14748299319729,45,30,162,2,143
396,64,212,68.3827664399093,70.86730158730158,45,28,183,2,148
397,64,427,68.3827664399093,70.10104308390022,45,21,370,2,363
398,49,60,70.12426303854875,72.2140589569161,42,46,91,2,11
399,49,82,70.12426303854875,72.56235827664399,42,45,110,2,33
400,49,209,70.12426303854875,72.19083900226758,42,29,183,2,160
401,49,540,70.12426303854875,72.95709750566894,42,22,506,3,491
402,61,60,70.82086167800453,72.2140589569161,45,46,60,1,1
403,61,82,70.82086167800453,72.56235827664399,45,45,78,2,21
404,61,209,70.82086167800453,72.19083900226758,45,29,159,1,148
405,61,215,70.82086167800453,73.32861678004535,45,34,188,3,154
406,61,215,70.82086167800453,73.35183673469388,45,33,189,3,154
407,61,540,70.82086167800453,72.95709750566894,45,22,488,2,479
408,60,18,72.2140589569161,74.21097505668935,46,46,96,2,42
409,60,18,72.2140589569161,74.3502947845805,46,43,101,2,42
410,60,215,72.2140589569161,73.32861678004535,46,34,162,1,155
411,60,215,72.2140589569161,73.35183673469388,46,33,163,1,155
412,60,206,72.2140589569161,74.8843537414966,46,16,186,3,146
413,60,445,72.2140589569161,74.14131519274376,46,20,394,2,385
414,60,444,72.2140589569161,74.83791383219955,46,18,400,3,384
415,82,18,72.56235827664399,74.21097505668935,45,46,96,2,64
416,82,18,72.56235827664399,74.3502947845805,45,43,100,2,64
417,82,206,72.56235827664399,74.8843537414966,45,16,159,2,124
418,82,445,72.56235827664399,74.14131519274376,45,20,369,2,363
419,82,444,72.56235827664399,74.83791383219955,45,18,375,2,362
420,18,28,74.21097505668935,75.74349206349207,46,43,67,2,10
421,18,20,74.21097505668935,76.579410430839,46,44,102,2,2
422,18,213,74.21097505668935,76.02213151927438,46,36,210,2,195
423,18,381,74.21097505668935,76.34721088435374,46,22,374,2,363
424,18,491,74.21097505668935,76.37043083900227,46,23,482,2,473
425,18,28,74.3502947845805,75.74349206349207,43,43,61,1,10
426,18,20,74.3502947845805,76.579410430839,43,44,96,2,2
427,18,213,74.3502947845805,76.02213151927438,43,36,208,2,195
428,18,381,74.3502947845805,76.34721088435374,43,22,373,2,363
429,18,491,74.3502947845805,76.37043083900227,43,23,481,2,473
430,28,18,75.74349206349207,78.25124716553289,43,46,108,3,10
431,28,82,75.74349206349207,78.57632653061225,43,42,133,3,54
432,28,286,75.74349206349207,78.1815873015873,43,18,279,2,258
433,20,18,76.579410430839,78.25124716553289,44,46,72,2,2
434,20,82,76.579410430839,78.57632653061225,44,42,106,2,62
435,20,286,76.579410430839,78.1815873015873,44,18,275,2,266
436,20,268,76.579410430839,78.94784580498866,44,26,268,2,248
437,20,427,76.579410430839,79.52834467120182,44,20,426,3,407
438,18,21,78.25124716553289,79.5980045351474,46,41,58,1,3
439,18,304,78.25124716553289,80.2249433106576,46,15,298,2,286
440,18,291,78.25124716553289,80.89832199546485,46,31,296,3,273
441,18,427,78.25124716553289,79.52834467120182,46,20,413,1,409
442,18,427,78.25124716553289,80.87510204081633,46,20,424,3,409
443,82,21,78.57632653061225,79.5980045351474,42,41,75,1,61
444,82,61,78.57632653061225,81.24662131519274,42,46,117,3,21
445,82,304,78.57632653061225,80.2249433106576,42,15,233,2,222
446,82,291,78.57632653061225,80.89832199546485,42,31,232,2,209
447,82,427,78.57632653061225,80.87510204081633,42,20,359,2,345
448,21,61,79.5980045351474,81.24662131519274,41,46,81,2,40
449,21,61,79.5980045351474,81.94321995464853,41,45,109,2,40
450,21,291,79.5980045351474,80.89832199546485,41,31,276,1,270
451,21,271,79.5980045351474,82.0128798185941,41,28,271,2,250
452,21,427,79.5980045351474,80.87510204081633,41,20,410,1,406
453,21,421,79.5980045351474,82.0128798185941,41,22,413,2,400
454,61,18,81.24662131519274,83.61505668934241,46,45,111,2,43
455,61,218,81.24662131519274,83.35963718820862,46,38,181,2,157
456,61,217,81.24662131519274,83.38285714285715,46,40,181,2,156
457,61,423,81.24662131519274,82.75591836734694,46,19,368,2,362
458,61,533,81.24662131519274,83.56861678004535,46,23,482,2,472
459,61,18,81.94321995464853,83.61505668934241,45,45,84,2,43
460,61,218,81.94321995464853,83.35963718820862,45,38,168,1,157
461,61,217,81.94321995464853,83.38285714285715,45,40,168,1,156
462,61,247,81.94321995464853,84.45097505668934,45,26,215,3,186
463,61,533,81.94321995464853,83.56861678004535,45,23,477,2,472
464,61,19,82.63981859410431,84.96181405895692,46,42,108,2,42
465,61,247,82.63981859410431,84.45097505668934,46,26,202,2,186
466,61,427,82.63981859410431,84.9385941043084,46,19,379,2,366
467,18,19,83.61505668934241,84.96181405895692,45,42,58,1,1
468,18,50,83.61505668934241,86.21569160997733,45,43,116,3,32
469,18,56,83.61505668934241,86.58721088435374,45,47,134,3,38
470,18,232,83.61505668934241,86.33179138321995,45,26,244,3,214
471,18,427,83.61505668934241,84.9385941043084,45,19,413,1,409
472,18,427,83.61505668934241,86.2853514739229,45,20,425,3,409
473,19,50,84.96181405895692,86.21569160997733,42,43,62,1,31
474,19,56,84.96181405895692,86.58721088435374,42,47,79,2,37
475,19,35,84.96181405895692,87.86430839002267,42,42,126,3,16
476,19,232,84.96181405895692,86.33179138321995,42,26,221,1,213
477,19,213,84.96181405895692,86.7265306122449,42,37,208,2,194
478,19,269,84.96181405895692,87.42312925170069,42,25,272,2,250
479,19,427,84.96181405895692,86.2853514739229,42,20,412,1,408
480,19,445,84.96181405895692,87.63210884353742,42,20,441,3,426
481,50,35,86.21569160997733,87.86430839002267,43,42,73,2,15
482,50,30,86.21569160997733,89.09496598639456,43,45,126,3,20
483,50,269,86.21569160997733,87.42312925170069,43,25,225,1,219
484,50,445,86.21569160997733,87.63210884353742,43,20,400,1,395
485,50,427,86.21569160997733,88.97886621315193,43,20,395,3,377
486,56,35,86.58721088435374,87.86430839002267,47,42,59,1,21
487,56,30,86.58721088435374,89.09496598639456,47,45,111,3,26
488,56,299,86.58721088435374,89.37360544217687,47,30,271,3,243
489,56,271,86.58721088435374,89.55936507936508,47,27,250,3,215
490,56,445,86.58721088435374,87.63210884353742,47,20,392,1,389
491,56,427,86.58721088435374,88.97886621315193,47,20,385,2,371
492,35,30,87.86430839002267,89.09496598639456,42,45,53,1,5
493,35,24,87.86430839002267,89.95410430839003,42,44,91,2,11
494,35,299,87.86430839002267,89.37360544217687,42,30,272,2,264
495,35,271,87.86430839002267,89.55936507936508,42,27,247,2,236
496,35,427,87.86430839002267,88.97886621315193,42,20,395,1,392
497,35,427,87.86430839002267,90.32562358276644,42,20,406,2,392
498,30,54,89.09496598639456,91.41696145124716,45,45,103,2,24
499,30,54,89.09496598639456,91.4401814058957,45,45,104,2,24
500,30,246,89.09496598639456,91.25442176870749,45,20,235,2,216
501,30,271,89.09496598639456,91.48662131519275,45,22,262,2,241
502,30,427,89.09496598639456,90.32562358276644,45,20,401,1,397
503,30,443,89.09496598639456,91.02222222222223,45,18,421,2,413
504,30,445,89.09496598639456,91.67238095238095,45,20,430,3,415
505,24,54,89.95410430839003,91.41696145124716,44,45,70,1,30
506,24,54,89.95410430839003,91.4401814058957,44,45,71,1,30
507,24,246,89.95410430839003,91.25442176870749,44,20,229,1,222
508,24,271,89.95410430839003,91.48662131519275,44,22,256,2,247
509,24,443,89.95410430839003,91.02222222222223,44,18,422,1,419
510,24,445,89.95410430839003,91.67238095238095,44,20,427,2,421
511,54,65,91.41696145124716,93.39065759637188,45,44,86,2,11
512,54,64,91.41696145124716,93.483537414966,45,45,90,2,10
513,54,275,91.41696145124716,93.4138775510204,45,19,237,2,221
514,54,253,91.41696145124716,93.97115646258504,45,32,227,3,199
515,54,427,91.41696145124716,93.01913832199547,45,20,379,2,373
516,54,422,91.41696145124716,93.64607709750567,45,23,380,2,368
517,54,65,91.4401814058957,93.39065759637188,45,44,85,2,11
518,54,64,91.4401814058957,93.483537414966,45,45,89,2,10
519,54,275,91.4401814058957,93.4138775510204,45,19,237,2,221
520,54,253,91.4401814058957,93.97115646258504,45,32,227,3,199
521,54,427,91.4401814058957,93.01913832199547,45,20,379,2,373
522,54,422,91.4401814058957,93.64607709750567,45,23,380,2,368
523,65,61,93.39065759637188,95.41079365079365,44,46,87,2,4
524,65,61,93.39065759637188,95.8055328798186,44,46,104,2,4
525,65,258,93.39065759637188,94.7374149659864,44,28,202,1,193
526,65,273,93.39065759637188,95.55011337868481,44,23,228,2,208
527,65,410,93.39065759637188,94.59809523809524,44,25,349,1,345
528,65,436,93.39065759637188,95.71265306122449,44,20,384,2,371
529,64,61,93.483537414966,95.41079365079365,45,46,83,2,3
530,64,61,93.483537414966,95.8055328798186,45,46,100,2,3
531,64,19,93.483537414966,96.45569160997732,45,47,136,3,45
532,64,258,93.483537414966,94.7374149659864,45,28,201,1,194
533,64,273,93.483537414966,95.55011337868481,45,23,227,2,209
534,64,410,93.483537414966,94.59809523809524,45,25,349,1,346
535,64,436,93.483537414966,95.71265306122449,45,20,384,2,372
536,61,19,95.41079365079365,96.45569160997732,46,47,62,1,42
537,61,63,95.41079365079365,97.63990929705216,46,45,96,2,2
538,61,266,95.41079365079365,97.4077097505669,46,33,222,2,205
539,61,261,95.41079365079365,97.52380952380953,46,36,220,2,200
540,61,445,95.41079365079365,97.05941043083901,46,20,391,2,384
541,61,63,95.8055328798186,97.63990929705216,46,45,79,2,2
542,61,266,95.8055328798186,97.4077097505669,46,33,216,2,205
543,61,261,95.8055328798186,97.52380952380953,46,36,213,2,200
544,61,445,95.8055328798186,97.05941043083901,46,20,388,1,384
545,61,427,95.8055328798186,98.40616780045352,46,20,383,3,366
546,19,63,96.45569160997732,97.63990929705216,47,45,67,1,44
547,19,66,96.45569160997732,98.82412698412699,47,44,112,2,47
548,19,261,96.45569160997732,97.52380952380953,47,36,246,1,242
549,19,220,96.45569160997732,99.35818594104309,47,28,237,3,201
550,19,427,96.45569160997732,98.40616780045352,47,20,417,2,408
551,19,443,96.45569160997732,99.1027664399093,47,17,439,3,424
552,63,66,97.63990929705216,98.82412698412699,45,44,51,1,3
553,63,24,97.63990929705216,99.82258503401361,45,47,102,2,39
554,63,220,97.63990929705216,99.35818594104309,45,28,174,2,157
555,63,220,97.63990929705216,100.03156462585034,45,24,188,2,157
556,63,247,97.63990929705216,100.47274376417234,45,20,221,3,184
557,63,443,97.63990929705216,99.1027664399093,45,17,385,1,380
558,63,432,97.63990929705216,99.91546485260771,45,24,382,2,369
559,66,27,98.82412698412699,100.63528344671202,44,46,87,2,39
560,66,220,98.82412698412699,100.03156462585034,44,24,163,1,154
561,66,247,98.82412698412699,100.47274376417234,44,20,194,2,181
562,66,432,98.82412698412699,99.91546485260771,44,24,369,1,366
563,24,56,99.82258503401361,102.37678004535148,47,48,115,3,32
564,24,62,99.82258503401361,102.4928798185941,47,48,121,3,38
565,24,224,99.82258503401361,102.33034013605442,47,26,227,3,200
566,24,248,99.82258503401361,102.51609977324263,47,23,252,3,224
567,24,477,99.82258503401361,102.26068027210884,47,18,465,2,453
568,27,56,100.63528344671202,102.37678004535148,46,48,80,2,29
569,27,62,100.63528344671202,102.4928798185941,46,48,87,2,35
570,27,224,100.63528344671202,102.33034013605442,46,26,210,2,197
571,27,248,100.63528344671202,102.51609977324263,46,23,235,2,221
572,27,477,100.63528344671202,102.26068027210884,46,18,455,2,450
573,27,425,100.63528344671202,103.16625850340137,46,18,413,3,398
574,56,30,102.37678004535148,104.11827664399094,48,45,79,2,26
575,56,24,102.37678004535148,104.95419501133787,48,43,116,3,32
576,56,218,102.37678004535148,104.4433560090703,48,38,185,2,162
577,56,218,102.37678004535148,104.51301587301587,48,36,186,2,162
578,56,508,102.37678004535148,104.4433560090703,48,20,461,2,452
579,56,436,102.37678004535148,105.13995464852609,48,20,398,3,380
580,62,30,102.4928798185941,104.11827664399094,48,45,77,2,32
581,62,24,102.4928798185941,104.95419501133787,48,43,113,2,38
582,62,218,102.4928798185941,104.4433560090703,48,38,177,2,156
583,62,218,102.4928798185941,104.51301587301587,48,36,179,2,156
584,62,508,102.4928798185941,104.4433560090703,48,20,454,2,446
585,62,436,102.4928798185941,105.13995464852609,48,20,391,3,374
586,30,23,104.11827664399094,106.02231292517007,45,45,82,2,7
587,30,31,104.11827664399094,106.62603174603174,45,45,108,3,1
588,30,219,104.11827664399094,105.48825396825397,45,19,198,1,189
589,30,436,104.11827664399094,105.13995464852609,45,20,408,1,406
590,30,489,104.11827664399094,106.11519274376417,45,24,467,2,459
591,24,23,104.95419501133787,106.02231292517007,43,45,46,1,1
592,24,31,104.95419501133787,106.62603174603174,43,45,72,2,7
593,24,83,104.95419501133787,107.67092970521543,43,46,131,3,59
594,24,219,104.95419501133787,107.299410430839,43,37,220,2,195
595,24,489,104.95419501133787,106.11519274376417,43,24,468,1,465
596,24,439,104.95419501133787,107.18331065759638,43,23,426,2,415
597,24,427,104.95419501133787,107.85668934240363,43,21,422,3,403
598,23,83,106.02231292517007,107.67092970521543,45,46,93,2,60
599,23,20,106.02231292517007,108.92480725623582,45,45,125,3,3
600,23,219,106.02231292517007,107.299410430839,45,37,204,1,196
601,23,229,106.02231292517007,108.32108843537415,45,31,229,2,206
602,23,439,106.02231292517007,107.18331065759638,45,23,419,1,416
603,23,427,106.02231292517007,107.85668934240363,45,21,412,2,404
604,31,83,106.62603174603174,107.67092970521543,45,46,69,1,52
605,31,20,106.62603174603174,108.92480725623582,45,45,100,2,11
606,31,229,106.62603174603174,108.32108843537415,45,31,211,2,198
607,31,206,106.62603174603174,109.48208616780046,45,23,214,3,175
608,31,427,106.62603174603174,107.85668934240363,45,21,400,1,396
609,31,445,106.62603174603174,109.20344671201815,45,21,429,3,414
610,83,20,107.67092970521543,108.92480725623582,46,45,83,1,63
611,83,18,107.67092970521543,110.24834467120182,46,42,129,3,65
612,83,18,107.67092970521543,110.5966439909297,46,46,142,3,65
613,83,206,107.67092970521543,109.48208616780046,46,23,146,2,123
614,83,267,107.67092970521543,110.50376417233561,46,17,221,3,184
615,83,445,107.67092970521543,109.20344671201815,46,21,368,2,362
616,83,425,107.67092970521543,109.90004535147392,46,18,355,2,342
617,83,427,107.67092970521543,110.55020408163266,46,20,366,3,344
618,20,18,108.92480725623582,110.24834467120182,45,42,57,1,2
619,20,18,108.92480725623582,110.5966439909297,45,46,72,2,2
620,20,60,108.92480725623582,111.54866213151928,45,45,120,3,40
621,20,267,108.92480725623582,110.50376417233561,45,17,256,2,247
622,20,260,108.92480725623582,111.08426303854876,45,29,257,2,240
623,20,427,108.92480725623582,110.55020408163266,45,20,413,2,407
624,20,427,108.92480725623582,111.89696145124717,45,21,427,3,407
625,18,60,110.24834467120182,111.54866213151928,42,45,70,1,42
626,18,61,110.24834467120182,112.82575963718821,42,46,119,3,43
627,18,231,110.24834467120182,112.47746031746031,42,35,234,2,213
628,18,261,110.24834467120182,112.52390022675738,42,33,262,2,243
629,18,427,110.24834467120182,111.89696145124717,42,21,415,2,409
630,18,61,110.5966439909297,112.82575963718821,46,46,105,2,43
631,18,231,110.5966439909297,112.47746031746031,46,35,228,2,213
632,18,261,110.5966439909297,112.52390022675738,46,33,257,2,243
633,18,427,110.5966439909297,111.89696145124717,46,21,413,1,409
634,18,445,110.5966439909297,113.24371882086169,46,22,442,3,427
635,60,61,111.54866213151928,112.82575963718821,45,46,55,1,1
636,60,93,111.54866213151928,114.42793650793651,45,45,128,3,33
637,60,245,111.54866213151928,114.49759637188208,45,22,224,3,185
638,60,445,111.54866213151928,113.24371882086169,45,22,392,2,385
639,60,414,111.54866213151928,113.94031746031746,45,16,369,2,354
640,61,93,112.82575963718821,114.42793650793651,46,45,76,2,32
641,61,109,112.82575963718821,115.26385487528344,46,45,115,2,48
642,61,245,112.82575963718821,114.49759637188208,46,22,198,2,184
643,61,214,112.82575963718821,114.91555555555556,46,31,178,2,153
644,61,414,112.82575963718821,113.94031746031746,46,16,356,1,353
645,61,428,112.82575963718821,114.5904761904762,46,20,375,2,367
646,93,18,114.42793650793651,115.98367346938775,45,44,101,2,75
647,93,18,114.42793650793651,116.65705215419501,45,44,122,2,75
648,93,264,114.42793650793651,115.9372335600907,45,28,183,2,171
649,93,213,114.42793650793651,117.28399092970521,45,37,172,3,120
650,93,436,114.42793650793651,115.9372335600907,45,21,349,2,343
651,93,428,114.42793650793651,117.28399092970521,45,21,357,3,335
652,109,18,115.26385487528344,116.65705215419501,45,44,109,1,91
653,109,213,115.26385487528344,117.28399092970521,45,37,136,2,104
654,109,255,115.26385487528344,117.8877097505669,45,29,185,3,146
655,109,428,115.26385487528344,117.28399092970521,45,21,331,2,319
656,109,486,115.26385487528344,117.60907029478459,45,23,390,2,377
657,18,42,115.98367346938775,118.44498866213152,44,46,109,2,24
658,18,23,115.98367346938775,118.81650793650793,44,47,122,3,5
659,18,213,115.98367346938775,117.28399092970521,44,37,203,1,195
660,18,255,115.98367346938775,117.8877097505669,44,29,251,2,237
661,18,428,115.98367346938775,117.28399092970521,44,21,414,1,410
662,18,486,115.98367346938775,117.60907029478459,44,23,473,2,468
663,18,445,115.98367346938775,118.63074829931973,44,20,442,3,427
664,18,42,116.65705215419501,118.44498866213152,44,46,81,2,24
665,18,23,116.65705215419501,118.81650793650793,44,47,93,2,5
666,18,41,116.65705215419501,119.58276643990929,44,44,128,3,23
667,18,255,116.65705215419501,117.8877097505669,44,29,243,1,237
668,18,230,116.65705215419501,118.97904761904762,44,34,234,2,212
669,18,205,116.65705215419501,119.58276643990929,44,24,225,3,187
670,18,445,116.65705215419501,118.63074829931973,44,20,435,2,427
671,42,41,118.44498866213152,119.58276643990929,46,44,49,1,1
672,42,18,118.44498866213152,121.39392290249434,46,46,129,3,24
673,42,205,118.44498866213152,119.58276643990929,46,24,170,1,163
674,42,224,118.44498866213152,121.20816326530613,46,23,217,3,182
675,42,445,118.44498866213152,119.97750566893424,46,21,408,2,403
676,42,428,118.44498866213152,121.32426303854875,46,20,405,3,386
677,23,18,118.81650793650793,121.39392290249434,47,46,111,3,5
678,23,224,118.81650793650793,121.20816326530613,47,23,226,2,201
679,23,258,118.81650793650793,121.64934240362813,47,27,265,3,235
680,23,445,118.81650793650793,119.97750566893424,47,21,425,1,422
681,23,428,118.81650793650793,121.32426303854875,47,20,419,3,405
682,23,419,118.81650793650793,121.64934240362813,47,26,414,3,396
683,41,18,119.58276643990929,121.39392290249434,44,46,81,2,23
684,41,54,119.58276643990929,122.2530612244898,44,46,116,3,13
685,41,224,119.58276643990929,121.20816326530613,44,23,196,2,183
686,41,258,119.58276643990929,121.64934240362813,44,27,235,2,217
687,41,428,119.58276643990929,121.32426303854875,44,20,394,2,387
688,41,419,119.58276643990929,121.64934240362813,44,26,388,2,378
689,18,65,121.39392290249434,122.97287981859411,46,47,83,2,47
690,18,49,121.39392290249434,124.27319727891157,46,44,128,3,31
691,18,275,121.39392290249434,123.34439909297052,46,26,270,2,257
692,18,271,121.39392290249434,123.62303854875283,46,28,271,2,253
693,18,445,121.39392290249434,124.0409977324263,46,20,442,3,427
694,54,49,122.2530612244898,124.27319727891157,46,44,87,2,5
695,54,24,122.2530612244898,124.73759637188209,46,42,111,2,30
696,54,275,122.2530612244898,123.34439909297052,46,26,226,1,221
697,54,271,122.2530612244898,123.62303854875283,46,28,225,1,217
698,54,445,122.2530612244898,124.0409977324263,46,20,399,2,391
699,65,49,122.97287981859411,124.27319727891157,47,44,58,1,16
700,65,24,122.97287981859411,124.73759637188209,47,42,86,2,41
701,65,24,122.97287981859411,125.80571428571429,47,45,129,3,41
702,65,304,122.97287981859411,125.57351473922903,47,19,264,3,239
703,65,445,122.97287981859411,124.0409977324263,47,20,383,1,380
704,65,428,122.97287981859411,125.38775510204081,47,20,378,2,363
705,49,24,124.27319727891157,125.80571428571429,44,45,71,2,25
706,49,304,124.27319727891157,125.57351473922903,44,19,261,1,255
707,49,284,124.27319727891157,126.40943310657596,44,25,252,2,235
708,49,214,124.27319727891157,126.80417233560091,44,23,198,3,165
709,49,428,124.27319727891157,125.38775510204081,44,20,382,1,379
710,49,444,124.27319727891157,126.06113378684807,44,19,402,2,395
711,49,445,124.27319727891157,126.73451247165534,44,19,410,2,396
712,24,46,124.73759637188209,127.40789115646258,42,48,117,3,22
713,24,284,124.73759637188209,126.40943310657596,42,25,270,2,260
714,24,214,124.73759637188209,126.80417233560091,42,23,210,2,190
715,24,444,124.73759637188209,126.06113378684807,42,19,424,1,420
716,24,445,124.73759637188209,126.73451247165534,42,19,430,2,421
717,24,46,125.80571428571429,127.40789115646258,45,48,72,2,22
718,24,46,125.80571428571429,127.73297052154196,45,47,86,2,22
719,24,304,125.80571428571429,128.05804988662132,45,21,296,2,280
720,24,427,125.80571428571429,128.08126984126986,45,20,415,2,403
721,46,41,127.40789115646258,129.3815873015873,48,47,85,2,5
722,46,41,127.40789115646258,130.1942857142857,48,48,120,3,5
723,46,277,127.40789115646258,129.12616780045352,48,21,243,2,231
724,46,206,127.40789115646258,130.2871655328798,48,22,202,3,160
725,46,427,127.40789115646258,129.42802721088435,48,21,391,2,381
726,46,445,127.40789115646258,130.12462585034015,48,19,416,3,399
727,46,41,127.73297052154196,129.3815873015873,47,47,71,2,5
728,46,41,127.73297052154196,130.1942857142857,47,48,106,2,5
729,46,277,127.73297052154196,129.12616780045352,47,21,239,1,231
730,46,206,127.73297052154196,130.2871655328798,47,22,194,3,160
731,46,427,127.73297052154196,129.42802721088435,47,21,388,2,381
732,46,445,127.73297052154196,130.12462585034015,47,19,412,2,399
733,41,36,129.3815873015873,131.93578231292517,47,48,110,3,5
734,41,206,129.3815873015873,130.84444444444443,47,23,177,1,165
735,41,427,129.3815873015873,130.77478458049887,47,20,391,1,386
736,41,427,129.3815873015873,132.12154195011337,47,20,404,3,386
737,41,36,130.1942857142857,131.93578231292517,48,48,75,2,5
738,41,258,130.1942857142857,132.53950113378684,48,16,239,2,217
739,41,264,130.1942857142857,133.0271201814059,48,20,254,3,223
740,41,427,130.1942857142857,132.12154195011337,48,20,395,2,386
741,41,36,130.8908843537415,131.93578231292517,47,48,45,1,5
742,41,64,130.8908843537415,133.23609977324264,47,44,104,2,23
743,41,258,130.8908843537415,132.53950113378684,47,16,228,2,217
744,41,264,130.8908843537415,133.0271201814059,47,20,241,2,223
745,41,213,130.8908843537415,133.81659863945578,47,27,213,3,172
746,41,427,130.8908843537415,132.12154195011337,47,20,390,1,386
747,41,427,130.8908843537415,133.4682993197279,47,21,402,3,386
748,36,64,131.93578231292517,133.23609977324264,48,44,63,1,28
749,36,62,131.93578231292517,134.1184580498866,48,43,98,2,26
750,36,264,131.93578231292517,133.0271201814059,48,20,233,1,228
751,36,213,131.93578231292517,133.81659863945578,48,27,195,2,177
752,36,427,131.93578231292517,133.4682993197279,48,21,397,2,391
753,36,443,131.93578231292517,134.16489795918366,48,18,418,2,407
754,36,445,131.93578231292517,134.8150566893424,48,21,427,3,409
755,64,27,133.23609977324264,135.1633560090703,44,44,91,2,37
756,64,61,133.23609977324264,135.92961451247166,44,47,116,3,3
757,64,278,133.23609977324264,135.11691609977325,44,27,229,2,214
758,64,445,133.23609977324264,134.8150566893424,44,21,387,2,381
759,62,27,134.1184580498866,135.1633560090703,43,44,57,1,35
760,62,61,134.1184580498866,135.92961451247166,43,47,78,2,1
761,62,28,134.1184580498866,137.09061224489795,43,42,132,3,34
762,62,214,134.1184580498866,136.2314739229025,43,36,177,2,152
763,62,289,134.1184580498866,136.71909297052156,43,29,253,3,227
764,27,28,135.1633560090703,137.09061224489795,44,42,83,2,1
765,27,214,135.1633560090703,136.2314739229025,44,36,193,1,187
766,27,289,135.1633560090703,136.71909297052156,44,29,270,2,262
767,27,278,135.1633560090703,138.04263038548754,44,28,280,3,251
768,27,445,135.1633560090703,137.50857142857143,44,20,430,2,418
769,27,502,135.1633560090703,137.7407709750567,44,19,488,3,475
770,61,28,135.92961451247166,137.09061224489795,47,42,60,1,33
771,61,60,135.92961451247166,138.15873015873015,47,45,96,2,1
772,61,72,135.92961451247166,138.7392290249433,47,46,121,3,11
773,61,278,135.92961451247166,138.04263038548754,47,28,235,2,217
774,61,445,135.92961451247166,137.50857142857143,47,20,390,2,384
775,61,502,135.92961451247166,137.7407709750567,47,19,448,2,441
776,61,427,135.92961451247166,138.85532879818595,47,20,387,3,366
777,28,60,137.09061224489795,138.15873015873015,42,45,56,1,32
778,28,72,137.09061224489795,138.7392290249433,42,46,84,2,44
779,28,42,137.09061224489795,139.85378684807256,42,45,120,3,14
780,28,205,137.09061224489795,139.48226757369613,42,33,205,2,177
781,28,243,137.09061224489795,139.784126984127,42,31,244,3,215
782,28,427,137.09061224489795,138.85532879818595,42,20,406,2,399
783,60,42,138.15873015873015,139.85378684807256,45,45,75,2,18
784,60,205,138.15873015873015,139.48226757369613,45,33,156,1,145
785,60,243,138.15873015873015,139.784126984127,45,31,196,2,183
786,60,290,138.15873015873015,140.82902494331066,45,28,257,3,230
787,60,427,138.15873015873015,140.20208616780045,45,20,377,2,367
788,72,42,138.7392290249433,139.85378684807256,46,45,57,1,30
789,72,82,138.7392290249433,141.5720634920635,46,46,122,3,10
790,72,243,138.7392290249433,139.784126984127,46,31,177,1,171
791,72,290,138.7392290249433,140.82902494331066,46,28,236,2,218
792,72,388,138.7392290249433,141.68816326530612,46,23,341,3,316
793,72,427,138.7392290249433,140.20208616780045,46,20,361,1,355
794,72,486,138.7392290249433,141.54884353741497,46,22,431,3,414
795,42,82,139.85378684807256,141.5720634920635,45,46,84,2,40
796,42,82,139.85378684807256,142.12934240362813,45,45,106,2,40
797,42,388,139.85378684807256,141.68816326530612,45,23,355,2,346
798,42,486,139.85378684807256,141.54884353741497,45,22,450,2,444
799,42,489,139.85378684807256,141.87392290249434,45,20,455,2,447
800,82,221,141.5720634920635,143.10458049886623,46,26,154,2,139
801,82,277,141.5720634920635,144.28879818594103,46,27,227,3,195
802,82,437,141.5720634920635,142.8956009070295,46,19,360,1,355
803,82,427,141.5720634920635,144.26557823129252,46,20,364,3,345
804,82,46,142.12934240362813,144.56743764172336,45,43,111,2,36
805,82,46,142.12934240362813,144.93895691609978,45,46,126,3,36
806,82,277,142.12934240362813,144.28879818594103,45,27,216,2,195
807,82,427,142.12934240362813,144.26557823129252,45,20,357,2,345
808,82,46,143.03492063492064,144.56743764172336,45,43,75,2,36
809,82,46,143.03492063492064,144.93895691609978,45,46,90,2,36
810,82,277,143.03492063492064,144.28879818594103,45,27,202,1,195
811,82,265,143.03492063492064,145.6587755102041,45,23,215,3,183
812,82,427,143.03492063492064,144.26557823129252,45,20,349,1,345
813,82,427,143.03492063492064,145.61233560090704,45,20,362,3,345
814,46,60,144.56743764172336,146.68045351473924,43,47,92,2,14
815,46,60,144.56743764172336,146.70367346938775,43,45,93,2,14
816,46,265,144.56743764172336,145.6587755102041,43,23,224,1,219
817,46,271,144.56743764172336,146.14639455782313,43,24,235,2,225
818,46,280,144.56743764172336,147.12163265306123,43,29,259,3,234
819,46,427,144.56743764172336,145.61233560090704,43,20,384,1,381
820,46,444,144.56743764172336,146.28571428571428,43,18,405,2,398
821,46,60,144.93895691609978,146.68045351473924,46,47,76,2,14
822,46,60,144.93895691609978,146.70367346938775,46,45,77,2,14
823,46,271,144.93895691609978,146.14639455782313,46,24,231,1,225
824,46,280,144.93895691609978,147.12163265306123,46,29,252,2,234
825,46,444,144.93895691609978,146.28571428571428,46,18,402,1,398
826,60,73,146.68045351473924,148.259410430839,47,47,69,2,13
827,60,61,146.68045351473924,149.141768707483,47,45,106,2,1
828,60,279,146.68045351473924,148.5380498866213,47,29,233,2,219
829,60,274,146.68045351473924,148.97922902494332,47,27,236,2,214
830,60,445,146.68045351473924,148.30585034013606,47,20,391,2,385
831,60,73,146.70367346938775,148.259410430839,45,47,68,2,13
832,60,61,146.70367346938775,149.141768707483,45,45,105,2,1
833,60,279,146.70367346938775,148.5380498866213,45,29,233,2,219
834,60,274,146.70367346938775,148.97922902494332,45,27,235,2,214
835,60,445,146.70367346938775,148.30585034013606,45,20,391,2,385
836,73,15,148.259410430839,149.72226757369614,47,42,86,1,58
837,73,46,148.259410430839,151.16190476190476,47,47,128,3,27
838,73,205,148.259410430839,150.51174603174604,47,38,164,2,132
839,73,276,148.259410430839,150.99936507936508,47,26,235,3,203
840,73,410,148.259410430839,149.69904761904763,47,23,343,1,337
841,73,410,148.259410430839,150.27954648526077,47,24,348,2,337
842,73,427,148.259410430839,150.99936507936508,47,21,373,3,354
843,61,46,149.141768707483,151.16190476190476,45,47,88,2,15
844,61,205,149.141768707483,150.51174603174604,45,38,156,1,144
845,61,276,149.141768707483,150.99936507936508,45,26,229,2,215
846,61,410,149.141768707483,150.27954648526077,45,24,352,1,349
847,61,427,149.141768707483,150.99936507936508,45,21,375,2,366
848,15,46,149.72226757369614,151.16190476190476,42,47,69,1,31
849,15,49,149.72226757369614,152.46222222222224,42,45,123,3,34
850,15,276,149.72226757369614,150.99936507936508,42,26,267,1,261
851,15,244,149.72226757369614,152.23002267573696,42,24,253,3,229
852,15,427,149.72226757369614,150.99936507936508,42,21,416,1,412
853,15,427,149.72226757369614,152.3461224489796,42,21,427,3,412
854,46,49,151.16190476190476,152.46222222222224,47,45,56,1,3
855,46,82,151.16190476190476,153.0659410430839,47,46,90,2,36
856,46,244,151.16190476190476,152.23002267573696,47,24,203,1,198
857,46,228,151.16190476190476,153.6928798185941,47,23,212,3,182
858,46,220,151.16190476190476,153.97151927437642,47,22,212,3,174
859,46,427,151.16190476190476,152.3461224489796,47,21,384,1,381
860,46,445,151.16190476190476,153.6928798185941,47,20,414,3,399
861,49,46,152.46222222222224,154.18049886621316,45,49,74,2,3
862,49,41,152.46222222222224,155.17895691609976,45,43,117,3,8
863,49,228,152.46222222222224,153.6928798185941,45,23,187,1,179
864,49,220,152.46222222222224,153.97151927437642,45,22,183,2,171
865,49,445,152.46222222222224,153.6928798185941,45,20,400,1,396
866,49,463,152.46222222222224,154.2037188208617,45,13,421,2,414
867,49,489,152.46222222222224,154.99319727891157,45,11,453,3,440
868,82,46,153.0659410430839,154.18049886621316,46,49,60,1,36
869,82,41,153.0659410430839,155.17895691609976,46,43,100,2,41
870,82,216,153.0659410430839,155.50403628117914,46,23,170,2,134
871,82,463,153.0659410430839,154.2037188208617,46,13,384,1,381
872,82,489,153.0659410430839,154.99319727891157,46,11,415,2,407
873,46,61,154.18049886621316,156.3399546485261,49,45,94,2,15
874,46,72,154.18049886621316,157.12943310657596,49,44,130,3,26
875,46,216,154.18049886621316,155.50403628117914,49,23,179,1,170
876,46,213,154.18049886621316,156.4560544217687,49,27,194,2,167
877,46,435,154.18049886621316,156.38639455782314,49,18,400,2,389
878,41,61,155.17895691609976,156.3399546485261,43,45,54,1,20
879,41,72,155.17895691609976,157.12943310657596,43,44,90,2,31
880,41,61,155.17895691609976,157.8724716553288,43,46,118,3,20
881,41,213,155.17895691609976,156.4560544217687,43,27,181,1,172
882,41,247,155.17895691609976,157.73315192743763,43,19,234,3,206
883,41,435,155.17895691609976,156.38639455782314,43,18,397,1,394
884,41,428,155.17895691609976,157.73315192743763,43,20,402,3,387
885,41,427,155.17895691609976,157.75637188208617,43,18,402,3,386
886,61,24,156.3399546485261,158.89414965986396,45,43,116,3,37
887,61,247,156.3399546485261,157.73315192743763,45,19,195,1,186
888,61,218,156.3399546485261,158.499410430839,45,36,182,2,157
889,61,219,156.3399546485261,159.17278911564625,45,22,200,3,158
890,61,428,156.3399546485261,157.73315192743763,45,20,372,1,367
891,61,427,156.3399546485261,157.75637188208617,45,18,371,1,366
892,61,436,156.3399546485261,159.07990929705215,45,22,393,3,375
893,72,24,157.12943310657596,158.89414965986396,44,43,90,2,48
894,72,23,157.12943310657596,159.96226757369615,44,46,131,3,49
895,72,218,157.12943310657596,158.499410430839,44,36,157,1,146
896,72,219,157.12943310657596,159.17278911564625,44,22,171,2,147
897,72,436,157.12943310657596,159.07990929705215,44,22,374,2,364
898,72,531,157.12943310657596,160.0319274376417,44,23,476,3,459
899,61,24,157.8724716553288,158.89414965986396,46,43,57,1,37
900,61,23,157.8724716553288,159.96226757369615,46,46,98,2,38
901,61,219,157.8724716553288,159.17278911564625,46,22,168,1,158
902,61,311,157.8724716553288,160.42666666666668,46,21,273,3,250
903,61,436,157.8724716553288,159.07990929705215,46,22,379,1,375
904,61,531,157.8724716553288,160.0319274376417,46,23,479,2,470
905,24,23,158.89414965986396,159.96226757369615,43,46,46,1,1
906,24,83,158.89414965986396,161.6108843537415,43,46,131,3,59
907,24,311,158.89414965986396,160.42666666666668,43,21,294,2,287
908,24,219,158.89414965986396,161.10004535147394,43,35,217,2,195
909,24,437,158.89414965986396,161.21614512471655,43,20,425,2,413
910,24,428,158.89414965986396,161.77342403628117,43,20,423,3,404
911,23,83,159.96226757369615,161.6108843537415,46,46,93,2,60
912,23,24,159.96226757369615,162.49324263038548,46,43,109,3,1
913,23,20,159.96226757369615,162.8647619047619,46,46,125,3,3
914,23,219,159.96226757369615,161.10004535147394,46,35,202,1,196
915,23,230,159.96226757369615,162.28426303854874,46,32,230,2,207
916,23,206,159.96226757369615,162.8647619047619,46,23,222,3,183
917,23,437,159.96226757369615,161.21614512471655,46,20,418,1,414
918,23,428,159.96226757369615,161.77342403628117,46,20,412,2,405
919,83,20,161.6108843537415,162.8647619047619,46,46,83,1,63
920,83,18,161.6108843537415,164.53659863945578,46,47,142,3,65
921,83,206,161.6108843537415,162.8647619047619,46,23,134,1,123
922,83,205,161.6108843537415,164.58303854875282,46,21,177,3,122
923,83,445,161.6108843537415,163.1201814058957,46,20,368,2,362
924,83,428,161.6108843537415,164.46693877551022,46,19,366,3,345
925,24,18,162.49324263038548,164.53659863945578,43,47,88,2,6
926,24,61,162.49324263038548,165.37251700680272,43,45,129,3,37
927,24,205,162.49324263038548,164.58303854875282,43,21,202,2,181
928,24,261,162.49324263038548,165.0009977324263,43,29,260,3,237
929,24,428,162.49324263038548,164.46693877551022,43,19,413,2,404
930,24,425,162.49324263038548,165.18675736961453,43,17,417,3,401
931,20,18,162.8647619047619,164.53659863945578,46,47,72,2,2
932,20,61,162.8647619047619,165.37251700680272,46,45,116,3,41
933,20,25,162.8647619047619,165.83691609977325,46,45,128,3,5
934,20,205,162.8647619047619,164.58303854875282,46,21,199,2,185
935,20,261,162.8647619047619,165.0009977324263,46,29,258,2,241
936,20,428,162.8647619047619,164.46693877551022,46,19,414,2,408
937,20,425,162.8647619047619,165.18675736961453,46,17,417,2,405
938,20,445,162.8647619047619,165.83691609977325,46,20,444,3,425
939,18,25,164.53659863945578,165.83691609977325,47,45,56,1,7
940,18,81,164.53659863945578,166.9514739229025,47,45,122,2,63
941,18,263,164.53659863945578,166.37097505668933,47,36,257,2,245
942,18,216,164.53659863945578,166.92825396825398,47,24,223,2,198
943,18,445,164.53659863945578,165.83691609977325,47,20,431,1,427
944,18,445,164.53659863945578,167.18367346938777,47,20,442,3,427
945,61,81,165.37251700680272,166.9514739229025,45,45,71,2,20
946,61,216,165.37251700680272,166.92825396825398,45,24,169,2,155
947,61,445,165.37251700680272,167.18367346938777,45,20,392,2,384
948,25,81,165.83691609977325,166.9514739229025,45,45,74,1,56
949,25,61,165.83691609977325,168.4607709750567,45,45,119,3,36
950,25,216,165.83691609977325,166.92825396825398,45,24,197,1,191
951,25,242,165.83691609977325,168.78585034013605,45,27,251,3,217
952,25,243,165.83691609977325,168.8090702947846,45,27,253,3,218
953,25,445,165.83691609977325,167.18367346938777,45,20,424,1,420
954,25,427,165.83691609977325,168.53043083900226,45,21,418,3,402
955,81,61,166.9514739229025,168.4607709750567,45,45,68,2,20
956,81,31,166.9514739229025,168.8322902494331,45,48,95,2,50
957,81,72,166.9514739229025,169.8075283446712,45,44,123,3,9
958,81,242,166.9514739229025,168.78585034013605,45,27,179,2,161
959,81,243,166.9514739229025,168.8090702947846,45,27,181,2,162
960,81,427,166.9514739229025,168.53043083900226,45,21,353,2,346
961,81,414,166.9514739229025,169.22702947845806,45,17,347,2,333
962,81,445,166.9514739229025,169.8771882086168,45,21,385,3,364
963,61,72,168.4607709750567,169.8075283446712,45,44,59,1,11
964,61,276,168.4607709750567,170.5273469387755,45,33,233,2,215
965,61,260,168.4607709750567,171.08462585034013,45,27,229,3,199
966,61,445,168.4607709750567,169.8771882086168,45,21,389,1,384
967,31,29,168.8322902494331,171.64190476190475,48,45,121,3,2
968,31,276,168.8322902494331,170.5273469387755,48,33,256,2,245
969,31,260,168.8322902494331,171.08462585034013,48,27,249,2,229
970,31,445,168.8322902494331,169.8771882086168,48,21,416,1,414
971,31,518,168.8322902494331,171.52580498866214,48,24,501,3,487
972,72,29,169.8075283446712,171.64190476190475,44,45,90,2,43
973,72,109,169.8075283446712,172.43138321995465,44,45,119,3,37
974,72,260,169.8075283446712,171.08462585034013,44,27,196,1,188
975,72,518,169.8075283446712,171.52580498866214,44,24,452,2,446
976,72,445,169.8075283446712,172.5707029478458,44,21,392,3,373
977,29,55,171.64190476190475,173.01188208616782,45,46,64,1,26
978,29,34,171.64190476190475,174.14965986394557,45,44,108,3,5
979,29,276,171.64190476190475,172.80290249433108,45,35,252,1,247
980,29,276,171.64190476190475,172.8261224489796,45,34,252,1,247
981,29,206,171.64190476190475,174.03356009070296,45,22,205,2,177
982,29,461,171.64190476190475,173.2673015873016,45,17,438,2,432
983,29,445,171.64190476190475,173.91746031746032,45,21,427,2,416
984,109,34,172.43138321995465,174.14965986394557,45,44,105,2,75
985,109,18,172.43138321995465,175.3106575963719,45,45,154,3,91
986,109,206,172.43138321995465,174.03356009070296,45,22,119,2,97
987,109,445,172.43138321995465,173.91746031746032,45,21,342,1,336
988,55,34,173.01188208616782,174.14965986394557,46,44,53,1,21
989,55,18,173.01188208616782,175.3106575963719,46,45,106,2,37
990,55,206,173.01188208616782,174.03356009070296,46,22,157,1,151
991,55,404,173.01188208616782,175.51963718820863,46,26,365,3,349
992,55,419,173.01188208616782,175.5892970521542,46,25,381,3,364
993,34,18,174.14965986394557,175.3106575963719,44,45,52,1,16
994,34,54,174.14965986394557,176.19301587301587,44,45,90,2,20
995,34,65,174.14965986394557,176.91283446712018,44,47,123,3,31
996,34,404,174.14965986394557,175.51963718820863,44,26,375,1,370
997,34,215,174.14965986394557,176.2162358276644,44,25,202,2,181
998,34,419,174.14965986394557,175.5892970521542,44,25,390,1,385
999,34,462,174.14965986394557,176.70385487528344,44,22,442,3,428
1000,34,489,174.14965986394557,177.05215419501135,44,20,472,3,455
1001,18,65,175.3106575963719,176.91283446712018,45,47,83,2,47
1002,18,71,175.3106575963719,177.86485260770976,45,45,122,3,53
1003,18,271,175.3106575963719,177.56299319727893,45,28,271,2,253
1004,18,217,175.3106575963719,178.1899319727891,45,24,234,3,199
1005,18,462,175.3106575963719,176.70385487528344,45,22,448,1,444
1006,18,489,175.3106575963719,177.05215419501135,45,20,477,2,471
1007,18,427,175.3106575963719,177.95773242630386,45,20,425,3,409
1008,54,71,176.19301587301587,177.86485260770976,45,45,74,2,17
1009,54,271,176.19301587301587,177.56299319727893,45,28,225,1,217
1010,54,217,176.19301587301587,178.1899319727891,45,24,184,2,163
1011,54,427,176.19301587301587,177.95773242630386,45,20,381,2,373
1012,65,24,176.91283446712018,179.69922902494332,47,46,127,3,41
1013,65,217,176.91283446712018,178.1899319727891,47,24,162,1,152
1014,65,304,176.91283446712018,179.30448979591836,47,22,260,2,239
1015,65,427,176.91283446712018,177.95773242630386,47,20,365,1,362
1016,65,446,176.91283446712018,179.30448979591836,47,21,395,2,381
1017,71,24,177.86485260770976,179.69922902494332,45,46,92,2,47
1018,71,49,177.86485260770976,180.76734693877552,45,49,127,3,22
1019,71,304,177.86485260770976,179.30448979591836,45,22,241,1,233
1020,71,214,177.86485260770976,180.72090702947847,45,22,189,3,143
1021,71,446,177.86485260770976,179.30448979591836,45,21,380,1,375
1022,71,445,177.86485260770976,180.65124716553288,45,20,393,3,374
1023,24,49,179.69922902494332,180.76734693877552,46,49,52,1,25
1024,24,46,179.69922902494332,180.95310657596372,46,48,58,1,22
1025,24,214,179.69922902494332,180.72090702947847,46,22,195,1,190
1026,24,228,179.69922902494332,181.06920634920635,46,18,212,1,204
1027,24,304,179.69922902494332,181.97478458049886,46,21,297,2,280
1028,24,443,179.69922902494332,181.34784580498868,46,19,425,2,419
1029,24,428,179.69922902494332,181.9980045351474,46,20,416,2,404
1030,49,27,180.76734693877552,182.69460317460317,49,46,86,2,22
1031,49,46,180.76734693877552,183.48408163265307,49,48,117,3,3
1032,49,304,180.76734693877552,181.97478458049886,49,21,260,1,255
1033,49,428,180.76734693877552,181.9980045351474,49,20,383,1,379
1034,49,427,180.76734693877552,183.36798185941043,49,20,394,3,378
1035,46,27,180.95310657596372,182.69460317460317,48,46,77,2,19
1036,46,41,180.95310657596372,183.90204081632655,48,48,127,3,5
1037,46,304,180.95310657596372,181.97478458049886,48,21,262,1,258
1038,46,205,180.95310657596372,183.76272108843537,48,20,200,3,159
1039,46,428,180.95310657596372,181.9980045351474,48,20,385,1,382
1040,46,427,180.95310657596372,183.36798185941043,48,20,395,2,381
1041,27,41,182.69460317460317,183.90204081632655,46,48,54,1,14
1042,27,41,182.69460317460317,184.87727891156462,46,46,95,2,14
1043,27,205,182.69460317460317,183.76272108843537,46,20,184,1,178
1044,27,206,182.69460317460317,184.761179138322,46,23,200,2,179
1045,27,206,182.69460317460317,184.9469387755102,46,21,204,2,179
1046,27,445,182.69460317460317,184.71473922902496,46,20,427,2,418
1047,27,444,182.69460317460317,185.3881179138322,46,17,433,3,417
1048,46,41,183.48408163265307,184.87727891156462,48,46,60,1,5
1049,46,18,183.48408163265307,186.1079365079365,48,46,116,3,28
1050,46,206,183.48408163265307,184.761179138322,48,23,169,1,160
1051,46,206,183.48408163265307,184.9469387755102,48,21,172,1,160
1052,46,223,183.48408163265307,186.06149659863945,48,27,209,3,177
1053,46,445,183.48408163265307,184.71473922902496,48,20,403,1,399
1054,46,444,183.48408163265307,185.3881179138322,48,17,406,2,398
1055,46,445,183.48408163265307,186.06149659863945,48,21,414,3,399
1056,41,18,183.90204081632655,186.1079365079365,48,46,98,2,23
1057,41,206,183.90204081632655,184.9469387755102,48,21,171,1,165
1058,41,223,183.90204081632655,186.06149659863945,48,27,204,2,182
1059,41,444,183.90204081632655,185.3881179138322,48,17,408,1,403
1060,41,445,183.90204081632655,186.06149659863945,48,21,415,2,404
1061,41,18,184.87727891156462,186.1079365079365,46,46,58,1,23
1062,41,49,184.87727891156462,187.36181405895692,46,47,107,2,8
1063,41,223,184.87727891156462,186.06149659863945,46,27,189,1,182
1064,41,222,184.87727891156462,187.0831746031746,46,28,204,2,181
1065,41,445,184.87727891156462,186.06149659863945,46,21,407,1,404
1066,18,49,186.1079365079365,187.36181405895692,46,47,62,1,31
1067,18,54,186.1079365079365,188.47637188208617,46,45,108,2,36
1068,18,246,186.1079365079365,188.03519274376418,46,28,243,2,228
1069,18,427,186.1079365079365,188.7550113378685,46,20,425,3,409
1070,49,54,187.36181405895692,188.47637188208617,47,45,48,1,5
1071,49,24,187.36181405895692,189.59092970521542,47,45,99,2,25
1072,49,24,187.36181405895692,189.98566893424038,47,45,116,3,25
1073,49,308,187.36181405895692,189.33551020408163,47,22,273,2,259
1074,49,427,187.36181405895692,188.7550113378685,47,20,383,1,378
1075,49,465,187.36181405895692,189.26585034013607,47,15,424,2,416
1076,54,24,188.47637188208617,189.59092970521542,45,45,57,1,30
1077,54,24,188.47637188208617,189.98566893424038,45,45,72,2,30
1078,54,24,188.47637188208617,190.96090702947845,45,37,111,2,30
1079,24,31,189.59092970521542,192.07546485260772,45,28,107,2,7
1080,24,31,189.98566893424038,192.07546485260772,45,28,90,2,7
1081,24,31,190.96090702947845,192.07546485260772,37,28,49,1,7
1082,275,19,0.7430385487528345,2.7399546485260773,15,43,270,2,256
1083,275,18,0.7430385487528345,3.4133333333333336,15,42,282,3,257
1084,275,293,0.7430385487528345,2.7631746031746034,15,17,89,2,18
1085,275,306,0.7430385487528345,3.3668934240362813,15,19,117,3,31
1086,275,446,0.7430385487528345,2.670294784580499,15,19,190,2,171
1087,275,444,0.7430385487528345,3.3668934240362813,15,18,203,3,169
1088,275,672,0.7430385487528345,2.716734693877551,15,15,406,2,397
1089,214,19,1.4396371882086167,2.7399546485260773,18,43,203,1,195
1090,214,18,1.4396371882086167,3.4133333333333336,18,42,214,2,196
1091,214,34,1.4396371882086167,4.272471655328799,18,43,217,3,180
1092,214,293,1.4396371882086167,2.7631746031746034,18,17,97,1,79
1093,214,306,1.4396371882086167,3.3668934240362813,18,19,124,2,92
1094,214,446,1.4396371882086167,2.670294784580499,18,19,238,1,232
1095,214,444,1.4396371882086167,3.3668934240362813,18,18,245,2,230
1096,214,427,1.4396371882086167,4.040272108843538,18,20,241,3,213
1097,214,672,1.4396371882086167,2.716734693877551,18,15,461,1,458
1098,214,672,1.4396371882086167,4.063492063492063,18,10,472,3,458
1099,293,34,2.7631746031746034,4.272471655328799,17,43,267,2,259
1100,293,28,2.7631746031746034,5.596009070294785,17,45,292,3,265
1101,293,297,2.7631746031746034,4.713650793650793,17,16,84,2,4
1102,293,210,2.7631746031746034,5.410249433106576,17,29,141,3,83
1103,293,427,2.7631746031746034,4.040272108843538,17,20,145,1,134
1104,293,427,2.7631746031746034,5.38702947845805,17,22,175,3,134
1105,293,672,2.7631746031746034,4.063492063492063,17,10,383,1,379
1106,306,28,3.3668934240362813,5.596009070294785,19,45,294,2,278
1107,306,297,3.3668934240362813,4.713650793650793,19,16,59,1,9
1108,306,210,3.3668934240362813,5.410249433106576,19,29,130,2,96
1109,306,274,3.3668934240362813,6.130068027210885,19,23,123,3,32
1110,306,427,3.3668934240362813,5.38702947845805,19,22,149,2,121
1111,306,638,3.3668934240362813,6.292607709750567,19,19,355,3,332
1112,297,61,4.713650793650793,6.524807256235828,16,43,249,2,236
1113,297,61,4.713650793650793,7.500045351473923,16,44,265,3,236
1114,297,274,4.713650793650793,6.130068027210885,16,23,65,1,23
1115,297,536,4.713650793650793,6.362267573696145,16,21,249,2,239
1116,297,414,4.713650793650793,7.430385487528345,16,17,165,3,117
1117,297,638,4.713650793650793,6.292607709750567,16,19,348,2,341
1118,297,622,4.713650793650793,7.198185941043084,16,9,342,2,325
1119,210,61,5.410249433106576,6.524807256235828,29,43,157,1,149
1120,210,61,5.410249433106576,7.500045351473923,29,44,174,2,149
1121,210,281,5.410249433106576,7.801904761904762,29,32,125,2,71
1122,210,414,5.410249433106576,7.430385487528345,29,17,222,2,204
1123,210,531,5.410249433106576,8.150204081632653,29,23,342,3,321
1124,210,622,5.410249433106576,7.198185941043084,29,9,419,2,412
1125,210,622,5.410249433106576,8.150204081632653,29,16,429,3,412
1126,274,61,6.130068027210885,7.500045351473923,23,44,221,1,213
1127,274,31,6.130068027210885,8.70748299319728,23,44,267,3,243
1128,274,281,6.130068027210885,7.801904761904762,23,32,72,2,7
1129,274,217,6.130068027210885,8.52172335600907,23,35,118,2,57
1130,274,414,6.130068027210885,7.430385487528345,23,17,151,1,140
1131,274,531,6.130068027210885,8.150204081632653,23,23,271,2,257
1132,274,622,6.130068027210885,7.198185941043084,23,9,351,1,348
1133,274,622,6.130068027210885,8.150204081632653,23,16,359,2,348
1134,281,18,7.801904761904762,9.47374149659864,32,44,273,2,263
1135,281,342,7.801904761904762,9.427301587301587,32,19,93,2,61
1136,281,445,7.801904761904762,9.427301587301587,32,20,178,2,164
1137,217,82,8.52172335600907,10.797278911564627,35,43,167,2,135
1138,217,61,8.52172335600907,11.261678004535147,35,46,196,3,156
1139,217,395,8.52172335600907,10.95981859410431,35,23,207,2,178
1140,217,292,8.52172335600907,11.052698412698414,35,24,132,3,75
1141,217,505,8.52172335600907,10.95981859410431,35,26,307,2,288
1142,217,443,8.52172335600907,11.470657596371883,35,18,259,3,226
1143,217,620,8.52172335600907,11.00625850340136,35,20,417,2,403
1144,217,616,8.52172335600907,11.052698412698414,35,15,414,3,399
1145,342,82,9.427301587301587,10.797278911564627,19,43,267,1,260
1146,342,61,9.427301587301587,11.261678004535147,19,46,292,2,281
1147,342,20,9.427301587301587,12.283356009070294,19,43,345,3,322
1148,342,395,9.427301587301587,10.95981859410431,19,23,85,2,53
1149,342,292,9.427301587301587,11.052698412698414,19,24,86,2,50
1150,342,505,9.427301587301587,10.95981859410431,19,26,176,2,163
1151,342,443,9.427301587301587,11.470657596371883,19,18,134,2,101
1152,342,427,9.427301587301587,12.120816326530612,19,20,144,3,85
1153,342,620,9.427301587301587,11.00625850340136,19,20,286,2,278
1154,342,616,9.427301587301587,11.052698412698414,19,15,283,2,274
1155,342,724,9.427301587301587,12.120816326530612,19,9,399,3,382
1156,395,20,10.95981859410431,12.283356009070294,23,43,379,1,375
1157,395,18,10.95981859410431,13.514013605442177,23,45,393,3,377
1158,395,219,10.95981859410431,12.84063492063492,23,16,194,2,176
1159,395,268,10.95981859410431,13.746213151927439,23,22,175,3,127
1160,395,427,10.95981859410431,12.120816326530612,23,20,59,1,32
1161,395,541,10.95981859410431,13.467573696145125,23,23,182,3,146
1162,395,724,10.95981859410431,12.120816326530612,23,9,333,1,329
1163,395,713,10.95981859410431,13.444353741496599,23,19,336,2,318
1164,395,878,10.95981859410431,12.817414965986394,23,15,490,2,483
1165,395,865,10.95981859410431,13.467573696145125,23,14,482,3,470
1166,292,20,11.052698412698414,12.283356009070294,24,43,277,1,272
1167,292,18,11.052698412698414,13.514013605442177,24,45,294,2,274
1168,292,219,11.052698412698414,12.84063492063492,24,16,106,2,73
1169,292,268,11.052698412698414,13.746213151927439,24,22,118,3,24
1170,292,427,11.052698412698414,12.120816326530612,24,20,143,1,135
1171,292,541,11.052698412698414,13.467573696145125,24,23,270,2,249
1172,292,724,11.052698412698414,12.120816326530612,24,9,434,1,432
1173,292,713,11.052698412698414,13.444353741496599,24,19,433,2,421
1174,219,24,12.84063492063492,14.280272108843537,16,43,205,1,195
1175,219,35,12.84063492063492,15.069750566893424,16,38,208,2,184
1176,219,268,12.84063492063492,14.09451247165533,16,20,73,1,49
1177,219,436,12.84063492063492,14.814331065759637,16,20,233,2,217
1178,219,443,12.84063492063492,15.51092970521542,16,18,252,3,224
1179,219,629,12.84063492063492,15.534149659863946,16,10,426,3,410
1180,268,35,13.746213151927439,15.069750566893424,22,38,240,1,233
1181,268,61,13.746213151927439,16.532607709750568,22,46,239,3,207
1182,268,264,13.746213151927439,15.905668934240364,22,18,93,2,4
1183,268,274,13.746213151927439,16.23074829931973,22,30,107,2,6
1184,268,436,13.746213151927439,14.814331065759637,22,20,174,1,168
1185,268,443,13.746213151927439,15.51092970521542,22,18,191,2,175
1186,268,427,13.746213151927439,16.16108843537415,22,21,190,2,159
1187,268,629,13.746213151927439,15.534149659863946,22,10,369,2,361
1188,268,617,13.746213151927439,16.207528344671204,22,11,365,2,349
1189,268,61,14.09451247165533,16.532607709750568,20,46,232,2,207
1190,268,264,14.09451247165533,15.905668934240364,20,18,78,2,4
1191,268,274,14.09451247165533,16.23074829931973,20,30,92,2,6
1192,268,443,14.09451247165533,15.51092970521542,20,18,185,1,175
1193,268,427,14.09451247165533,16.16108843537415,20,21,182,2,159
1194,268,629,14.09451247165533,15.534149659863946,20,10,366,1,361
1195,268,617,14.09451247165533,16.207528344671204,20,11,361,2,349
1196,264,61,15.905668934240364,17.34530612244898,18,45,212,1,203
1197,264,31,15.905668934240364,18.52952380952381,18,45,259,3,233
1198,264,277,15.905668934240364,17.902585034013605,18,29,87,2,13
1199,264,218,15.905668934240364,18.83138321995465,18,32,134,3,46
1200,264,436,15.905668934240364,17.507845804988662,18,21,185,2,172
1201,264,416,15.905668934240364,18.784943310657596,18,24,196,3,152
1202,264,639,15.905668934240364,17.136326530612244,18,17,379,1,375
1203,274,61,16.23074829931973,17.34530612244898,30,45,218,1,213
1204,274,31,16.23074829931973,18.52952380952381,30,45,262,2,243
1205,274,277,16.23074829931973,17.902585034013605,30,29,72,2,3
1206,274,218,16.23074829931973,18.83138321995465,30,32,125,3,56
1207,274,436,16.23074829931973,17.507845804988662,30,21,171,1,162
1208,274,416,16.23074829931973,18.784943310657596,30,24,180,3,142
1209,274,620,16.23074829931973,19.017142857142858,30,19,366,3,346
1210,277,31,17.902585034013605,19.644081632653062,29,44,257,2,246
1211,277,18,17.902585034013605,20.24780045351474,29,43,278,2,259
1212,277,216,17.902585034013605,19.272562358276645,29,34,85,1,61
1213,277,342,17.902585034013605,20.224580498866214,29,18,119,2,65
1214,277,612,17.902585034013605,19.388662131519276,29,19,341,1,335
1215,277,445,17.902585034013605,20.20136054421769,29,21,195,2,168
1216,277,620,17.902585034013605,19.017142857142858,29,19,346,1,343
1217,277,617,17.902585034013605,19.458321995464853,29,21,347,2,340
1218,218,18,18.83138321995465,20.24780045351474,32,43,209,1,200
1219,218,342,18.83138321995465,20.224580498866214,32,18,138,1,124
1220,218,445,18.83138321995465,20.20136054421769,32,21,235,1,227
1221,218,428,18.83138321995465,21.5481179138322,32,20,240,3,210
1222,216,28,19.272562358276645,21.826757369614512,34,46,218,3,188
1223,216,276,19.272562358276645,22.03573696145125,34,35,133,3,60
1224,216,276,19.272562358276645,22.105396825396827,34,35,136,3,60
1225,216,428,19.272562358276645,21.5481179138322,34,20,234,2,212
1226,216,638,19.272562358276645,21.989297052154196,34,13,438,3,422
1227,216,644,19.272562358276645,22.105396825396827,34,10,445,3,428
1228,342,28,20.224580498866214,21.826757369614512,18,46,321,2,314
1229,342,24,20.224580498866214,22.430476190476192,18,46,332,2,318
1230,342,35,20.224580498866214,23.1502947845805,18,42,332,3,307
1231,342,276,20.224580498866214,22.03573696145125,18,35,102,2,66
1232,342,276,20.224580498866214,22.105396825396827,18,35,104,2,66
1233,342,428,20.224580498866214,21.5481179138322,18,20,103,1,86
1234,342,427,20.224580498866214,22.918095238095237,18,20,144,3,85
1235,342,638,20.224580498866214,21.989297052154196,18,13,306,2,296
1236,342,644,20.224580498866214,22.105396825396827,18,10,313,2,302
1237,276,35,22.03573696145125,23.1502947845805,35,42,246,1,241
1238,276,82,22.03573696145125,24.61315192743764,35,45,224,3,194
1239,276,219,22.03573696145125,23.61469387755102,35,16,89,2,57
1240,276,206,22.03573696145125,24.473832199546486,35,27,126,2,70
1241,276,444,22.03573696145125,23.591473922902495,35,18,181,2,168
1242,276,489,22.03573696145125,24.264852607709752,35,23,234,2,213
1243,276,715,22.03573696145125,24.241632653061224,35,18,449,2,439
1244,276,35,22.105396825396827,23.1502947845805,35,42,245,1,241
1245,276,82,22.105396825396827,24.61315192743764,35,45,222,3,194
1246,276,219,22.105396825396827,23.61469387755102,35,16,86,2,57
1247,276,206,22.105396825396827,24.473832199546486,35,27,124,2,70
1248,276,444,22.105396825396827,23.591473922902495,35,18,180,1,168
1249,276,489,22.105396825396827,24.264852607709752,35,23,232,2,213
1250,276,715,22.105396825396827,24.241632653061224,35,18,449,2,439
1251,219,25,23.61469387755102,25.240090702947846,16,44,206,2,194
1252,219,305,23.61469387755102,26.28498866213152,16,14,144,3,86
1253,219,427,23.61469387755102,25.611609977324264,16,20,225,2,208
1254,219,629,23.61469387755102,26.33142857142857,16,9,426,3,410
1255,206,20,24.473832199546486,27.028027210884353,27,41,216,3,186
1256,206,219,24.473832199546486,25.658049886621317,27,14,53,1,13
1257,206,305,24.473832199546486,26.28498866213152,27,14,126,2,99
1258,206,427,24.473832199546486,25.611609977324264,27,20,226,1,221
1259,206,427,24.473832199546486,26.958367346938775,27,20,246,2,221
1260,206,629,24.473832199546486,26.33142857142857,27,9,430,2,423
1261,219,20,25.658049886621317,27.028027210884353,14,41,208,1,199
1262,219,20,25.658049886621317,27.678185941043086,14,42,217,2,199
1263,219,225,25.658049886621317,27.654965986394558,14,15,86,2,6
1264,219,427,25.658049886621317,26.958367346938775,14,20,215,1,208
1265,219,443,25.658049886621317,27.654965986394558,14,17,240,2,224
1266,305,20,26.28498866213152,27.678185941043086,14,42,291,1,285
1267,305,64,26.28498866213152,28.76952380952381,14,45,264,2,241
1268,305,72,26.28498866213152,29.23392290249433,14,44,265,3,233
1269,305,225,26.28498866213152,27.654965986394558,14,15,99,1,80
1270,305,260,26.28498866213152,28.93206349206349,14,23,123,3,45
1271,305,443,26.28498866213152,27.654965986394558,14,17,150,1,138
1272,305,422,26.28498866213152,28.93206349206349,14,24,163,3,117
1273,305,784,26.28498866213152,28.35156462585034,14,10,487,2,479
1274,225,64,27.654965986394558,28.76952380952381,15,45,168,1,161
1275,225,72,27.654965986394558,29.23392290249433,15,44,167,2,153
1276,225,260,27.654965986394558,28.93206349206349,15,23,65,1,35
1277,225,258,27.654965986394558,30.02340136054422,15,30,107,2,33
1278,225,275,27.654965986394558,30.394920634920634,15,28,128,3,50
1279,225,422,27.654965986394558,28.93206349206349,15,24,205,1,197
1280,225,427,27.654965986394558,29.651882086167802,15,20,220,2,202
1281,225,630,27.654965986394558,30.046621315192745,15,15,418,2,405
1282,260,61,28.93206349206349,30.78965986394558,23,48,214,2,199
1283,260,19,28.93206349206349,31.71845804988662,23,45,269,3,241
1284,260,258,28.93206349206349,30.02340136054422,23,30,47,1,2
1285,260,275,28.93206349206349,30.394920634920634,23,28,65,1,15
1286,260,275,28.93206349206349,31.207619047619048,23,18,99,2,15
1287,260,436,28.93206349206349,30.998639455782314,23,21,197,2,176
1288,260,443,28.93206349206349,31.695238095238096,23,18,218,3,183
1289,260,630,28.93206349206349,30.046621315192745,23,15,373,1,370
1290,260,631,28.93206349206349,30.78965986394558,23,16,380,2,371
1291,258,19,30.02340136054422,31.71845804988662,30,45,250,2,239
1292,258,31,30.02340136054422,32.55437641723356,30,46,252,3,227
1293,258,275,30.02340136054422,31.207619047619048,30,18,54,1,17
1294,258,261,30.02340136054422,32.76335600907029,30,36,118,3,3
1295,258,443,30.02340136054422,31.695238095238096,30,18,199,2,185
1296,258,427,30.02340136054422,32.345396825396826,30,21,196,2,169
1297,258,619,30.02340136054422,32.786575963718825,30,21,380,3,361
1298,275,19,30.394920634920634,31.71845804988662,28,45,262,1,256
1299,275,31,30.394920634920634,32.55437641723356,28,46,261,2,244
1300,275,261,30.394920634920634,32.76335600907029,28,36,103,2,14
1301,275,443,30.394920634920634,31.695238095238096,28,18,177,1,168
1302,275,427,30.394920634920634,32.345396825396826,28,21,174,2,152
1303,275,619,30.394920634920634,32.786575963718825,28,21,359,2,344
1304,275,31,31.207619047619048,32.55437641723356,18,46,251,1,244
1305,275,66,31.207619047619048,34.11011337868481,18,45,244,3,209
1306,275,261,31.207619047619048,32.76335600907029,18,36,68,2,14
1307,275,264,31.207619047619048,34.04045351473923,18,25,122,3,11
1308,275,427,31.207619047619048,32.345396825396826,18,21,160,1,152
1309,275,445,31.207619047619048,33.69215419501134,18,21,201,2,170
1310,275,619,31.207619047619048,32.786575963718825,18,21,351,2,344
1311,275,635,31.207619047619048,33.552834467120185,18,17,374,2,360
1312,261,66,32.76335600907029,34.11011337868481,36,45,203,1,195
1313,261,24,32.76335600907029,35.10857142857143,36,48,258,2,237
1314,261,24,32.76335600907029,35.15501133786848,36,47,258,2,237
1315,261,264,32.76335600907029,34.04045351473923,36,25,55,1,3
1316,261,221,32.76335600907029,34.644172335600906,36,26,90,2,40
1317,261,219,32.76335600907029,35.294331065759636,36,24,117,3,42
1318,261,462,32.76335600907029,34.89959183673469,36,21,221,2,201
1319,261,432,32.76335600907029,35.20145124716554,36,24,201,2,171
1320,264,24,34.04045351473923,35.10857142857143,25,48,244,1,240
1321,264,24,34.04045351473923,35.15501133786848,25,47,245,1,240
1322,264,28,34.04045351473923,36.17668934240363,25,43,253,2,236
1323,264,219,34.04045351473923,35.294331065759636,25,24,70,1,45
1324,264,432,34.04045351473923,35.20145124716554,25,24,175,1,168
1325,221,28,34.644172335600906,36.17668934240363,26,43,204,2,193
1326,219,62,35.294331065759636,37.802086167800454,24,47,191,3,157
1327,219,221,35.294331065759636,37.151927437641724,24,14,80,2,2
1328,219,248,35.294331065759636,37.755646258503404,24,27,110,2,29
1329,219,443,35.294331065759636,37.73242630385488,24,19,247,2,224
1330,219,619,35.294331065759636,37.755646258503404,24,15,414,2,400
1331,221,61,37.151927437641724,39.14884353741497,14,45,182,2,160
1332,221,61,37.151927437641724,39.19528344671202,14,46,183,2,160
1333,221,276,37.151927437641724,39.14884353741497,14,21,102,2,55
1334,221,218,37.151927437641724,39.72934240362812,14,38,111,3,3
1335,221,428,37.151927437641724,39.07918367346939,14,19,223,2,207
1336,221,512,37.151927437641724,39.65968253968254,14,20,310,3,291
1337,221,672,37.151927437641724,39.10240362811791,14,12,459,2,451
1338,248,61,37.755646258503404,39.14884353741497,27,45,196,1,187
1339,248,61,37.755646258503404,39.19528344671202,27,46,197,1,187
1340,248,276,37.755646258503404,39.14884353741497,27,21,66,1,28
1341,248,218,37.755646258503404,39.72934240362812,27,38,90,2,30
1342,248,306,37.755646258503404,40.51882086167801,27,18,132,3,58
1343,248,428,37.755646258503404,39.07918367346939,27,19,189,1,180
1344,248,512,37.755646258503404,39.65968253968254,27,20,276,2,264
1345,248,428,37.755646258503404,40.4259410430839,27,20,214,3,180
1346,248,672,37.755646258503404,39.10240362811791,27,12,428,1,424
1347,276,18,39.14884353741497,41.145759637188206,21,45,272,2,258
1348,276,31,39.14884353741497,41.81913832199547,21,45,271,3,245
1349,276,306,39.14884353741497,40.51882086167801,21,18,66,1,30
1350,276,271,39.14884353741497,41.86557823129252,21,19,117,3,5
1351,276,428,39.14884353741497,40.4259410430839,21,20,162,1,152
1352,276,489,39.14884353741497,41.40117913832199,21,25,234,2,213
1353,276,660,39.14884353741497,41.40117913832199,21,15,396,2,384
1354,218,18,39.72934240362812,41.145759637188206,38,45,209,1,200
1355,218,31,39.72934240362812,41.81913832199547,38,45,208,2,187
1356,218,271,39.72934240362812,41.86557823129252,38,19,106,2,53
1357,218,219,39.72934240362812,42.49251700680272,38,35,119,3,1
1358,218,489,39.72934240362812,41.40117913832199,38,25,280,2,271
1359,218,660,39.72934240362812,41.40117913832199,38,15,448,2,442
1360,218,621,39.72934240362812,42.4692970521542,38,12,420,3,403
1361,306,31,40.51882086167801,41.81913832199547,18,45,281,1,275
1362,306,83,40.51882086167801,42.956916099773245,18,44,246,2,223
1363,306,23,40.51882086167801,43.46775510204082,18,44,310,3,283
1364,306,271,40.51882086167801,41.86557823129252,18,19,68,1,35
1365,306,219,40.51882086167801,42.49251700680272,18,35,122,2,87
1366,306,427,40.51882086167801,43.14267573696145,18,20,166,3,121
1367,306,621,40.51882086167801,42.4692970521542,18,12,326,2,315
1368,271,83,41.86557823129252,42.956916099773245,19,44,194,1,188
1369,271,23,41.86557823129252,43.46775510204082,19,44,257,2,248
1370,271,20,41.86557823129252,44.210793650793654,19,45,271,2,251
1371,271,229,41.86557823129252,43.6302947845805,19,30,87,2,42
1372,271,312,41.86557823129252,44.489433106575966,19,16,120,3,41
1373,271,427,41.86557823129252,43.14267573696145,19,20,165,1,156
1374,271,425,41.86557823129252,43.83927437641724,19,17,176,2,154
1375,271,427,41.86557823129252,44.489433106575966,19,20,193,3,156
1376,271,668,41.86557823129252,43.67673469387755,19,12,405,2,397
1377,271,752,41.86557823129252,44.489433106575966,19,10,494,3,481
1378,219,20,42.49251700680272,44.210793650793654,35,45,212,2,199
1379,219,229,42.49251700680272,43.6302947845805,35,30,50,1,10
1380,219,312,42.49251700680272,44.489433106575966,35,16,127,2,93
1381,219,425,42.49251700680272,43.83927437641724,35,17,214,1,206
1382,219,427,42.49251700680272,44.489433106575966,35,20,225,2,208
1383,219,668,42.49251700680272,43.67673469387755,35,12,452,1,449
1384,229,18,43.6302947845805,45.88263038548753,30,46,232,2,211
1385,229,267,43.6302947845805,45.81297052154195,30,21,101,2,38
1386,229,261,43.6302947845805,46.34702947845805,30,29,121,3,32
1387,229,438,43.6302947845805,45.81297052154195,30,20,229,2,209
1388,229,617,43.6302947845805,45.952290249433105,30,12,401,2,388
1389,312,18,44.489433106575966,45.88263038548753,16,46,300,1,294
1390,312,61,44.489433106575966,46.672108843537416,16,47,268,2,251
1391,312,267,44.489433106575966,45.81297052154195,16,21,73,1,45
1392,312,261,44.489433106575966,46.34702947845805,16,29,95,2,51
1393,312,438,44.489433106575966,45.81297052154195,16,20,138,1,126
1394,312,427,44.489433106575966,47.18294784580499,16,21,163,3,115
1395,312,617,44.489433106575966,45.952290249433105,16,12,311,1,305
1396,312,633,44.489433106575966,47.09006802721088,16,10,340,3,321
1397,267,25,45.81297052154195,47.484807256235825,21,45,252,2,242
1398,267,81,45.81297052154195,48.29750566893424,21,46,215,2,186
1399,267,263,45.81297052154195,47.71700680272109,21,35,82,2,4
1400,267,243,45.81297052154195,48.29750566893424,21,23,110,2,24
1401,267,427,45.81297052154195,47.18294784580499,21,21,171,1,160
1402,267,444,45.81297052154195,47.85632653061224,21,17,198,2,177
1403,267,427,45.81297052154195,48.529705215419504,21,20,198,3,160
1404,267,633,45.81297052154195,47.09006802721088,21,10,370,1,366
1405,267,755,45.81297052154195,47.78666666666667,21,16,495,2,488
1406,267,700,45.81297052154195,48.50648526077098,21,11,448,3,433
1407,261,25,46.34702947845805,47.484807256235825,29,45,241,1,236
1408,261,81,46.34702947845805,48.29750566893424,29,46,199,2,180
1409,261,263,46.34702947845805,47.71700680272109,29,35,59,1,2
1410,261,243,46.34702947845805,48.29750566893424,29,23,86,2,18
1411,261,444,46.34702947845805,47.85632653061224,29,17,194,2,183
1412,261,427,46.34702947845805,48.529705215419504,29,20,191,2,166
1413,261,755,46.34702947845805,47.78666666666667,29,16,498,1,494
1414,261,700,46.34702947845805,48.50648526077098,29,11,449,2,439
1415,263,31,47.71700680272109,50.178321995464856,35,46,255,2,232
1416,263,109,47.71700680272109,50.59628117913832,35,46,198,3,154
1417,263,214,47.71700680272109,50.178321995464856,35,27,117,2,49
1418,263,254,47.71700680272109,50.24798185941043,35,33,109,3,9
1419,263,445,47.71700680272109,49.87646258503401,35,21,204,2,182
1420,263,673,47.71700680272109,49.89968253968254,35,10,421,2,410
1421,263,743,47.71700680272109,50.43374149659864,35,16,494,3,480
1422,243,31,48.29750566893424,50.178321995464856,23,46,227,2,212
1423,243,109,48.29750566893424,50.59628117913832,23,46,167,2,134
1424,243,18,48.29750566893424,51.26965986394558,23,44,259,3,225
1425,243,214,48.29750566893424,50.178321995464856,23,27,86,2,29
1426,243,254,48.29750566893424,50.24798185941043,23,33,85,2,11
1427,243,445,48.29750566893424,49.87646258503401,23,21,213,2,202
1428,243,445,48.29750566893424,51.22321995464853,23,21,238,3,202
1429,243,556,48.29750566893424,51.24643990929705,23,19,338,3,313
1430,243,673,48.29750566893424,49.89968253968254,23,10,436,2,430
1431,214,18,50.178321995464856,51.26965986394558,27,44,202,1,196
1432,214,18,50.178321995464856,52.61641723356009,27,45,222,2,196
1433,214,264,50.178321995464856,51.316099773242634,27,24,70,1,50
1434,214,218,50.178321995464856,52.45387755102041,27,37,98,2,4
1435,214,445,50.178321995464856,51.22321995464853,27,21,235,1,231
1436,214,556,50.178321995464856,51.24643990929705,27,19,345,1,342
1437,214,486,50.178321995464856,52.895056689342404,27,22,296,3,272
1438,214,673,50.178321995464856,51.89659863945578,27,11,465,2,459
1439,214,684,50.178321995464856,52.848616780045354,27,20,484,3,470
1440,254,18,50.24798185941043,51.26965986394558,33,44,240,1,236
1441,254,18,50.24798185941043,52.61641723356009,33,45,257,2,236
1442,254,264,50.24798185941043,51.316099773242634,33,24,47,1,10
1443,254,218,50.24798185941043,52.45387755102041,33,37,102,2,36
1444,254,486,50.24798185941043,52.895056689342404,33,22,258,3,232
1445,254,673,50.24798185941043,51.89659863945578,33,11,425,2,419
1446,254,684,50.24798185941043,52.848616780045354,33,20,444,3,430
1447,264,18,51.316099773242634,52.61641723356009,24,45,252,1,246
1448,264,41,51.316099773242634,53.68453514739229,24,47,245,2,223
1449,264,218,51.316099773242634,52.45387755102041,24,37,67,1,46
1450,264,231,51.316099773242634,54.218594104308394,24,31,129,3,33
1451,264,230,51.316099773242634,54.24181405895692,24,33,131,3,34
1452,264,486,51.316099773242634,52.895056689342404,24,22,232,2,222
1453,264,445,51.316099773242634,53.91673469387755,24,21,213,3,181
1454,264,684,51.316099773242634,52.848616780045354,24,20,425,2,420
1455,218,41,52.45387755102041,53.68453514739229,37,47,185,1,177
1456,218,20,52.45387755102041,55.00807256235828,37,45,227,3,198
1457,218,231,52.45387755102041,54.218594104308394,37,31,77,2,13
1458,218,230,52.45387755102041,54.24181405895692,37,33,78,2,12
1459,218,445,52.45387755102041,53.91673469387755,37,21,236,1,227
1460,218,543,52.45387755102041,54.61333333333334,37,18,338,2,325
1461,218,427,52.45387755102041,55.263492063492066,37,22,241,3,209
1462,218,673,52.45387755102041,54.61333333333334,37,12,464,2,455
1463,231,34,54.218594104308394,55.49569160997733,31,44,205,1,197
1464,231,18,54.218594104308394,56.679909297052156,31,46,238,2,213
1465,231,219,54.218594104308394,55.98331065759637,31,17,77,2,12
1466,231,404,54.218594104308394,56.86566893424036,31,25,207,3,173
1467,231,427,54.218594104308394,55.263492063492066,31,22,201,1,196
1468,231,419,54.218594104308394,56.93532879818594,31,24,221,3,188
1469,231,616,54.218594104308394,55.960090702947845,31,10,392,2,385
1470,231,622,54.218594104308394,56.65668934240363,31,20,405,2,391
1471,230,34,54.24181405895692,55.49569160997733,33,44,203,1,196
1472,230,18,54.24181405895692,56.679909297052156,33,46,237,2,212
1473,230,219,54.24181405895692,55.98331065759637,33,17,76,2,11
1474,230,404,54.24181405895692,56.86566893424036,33,25,207,3,174
1475,230,427,54.24181405895692,55.263492063492066,33,22,202,1,197
1476,230,419,54.24181405895692,56.93532879818594,33,24,222,3,189
1477,230,616,54.24181405895692,55.960090702947845,33,10,393,2,386
1478,230,622,54.24181405895692,56.65668934240363,33,20,406,2,392
1479,219,65,55.98331065759637,58.258866213151926,17,47,183,2,154
1480,219,65,55.98331065759637,58.28208616780046,17,45,183,2,154
1481,219,215,55.98331065759637,57.58548752834467,17,24,69,2,4
1482,219,271,55.98331065759637,58.90902494331066,17,28,136,3,52
1483,219,462,55.98331065759637,58.049886621315196,17,22,259,2,243
1484,219,561,55.98331065759637,58.42140589569161,17,18,358,2,342
1485,219,646,55.98331065759637,58.02666666666667,17,17,436,2,427
1486,219,697,55.98331065759637,58.42140589569161,17,14,489,2,478
1487,404,65,56.86566893424036,58.258866213151926,25,47,344,1,339
1488,404,65,56.86566893424036,58.28208616780046,25,45,344,1,339
1489,404,81,56.86566893424036,59.32698412698413,25,43,340,2,323
1490,404,271,56.86566893424036,58.90902494331066,25,28,159,2,133
1491,404,217,56.86566893424036,59.53596371882086,25,23,220,3,187
1492,404,462,56.86566893424036,58.049886621315196,25,22,77,1,58
1493,404,561,56.86566893424036,58.42140589569161,25,18,171,2,157
1494,404,445,56.86566893424036,59.303764172335605,25,21,113,2,41
1495,404,646,56.86566893424036,58.02666666666667,25,17,247,1,242
1496,404,697,56.86566893424036,58.42140589569161,25,14,301,2,293
1497,404,873,56.86566893424036,58.6768253968254,25,16,475,2,469
1498,215,81,57.58548752834467,59.32698412698413,24,43,154,2,134
1499,215,271,57.58548752834467,58.90902494331066,24,28,80,1,56
1500,215,217,57.58548752834467,59.53596371882086,24,23,84,2,2
1501,215,445,57.58548752834467,59.303764172335605,24,21,242,2,230
1502,215,633,57.58548752834467,60.02358276643991,24,10,431,2,418
1503,271,23,58.90902494331066,61.02204081632653,28,43,264,2,248
1504,271,350,58.90902494331066,60.67374149659864,28,18,110,2,79
1505,271,286,58.90902494331066,61.69541950113379,28,25,121,3,15
1506,271,446,58.90902494331066,60.65052154195011,28,20,190,2,175
1507,271,633,58.90902494331066,60.02358276643991,28,10,365,1,362
1508,271,670,58.90902494331066,60.65052154195011,28,12,406,2,399
1509,271,675,58.90902494331066,61.3471201814059,28,11,417,2,404
1510,217,23,59.53596371882086,61.02204081632653,23,43,204,1,194
1511,217,49,59.53596371882086,62.15981859410431,23,48,202,3,168
1512,217,350,59.53596371882086,60.67374149659864,23,18,142,1,133
1513,217,286,59.53596371882086,61.69541950113379,23,25,116,2,69
1514,217,446,59.53596371882086,60.65052154195011,23,20,234,1,229
1515,217,445,59.53596371882086,61.99727891156463,23,20,251,2,228
1516,217,670,59.53596371882086,60.65052154195011,23,12,456,1,453
1517,217,675,59.53596371882086,61.3471201814059,23,11,465,2,458
1518,350,49,60.67374149659864,62.15981859410431,18,48,308,1,301
1519,350,46,60.67374149659864,62.69387755102041,18,48,316,2,304
1520,350,18,60.67374149659864,63.41369614512472,18,45,352,3,332
1521,350,286,60.67374149659864,61.69541950113379,18,25,78,1,64
1522,350,206,60.67374149659864,62.78675736961451,18,18,170,2,144
1523,350,310,60.67374149659864,63.36725623582767,18,19,123,3,40
1524,350,445,60.67374149659864,61.99727891156463,18,20,111,1,95
1525,350,443,60.67374149659864,62.69387755102041,18,19,127,2,93
1526,350,445,60.67374149659864,63.36725623582767,18,20,150,3,95
1527,350,789,60.67374149659864,63.39047619047619,18,14,454,3,439
1528,286,18,61.69541950113379,63.41369614512472,25,45,278,2,268
1529,286,206,61.69541950113379,62.78675736961451,25,18,93,1,80
1530,286,310,61.69541950113379,63.36725623582767,25,19,76,2,24
1531,286,276,61.69541950113379,64.38893424036281,25,22,116,3,10
1532,286,445,61.69541950113379,63.36725623582767,25,20,175,2,159
1533,206,41,62.78675736961451,65.2712925170068,18,47,197,2,165
1534,206,276,62.78675736961451,64.38893424036281,18,22,98,2,70
1535,206,427,62.78675736961451,64.71401360544218,18,20,236,2,221
1536,310,41,63.36725623582767,65.2712925170068,19,47,281,2,269
1537,310,41,63.36725623582767,65.89823129251701,19,48,290,3,269
1538,310,276,63.36725623582767,64.38893424036281,19,22,56,1,34
1539,310,286,63.36725623582767,66.06077097505668,19,17,118,3,24
1540,310,427,63.36725623582767,64.71401360544218,19,20,131,1,117
1541,310,427,63.36725623582767,66.06077097505668,19,20,165,3,117
1542,276,41,64.38893424036281,65.89823129251701,22,48,244,2,235
1543,276,36,64.38893424036281,66.85024943310658,22,45,262,2,240
1544,276,286,64.38893424036281,66.06077097505668,22,17,73,2,10
1545,276,219,64.38893424036281,66.80380952380952,22,15,119,2,57
1546,276,427,64.38893424036281,66.06077097505668,22,20,167,2,151
1547,276,443,64.38893424036281,66.75736961451247,22,17,196,2,167
1548,276,616,64.38893424036281,66.73414965986395,22,9,355,2,340
1549,286,18,66.06077097505668,67.45396825396826,17,45,275,1,268
1550,286,64,66.06077097505668,68.3827664399093,17,45,243,2,222
1551,286,261,66.06077097505668,67.91836734693878,17,20,84,2,25
1552,286,427,66.06077097505668,67.4075283446712,17,21,152,1,141
1553,286,427,66.06077097505668,68.75428571428571,17,21,183,3,141
1554,219,64,66.80380952380952,68.3827664399093,15,45,169,2,155
1555,219,261,66.80380952380952,67.91836734693878,15,20,64,1,42
1556,219,213,66.80380952380952,69.07936507936508,15,27,98,2,6
1557,219,427,66.80380952380952,68.75428571428571,15,21,224,2,208
1558,261,49,67.91836734693878,70.12426303854875,20,42,232,2,212
1559,261,61,67.91836734693878,70.82086167800453,20,45,236,3,200
1560,261,213,67.91836734693878,69.07936507936508,20,27,69,1,48
1561,261,207,67.91836734693878,70.14748299319729,20,30,110,2,54
1562,261,212,67.91836734693878,70.86730158730158,20,28,136,3,49
1563,261,427,67.91836734693878,70.10104308390022,20,21,191,2,166
1564,261,623,67.91836734693878,70.19392290249434,20,14,375,2,362
1565,261,623,67.91836734693878,70.4261224489796,20,19,378,3,362
1566,213,49,69.07936507936508,70.12426303854875,27,42,170,1,164
1567,213,61,69.07936507936508,70.82086167800453,27,45,169,2,152
1568,213,207,69.07936507936508,70.14748299319729,27,30,46,1,6
1569,213,212,69.07936507936508,70.86730158730158,27,28,77,2,1
1570,213,427,69.07936507936508,70.10104308390022,27,21,218,1,214
1571,213,598,69.07936507936508,71.09950113378684,27,19,395,2,385
1572,213,574,69.07936507936508,71.95863945578232,27,24,382,3,361
1573,213,623,69.07936507936508,70.19392290249434,27,14,413,1,410
1574,213,623,69.07936507936508,70.4261224489796,27,19,414,1,410
1575,213,618,69.07936507936508,72.00507936507937,27,20,424,3,405
1576,207,60,70.14748299319729,72.2140589569161,30,46,172,2,147
1577,207,82,70.14748299319729,72.56235827664399,30,45,163,2,125
1578,207,209,70.14748299319729,72.19083900226758,30,29,88,2,2
1579,207,574,70.14748299319729,71.95863945578232,30,24,375,2,367
1580,207,540,70.14748299319729,72.95709750566894,30,22,354,3,333
1581,207,618,70.14748299319729,72.00507936507937,30,20,419,2,411
1582,207,633,70.14748299319729,72.91065759637188,30,17,442,3,426
1583,212,60,70.86730158730158,72.2140589569161,28,46,163,1,152
1584,212,82,70.86730158730158,72.56235827664399,28,45,149,2,130
1585,212,209,70.86730158730158,72.19083900226758,28,29,57,1,3
1586,212,215,70.86730158730158,73.32861678004535,28,34,106,2,3
1587,212,215,70.86730158730158,73.35183673469388,28,33,107,2,3
1588,212,574,70.86730158730158,71.95863945578232,28,24,365,1,362
1589,212,540,70.86730158730158,72.95709750566894,28,22,340,2,328
1590,212,618,70.86730158730158,72.00507936507937,28,20,409,1,406
1591,212,633,70.86730158730158,72.91065759637188,28,17,430,2,421
1592,209,18,72.19083900226758,74.21097505668935,29,46,210,2,191
1593,209,18,72.19083900226758,74.3502947845805,29,43,212,2,191
1594,209,215,72.19083900226758,73.32861678004535,29,34,49,1,6
1595,209,215,72.19083900226758,73.35183673469388,29,33,50,1,6
1596,209,206,72.19083900226758,74.8843537414966,29,16,116,3,3
1597,209,445,72.19083900226758,74.14131519274376,29,20,251,2,236
1598,209,444,72.19083900226758,74.83791383219955,29,18,261,3,235
1599,215,18,73.32861678004535,74.3502947845805,34,43,202,1,197
1600,215,28,73.32861678004535,75.74349206349207,34,43,214,2,187
1601,215,206,73.32861678004535,74.8843537414966,34,16,68,2,9
1602,215,213,73.32861678004535,76.02213151927438,34,36,116,3,2
1603,215,444,73.32861678004535,74.83791383219955,34,18,238,2,229
1604,215,562,73.32861678004535,75.58095238095238,34,25,360,2,347
1605,215,623,73.32861678004535,75.53451247165533,34,22,419,2,408
1606,215,28,73.35183673469388,75.74349206349207,33,43,213,2,187
1607,215,206,73.35183673469388,74.8843537414966,33,16,67,2,9
1608,215,213,73.35183673469388,76.02213151927438,33,36,115,3,2
1609,215,444,73.35183673469388,74.83791383219955,33,18,238,1,229
1610,215,562,73.35183673469388,75.58095238095238,33,25,360,2,347
1611,215,623,73.35183673469388,75.53451247165533,33,22,419,2,408
1612,206,20,74.8843537414966,76.579410430839,16,44,200,2,186
1613,206,213,74.8843537414966,76.02213151927438,16,36,49,1,7
1614,206,381,74.8843537414966,76.34721088435374,16,22,186,1,175
1615,206,491,74.8843537414966,76.37043083900227,16,23,292,1,285
1616,206,668,74.8843537414966,76.34721088435374,16,18,466,1,462
1617,213,18,76.02213151927438,78.25124716553289,36,46,217,2,195
1618,213,82,76.02213151927438,78.57632653061225,36,42,171,3,131
1619,213,286,76.02213151927438,78.1815873015873,36,18,118,2,73
1620,213,268,76.02213151927438,78.94784580498866,36,26,137,3,55
1621,213,564,76.02213151927438,78.29768707482994,36,24,364,2,351
1622,213,559,76.02213151927438,78.36734693877551,36,23,360,2,346
1623,213,652,76.02213151927438,78.29768707482994,36,20,450,2,439
1624,213,628,76.02213151927438,78.36734693877551,36,18,427,2,415
1625,381,18,76.34721088435374,78.25124716553289,22,46,372,2,363
1626,381,82,76.34721088435374,78.57632653061225,22,42,314,2,299
1627,381,286,76.34721088435374,78.1815873015873,22,18,124,2,95
1628,381,268,76.34721088435374,78.94784580498866,22,26,159,3,113
1629,381,564,76.34721088435374,78.29768707482994,22,24,201,2,183
1630,381,559,76.34721088435374,78.36734693877551,22,23,198,2,178
1631,381,652,76.34721088435374,78.29768707482994,22,20,284,2,271
1632,381,628,76.34721088435374,78.36734693877551,22,18,262,2,247
1633,381,826,76.34721088435374,78.22802721088435,22,16,452,2,445
1634,381,873,76.34721088435374,78.90140589569161,22,16,504,3,492
1635,286,21,78.1815873015873,79.5980045351474,18,41,272,1,265
1636,286,304,78.1815873015873,80.2249433106576,18,15,90,2,18
1637,286,291,78.1815873015873,80.89832199546485,18,31,117,3,5
1638,286,427,78.1815873015873,79.52834467120182,18,20,152,1,141
1639,286,427,78.1815873015873,80.87510204081633,18,20,183,3,141
1640,286,627,78.1815873015873,80.92154195011338,18,11,361,3,341
1641,268,61,78.94784580498866,81.24662131519274,26,46,229,2,207
1642,268,304,78.94784580498866,80.2249433106576,26,15,66,1,36
1643,268,291,78.94784580498866,80.89832199546485,26,31,87,2,23
1644,268,427,78.94784580498866,80.87510204081633,26,20,179,2,159
1645,268,627,78.94784580498866,80.92154195011338,26,11,369,2,359
1646,304,61,80.2249433106576,81.24662131519274,15,46,247,1,243
1647,304,61,80.2249433106576,81.94321995464853,15,45,254,2,243
1648,304,61,80.2249433106576,82.63981859410431,15,46,264,2,243
1649,304,271,80.2249433106576,82.0128798185941,15,28,84,2,33
1650,304,421,80.2249433106576,82.0128798185941,15,22,140,2,117
1651,304,423,80.2249433106576,82.75591836734694,15,19,161,3,119
1652,304,632,80.2249433106576,82.0128798185941,15,14,337,2,328
1653,304,633,80.2249433106576,82.77913832199546,15,14,347,3,329
1654,291,61,80.89832199546485,81.94321995464853,31,45,234,1,230
1655,291,61,80.89832199546485,82.63981859410431,31,46,242,2,230
1656,291,18,80.89832199546485,83.61505668934241,31,45,297,3,273
1657,291,271,80.89832199546485,82.0128798185941,31,28,52,1,20
1658,291,218,80.89832199546485,83.35963718820862,31,38,129,2,73
1659,291,217,80.89832199546485,83.38285714285715,31,40,130,2,74
1660,291,421,80.89832199546485,82.0128798185941,31,22,139,1,130
1661,291,423,80.89832199546485,82.75591836734694,31,19,154,2,132
1662,291,533,80.89832199546485,83.56861678004535,31,23,268,3,242
1663,291,632,80.89832199546485,82.0128798185941,31,14,344,1,341
1664,291,633,80.89832199546485,82.77913832199546,31,14,351,2,342
1665,291,767,80.89832199546485,83.49895691609977,31,18,489,3,476
1666,271,18,82.0128798185941,83.61505668934241,28,45,262,2,253
1667,271,19,82.0128798185941,84.96181405895692,28,42,282,3,252
1668,271,218,82.0128798185941,83.35963718820862,28,38,79,1,53
1669,271,217,82.0128798185941,83.38285714285715,28,40,80,1,54
1670,271,247,82.0128798185941,84.45097505668934,28,26,108,2,24
1671,271,533,82.0128798185941,83.56861678004535,28,23,270,2,262
1672,271,427,82.0128798185941,84.9385941043084,28,19,201,3,156
1673,271,767,82.0128798185941,83.49895691609977,28,18,500,1,496
1674,218,19,83.35963718820862,84.96181405895692,38,42,211,2,199
1675,218,50,83.35963718820862,86.21569160997733,38,43,208,3,168
1676,218,247,83.35963718820862,84.45097505668934,38,26,55,1,29
1677,218,232,83.35963718820862,86.33179138321995,38,26,129,3,14
1678,218,427,83.35963718820862,84.9385941043084,38,19,220,2,209
1679,218,427,83.35963718820862,86.2853514739229,38,20,244,3,209
1680,218,617,83.35963718820862,86.14603174603175,38,12,417,3,399
1681,217,19,83.38285714285715,84.96181405895692,40,42,209,2,198
1682,217,50,83.38285714285715,86.21569160997733,40,43,207,3,167
1683,217,247,83.38285714285715,84.45097505668934,40,26,55,1,30
1684,217,232,83.38285714285715,86.33179138321995,40,26,128,3,15
1685,217,427,83.38285714285715,84.9385941043084,40,19,220,2,210
1686,217,427,83.38285714285715,86.2853514739229,40,20,244,3,210
1687,217,617,83.38285714285715,86.14603174603175,40,12,417,3,400
1688,247,50,84.45097505668934,86.21569160997733,26,43,211,2,197
1689,247,56,84.45097505668934,86.58721088435374,26,47,212,2,191
1690,247,232,84.45097505668934,86.33179138321995,26,26,82,2,15
1691,247,213,84.45097505668934,86.7265306122449,26,37,104,2,34
1692,247,269,84.45097505668934,87.42312925170069,26,25,130,3,22
1693,247,427,84.45097505668934,86.2853514739229,26,20,197,2,180
1694,247,574,84.45097505668934,86.47111111111111,26,20,338,2,327
1695,247,617,84.45097505668934,86.14603174603175,26,12,377,2,370
1696,247,627,84.45097505668934,86.47111111111111,26,19,390,2,380
1697,232,35,86.33179138321995,87.86430839002267,26,42,208,2,197
1698,232,30,86.33179138321995,89.09496598639456,26,45,234,3,202
1699,232,269,86.33179138321995,87.42312925170069,26,25,60,1,37
1700,232,445,86.33179138321995,87.63210884353742,26,20,220,1,213
1701,232,427,86.33179138321995,88.97886621315193,26,20,226,3,195
1702,213,35,86.7265306122449,87.86430839002267,37,42,185,1,178
1703,213,30,86.7265306122449,89.09496598639456,37,45,210,2,183
1704,213,299,86.7265306122449,89.37360544217687,37,30,143,3,86
1705,213,271,86.7265306122449,89.55936507936508,37,27,135,3,58
1706,213,427,86.7265306122449,88.97886621315193,37,20,235,2,214
1707,213,626,86.7265306122449,89.37360544217687,37,16,428,3,413
1708,269,30,87.42312925170069,89.09496598639456,25,45,250,2,239
1709,269,24,87.42312925170069,89.95410430839003,25,44,268,3,245
1710,269,299,87.42312925170069,89.37360544217687,25,30,89,2,30
1711,269,271,87.42312925170069,89.55936507936508,25,27,92,2,2
1712,269,427,87.42312925170069,88.97886621315193,25,20,172,2,158
1713,269,427,87.42312925170069,90.32562358276644,25,20,201,3,158
1714,269,626,87.42312925170069,89.37360544217687,25,16,367,2,357
1715,269,627,87.42312925170069,89.83800453514739,25,12,373,2,358
1716,299,54,89.37360544217687,91.41696145124716,30,45,260,2,245
1717,299,54,89.37360544217687,91.4401814058957,30,45,261,2,245
1718,299,246,89.37360544217687,91.25442176870749,30,20,97,2,53
1719,299,271,89.37360544217687,91.48662131519275,30,22,95,2,28
1720,299,443,89.37360544217687,91.02222222222223,30,18,161,2,144
1721,299,445,89.37360544217687,91.67238095238095,30,20,176,2,146
1722,271,54,89.55936507936508,91.41696145124716,27,45,231,2,217
1723,271,54,89.55936507936508,91.4401814058957,27,45,232,2,217
1724,271,246,89.55936507936508,91.25442176870749,27,20,77,2,25
1725,271,443,89.55936507936508,91.02222222222223,27,18,183,1,172
1726,271,445,89.55936507936508,91.67238095238095,27,20,196,2,174
1727,246,65,91.25442176870749,93.39065759637188,20,44,203,2,181
1728,246,64,91.25442176870749,93.483537414966,20,45,206,2,182
1729,246,275,91.25442176870749,93.4138775510204,20,19,97,2,29
1730,246,253,91.25442176870749,93.97115646258504,20,32,117,3,7
1731,246,427,91.25442176870749,93.01913832199547,20,20,196,2,181
1732,246,422,91.25442176870749,93.64607709750567,20,23,204,2,176
1733,271,65,91.48662131519275,93.39065759637188,22,44,222,2,206
1734,271,64,91.48662131519275,93.483537414966,22,45,224,2,207
1735,271,275,91.48662131519275,93.4138775510204,22,19,83,2,4
1736,271,253,91.48662131519275,93.97115646258504,22,32,109,2,18
1737,271,427,91.48662131519275,93.01913832199547,22,20,169,2,156
1738,271,422,91.48662131519275,93.64607709750567,22,23,177,2,151
1739,275,61,93.4138775510204,95.41079365079365,19,46,231,2,214
1740,275,61,93.4138775510204,95.8055328798186,19,46,237,2,214
1741,275,258,93.4138775510204,94.7374149659864,19,28,59,1,17
1742,275,273,93.4138775510204,95.55011337868481,19,23,92,2,2
1743,275,410,93.4138775510204,94.59809523809524,19,25,144,1,135
1744,275,436,93.4138775510204,95.71265306122449,19,20,189,2,161
1745,275,630,93.4138775510204,94.76063492063493,19,13,360,1,355
1746,275,631,93.4138775510204,95.50367346938776,19,16,367,2,356
1747,253,61,93.97115646258504,95.41079365079365,32,46,202,1,192
1748,253,61,93.97115646258504,95.8055328798186,32,46,208,2,192
1749,253,19,93.97115646258504,96.45569160997732,32,47,257,2,234
1750,253,273,93.97115646258504,95.55011337868481,32,23,71,2,20
1751,253,436,93.97115646258504,95.71265306122449,32,20,198,2,183
1752,253,631,93.97115646258504,95.50367346938776,32,16,384,2,378
1753,258,61,94.7374149659864,95.8055328798186,28,46,202,1,197
1754,258,19,94.7374149659864,96.45569160997732,28,47,250,2,239
1755,258,63,94.7374149659864,97.63990929705216,28,45,232,3,195
1756,258,266,94.7374149659864,97.4077097505669,28,33,115,3,8
1757,258,261,94.7374149659864,97.52380952380953,28,36,120,3,3
1758,258,445,94.7374149659864,97.05941043083901,28,20,212,2,187
1759,258,636,94.7374149659864,97.36126984126984,28,14,395,3,378
1760,258,619,94.7374149659864,97.500589569161,28,20,380,3,361
1761,273,63,95.55011337868481,97.63990929705216,23,45,228,2,210
1762,273,266,95.55011337868481,97.4077097505669,23,33,80,2,7
1763,273,261,95.55011337868481,97.52380952380953,23,36,86,2,12
1764,273,445,95.55011337868481,97.05941043083901,23,20,184,2,172
1765,273,427,95.55011337868481,98.40616780045352,23,20,197,3,154
1766,273,636,95.55011337868481,97.36126984126984,23,14,371,2,363
1767,273,619,95.55011337868481,97.500589569161,23,20,356,2,346
1768,266,66,97.4077097505669,98.82412698412699,33,44,209,1,200
1769,266,24,97.4077097505669,99.82258503401361,33,47,263,2,242
1770,266,220,97.4077097505669,99.35818594104309,33,28,96,2,46
1771,266,220,97.4077097505669,100.03156462585034,33,24,122,3,46
1772,266,443,97.4077097505669,99.1027664399093,33,17,191,2,177
1773,266,432,97.4077097505669,99.91546485260771,33,24,198,3,166
1774,266,629,97.4077097505669,98.59192743764173,33,11,367,1,363
1775,261,66,97.52380952380953,98.82412698412699,36,44,203,1,195
1776,261,24,97.52380952380953,99.82258503401361,36,47,257,2,237
1777,261,220,97.52380952380953,99.35818594104309,36,28,89,2,41
1778,261,220,97.52380952380953,100.03156462585034,36,24,116,3,41
1779,261,247,97.52380952380953,100.47274376417234,36,20,128,3,14
1780,261,443,97.52380952380953,99.1027664399093,36,17,194,2,182
1781,261,432,97.52380952380953,99.91546485260771,36,24,200,2,171
1782,261,629,97.52380952380953,98.59192743764173,36,11,371,1,368
1783,220,27,99.35818594104309,100.63528344671202,28,46,201,1,193
1784,220,247,99.35818594104309,100.47274376417234,28,20,55,1,27
1785,220,224,99.35818594104309,102.33034013605442,28,26,128,3,4
1786,220,477,99.35818594104309,102.26068027210884,28,18,286,3,257
1787,220,56,100.03156462585034,102.37678004535148,24,48,193,2,164
1788,220,62,100.03156462585034,102.4928798185941,24,48,190,2,158
1789,220,224,100.03156462585034,102.33034013605442,24,26,99,2,4
1790,220,248,100.03156462585034,102.51609977324263,24,23,111,2,28
1791,220,477,100.03156462585034,102.26068027210884,24,18,274,2,257
1792,220,696,100.03156462585034,102.44643990929706,24,15,487,2,476
1793,220,619,100.03156462585034,102.4928798185941,24,10,413,2,399
1794,247,56,100.47274376417234,102.37678004535148,20,48,208,2,191
1795,247,62,100.47274376417234,102.4928798185941,20,48,204,2,185
1796,247,224,100.47274376417234,102.33034013605442,20,26,83,2,23
1797,247,248,100.47274376417234,102.51609977324263,20,23,88,2,1
1798,247,477,100.47274376417234,102.26068027210884,20,18,243,2,230
1799,247,425,100.47274376417234,103.16625850340137,20,18,212,3,178
1800,247,696,100.47274376417234,102.44643990929706,20,15,457,2,449
1801,247,619,100.47274376417234,102.4928798185941,20,10,382,2,372
1802,224,30,102.33034013605442,104.11827664399094,26,45,209,2,194
1803,224,24,102.33034013605442,104.95419501133787,26,43,230,3,200
1804,224,218,102.33034013605442,104.4433560090703,26,38,91,2,6
1805,224,218,102.33034013605442,104.51301587301587,26,36,94,2,6
1806,224,508,102.33034013605442,104.4433560090703,26,20,298,2,284
1807,224,436,102.33034013605442,105.13995464852609,26,20,244,3,212
1808,248,30,102.51609977324263,104.11827664399094,23,45,229,2,218
1809,248,24,102.51609977324263,104.95419501133787,23,43,247,2,224
1810,248,218,102.51609977324263,104.4433560090703,23,38,88,2,30
1811,248,218,102.51609977324263,104.51301587301587,23,36,91,2,30
1812,248,219,102.51609977324263,105.48825396825397,23,19,131,3,29
1813,248,508,102.51609977324263,104.4433560090703,23,20,273,2,260
1814,248,436,102.51609977324263,105.13995464852609,23,20,219,3,188
1815,218,23,104.4433560090703,106.02231292517007,38,45,207,2,195
1816,218,31,104.4433560090703,106.62603174603174,38,45,209,2,187
1817,218,219,104.4433560090703,105.48825396825397,38,19,45,1,1
1818,218,219,104.4433560090703,107.299410430839,38,37,123,3,1
1819,218,489,104.4433560090703,106.11519274376417,38,24,280,2,271
1820,218,439,104.4433560090703,107.18331065759638,38,23,251,3,221
1821,218,630,104.4433560090703,106.11519274376417,38,15,418,2,412
1822,218,656,104.4433560090703,107.27619047619048,38,12,455,3,438
1823,218,23,104.51301587301587,106.02231292517007,36,45,206,2,195
1824,218,31,104.51301587301587,106.62603174603174,36,45,208,2,187
1825,218,219,104.51301587301587,107.299410430839,36,37,120,3,1
1826,218,489,104.51301587301587,106.11519274376417,36,24,280,2,271
1827,218,439,104.51301587301587,107.18331065759638,36,23,249,3,221
1828,218,630,104.51301587301587,106.11519274376417,36,15,418,2,412
1829,218,656,104.51301587301587,107.27619047619048,36,12,454,3,438
1830,219,31,105.48825396825397,106.62603174603174,19,45,194,1,188
1831,219,83,105.48825396825397,107.67092970521543,19,46,165,2,136
1832,219,229,105.48825396825397,108.32108843537415,19,31,122,3,10
1833,219,439,105.48825396825397,107.18331065759638,19,23,232,2,220
1834,219,427,105.48825396825397,107.85668934240363,19,21,232,2,208
1835,219,656,105.48825396825397,107.27619047619048,19,12,444,2,437
1836,219,668,105.48825396825397,108.39074829931972,19,12,466,3,449
1837,219,20,107.299410430839,108.92480725623582,37,45,211,2,199
1838,219,18,107.299410430839,110.24834467120182,37,42,238,3,201
1839,219,229,107.299410430839,108.32108843537415,37,31,45,1,10
1840,219,206,107.299410430839,109.48208616780046,37,23,95,2,13
1841,219,445,107.299410430839,109.20344671201815,37,21,240,2,226
1842,219,425,107.299410430839,109.90004535147392,37,18,234,3,206
1843,219,668,107.299410430839,108.39074829931972,37,12,451,1,449
1844,229,18,108.32108843537415,110.24834467120182,31,42,227,2,211
1845,229,18,108.32108843537415,110.5966439909297,31,46,233,2,211
1846,229,206,108.32108843537415,109.48208616780046,31,23,55,1,23
1847,229,267,108.32108843537415,110.50376417233561,31,17,101,2,38
1848,229,260,108.32108843537415,111.08426303854876,31,29,123,3,31
1849,229,425,108.32108843537415,109.90004535147392,31,18,207,2,196
1850,229,427,108.32108843537415,110.55020408163266,31,20,220,2,198
1851,229,617,108.32108843537415,110.66630385487528,31,12,401,2,388
1852,206,18,109.48208616780046,110.5966439909297,23,46,194,1,188
1853,206,60,109.48208616780046,111.54866213151928,23,45,171,2,146
1854,206,267,109.48208616780046,110.50376417233561,23,17,75,1,61
1855,206,260,109.48208616780046,111.08426303854876,23,29,88,2,54
1856,206,427,109.48208616780046,110.55020408163266,23,20,226,1,221
1857,206,427,109.48208616780046,111.89696145124717,23,21,244,2,221
1858,206,617,109.48208616780046,110.66630385487528,23,12,414,1,411
1859,267,60,110.50376417233561,111.54866213151928,17,45,212,1,207
1860,267,61,110.50376417233561,112.82575963718821,17,46,229,2,206
1861,267,231,110.50376417233561,112.47746031746031,17,35,92,2,36
1862,267,261,110.50376417233561,112.52390022675738,17,33,87,2,6
1863,267,427,110.50376417233561,111.89696145124717,17,21,171,1,160
1864,267,445,110.50376417233561,113.24371882086169,17,22,214,3,178
1865,267,755,110.50376417233561,112.50068027210885,17,16,496,2,488
1866,267,644,110.50376417233561,112.7328798185941,17,15,389,2,377
1867,260,61,111.08426303854876,112.82575963718821,29,46,213,2,199
1868,260,231,111.08426303854876,112.47746031746031,29,35,67,1,29
1869,260,261,111.08426303854876,112.52390022675738,29,33,62,1,1
1870,260,445,111.08426303854876,113.24371882086169,29,22,207,2,185
1871,260,414,111.08426303854876,113.94031746031746,29,16,197,3,154
1872,260,755,111.08426303854876,112.50068027210885,29,16,499,1,495
1873,260,644,111.08426303854876,112.7328798185941,29,15,391,2,384
1874,231,93,112.47746031746031,114.42793650793651,35,45,162,2,138
1875,231,109,112.47746031746031,115.26385487528344,35,45,171,3,122
1876,231,245,112.47746031746031,114.49759637188208,35,22,88,2,14
1877,231,214,112.47746031746031,114.91555555555556,35,31,106,2,17
1878,231,414,112.47746031746031,113.94031746031746,35,16,194,1,183
1879,231,428,112.47746031746031,114.5904761904762,35,20,217,2,197
1880,261,93,112.52390022675738,114.42793650793651,33,45,187,2,168
1881,261,109,112.52390022675738,115.26385487528344,33,45,192,3,152
1882,261,245,112.52390022675738,114.49759637188208,33,22,86,2,16
1883,261,214,112.52390022675738,114.91555555555556,33,31,113,2,47
1884,261,414,112.52390022675738,113.94031746031746,33,16,165,1,153
1885,261,428,112.52390022675738,114.5904761904762,33,20,189,2,167
1886,261,744,112.52390022675738,115.14775510204082,33,15,496,3,483
1887,245,18,114.49759637188208,115.98367346938775,22,44,236,1,227
1888,245,18,114.49759637188208,116.65705215419501,22,44,245,2,227
1889,245,264,114.49759637188208,115.9372335600907,22,28,65,1,19
1890,245,213,114.49759637188208,117.28399092970521,22,37,124,3,32
1891,245,436,114.49759637188208,115.9372335600907,22,21,201,1,191
1892,245,428,114.49759637188208,117.28399092970521,22,21,219,3,183
1893,245,617,114.49759637188208,117.37687074829932,22,17,392,3,372
1894,214,18,114.91555555555556,115.98367346938775,31,44,201,1,196
1895,214,18,114.91555555555556,116.65705215419501,31,44,210,2,196
1896,214,264,114.91555555555556,115.9372335600907,31,28,67,1,50
1897,214,213,114.91555555555556,117.28399092970521,31,37,102,2,1
1898,214,255,114.91555555555556,117.8877097505669,31,29,134,3,41
1899,214,436,114.91555555555556,115.9372335600907,31,21,226,1,222
1900,214,428,114.91555555555556,117.28399092970521,31,21,237,2,214
1901,214,486,114.91555555555556,117.60907029478459,31,23,296,3,272
1902,214,617,114.91555555555556,117.37687074829932,31,17,417,2,403
1903,214,684,114.91555555555556,117.58585034013606,31,19,484,3,470
1904,264,42,115.9372335600907,118.44498866213152,28,46,247,3,222
1905,264,23,115.9372335600907,118.81650793650793,28,47,271,3,241
1906,264,213,115.9372335600907,117.28399092970521,28,37,77,1,51
1907,264,255,115.9372335600907,117.8877097505669,28,29,84,2,9
1908,264,428,115.9372335600907,117.28399092970521,28,21,174,1,164
1909,264,486,115.9372335600907,117.60907029478459,28,23,233,2,222
1910,264,445,115.9372335600907,118.63074829931973,28,20,215,3,181
1911,264,617,115.9372335600907,117.37687074829932,28,17,358,1,353
1912,264,684,115.9372335600907,117.58585034013606,28,19,426,2,420
1913,213,42,117.28399092970521,118.44498866213152,37,46,178,1,171
1914,213,23,117.28399092970521,118.81650793650793,37,47,201,2,190
1915,213,41,117.28399092970521,119.58276643990929,37,44,198,2,172
1916,213,230,117.28399092970521,118.97904761904762,37,34,75,2,17
1917,213,205,117.28399092970521,119.58276643990929,37,24,99,2,8
1918,213,445,117.28399092970521,118.63074829931973,37,20,239,1,232
1919,213,445,117.28399092970521,119.97750566893424,37,21,259,3,232
1920,255,41,117.8877097505669,119.58276643990929,29,44,226,2,214
1921,255,230,117.8877097505669,118.97904761904762,29,34,53,1,25
1922,255,205,117.8877097505669,119.58276643990929,29,24,88,2,50
1923,255,445,117.8877097505669,119.97750566893424,29,21,210,2,190
1924,255,724,117.8877097505669,120.00072562358277,29,10,478,2,469
1925,230,18,118.97904761904762,121.39392290249434,34,46,236,2,212
1926,230,224,118.97904761904762,121.20816326530613,34,23,96,2,6
1927,230,258,118.97904761904762,121.64934240362813,34,27,118,3,28
1928,230,428,118.97904761904762,121.32426303854875,34,20,222,2,198
1929,230,419,118.97904761904762,121.64934240362813,34,26,221,3,189
1930,230,724,118.97904761904762,120.00072562358277,34,10,496,1,494
1931,230,703,118.97904761904762,121.39392290249434,34,19,484,2,473
1932,230,651,118.97904761904762,121.76544217687075,34,15,438,3,421
1933,205,18,119.58276643990929,121.39392290249434,24,46,203,2,187
1934,205,54,119.58276643990929,122.2530612244898,24,46,190,3,151
1935,205,224,119.58276643990929,121.20816326530613,24,23,73,2,19
1936,205,258,119.58276643990929,121.64934240362813,24,27,104,2,53
1937,205,428,119.58276643990929,121.32426303854875,24,20,235,2,223
1938,205,419,119.58276643990929,121.64934240362813,24,26,232,2,214
1939,205,703,119.58276643990929,121.39392290249434,24,19,504,2,498
1940,205,651,119.58276643990929,121.76544217687075,24,15,456,2,446
1941,224,54,121.20816326530613,122.2530612244898,23,46,176,1,170
1942,224,65,121.20816326530613,122.97287981859411,23,47,176,2,159
1943,224,275,121.20816326530613,123.34439909297052,23,26,105,2,51
1944,224,271,121.20816326530613,123.62303854875283,23,28,114,2,47
1945,224,529,121.20816326530613,122.71746031746032,23,22,312,2,305
1946,224,445,121.20816326530613,124.0409977324263,23,20,252,3,221
1947,224,646,121.20816326530613,122.74068027210885,23,16,427,2,422
1948,224,654,121.20816326530613,123.57659863945578,23,9,442,2,430
1949,258,65,121.64934240362813,122.97287981859411,27,47,201,1,193
1950,258,49,121.64934240362813,124.27319727891157,27,44,238,3,209
1951,258,275,121.64934240362813,123.34439909297052,27,26,75,2,17
1952,258,271,121.64934240362813,123.62303854875283,27,28,86,2,13
1953,258,529,121.64934240362813,122.71746031746032,27,22,275,1,271
1954,258,445,121.64934240362813,124.0409977324263,27,20,213,2,187
1955,258,646,121.64934240362813,122.74068027210885,27,16,391,1,388
1956,258,654,121.64934240362813,123.57659863945578,27,9,405,2,396
1957,275,24,123.34439909297052,124.73759637188209,26,42,258,1,251
1958,275,24,123.34439909297052,125.80571428571429,26,45,272,2,251
1959,275,304,123.34439909297052,125.57351473922903,26,19,100,2,29
1960,275,428,123.34439909297052,125.38775510204081,26,20,177,2,153
1961,275,444,123.34439909297052,126.06113378684807,26,19,206,3,169
1962,275,673,123.34439909297052,125.38775510204081,26,12,408,2,398
1963,275,676,123.34439909297052,126.06113378684807,26,11,418,3,401
1964,271,24,123.62303854875283,124.73759637188209,28,42,252,1,247
1965,271,24,123.62303854875283,125.80571428571429,28,45,264,2,247
1966,271,304,123.62303854875283,125.57351473922903,28,19,90,2,33
1967,271,284,123.62303854875283,126.40943310657596,28,25,121,3,13
1968,271,428,123.62303854875283,125.38775510204081,28,20,174,2,157
1969,271,444,123.62303854875283,126.06113378684807,28,19,202,2,173
1970,271,673,123.62303854875283,125.38775510204081,28,12,409,2,402
1971,271,676,123.62303854875283,126.06113378684807,28,11,418,2,405
1972,304,46,125.57351473922903,127.40789115646258,19,48,270,2,258
1973,304,46,125.57351473922903,127.73297052154196,19,47,274,2,258
1974,304,214,125.57351473922903,126.80417233560091,19,23,104,1,90
1975,304,445,125.57351473922903,126.73451247165534,19,19,150,1,141
1976,304,427,125.57351473922903,128.08126984126986,19,20,164,3,123
1977,304,673,125.57351473922903,127.40789115646258,19,10,377,2,369
1978,304,789,125.57351473922903,128.1277097505669,19,11,497,3,485
1979,284,46,126.40943310657596,127.73297052154196,25,47,245,1,238
1980,284,41,126.40943310657596,129.3815873015873,25,47,275,3,243
1981,284,304,126.40943310657596,128.05804988662132,25,21,74,2,20
1982,284,277,126.40943310657596,129.12616780045352,25,21,117,3,7
1983,284,427,126.40943310657596,128.08126984126986,25,20,160,2,143
1984,284,615,126.40943310657596,129.07972789115647,25,9,350,3,331
1985,214,41,126.80417233560091,129.3815873015873,23,47,206,3,173
1986,214,304,126.80417233560091,128.05804988662132,23,21,105,1,90
1987,214,277,126.80417233560091,129.12616780045352,23,21,118,2,63
1988,214,427,126.80417233560091,128.08126984126986,23,20,220,1,213
1989,214,427,126.80417233560091,129.42802721088435,23,21,241,3,213
1990,214,615,126.80417233560091,129.07972789115647,23,9,413,2,401
1991,304,41,128.05804988662132,129.3815873015873,21,47,269,1,263
1992,304,41,128.05804988662132,130.1942857142857,21,48,279,2,263
1993,304,41,128.05804988662132,130.8908843537415,21,47,290,3,263
1994,304,277,128.05804988662132,129.12616780045352,21,21,53,1,27
1995,304,206,128.05804988662132,130.2871655328798,21,22,137,2,98
1996,304,206,128.05804988662132,130.84444444444443,21,23,155,3,98
1997,304,427,128.05804988662132,129.42802721088435,21,21,136,1,123
1998,304,445,128.05804988662132,130.12462585034015,21,19,167,2,141
1999,304,427,128.05804988662132,130.77478458049887,21,20,170,3,123
2000,304,615,128.05804988662132,129.07972789115647,21,9,314,1,311
2001,277,41,129.12616780045352,130.1942857142857,21,48,240,1,236
2002,277,41,129.12616780045352,130.8908843537415,21,47,248,2,236
2003,277,36,129.12616780045352,131.93578231292517,21,48,270,3,241
2004,277,206,129.12616780045352,130.2871655328798,21,22,87,1,71
2005,277,206,129.12616780045352,130.84444444444443,21,23,103,2,71
2006,277,427,129.12616780045352,130.77478458049887,21,20,166,2,150
2007,206,36,130.2871655328798,131.93578231292517,22,48,184,2,170
2008,206,64,130.2871655328798,133.23609977324264,22,44,191,3,142
2009,206,258,130.2871655328798,132.53950113378684,22,16,110,2,52
2010,206,264,130.2871655328798,133.0271201814059,22,20,131,3,58
2011,206,427,130.2871655328798,132.12154195011337,22,20,235,2,221
2012,206,36,130.84444444444443,131.93578231292517,23,48,176,1,170
2013,206,64,130.84444444444443,133.23609977324264,23,44,175,2,142
2014,206,258,130.84444444444443,132.53950113378684,23,16,90,2,52
2015,206,264,130.84444444444443,133.0271201814059,23,20,110,2,58
2016,206,213,130.84444444444443,133.81659863945578,23,27,128,3,7
2017,206,427,130.84444444444443,132.12154195011337,23,20,228,1,221
2018,206,427,130.84444444444443,133.4682993197279,23,21,248,3,221
2019,258,62,132.53950113378684,134.1184580498866,16,43,207,2,196
2020,258,27,132.53950113378684,135.1633560090703,16,44,257,3,231
2021,258,213,132.53950113378684,133.81659863945578,16,27,71,1,45
2022,258,278,132.53950113378684,135.11691609977325,16,27,113,3,20
2023,258,443,132.53950113378684,134.16489795918366,16,18,198,2,185
2024,258,445,132.53950113378684,134.8150566893424,16,21,211,2,187
2025,258,625,132.53950113378684,135.20979591836735,16,13,385,3,367
2026,264,62,133.0271201814059,134.1184580498866,20,43,207,1,202
2027,264,27,133.0271201814059,135.1633560090703,20,44,254,2,237
2028,264,61,133.0271201814059,135.92961451247166,20,47,238,3,203
2029,264,278,133.0271201814059,135.11691609977325,20,27,91,2,14
2030,264,443,133.0271201814059,134.16489795918366,20,18,186,1,179
2031,264,445,133.0271201814059,134.8150566893424,20,21,197,2,181
2032,264,625,133.0271201814059,135.20979591836735,20,13,373,2,361
2033,213,27,133.81659863945578,135.1633560090703,27,44,195,1,186
2034,213,61,133.81659863945578,135.92961451247166,27,47,177,2,152
2035,213,278,133.81659863945578,135.11691609977325,27,27,86,1,65
2036,213,214,133.81659863945578,136.2314739229025,27,36,104,2,1
2037,213,289,133.81659863945578,136.71909297052156,27,29,146,3,76
2038,213,606,133.81659863945578,136.34757369614513,27,22,408,3,393
2039,213,625,133.81659863945578,135.20979591836735,27,13,416,1,412
2040,213,676,133.81659863945578,136.34757369614513,27,17,476,3,463
2041,278,28,135.11691609977325,137.09061224489795,27,42,264,2,250
2042,278,214,135.11691609977325,136.2314739229025,27,36,80,1,64
2043,278,289,135.11691609977325,136.71909297052156,27,29,70,2,11
2044,278,606,135.11691609977325,136.34757369614513,27,22,332,1,328
2045,278,445,135.11691609977325,137.50857142857143,27,20,196,2,167
2046,278,502,135.11691609977325,137.7407709750567,27,19,251,3,224
2047,278,676,135.11691609977325,136.34757369614513,27,17,402,1,398
2048,278,615,135.11691609977325,136.83519274376417,27,13,345,2,337
2049,278,670,135.11691609977325,137.7407709750567,27,15,408,3,392
2050,214,60,136.2314739229025,138.15873015873015,36,45,175,2,154
2051,214,72,136.2314739229025,138.7392290249433,36,46,178,3,142
2052,214,278,136.2314739229025,138.04263038548754,36,28,101,2,64
2053,214,445,136.2314739229025,137.50857142857143,36,20,237,1,231
2054,214,502,136.2314739229025,137.7407709750567,36,19,295,2,288
2055,214,427,136.2314739229025,138.85532879818595,36,20,241,3,213
2056,214,670,136.2314739229025,137.7407709750567,36,15,461,2,456
2057,214,619,136.2314739229025,138.8321088435374,36,14,420,3,405
2058,289,60,136.71909297052156,138.15873015873015,29,45,237,1,229
2059,289,72,136.71909297052156,138.7392290249433,29,46,234,2,217
2060,289,278,136.71909297052156,138.04263038548754,29,28,58,1,11
2061,289,205,136.71909297052156,139.48226757369613,29,33,146,3,84
2062,289,502,136.71909297052156,137.7407709750567,29,19,217,1,213
2063,289,427,136.71909297052156,138.85532879818595,29,20,166,2,138
2064,289,670,136.71909297052156,137.7407709750567,29,15,384,1,381
2065,289,619,136.71909297052156,138.8321088435374,29,14,342,2,330
2066,278,42,138.04263038548754,139.85378684807256,28,45,249,2,236
2067,278,205,138.04263038548754,139.48226757369613,28,33,96,1,73
2068,278,243,138.04263038548754,139.784126984127,28,31,83,2,35
2069,278,290,138.04263038548754,140.82902494331066,28,28,121,3,12
2070,278,427,138.04263038548754,140.20208616780045,28,20,176,2,149
2071,278,773,138.04263038548754,140.08598639455784,28,15,503,2,495
2072,278,636,138.04263038548754,140.9451247165533,28,16,379,3,358
2073,205,82,139.48226757369613,141.5720634920635,33,46,152,2,123
2074,205,82,139.48226757369613,142.12934240362813,33,45,168,3,123
2075,205,290,139.48226757369613,140.82902494331066,33,28,103,1,85
2076,205,388,139.48226757369613,141.68816326530612,33,23,206,2,183
2077,205,486,139.48226757369613,141.54884353741497,33,22,295,2,281
2078,205,489,139.48226757369613,141.87392290249434,33,20,302,2,284
2079,205,636,139.48226757369613,140.9451247165533,33,16,436,1,431
2080,205,633,139.48226757369613,142.15256235827664,33,11,443,3,428
2081,243,82,139.784126984127,141.5720634920635,31,46,178,2,161
2082,243,82,139.784126984127,142.12934240362813,31,45,190,2,161
2083,243,290,139.784126984127,140.82902494331066,31,28,65,1,47
2084,243,388,139.784126984127,141.68816326530612,31,23,167,2,145
2085,243,486,139.784126984127,141.54884353741497,31,22,255,2,243
2086,243,489,139.784126984127,141.87392290249434,31,20,262,2,246
2087,243,636,139.784126984127,140.9451247165533,31,16,396,1,393
2088,243,633,139.784126984127,142.15256235827664,31,11,403,2,390
2089,290,82,140.82902494331066,142.12934240362813,28,45,215,1,208
2090,290,82,140.82902494331066,143.03492063492064,28,45,229,2,208
2091,290,221,140.82902494331066,143.10458049886623,28,26,120,2,69
2092,290,489,140.82902494331066,141.87392290249434,28,20,204,1,199
2093,290,437,140.82902494331066,142.8956009070295,28,19,172,2,147
2094,290,633,140.82902494331066,142.15256235827664,28,11,348,1,343
2095,290,658,140.82902494331066,143.6154195011338,28,9,387,3,368
2096,388,82,141.68816326530612,143.03492063492064,23,45,311,1,306
2097,388,46,141.68816326530612,144.56743764172336,23,43,364,3,342
2098,388,221,141.68816326530612,143.10458049886623,23,26,178,1,167
2099,388,277,141.68816326530612,144.28879818594103,23,27,158,3,111
2100,388,437,141.68816326530612,142.8956009070295,23,19,71,1,49
2101,388,427,141.68816326530612,144.26557823129252,23,20,118,3,39
2102,388,658,141.68816326530612,143.6154195011338,23,9,282,2,270
2103,388,878,141.68816326530612,143.6154195011338,23,15,497,2,490
2104,221,46,143.10458049886623,144.56743764172336,26,43,186,1,175
2105,221,46,143.10458049886623,144.93895691609978,26,46,192,2,175
2106,221,277,143.10458049886623,144.28879818594103,26,27,76,1,56
2107,221,265,143.10458049886623,145.6587755102041,26,23,118,3,44
2108,221,427,143.10458049886623,144.26557823129252,26,20,212,1,206
2109,221,427,143.10458049886623,145.61233560090704,26,20,233,3,206
2110,221,622,143.10458049886623,145.42657596371882,26,10,413,2,401
2111,277,60,144.28879818594103,146.68045351473924,27,47,240,2,217
2112,277,60,144.28879818594103,146.70367346938775,27,45,241,2,217
2113,277,265,144.28879818594103,145.6587755102041,27,23,60,1,12
2114,277,271,144.28879818594103,146.14639455782313,27,24,80,2,6
2115,277,280,144.28879818594103,147.12163265306123,27,29,122,3,3
2116,277,427,144.28879818594103,145.61233560090704,27,20,160,1,150
2117,277,444,144.28879818594103,146.28571428571428,27,18,188,2,167
2118,277,596,144.28879818594103,146.8197732426304,27,21,337,3,319
2119,277,622,144.28879818594103,145.42657596371882,27,10,348,1,345
2120,265,60,145.6587755102041,146.68045351473924,23,47,210,1,205
2121,265,60,145.6587755102041,146.70367346938775,23,45,210,1,205
2122,265,73,145.6587755102041,148.259410430839,23,47,222,3,192
2123,265,280,145.6587755102041,147.12163265306123,23,29,65,1,15
2124,265,279,145.6587755102041,148.5380498866213,23,29,125,3,14
2125,265,596,145.6587755102041,146.8197732426304,23,21,335,1,331
2126,265,445,145.6587755102041,148.30585034013606,23,20,213,3,180
2127,265,615,145.6587755102041,147.6324716553288,23,13,360,2,350
2128,265,652,145.6587755102041,148.5380498866213,23,22,406,3,387
2129,271,73,146.14639455782313,148.259410430839,24,47,218,2,198
2130,271,279,146.14639455782313,148.5380498866213,24,29,103,2,8
2131,271,274,146.14639455782313,148.97922902494332,24,27,122,3,3
2132,271,445,146.14639455782313,148.30585034013606,24,20,197,2,174
2133,271,615,146.14639455782313,147.6324716553288,24,13,350,1,344
2134,271,652,146.14639455782313,148.5380498866213,24,22,395,2,381
2135,271,615,146.14639455782313,148.88634920634922,24,17,364,3,344
2136,280,73,147.12163265306123,148.259410430839,29,47,213,1,207
2137,280,61,147.12163265306123,149.141768707483,29,45,236,2,219
2138,280,15,147.12163265306123,149.72226757369614,29,42,288,3,265
2139,280,279,147.12163265306123,148.5380498866213,29,29,61,1,1
2140,280,274,147.12163265306123,148.97922902494332,29,27,80,2,6
2141,280,445,147.12163265306123,148.30585034013606,29,20,173,1,165
2142,280,410,147.12163265306123,149.69904761904763,29,23,171,3,130
2143,280,652,147.12163265306123,148.5380498866213,29,22,377,1,372
2144,280,615,147.12163265306123,148.88634920634922,29,17,344,2,335
2145,279,15,148.5380498866213,149.72226757369614,29,42,269,1,264
2146,279,46,148.5380498866213,151.16190476190476,29,47,259,3,233
2147,279,205,148.5380498866213,150.51174603174604,29,38,113,2,74
2148,279,276,148.5380498866213,150.99936507936508,29,26,106,2,3
2149,279,410,148.5380498866213,149.69904761904763,29,23,140,1,131
2150,279,410,148.5380498866213,150.27954648526077,29,24,151,2,131
2151,279,427,148.5380498866213,150.99936507936508,29,21,182,2,148
2152,279,616,148.5380498866213,150.465306122449,29,28,347,2,337
2153,279,689,148.5380498866213,151.02258503401362,29,16,424,2,410
2154,274,46,148.97922902494332,151.16190476190476,27,47,247,2,228
2155,274,205,148.97922902494332,150.51174603174604,27,38,95,2,69
2156,274,276,148.97922902494332,150.99936507936508,27,26,87,2,2
2157,274,410,148.97922902494332,150.27954648526077,27,24,147,1,136
2158,274,427,148.97922902494332,150.99936507936508,27,21,176,2,153
2159,274,616,148.97922902494332,150.465306122449,27,28,348,1,342
2160,274,689,148.97922902494332,151.02258503401362,27,16,424,2,415
2161,274,729,148.97922902494332,151.78884353741498,27,17,471,3,455
2162,205,49,150.51174603174604,152.46222222222224,38,45,177,2,156
2163,205,82,150.51174603174604,153.0659410430839,38,46,165,3,123
2164,205,244,150.51174603174604,152.23002267573696,38,24,84,2,39
2165,205,427,150.51174603174604,152.3461224489796,38,21,236,2,222
2166,205,673,150.51174603174604,153.0659410430839,38,9,481,3,468
2167,276,49,150.99936507936508,152.46222222222224,26,45,236,1,227
2168,276,82,150.99936507936508,153.0659410430839,26,46,213,2,194
2169,276,244,150.99936507936508,152.23002267573696,26,24,62,1,32
2170,276,228,150.99936507936508,153.6928798185941,26,23,126,3,48
2171,276,220,150.99936507936508,153.97151927437642,26,22,140,3,56
2172,276,427,150.99936507936508,152.3461224489796,26,21,162,1,151
2173,276,445,150.99936507936508,153.6928798185941,26,20,205,3,169
2174,276,673,150.99936507936508,153.0659410430839,26,9,407,2,397
2175,244,46,152.23002267573696,154.18049886621316,24,49,215,2,198
2176,244,41,152.23002267573696,155.17895691609976,24,43,239,3,203
2177,244,228,152.23002267573696,153.6928798185941,24,23,65,1,16
2178,244,220,152.23002267573696,153.97151927437642,24,22,79,2,24
2179,244,445,152.23002267573696,153.6928798185941,24,20,211,1,201
2180,244,463,152.23002267573696,154.2037188208617,24,13,235,2,219
2181,244,489,152.23002267573696,154.99319727891157,24,11,272,3,245
2182,244,654,152.23002267573696,154.18049886621316,24,16,419,2,410
2183,228,41,153.6928798185941,155.17895691609976,23,43,198,1,187
2184,228,61,153.6928798185941,156.3399546485261,23,45,202,3,167
2185,228,216,153.6928798185941,155.50403628117914,23,23,79,2,12
2186,228,213,153.6928798185941,156.4560544217687,23,27,120,3,15
2187,228,489,153.6928798185941,154.99319727891157,23,11,267,1,261
2188,228,435,153.6928798185941,156.38639455782314,23,18,237,3,207
2189,228,618,153.6928798185941,156.38639455782314,23,16,407,3,390
2190,220,41,153.97151927437642,155.17895691609976,22,43,186,1,179
2191,220,61,153.97151927437642,156.3399546485261,22,45,189,2,159
2192,220,216,153.97151927437642,155.50403628117914,22,23,66,2,4
2193,220,213,153.97151927437642,156.4560544217687,22,27,107,2,7
2194,220,489,153.97151927437642,154.99319727891157,22,11,273,1,269
2195,220,435,153.97151927437642,156.38639455782314,22,18,239,2,215
2196,220,618,153.97151927437642,156.38639455782314,22,16,411,2,398
2197,216,72,155.50403628117914,157.12943310657596,23,44,160,2,144
2198,216,61,155.50403628117914,157.8724716553288,23,46,186,2,155
2199,216,247,155.50403628117914,157.73315192743763,23,19,101,2,31
2200,216,428,155.50403628117914,157.73315192743763,23,20,233,2,212
2201,216,427,155.50403628117914,157.75637188208617,23,18,232,2,211
2202,213,61,156.4560544217687,157.8724716553288,27,46,164,1,152
2203,213,24,156.4560544217687,158.89414965986396,27,43,216,2,189
2204,213,247,156.4560544217687,157.73315192743763,27,19,65,1,34
2205,213,218,156.4560544217687,158.499410430839,27,36,88,2,5
2206,213,219,156.4560544217687,159.17278911564625,27,22,117,3,6
2207,213,428,156.4560544217687,157.73315192743763,27,20,222,1,215
2208,213,427,156.4560544217687,157.75637188208617,27,18,221,1,214
2209,213,436,156.4560544217687,159.07990929705215,27,22,250,3,223
2210,247,24,157.73315192743763,158.89414965986396,19,43,229,1,223
2211,247,23,157.73315192743763,159.96226757369615,19,46,244,2,224
2212,247,219,157.73315192743763,159.17278911564625,19,22,68,1,28
2213,247,311,157.73315192743763,160.42666666666668,19,21,132,3,64
2214,247,436,157.73315192743763,159.07990929705215,19,22,198,1,189
2215,247,531,157.73315192743763,160.0319274376417,19,23,301,2,284
2216,247,630,157.73315192743763,160.0319274376417,19,15,396,2,383
2217,218,23,158.499410430839,159.96226757369615,36,46,205,1,195
2218,218,311,158.499410430839,160.42666666666668,36,21,125,2,93
2219,218,219,158.499410430839,161.10004535147394,36,35,112,3,1
2220,218,531,158.499410430839,160.0319274376417,36,23,320,2,313
2221,218,437,158.499410430839,161.21614512471655,36,20,248,3,219
2222,218,630,158.499410430839,160.0319274376417,36,15,417,2,412
2223,218,621,158.499410430839,161.12326530612245,36,13,419,3,403
2224,219,83,159.17278911564625,161.6108843537415,22,46,172,2,136
2225,219,311,159.17278911564625,160.42666666666668,22,21,107,1,92
2226,219,437,159.17278911564625,161.21614512471655,22,20,235,2,218
2227,219,428,159.17278911564625,161.77342403628117,22,20,237,3,209
2228,219,621,159.17278911564625,161.12326530612245,22,13,411,2,402
2229,311,83,160.42666666666668,161.6108843537415,21,46,234,1,228
2230,311,24,160.42666666666668,162.49324263038548,21,43,300,2,287
2231,311,20,160.42666666666668,162.8647619047619,21,46,309,2,291
2232,311,230,160.42666666666668,162.28426303854874,21,32,114,2,81
2233,311,206,160.42666666666668,162.8647619047619,21,23,148,2,105
2234,311,428,160.42666666666668,161.77342403628117,21,20,131,1,117
2235,311,445,160.42666666666668,163.1201814058957,21,20,177,3,134
2236,311,669,160.42666666666668,162.30748299319728,21,11,367,2,358
2237,311,752,160.42666666666668,163.14340136054423,21,10,456,3,441
2238,219,24,161.10004535147394,162.49324263038548,35,43,204,1,195
2239,219,20,161.10004535147394,162.8647619047619,35,46,213,2,199
2240,219,230,161.10004535147394,162.28426303854874,35,32,52,1,11
2241,219,206,161.10004535147394,162.8647619047619,35,23,77,2,13
2242,219,445,161.10004535147394,163.1201814058957,35,20,242,2,226
2243,219,669,161.10004535147394,162.30748299319728,35,11,453,1,450
2244,230,18,162.28426303854874,164.53659863945578,32,47,233,2,212
2245,230,205,162.28426303854874,164.58303854875282,32,21,102,2,25
2246,230,261,162.28426303854874,165.0009977324263,32,29,121,3,31
2247,230,428,162.28426303854874,164.46693877551022,32,19,219,2,198
2248,230,425,162.28426303854874,165.18675736961453,32,17,232,3,195
2249,230,616,162.28426303854874,164.60625850340136,32,9,399,2,386
2250,230,629,162.28426303854874,165.18675736961453,32,11,418,3,399
2251,206,18,162.8647619047619,164.53659863945578,23,47,201,2,188
2252,206,61,162.8647619047619,165.37251700680272,23,45,181,3,145
2253,206,25,162.8647619047619,165.83691609977325,23,45,222,3,181
2254,206,205,162.8647619047619,164.58303854875282,23,21,74,2,1
2255,206,261,162.8647619047619,165.0009977324263,23,29,107,2,55
2256,206,428,162.8647619047619,164.46693877551022,23,19,232,2,222
2257,206,425,162.8647619047619,165.18675736961453,23,17,241,2,219
2258,206,445,162.8647619047619,165.83691609977325,23,20,271,3,239
2259,206,616,162.8647619047619,164.60625850340136,23,9,417,2,410
2260,206,629,162.8647619047619,165.18675736961453,23,11,435,2,423
2261,205,25,164.58303854875282,165.83691609977325,21,45,188,1,180
2262,205,81,164.58303854875282,166.9514739229025,21,45,161,2,124
2263,205,263,164.58303854875282,166.37097505668933,21,36,96,2,58
2264,205,216,164.58303854875282,166.92825396825398,21,24,102,2,11
2265,205,445,164.58303854875282,165.83691609977325,21,20,246,1,240
2266,205,445,164.58303854875282,167.18367346938777,21,20,265,3,240
2267,205,675,164.58303854875282,167.46231292517007,21,11,486,3,470
2268,261,81,165.0009977324263,166.9514739229025,29,45,199,2,180
2269,261,263,165.0009977324263,166.37097505668933,29,36,59,1,2
2270,261,216,165.0009977324263,166.92825396825398,29,24,94,2,45
2271,261,445,165.0009977324263,167.18367346938777,29,20,207,2,184
2272,261,756,165.0009977324263,166.44063492063492,29,15,499,1,495
2273,261,675,165.0009977324263,167.46231292517007,29,11,427,2,414
2274,263,61,166.37097505668933,168.4607709750567,36,45,221,2,202
2275,263,31,166.37097505668933,168.8322902494331,36,48,255,2,232
2276,263,242,166.37097505668933,168.78585034013605,36,27,106,2,21
2277,263,243,166.37097505668933,168.8090702947846,36,27,107,2,20
2278,263,427,166.37097505668933,168.53043083900226,36,21,189,2,164
2279,263,414,166.37097505668933,169.22702947845806,36,17,195,3,151
2280,263,675,166.37097505668933,167.46231292517007,36,11,415,1,412
2281,263,615,166.37097505668933,168.50721088435375,36,15,364,2,352
2282,263,619,166.37097505668933,169.0877097505669,36,22,375,3,356
2283,216,61,166.92825396825398,168.4607709750567,24,45,168,2,155
2284,216,31,166.92825396825398,168.8322902494331,24,48,202,2,185
2285,216,72,166.92825396825398,169.8075283446712,24,44,190,3,144
2286,216,242,166.92825396825398,168.78585034013605,24,27,84,2,26
2287,216,243,166.92825396825398,168.8090702947846,24,27,85,2,27
2288,216,427,166.92825396825398,168.53043083900226,24,21,222,2,211
2289,216,414,166.92825396825398,169.22702947845806,24,17,221,2,198
2290,216,445,166.92825396825398,169.8771882086168,24,21,262,3,229
2291,216,615,166.92825396825398,168.50721088435375,24,15,405,2,399
2292,216,619,166.92825396825398,169.0877097505669,24,22,414,2,403
2293,242,72,168.78585034013605,169.8075283446712,27,44,176,1,170
2294,242,29,168.78585034013605,171.64190476190475,27,45,246,3,213
2295,242,276,168.78585034013605,170.5273469387755,27,33,82,2,34
2296,242,260,168.78585034013605,171.08462585034013,27,27,101,2,18
2297,242,445,168.78585034013605,169.8771882086168,27,21,208,1,203
2298,242,518,168.78585034013605,171.52580498866214,27,24,300,3,276
2299,242,680,168.78585034013605,171.5025850340136,27,15,453,3,438
2300,243,29,168.8090702947846,171.64190476190475,27,45,246,3,214
2301,243,276,168.8090702947846,170.5273469387755,27,33,81,2,33
2302,243,260,168.8090702947846,171.08462585034013,27,27,99,2,17
2303,243,445,168.8090702947846,169.8771882086168,27,21,207,1,202
2304,243,518,168.8090702947846,171.52580498866214,27,24,299,3,275
2305,243,680,168.8090702947846,171.5025850340136,27,15,452,3,437
2306,276,29,170.5273469387755,171.64190476190475,33,45,252,1,247
2307,276,109,170.5273469387755,172.43138321995465,33,45,186,2,167
2308,276,55,170.5273469387755,173.01188208616782,33,46,246,2,221
2309,276,445,170.5273469387755,172.5707029478458,33,21,191,2,169
2310,276,461,170.5273469387755,173.2673015873016,33,17,219,3,185
2311,276,620,170.5273469387755,172.40816326530611,33,15,353,2,344
2312,276,615,170.5273469387755,172.8261224489796,33,16,353,2,339
2313,260,109,171.08462585034013,172.43138321995465,27,45,162,1,151
2314,260,55,171.08462585034013,173.01188208616782,27,46,221,2,205
2315,260,276,171.08462585034013,172.80290249433108,27,35,76,2,16
2316,260,276,171.08462585034013,172.8261224489796,27,34,77,2,16
2317,260,206,171.08462585034013,174.03356009070296,27,22,138,3,54
2318,260,445,171.08462585034013,172.5707029478458,27,21,196,1,185
2319,260,461,171.08462585034013,173.2673015873016,27,17,222,2,201
2320,260,445,171.08462585034013,173.91746031746032,27,21,222,3,185
2321,260,620,171.08462585034013,172.40816326530611,27,15,364,1,360
2322,260,615,171.08462585034013,172.8261224489796,27,16,363,2,355
2323,260,673,171.08462585034013,173.91746031746032,27,10,431,3,413
2324,276,34,172.80290249433108,174.14965986394557,35,44,249,1,242
2325,276,18,172.80290249433108,175.3106575963719,35,45,280,3,258
2326,276,206,172.80290249433108,174.03356009070296,35,22,88,1,70
2327,276,404,172.80290249433108,175.51963718820863,35,26,173,3,128
2328,276,445,172.80290249433108,173.91746031746032,35,21,176,1,169
2329,276,419,172.80290249433108,175.5892970521542,35,25,187,3,143
2330,276,673,172.80290249433108,173.91746031746032,35,10,400,1,397
2331,276,694,172.80290249433108,175.3338775510204,35,18,432,3,418
2332,276,34,172.8261224489796,174.14965986394557,34,44,249,1,242
2333,276,18,172.8261224489796,175.3106575963719,34,45,279,2,258
2334,276,206,172.8261224489796,174.03356009070296,34,22,87,1,70
2335,276,404,172.8261224489796,175.51963718820863,34,26,173,3,128
2336,276,445,172.8261224489796,173.91746031746032,34,21,175,1,169
2337,276,419,172.8261224489796,175.5892970521542,34,25,186,3,143
2338,276,673,172.8261224489796,173.91746031746032,34,10,400,1,397
2339,276,694,172.8261224489796,175.3338775510204,34,18,432,3,418
2340,206,18,174.03356009070296,175.3106575963719,22,45,196,1,188
2341,206,54,174.03356009070296,176.19301587301587,22,45,178,2,152
2342,206,65,174.03356009070296,176.91283446712018,22,47,188,3,141
2343,206,404,174.03356009070296,175.51963718820863,22,26,208,1,198
2344,206,215,174.03356009070296,176.2162358276644,22,25,94,2,9
2345,206,419,174.03356009070296,175.5892970521542,22,25,223,2,213
2346,206,462,174.03356009070296,176.70385487528344,22,22,281,3,256
2347,206,694,174.03356009070296,175.3338775510204,22,18,491,1,488
2348,206,673,174.03356009070296,176.70385487528344,22,15,481,3,467
2349,404,65,175.51963718820863,176.91283446712018,26,47,344,1,339
2350,404,71,175.51963718820863,177.86485260770976,26,45,348,2,333
2351,404,271,175.51963718820863,177.56299319727893,26,28,159,2,133
2352,404,217,175.51963718820863,178.1899319727891,26,24,220,3,187
2353,404,462,175.51963718820863,176.70385487528344,26,22,77,1,58
2354,404,489,175.51963718820863,177.05215419501135,26,20,108,2,85
2355,404,427,175.51963718820863,177.95773242630386,26,20,107,2,23
2356,404,673,175.51963718820863,176.70385487528344,26,15,274,1,269
2357,404,714,175.51963718820863,177.16825396825396,26,13,318,2,310
2358,404,878,175.51963718820863,177.30757369614514,26,16,480,2,474
2359,215,71,176.2162358276644,177.86485260770976,25,45,161,2,144
2360,215,271,176.2162358276644,177.56299319727893,25,28,81,1,56
2361,215,217,176.2162358276644,178.1899319727891,25,24,85,2,2
2362,215,427,176.2162358276644,177.95773242630386,25,20,225,2,212
2363,271,24,177.56299319727893,179.69922902494332,28,46,264,2,247
2364,271,304,177.56299319727893,179.30448979591836,28,22,82,2,33
2365,271,446,177.56299319727893,179.30448979591836,28,21,190,2,175
2366,271,674,177.56299319727893,179.3277097505669,28,12,410,2,403
2367,271,676,177.56299319727893,180.00108843537416,28,10,418,2,405
2368,217,24,178.1899319727891,179.69922902494332,24,46,204,2,193
2369,217,49,178.1899319727891,180.76734693877552,24,49,201,3,168
2370,217,46,178.1899319727891,180.95310657596372,24,48,208,3,171
2371,217,304,178.1899319727891,179.30448979591836,24,22,99,1,87
2372,217,214,178.1899319727891,180.72090702947847,24,22,109,3,3
2373,217,228,178.1899319727891,181.06920634920635,24,18,124,3,11
2374,217,446,178.1899319727891,179.30448979591836,24,21,234,1,229
2375,217,445,178.1899319727891,180.65124716553288,24,20,251,2,228
2376,217,674,178.1899319727891,179.3277097505669,24,12,460,1,457
2377,217,676,178.1899319727891,180.00108843537416,24,10,466,2,459
2378,304,49,179.30448979591836,180.76734693877552,22,49,263,1,255
2379,304,46,179.30448979591836,180.95310657596372,22,48,268,2,258
2380,304,214,179.30448979591836,180.72090702947847,22,22,109,1,90
2381,304,228,179.30448979591836,181.06920634920635,22,18,107,2,76
2382,304,445,179.30448979591836,180.65124716553288,22,20,152,1,141
2383,304,443,179.30448979591836,181.34784580498868,22,19,165,2,139
2384,304,428,179.30448979591836,181.9980045351474,22,20,170,3,124
2385,304,692,179.30448979591836,182.0212244897959,22,12,405,3,388
2386,214,27,180.72090702947847,182.69460317460317,22,46,205,2,187
2387,214,46,180.72090702947847,183.48408163265307,22,48,206,3,168
2388,214,304,180.72090702947847,181.97478458049886,22,21,105,1,90
2389,214,428,180.72090702947847,181.9980045351474,22,20,221,1,214
2390,214,427,180.72090702947847,183.36798185941043,22,20,242,3,213
2391,214,692,180.72090702947847,182.0212244897959,22,12,481,1,478
2392,228,27,181.06920634920635,182.69460317460317,18,46,213,2,201
2393,228,46,181.06920634920635,183.48408163265307,18,48,210,2,182
2394,228,41,181.06920634920635,183.90204081632655,18,48,223,3,187
2395,228,205,181.06920634920635,183.76272108843537,18,20,118,3,23
2396,228,427,181.06920634920635,183.36798185941043,18,20,222,2,199
2397,304,46,181.97478458049886,183.48408163265307,21,48,266,2,258
2398,304,41,181.97478458049886,183.90204081632655,21,48,276,2,263
2399,304,41,181.97478458049886,184.87727891156462,21,46,291,3,263
2400,304,205,181.97478458049886,183.76272108843537,21,20,125,2,99
2401,304,206,181.97478458049886,184.761179138322,21,23,155,3,98
2402,304,206,181.97478458049886,184.9469387755102,21,21,161,3,98
2403,304,427,181.97478458049886,183.36798185941043,21,20,137,1,123
2404,304,445,181.97478458049886,184.71473922902496,21,20,184,3,141
2405,304,796,181.97478458049886,183.04290249433106,21,9,494,1,492
2406,205,41,183.76272108843537,184.87727891156462,20,46,171,1,164
2407,205,18,183.76272108843537,186.1079365079365,20,46,213,2,187
2408,205,206,183.76272108843537,184.9469387755102,20,21,51,1,1
2409,205,223,183.76272108843537,186.06149659863945,20,27,101,2,18
2410,205,444,183.76272108843537,185.3881179138322,20,17,249,2,239
2411,205,445,183.76272108843537,186.06149659863945,20,21,260,2,240
2412,205,617,183.76272108843537,186.45623582766441,20,9,428,3,412
2413,206,18,184.761179138322,186.1079365079365,23,46,197,1,188
2414,206,49,184.761179138322,187.36181405895692,23,47,193,3,157
2415,206,223,184.761179138322,186.06149659863945,23,27,59,1,17
2416,206,222,184.761179138322,187.0831746031746,23,28,101,2,16
2417,206,445,184.761179138322,186.06149659863945,23,21,245,1,239
2418,206,548,184.761179138322,187.50113378684807,23,22,362,3,342
2419,206,617,184.761179138322,186.45623582766441,23,9,417,2,411
2420,206,618,184.761179138322,187.50113378684807,23,14,429,3,412
2421,206,18,184.9469387755102,186.1079365079365,21,46,195,1,188
2422,206,49,184.9469387755102,187.36181405895692,21,47,188,2,157
2423,206,223,184.9469387755102,186.06149659863945,21,27,51,1,17
2424,206,222,184.9469387755102,187.0831746031746,21,28,93,2,16
2425,206,445,184.9469387755102,186.06149659863945,21,21,244,1,239
2426,206,548,184.9469387755102,187.50113378684807,21,22,359,3,342
2427,206,617,184.9469387755102,186.45623582766441,21,9,416,2,411
2428,206,618,184.9469387755102,187.50113378684807,21,14,426,3,412
2429,223,49,186.06149659863945,187.36181405895692,27,47,183,1,174
2430,223,54,186.06149659863945,188.47637188208617,27,45,198,2,169
2431,223,222,186.06149659863945,187.0831746031746,27,28,44,1,1
2432,223,246,186.06149659863945,188.03519274376418,27,28,88,2,23
2433,223,548,186.06149659863945,187.50113378684807,27,22,331,1,325
2434,223,427,186.06149659863945,188.7550113378685,27,20,235,3,204
2435,223,618,186.06149659863945,187.50113378684807,27,14,400,1,395
2436,222,54,187.0831746031746,188.47637188208617,28,45,178,1,168
2437,222,24,187.0831746031746,189.59092970521542,28,45,226,3,198
2438,222,24,187.0831746031746,189.98566893424038,28,45,234,3,198
2439,222,308,187.0831746031746,189.33551020408163,28,22,130,2,86
2440,222,427,187.0831746031746,188.7550113378685,28,20,217,2,205
2441,222,465,187.0831746031746,189.26585034013607,28,15,261,2,243
2442,246,24,188.03519274376418,189.59092970521542,28,45,232,2,222
2443,246,24,188.03519274376418,189.98566893424038,28,45,237,2,222
2444,246,24,188.03519274376418,190.96090702947845,28,37,255,3,222
2445,246,308,188.03519274376418,189.33551020408163,28,22,84,1,62
2446,246,465,188.03519274376418,189.26585034013607,28,15,225,1,219
2447,308,24,189.33551020408163,190.96090702947845,22,37,292,2,284
2448,308,31,189.33551020408163,192.07546485260772,22,28,301,3,277
2449,444,19,0.6733786848072563,2.7399546485260773,19,43,434,2,425
2450,444,18,0.6733786848072563,3.4133333333333336,19,42,442,3,426
2451,444,293,0.6733786848072563,2.7631746031746034,19,17,176,2,151
2452,444,306,0.6733786848072563,3.3668934240362813,19,19,180,3,138
2453,444,446,0.6733786848072563,2.670294784580499,19,19,86,2,2
2454,444,672,0.6733786848072563,2.716734693877551,19,15,244,2,228
2455,444,878,0.6733786848072563,2.043356009070295,19,15,438,1,434
2456,444,873,0.6733786848072563,3.3901133786848074,19,16,445,3,429
2457,446,19,1.3235374149659864,2.7399546485260773,20,43,431,1,427
2458,446,18,1.3235374149659864,3.4133333333333336,20,42,437,2,428
2459,446,34,1.3235374149659864,4.272471655328799,20,43,431,3,412
2460,446,293,1.3235374149659864,2.7631746031746034,20,17,165,1,153
2461,446,306,1.3235374149659864,3.3668934240362813,20,19,165,2,140
2462,446,444,1.3235374149659864,3.3668934240362813,20,18,88,2,2
2463,446,427,1.3235374149659864,4.040272108843538,20,20,119,3,19
2464,446,672,1.3235374149659864,2.716734693877551,20,15,234,1,226
2465,446,672,1.3235374149659864,4.063492063492063,20,10,255,3,226
2466,446,873,1.3235374149659864,3.3901133786848074,20,16,436,2,427
2467,446,34,2.670294784580499,4.272471655328799,19,43,418,2,412
2468,446,28,2.670294784580499,5.596009070294785,19,45,437,3,418
2469,446,297,2.670294784580499,4.713650793650793,19,16,173,2,149
2470,446,210,2.670294784580499,5.410249433106576,19,29,264,3,236
2471,446,427,2.670294784580499,4.040272108843538,19,20,62,1,19
2472,446,427,2.670294784580499,5.38702947845805,19,22,119,3,19
2473,446,672,2.670294784580499,4.063492063492063,19,10,234,1,226
2474,446,873,2.670294784580499,4.73687074829932,19,16,436,2,427
2475,446,921,2.670294784580499,5.38702947845805,19,10,489,3,475
2476,444,28,3.3668934240362813,5.596009070294785,18,45,427,2,416
2477,444,297,3.3668934240362813,4.713650793650793,18,16,158,1,147
2478,444,210,3.3668934240362813,5.410249433106576,18,29,250,2,234
2479,444,274,3.3668934240362813,6.130068027210885,18,23,208,3,170
2480,444,427,3.3668934240362813,5.38702947845805,18,22,89,2,17
2481,444,638,3.3668934240362813,6.292607709750567,18,19,231,3,194
2482,444,873,3.3668934240362813,4.73687074829932,18,16,433,1,429
2483,444,921,3.3668934240362813,5.38702947845805,18,10,485,2,477
2484,444,873,3.3668934240362813,6.0836281179138325,18,15,445,3,429
2485,427,28,4.040272108843538,5.596009070294785,20,45,405,2,399
2486,427,61,4.040272108843538,6.524807256235828,20,43,381,2,366
2487,427,210,4.040272108843538,5.410249433106576,20,29,225,1,217
2488,427,274,4.040272108843538,6.130068027210885,20,23,178,2,153
2489,427,536,4.040272108843538,6.362267573696145,20,21,148,2,109
2490,427,638,4.040272108843538,6.292607709750567,20,19,232,2,211
2491,427,921,4.040272108843538,5.38702947845805,20,10,497,1,494
2492,427,873,4.040272108843538,6.0836281179138325,20,15,455,2,446
2493,427,61,5.38702947845805,6.524807256235828,22,43,369,1,366
2494,427,61,5.38702947845805,7.500045351473923,22,44,377,2,366
2495,427,281,5.38702947845805,7.801904761904762,22,32,179,2,146
2496,427,414,5.38702947845805,7.430385487528345,22,17,89,2,13
2497,427,531,5.38702947845805,8.150204081632653,22,23,158,3,104
2498,427,622,5.38702947845805,7.198185941043084,22,9,210,2,195
2499,427,622,5.38702947845805,8.150204081632653,22,16,228,3,195
2500,427,873,5.38702947845805,7.430385487528345,22,17,455,2,446
2501,536,61,6.362267573696145,7.500045351473923,21,44,478,1,475
2502,536,281,6.362267573696145,7.801904761904762,21,32,262,1,255
2503,536,217,6.362267573696145,8.52172335600907,21,35,332,2,319
2504,536,414,6.362267573696145,7.430385487528345,21,17,130,1,122
2505,536,531,6.362267573696145,8.150204081632653,21,23,77,2,5
2506,536,622,6.362267573696145,8.150204081632653,21,16,115,2,86
2507,536,873,6.362267573696145,7.430385487528345,21,17,340,1,337
2508,536,872,6.362267573696145,8.777142857142858,21,15,352,2,336
2509,414,31,7.430385487528345,8.70748299319728,17,44,387,1,383
2510,414,18,7.430385487528345,9.47374149659864,17,44,406,2,396
2511,414,217,7.430385487528345,8.52172335600907,17,35,203,1,197
2512,414,342,7.430385487528345,9.427301587301587,17,19,112,2,72
2513,414,445,7.430385487528345,9.427301587301587,17,20,91,2,31
2514,414,872,7.430385487528345,8.777142857142858,17,15,462,1,458
2515,414,907,7.430385487528345,9.427301587301587,17,13,500,2,493
2516,414,872,7.430385487528345,10.12390022675737,17,15,472,3,458
2517,531,82,8.150204081632653,10.797278911564627,23,43,463,3,449
2518,531,342,8.150204081632653,9.427301587301587,23,19,197,1,189
2519,531,395,8.150204081632653,10.95981859410431,23,23,182,3,136
2520,531,292,8.150204081632653,11.052698412698414,23,24,270,3,239
2521,531,445,8.150204081632653,9.427301587301587,23,20,102,1,86
2522,531,505,8.150204081632653,10.95981859410431,23,26,124,3,26
2523,531,620,8.150204081632653,11.00625850340136,23,20,152,3,89
2524,531,616,8.150204081632653,11.052698412698414,23,15,151,3,85
2525,531,907,8.150204081632653,9.427301587301587,23,13,380,1,376
2526,531,872,8.150204081632653,10.12390022675737,23,15,351,2,341
2527,445,82,9.427301587301587,10.797278911564627,20,43,368,1,363
2528,445,61,9.427301587301587,11.261678004535147,20,46,392,2,384
2529,445,20,9.427301587301587,12.283356009070294,20,43,442,3,425
2530,445,395,9.427301587301587,10.95981859410431,20,23,83,2,50
2531,445,292,9.427301587301587,11.052698412698414,20,24,168,2,153
2532,445,505,9.427301587301587,10.95981859410431,20,26,89,2,60
2533,445,443,9.427301587301587,11.470657596371883,20,18,88,2,2
2534,445,427,9.427301587301587,12.120816326530612,20,20,117,3,18
2535,445,620,9.427301587301587,11.00625850340136,20,20,188,2,175
2536,445,616,9.427301587301587,11.052698412698414,20,15,185,2,171
2537,445,724,9.427301587301587,12.120816326530612,20,9,302,3,279
2538,445,878,9.427301587301587,11.470657596371883,20,16,442,2,433
2539,505,20,10.95981859410431,12.283356009070294,26,43,488,1,485
2540,505,18,10.95981859410431,13.514013605442177,26,45,499,3,487
2541,505,219,10.95981859410431,12.84063492063492,26,16,297,2,286
2542,505,268,10.95981859410431,13.746213151927439,26,22,266,3,237
2543,505,427,10.95981859410431,12.120816326530612,26,20,93,1,78
2544,505,541,10.95981859410431,13.467573696145125,26,23,114,3,36
2545,505,724,10.95981859410431,12.120816326530612,26,9,225,1,219
2546,505,713,10.95981859410431,13.444353741496599,26,19,234,2,208
2547,505,878,10.95981859410431,12.817414965986394,26,15,381,2,373
2548,505,865,10.95981859410431,13.467573696145125,26,14,376,3,360
2549,443,18,11.470657596371883,13.514013605442177,18,45,434,2,425
2550,443,24,11.470657596371883,14.280272108843537,18,43,436,3,419
2551,443,219,11.470657596371883,12.84063492063492,18,16,232,1,224
2552,443,268,11.470657596371883,13.746213151927439,18,22,201,2,175
2553,443,268,11.470657596371883,14.09451247165533,18,20,208,3,175
2554,443,541,11.470657596371883,13.467573696145125,18,23,130,2,98
2555,443,713,11.470657596371883,13.444353741496599,18,19,283,2,270
2556,443,784,11.470657596371883,14.164172335600908,18,9,360,3,341
2557,443,878,11.470657596371883,12.817414965986394,18,15,439,1,435
2558,443,865,11.470657596371883,13.467573696145125,18,14,431,2,422
2559,443,873,11.470657596371883,14.164172335600908,18,16,445,3,430
2560,427,18,12.120816326530612,13.514013605442177,20,45,413,1,409
2561,427,24,12.120816326530612,14.280272108843537,20,43,414,2,403
2562,427,35,12.120816326530612,15.069750566893424,20,38,412,3,392
2563,427,268,12.120816326530612,13.746213151927439,20,22,174,2,159
2564,427,268,12.120816326530612,14.09451247165533,20,20,180,2,159
2565,427,541,12.120816326530612,13.467573696145125,20,23,128,1,114
2566,427,436,12.120816326530612,14.814331065759637,20,20,116,3,9
2567,427,713,12.120816326530612,13.444353741496599,20,19,292,1,286
2568,427,784,12.120816326530612,14.164172335600908,20,9,368,2,357
2569,427,865,12.120816326530612,13.467573696145125,20,14,442,1,438
2570,427,873,12.120816326530612,14.164172335600908,20,16,455,2,446
2571,541,264,13.467573696145125,15.905668934240364,23,18,296,2,277
2572,541,274,13.467573696145125,16.23074829931973,23,30,292,3,267
2573,541,436,13.467573696145125,14.814331065759637,23,20,120,1,105
2574,541,443,13.467573696145125,15.51092970521542,23,18,132,2,98
2575,541,427,13.467573696145125,16.16108843537415,23,21,163,3,114
2576,541,629,13.467573696145125,15.534149659863946,23,10,125,2,88
2577,541,617,13.467573696145125,16.207528344671204,23,11,140,3,76
2578,541,878,13.467573696145125,15.51092970521542,23,16,348,2,337
2579,436,61,14.814331065759637,16.532607709750568,20,46,382,2,375
2580,436,61,14.814331065759637,17.34530612244898,20,45,391,3,375
2581,436,264,14.814331065759637,15.905668934240364,20,18,178,1,172
2582,436,274,14.814331065759637,16.23074829931973,20,30,173,1,162
2583,436,427,14.814331065759637,16.16108843537415,20,21,59,1,9
2584,436,617,14.814331065759637,16.207528344671204,20,11,191,1,181
2585,436,639,14.814331065759637,17.136326530612244,20,17,226,2,203
2586,436,878,14.814331065759637,16.857687074829933,20,15,451,2,442
2587,436,921,14.814331065759637,17.507845804988662,20,11,499,3,485
2588,443,61,15.51092970521542,16.532607709750568,18,46,385,1,382
2589,443,61,15.51092970521542,17.34530612244898,18,45,390,2,382
2590,443,277,15.51092970521542,17.902585034013605,18,29,195,2,166
2591,443,436,15.51092970521542,17.507845804988662,18,21,86,2,7
2592,443,639,15.51092970521542,17.136326530612244,18,17,208,2,196
2593,443,878,15.51092970521542,16.857687074829933,18,15,439,1,435
2594,443,921,15.51092970521542,17.507845804988662,18,11,486,2,478
2595,443,873,15.51092970521542,18.22766439909297,18,16,446,3,430
2596,427,61,16.16108843537415,17.34530612244898,21,45,370,1,366
2597,427,31,16.16108843537415,18.52952380952381,21,45,409,2,396
2598,427,277,16.16108843537415,17.902585034013605,21,29,168,2,150
2599,427,218,16.16108843537415,18.83138321995465,21,32,239,3,209
2600,427,436,16.16108843537415,17.507845804988662,21,21,59,1,9
2601,427,416,16.16108843537415,18.784943310657596,21,24,114,3,11
2602,427,620,16.16108843537415,19.017142857142858,21,19,229,3,193
2603,427,921,16.16108843537415,17.507845804988662,21,11,497,1,494
2604,427,873,16.16108843537415,18.22766439909297,21,16,455,2,446
2605,436,31,17.507845804988662,18.52952380952381,21,45,407,1,405
2606,436,31,17.507845804988662,19.644081632653062,21,44,415,2,405
2607,436,18,17.507845804988662,20.24780045351474,21,43,434,3,418
2608,436,218,17.507845804988662,18.83138321995465,21,32,225,1,218
2609,436,216,17.507845804988662,19.272562358276645,21,34,233,2,220
2610,436,342,17.507845804988662,20.224580498866214,21,18,150,3,94
2611,436,416,17.507845804988662,18.784943310657596,21,24,59,1,20
2612,436,612,17.507845804988662,19.388662131519276,21,19,194,2,176
2613,436,445,17.507845804988662,20.20136054421769,21,21,116,3,9
2614,436,620,17.507845804988662,19.017142857142858,21,19,195,2,184
2615,436,617,17.507845804988662,19.458321995464853,21,21,200,2,181
2616,436,873,17.507845804988662,19.574421768707484,21,16,446,2,437
2617,416,18,18.784943310657596,20.24780045351474,24,43,403,1,398
2618,416,342,18.784943310657596,20.224580498866214,24,18,97,1,74
2619,416,445,18.784943310657596,20.20136054421769,24,21,68,1,29
2620,416,428,18.784943310657596,21.5481179138322,24,20,120,3,12
2621,416,873,18.784943310657596,20.921179138321996,24,16,466,2,457
2622,416,907,18.784943310657596,21.571337868480725,24,11,505,3,491
2623,612,276,19.388662131519276,22.03573696145125,19,35,355,3,336
2624,612,276,19.388662131519276,22.105396825396827,19,35,356,3,336
2625,612,428,19.388662131519276,21.5481179138322,19,20,206,2,184
2626,612,638,19.388662131519276,21.989297052154196,19,13,115,3,26
2627,612,644,19.388662131519276,22.105396825396827,19,10,121,3,32
2628,612,873,19.388662131519276,20.921179138321996,19,16,269,2,261
2629,612,907,19.388662131519276,21.571337868480725,19,11,310,2,295
2630,612,873,19.388662131519276,22.267936507936508,19,15,289,3,261
2631,445,28,20.20136054421769,21.826757369614512,21,46,423,2,417
2632,445,24,20.20136054421769,22.430476190476192,21,46,432,2,421
2633,445,35,20.20136054421769,23.1502947845805,21,42,429,3,410
2634,445,276,20.20136054421769,22.03573696145125,21,35,187,2,169
2635,445,276,20.20136054421769,22.105396825396827,21,35,188,2,169
2636,445,428,20.20136054421769,21.5481179138322,21,20,60,1,17
2637,445,427,20.20136054421769,22.918095238095237,21,20,118,3,18
2638,445,638,20.20136054421769,21.989297052154196,21,13,208,2,193
2639,445,644,20.20136054421769,22.105396825396827,21,10,215,2,199
2640,445,907,20.20136054421769,21.571337868480725,21,11,466,1,462
2641,445,873,20.20136054421769,22.267936507936508,21,15,437,2,428
2642,428,35,21.5481179138322,23.1502947845805,20,42,399,2,393
2643,428,219,21.5481179138322,23.61469387755102,20,16,227,2,209
2644,428,206,21.5481179138322,24.473832199546486,20,27,255,3,222
2645,428,427,21.5481179138322,22.918095238095237,20,20,59,1,1
2646,428,444,21.5481179138322,23.591473922902495,20,18,89,2,16
2647,428,489,21.5481179138322,24.264852607709752,20,23,132,3,61
2648,428,715,21.5481179138322,24.241632653061224,20,18,310,3,287
2649,428,873,21.5481179138322,23.61469387755102,20,16,454,2,445
2650,428,911,21.5481179138322,24.264852607709752,20,20,497,3,483
2651,427,82,22.918095238095237,24.61315192743764,20,45,353,2,345
2652,427,25,22.918095238095237,25.240090702947846,20,44,414,2,402
2653,427,206,22.918095238095237,24.473832199546486,20,27,231,2,221
2654,427,219,22.918095238095237,25.658049886621317,20,14,239,3,208
2655,427,489,22.918095238095237,24.264852607709752,20,23,85,1,62
2656,427,715,22.918095238095237,24.241632653061224,20,18,294,1,288
2657,427,911,22.918095238095237,24.264852607709752,20,20,487,1,484
2658,427,907,22.918095238095237,25.611609977324264,20,11,494,3,480
2659,444,82,23.591473922902495,24.61315192743764,18,45,365,1,362
2660,444,25,23.591473922902495,25.240090702947846,18,44,425,2,419
2661,444,219,23.591473922902495,25.658049886621317,18,14,242,2,225
2662,444,305,23.591473922902495,26.28498866213152,18,14,181,3,139
2663,444,427,23.591473922902495,25.611609977324264,18,20,89,2,17
2664,444,629,23.591473922902495,26.33142857142857,18,9,219,3,185
2665,444,907,23.591473922902495,25.611609977324264,18,11,471,2,463
2666,444,873,23.591473922902495,26.308208616780046,18,16,445,3,429
2667,489,20,24.264852607709752,27.028027210884353,23,41,484,3,469
2668,489,219,24.264852607709752,25.658049886621317,23,14,277,1,270
2669,489,305,24.264852607709752,26.28498866213152,23,14,204,2,184
2670,489,427,24.264852607709752,25.611609977324264,23,20,85,1,62
2671,489,427,24.264852607709752,26.958367346938775,23,20,132,3,62
2672,489,629,24.264852607709752,26.33142857142857,23,9,166,2,140
2673,489,907,24.264852607709752,25.611609977324264,23,11,422,1,418
2674,489,873,24.264852607709752,26.308208616780046,23,16,394,2,384
2675,427,20,25.611609977324264,27.028027210884353,20,41,412,1,407
2676,427,20,25.611609977324264,27.678185941043086,20,42,417,2,407
2677,427,225,25.611609977324264,27.654965986394558,20,15,220,2,202
2678,427,443,25.611609977324264,27.654965986394558,20,17,89,2,16
2679,427,784,25.611609977324264,28.35156462585034,20,10,376,3,357
2680,427,878,25.611609977324264,27.654965986394558,20,15,460,2,451
2681,427,64,26.958367346938775,28.76952380952381,20,45,371,2,363
2682,427,72,26.958367346938775,29.23392290249433,20,44,368,2,355
2683,427,260,26.958367346938775,28.93206349206349,20,23,187,2,167
2684,427,422,26.958367346938775,28.93206349206349,20,24,85,2,5
2685,427,784,26.958367346938775,28.35156462585034,20,10,362,1,357
2686,427,873,26.958367346938775,29.00172335600907,20,16,455,2,446
2687,427,855,26.958367346938775,29.559002267573696,20,11,442,3,428
2688,443,64,27.654965986394558,28.76952380952381,17,45,382,1,379
2689,443,72,27.654965986394558,29.23392290249433,17,44,377,2,371
2690,443,260,27.654965986394558,28.93206349206349,17,23,191,1,183
2691,443,258,27.654965986394558,30.02340136054422,17,30,211,2,185
2692,443,275,27.654965986394558,30.394920634920634,17,28,205,3,168
2693,443,422,27.654965986394558,28.93206349206349,17,24,59,1,21
2694,443,427,27.654965986394558,29.651882086167802,17,20,87,2,16
2695,443,630,27.654965986394558,30.046621315192745,17,15,213,2,187
2696,443,873,27.654965986394558,29.00172335600907,17,16,434,1,430
2697,443,855,27.654965986394558,29.559002267573696,17,11,420,2,412
2698,443,878,27.654965986394558,30.348480725623585,17,14,450,3,435
2699,422,61,28.93206349206349,30.78965986394558,24,48,370,2,361
2700,422,19,28.93206349206349,31.71845804988662,24,45,420,3,403
2701,422,258,28.93206349206349,30.02340136054422,24,30,171,1,164
2702,422,275,28.93206349206349,30.394920634920634,24,28,160,1,147
2703,422,275,28.93206349206349,31.207619047619048,24,18,177,2,147
2704,422,436,28.93206349206349,30.998639455782314,24,21,90,2,14
2705,422,443,28.93206349206349,31.695238095238096,24,18,121,3,21
2706,422,630,28.93206349206349,30.046621315192745,24,15,213,1,208
2707,422,631,28.93206349206349,30.78965986394558,24,16,224,2,209
2708,422,878,28.93206349206349,30.348480725623585,24,14,460,1,456
2709,422,872,28.93206349206349,31.695238095238096,24,15,465,3,450
2710,427,61,29.651882086167802,30.78965986394558,20,48,369,1,366
2711,427,19,29.651882086167802,31.71845804988662,20,45,418,2,408
2712,427,31,29.651882086167802,32.55437641723356,20,46,415,3,396
2713,427,275,29.651882086167802,31.207619047619048,20,18,166,2,152
2714,427,436,29.651882086167802,30.998639455782314,20,21,59,1,9
2715,427,443,29.651882086167802,31.695238095238096,20,18,89,2,16
2716,427,631,29.651882086167802,30.78965986394558,20,16,210,1,204
2717,427,872,29.651882086167802,31.695238095238096,20,15,454,2,445
2718,436,31,30.998639455782314,32.55437641723356,21,46,411,2,405
2719,436,261,30.998639455782314,32.76335600907029,21,36,191,2,175
2720,436,427,30.998639455782314,32.345396825396826,21,21,59,1,9
2721,436,445,30.998639455782314,33.69215419501134,21,21,116,3,9
2722,436,619,30.998639455782314,32.786575963718825,21,21,199,2,183
2723,436,635,30.998639455782314,33.552834467120185,21,17,227,3,199
2724,436,878,30.998639455782314,33.04199546485261,21,15,451,2,442
2725,436,907,30.998639455782314,33.69215419501134,21,11,485,3,471
2726,443,66,31.695238095238096,34.11011337868481,18,45,391,2,377
2727,443,261,31.695238095238096,32.76335600907029,18,36,188,1,182
2728,443,264,31.695238095238096,34.04045351473923,18,25,206,2,179
2729,443,221,31.695238095238096,34.644172335600906,18,26,256,3,222
2730,443,445,31.695238095238096,33.69215419501134,18,21,86,2,2
2731,443,619,31.695238095238096,32.786575963718825,18,21,182,1,176
2732,443,635,31.695238095238096,33.552834467120185,18,17,208,2,192
2733,443,878,31.695238095238096,33.04199546485261,18,15,439,1,435
2734,443,907,31.695238095238096,33.69215419501134,18,11,472,2,464
2735,443,872,31.695238095238096,34.38875283446712,18,16,444,3,429
2736,427,66,32.345396825396826,34.11011337868481,21,45,369,2,361
2737,427,24,32.345396825396826,35.10857142857143,21,48,420,3,403
2738,427,24,32.345396825396826,35.15501133786848,21,47,421,3,403
2739,427,264,32.345396825396826,34.04045351473923,21,25,179,2,163
2740,427,221,32.345396825396826,34.644172335600906,21,26,229,2,206
2741,427,219,32.345396825396826,35.294331065759636,21,24,244,3,208
2742,427,445,32.345396825396826,33.69215419501134,21,21,61,1,18
2743,427,462,32.345396825396826,34.89959183673469,21,21,115,3,35
2744,427,432,32.345396825396826,35.20145124716554,21,24,123,3,5
2745,427,635,32.345396825396826,33.552834467120185,21,17,214,1,208
2746,427,907,32.345396825396826,33.69215419501134,21,11,483,1,480
2747,427,872,32.345396825396826,34.38875283446712,21,16,454,2,445
2748,445,24,33.69215419501134,35.10857142857143,21,48,425,1,421
2749,445,24,33.69215419501134,35.15501133786848,21,47,426,1,421
2750,445,28,33.69215419501134,36.17668934240363,21,43,431,2,417
2751,445,219,33.69215419501134,35.294331065759636,21,24,236,2,226
2752,445,462,33.69215419501134,34.89959183673469,21,21,55,1,17
2753,445,432,33.69215419501134,35.20145124716554,21,24,66,2,13
2754,445,808,33.69215419501134,35.48009070294785,21,11,371,2,363
2755,462,28,34.89959183673469,36.17668934240363,21,43,437,1,434
2756,462,62,34.89959183673469,37.802086167800454,21,47,419,3,400
2757,462,221,34.89959183673469,37.151927437641724,21,14,260,2,241
2758,462,248,34.89959183673469,37.755646258503404,21,27,247,3,214
2759,462,443,34.89959183673469,37.73242630385488,21,19,123,3,19
2760,462,619,34.89959183673469,37.755646258503404,21,15,199,3,157
2761,462,943,34.89959183673469,37.73242630385488,21,12,496,3,481
2762,432,62,35.20145124716554,37.802086167800454,24,47,387,3,370
2763,432,221,35.20145124716554,37.151927437641724,24,14,227,2,211
2764,432,248,35.20145124716554,37.755646258503404,24,27,214,3,184
2765,432,443,35.20145124716554,37.73242630385488,24,19,110,3,11
2766,432,619,35.20145124716554,37.755646258503404,24,15,217,3,187
2767,443,61,37.73242630385488,39.14884353741497,19,45,387,1,382
2768,443,61,37.73242630385488,39.19528344671202,19,46,387,1,382
2769,443,276,37.73242630385488,39.14884353741497,19,21,178,1,167
2770,443,218,37.73242630385488,39.72934240362812,19,38,241,2,225
2771,443,306,37.73242630385488,40.51882086167801,19,18,182,3,137
2772,443,428,37.73242630385488,39.07918367346939,19,19,60,1,15
2773,443,512,37.73242630385488,39.65968253968254,19,20,108,2,69
2774,443,428,37.73242630385488,40.4259410430839,19,20,117,3,15
2775,443,672,37.73242630385488,39.10240362811791,19,12,236,1,229
2776,443,802,37.73242630385488,39.91510204081633,19,16,371,2,359
2777,443,874,37.73242630385488,39.7990022675737,19,15,440,2,431
2778,428,18,39.07918367346939,41.145759637188206,19,45,420,2,410
2779,428,31,39.07918367346939,41.81913832199547,19,45,414,3,397
2780,428,306,39.07918367346939,40.51882086167801,19,18,137,1,122
2781,428,271,39.07918367346939,41.86557823129252,19,19,198,3,157
2782,428,489,39.07918367346939,41.40117913832199,19,25,117,2,61
2783,428,660,39.07918367346939,41.40117913832199,19,15,253,2,232
2784,428,873,39.07918367346939,41.145759637188206,19,15,454,2,445
2785,428,854,39.07918367346939,41.40117913832199,19,11,438,2,426
2786,512,18,39.65968253968254,41.145759637188206,20,45,498,1,494
2787,512,31,39.65968253968254,41.81913832199547,20,45,490,2,481
2788,512,271,39.65968253968254,41.86557823129252,20,19,259,2,241
2789,512,219,39.65968253968254,42.49251700680272,20,35,317,3,293
2790,512,489,39.65968253968254,41.40117913832199,20,25,78,2,23
2791,512,660,39.65968253968254,41.40117913832199,20,15,166,2,148
2792,512,621,39.65968253968254,42.4692970521542,20,12,163,3,109
2793,512,873,39.65968253968254,41.145759637188206,20,15,367,1,361
2794,512,854,39.65968253968254,41.40117913832199,20,11,350,2,342
2795,512,873,39.65968253968254,42.49251700680272,20,17,381,3,361
2796,428,31,40.4259410430839,41.81913832199547,20,45,402,1,397
2797,428,83,40.4259410430839,42.956916099773245,20,44,362,3,345
2798,428,271,40.4259410430839,41.86557823129252,20,19,169,1,157
2799,428,219,40.4259410430839,42.49251700680272,20,35,227,2,209
2800,428,427,40.4259410430839,43.14267573696145,20,20,117,3,1
2801,428,621,40.4259410430839,42.4692970521542,20,12,212,2,193
2802,428,873,40.4259410430839,42.49251700680272,20,17,454,2,445
2803,489,83,41.40117913832199,42.956916099773245,25,44,411,2,406
2804,489,23,41.40117913832199,43.46775510204082,25,44,474,2,466
2805,489,20,41.40117913832199,44.210793650793654,25,45,484,3,469
2806,489,219,41.40117913832199,42.49251700680272,25,35,274,1,270
2807,489,229,41.40117913832199,43.6302947845805,25,30,277,2,260
2808,489,427,41.40117913832199,43.14267573696145,25,20,97,2,62
2809,489,425,41.40117913832199,43.83927437641724,25,17,123,2,64
2810,489,621,41.40117913832199,42.4692970521542,25,12,140,1,132
2811,489,668,41.40117913832199,43.67673469387755,25,12,204,2,179
2812,489,873,41.40117913832199,42.49251700680272,25,17,387,1,384
2813,489,873,41.40117913832199,43.83927437641724,25,16,398,2,384
2814,427,20,43.14267573696145,44.210793650793654,20,45,410,1,407
2815,427,18,43.14267573696145,45.88263038548753,20,46,426,3,409
2816,427,312,43.14267573696145,44.489433106575966,20,16,129,1,115
2817,427,267,43.14267573696145,45.81297052154195,20,21,197,3,160
2818,427,438,43.14267573696145,45.81297052154195,20,20,116,3,11
2819,427,752,43.14267573696145,44.489433106575966,20,10,330,1,325
2820,427,617,43.14267573696145,45.952290249433105,20,12,225,3,190
2821,427,872,43.14267573696145,45.186031746031745,20,16,454,2,445
2822,427,907,43.14267573696145,45.836190476190474,20,12,494,3,480
2823,425,18,43.83927437641724,45.88263038548753,17,46,416,2,407
2824,425,61,43.83927437641724,46.672108843537416,17,47,384,3,364
2825,425,267,43.83927437641724,45.81297052154195,17,21,179,2,158
2826,425,261,43.83927437641724,46.34702947845805,17,29,196,3,164
2827,425,438,43.83927437641724,45.81297052154195,17,20,86,2,13
2828,425,617,43.83927437641724,45.952290249433105,17,12,212,2,192
2829,425,872,43.83927437641724,45.186031746031745,17,16,451,1,447
2830,425,907,43.83927437641724,45.836190476190474,17,12,490,2,482
2831,425,878,43.83927437641724,46.53278911564626,17,18,468,3,453
2832,427,18,44.489433106575966,45.88263038548753,20,46,413,1,409
2833,427,61,44.489433106575966,46.672108843537416,20,47,378,2,366
2834,427,267,44.489433106575966,45.81297052154195,20,21,170,1,160
2835,427,261,44.489433106575966,46.34702947845805,20,29,184,2,166
2836,427,438,44.489433106575966,45.81297052154195,20,20,58,1,11
2837,427,617,44.489433106575966,45.952290249433105,20,12,200,1,190
2838,427,633,44.489433106575966,47.09006802721088,20,10,234,3,206
2839,427,907,44.489433106575966,45.836190476190474,20,12,483,1,480
2840,427,878,44.489433106575966,46.53278911564626,20,18,460,2,451
2841,438,25,45.81297052154195,47.484807256235825,20,45,419,2,413
2842,438,81,45.81297052154195,48.29750566893424,20,46,373,2,357
2843,438,263,45.81297052154195,47.71700680272109,20,35,193,2,175
2844,438,243,45.81297052154195,48.29750566893424,20,23,222,2,195
2845,438,427,45.81297052154195,47.18294784580499,20,21,60,1,11
2846,438,444,45.81297052154195,47.85632653061224,20,17,88,2,6
2847,438,427,45.81297052154195,48.529705215419504,20,20,118,3,11
2848,438,633,45.81297052154195,47.09006802721088,20,10,203,1,195
2849,438,755,45.81297052154195,47.78666666666667,20,16,328,2,317
2850,438,700,45.81297052154195,48.50648526077098,20,11,287,3,262
2851,438,878,45.81297052154195,47.879546485260775,20,17,449,2,440
2852,427,81,47.18294784580499,48.29750566893424,21,46,349,1,346
2853,427,243,47.18294784580499,48.29750566893424,21,23,190,1,184
2854,427,445,47.18294784580499,49.87646258503401,21,21,117,3,18
2855,427,700,47.18294784580499,48.50648526077098,21,11,279,1,273
2856,427,673,47.18294784580499,49.89968253968254,21,10,272,3,246
2857,427,911,47.18294784580499,49.20308390022676,21,12,492,2,484
2858,427,878,47.18294784580499,49.22630385487528,21,16,460,2,451
2859,444,31,47.85632653061224,50.178321995464856,17,46,425,2,413
2860,444,109,47.85632653061224,50.59628117913832,17,46,355,3,335
2861,444,214,47.85632653061224,50.178321995464856,17,27,251,2,230
2862,444,254,47.85632653061224,50.24798185941043,17,33,216,2,190
2863,444,445,47.85632653061224,49.87646258503401,17,21,87,2,1
2864,444,673,47.85632653061224,49.89968253968254,17,10,245,2,229
2865,444,743,47.85632653061224,50.43374149659864,17,16,319,3,299
2866,444,911,47.85632653061224,49.20308390022676,17,12,471,1,467
2867,444,878,47.85632653061224,49.22630385487528,17,16,438,1,434
2868,444,872,47.85632653061224,50.5730612244898,17,16,444,3,428
2869,427,31,48.529705215419504,50.178321995464856,20,46,402,2,396
2870,427,109,48.529705215419504,50.59628117913832,20,46,330,2,318
2871,427,18,48.529705215419504,51.26965986394558,20,44,426,3,409
2872,427,214,48.529705215419504,50.178321995464856,20,27,225,2,213
2873,427,254,48.529705215419504,50.24798185941043,20,33,188,2,173
2874,427,264,48.529705215419504,51.316099773242634,20,24,202,3,163
2875,427,445,48.529705215419504,49.87646258503401,20,21,61,1,18
2876,427,445,48.529705215419504,51.22321995464853,20,21,117,3,18
2877,427,556,48.529705215419504,51.24643990929705,20,19,174,3,129
2878,427,673,48.529705215419504,49.89968253968254,20,10,253,1,246
2879,427,743,48.529705215419504,50.43374149659864,20,16,326,2,316
2880,427,872,48.529705215419504,50.5730612244898,20,16,454,2,445
2881,445,18,49.87646258503401,51.26965986394558,21,44,431,1,427
2882,445,18,49.87646258503401,52.61641723356009,21,45,443,3,427
2883,445,264,49.87646258503401,51.316099773242634,21,24,191,1,181
2884,445,218,49.87646258503401,52.45387755102041,21,37,253,3,227
2885,445,556,49.87646258503401,51.24643990929705,21,19,126,1,111
2886,445,673,49.87646258503401,51.89659863945578,21,11,244,2,228
2887,445,684,49.87646258503401,52.848616780045354,21,20,271,3,239
2888,445,878,49.87646258503401,51.919818594104306,21,15,442,2,433
2889,445,18,51.22321995464853,52.61641723356009,21,45,431,1,427
2890,445,41,51.22321995464853,53.68453514739229,21,47,418,2,404
2891,445,218,51.22321995464853,52.45387755102041,21,37,233,1,227
2892,445,486,51.22321995464853,52.895056689342404,21,22,83,2,41
2893,445,684,51.22321995464853,52.848616780045354,21,20,249,2,239
2894,445,849,51.22321995464853,52.895056689342404,21,13,410,2,404
2895,445,872,51.22321995464853,53.26657596371882,21,16,436,2,427
2896,556,218,51.24643990929705,52.45387755102041,19,37,342,1,338
2897,556,231,51.24643990929705,54.218594104308394,19,31,349,3,325
2898,556,486,51.24643990929705,52.895056689342404,19,22,100,2,70
2899,556,445,51.24643990929705,53.91673469387755,19,21,160,3,111
2900,556,684,51.24643990929705,52.848616780045354,19,20,145,2,128
2901,556,807,51.24643990929705,54.218594104308394,19,10,282,3,251
2902,556,849,51.24643990929705,52.895056689342404,19,13,301,2,293
2903,556,872,51.24643990929705,53.26657596371882,19,16,328,2,316
2904,486,20,52.895056689342404,55.00807256235828,22,45,475,2,466
2905,486,34,52.895056689342404,55.49569160997733,22,44,466,3,452
2906,486,231,52.895056689342404,54.218594104308394,22,31,261,1,255
2907,486,230,52.895056689342404,54.24181405895692,22,33,262,1,256
2908,486,445,52.895056689342404,53.91673469387755,22,21,60,1,41
2909,486,543,52.895056689342404,54.61333333333334,22,18,93,2,57
2910,486,427,52.895056689342404,55.263492063492066,22,22,118,2,59
2911,486,807,52.895056689342404,54.218594104308394,22,10,326,1,321
2912,486,673,52.895056689342404,54.61333333333334,22,12,201,2,187
2913,486,878,52.895056689342404,54.61333333333334,22,14,399,2,392
2914,445,20,53.91673469387755,55.00807256235828,21,45,428,1,425
2915,445,34,53.91673469387755,55.49569160997733,21,44,417,2,411
2916,445,18,53.91673469387755,56.679909297052156,21,46,443,3,427
2917,445,219,53.91673469387755,55.98331065759637,21,17,243,2,226
2918,445,404,53.91673469387755,56.86566893424036,21,25,133,3,41
2919,445,427,53.91673469387755,55.263492063492066,21,22,61,1,18
2920,445,616,53.91673469387755,55.960090702947845,21,10,192,2,171
2921,445,622,53.91673469387755,56.65668934240363,21,20,213,3,177
2922,445,872,53.91673469387755,55.960090702947845,21,15,436,2,427
2923,543,219,54.61333333333334,55.98331065759637,18,17,329,1,324
2924,543,404,54.61333333333334,56.86566893424036,18,25,169,2,139
2925,543,215,54.61333333333334,57.58548752834467,18,24,352,3,328
2926,543,419,54.61333333333334,56.93532879818594,18,24,159,2,124
2927,543,616,54.61333333333334,55.960090702947845,18,10,93,1,73
2928,543,622,54.61333333333334,56.65668934240363,18,20,118,2,79
2929,543,872,54.61333333333334,55.960090702947845,18,15,334,1,329
2930,543,842,54.61333333333334,57.0746485260771,18,19,317,2,299
2931,543,878,54.61333333333334,57.30684807256236,18,16,355,3,335
2932,427,18,55.263492063492066,56.679909297052156,22,46,414,1,409
2933,427,404,55.263492063492066,56.86566893424036,22,25,73,2,23
2934,427,215,55.263492063492066,57.58548752834467,22,24,234,2,212
2935,427,419,55.263492063492066,56.93532879818594,22,24,72,2,8
2936,427,462,55.263492063492066,58.049886621315196,22,22,125,3,35
2937,427,622,55.263492063492066,56.65668934240363,22,20,204,1,195
2938,427,646,55.263492063492066,58.02666666666667,22,17,249,3,219
2939,427,842,55.263492063492066,57.0746485260771,22,19,422,2,415
2940,427,878,55.263492063492066,57.30684807256236,22,16,460,2,451
2941,419,65,56.93532879818594,58.258866213151926,24,47,359,1,354
2942,419,65,56.93532879818594,58.28208616780046,24,45,359,1,354
2943,419,81,56.93532879818594,59.32698412698413,24,43,353,2,338
2944,419,271,56.93532879818594,58.90902494331066,24,28,171,2,148
2945,419,217,56.93532879818594,59.53596371882086,24,23,231,3,202
2946,419,462,56.93532879818594,58.049886621315196,24,22,64,1,43
2947,419,561,56.93532879818594,58.42140589569161,24,18,156,1,142
2948,419,445,56.93532879818594,59.303764172335605,24,21,105,2,26
2949,419,646,56.93532879818594,58.02666666666667,24,17,232,1,227
2950,419,697,56.93532879818594,58.42140589569161,24,14,285,1,278
2951,419,873,56.93532879818594,58.6768253968254,24,16,460,2,454
2952,462,81,58.049886621315196,59.32698412698413,22,43,385,1,381
2953,462,23,58.049886621315196,61.02204081632653,22,43,457,3,439
2954,462,217,58.049886621315196,59.53596371882086,22,23,253,1,245
2955,462,350,58.049886621315196,60.67374149659864,22,18,159,3,112
2956,462,445,58.049886621315196,59.303764172335605,22,21,57,1,17
2957,462,446,58.049886621315196,60.65052154195011,22,20,113,3,16
2958,462,633,58.049886621315196,60.02358276643991,22,10,191,2,171
2959,462,670,58.049886621315196,60.65052154195011,22,12,236,3,208
2960,462,873,58.049886621315196,60.02358276643991,22,16,420,2,411
2961,462,907,58.049886621315196,60.67374149659864,22,11,459,3,445
2962,561,217,58.42140589569161,59.53596371882086,18,23,347,1,344
2963,561,350,58.42140589569161,60.67374149659864,18,18,232,2,211
2964,561,446,58.42140589569161,60.65052154195011,18,20,150,2,115
2965,561,633,58.42140589569161,60.02358276643991,18,10,100,2,72
2966,561,670,58.42140589569161,60.65052154195011,18,12,145,2,109
2967,561,675,58.42140589569161,61.3471201814059,18,11,170,3,114
2968,561,873,58.42140589569161,60.02358276643991,18,16,320,2,312
2969,561,907,58.42140589569161,60.67374149659864,18,11,359,2,346
2970,561,873,58.42140589569161,61.37034013605442,18,16,337,3,312
2971,445,23,59.303764172335605,61.02204081632653,21,43,428,2,422
2972,445,49,59.303764172335605,62.15981859410431,21,48,415,3,396
2973,445,350,59.303764172335605,60.67374149659864,21,18,112,1,95
2974,445,286,59.303764172335605,61.69541950113379,21,25,189,2,159
2975,445,446,59.303764172335605,60.65052154195011,21,20,58,1,1
2976,445,670,59.303764172335605,60.65052154195011,21,12,232,1,225
2977,445,675,59.303764172335605,61.3471201814059,21,11,246,2,230
2978,445,907,59.303764172335605,60.67374149659864,21,11,466,1,462
2979,445,873,59.303764172335605,61.37034013605442,21,16,437,2,428
2980,446,49,60.65052154195011,62.15981859410431,20,48,402,2,397
2981,446,46,60.65052154195011,62.69387755102041,20,48,410,2,400
2982,446,18,60.65052154195011,63.41369614512472,20,45,444,3,428
2983,446,286,60.65052154195011,61.69541950113379,20,25,166,1,160
2984,446,206,60.65052154195011,62.78675736961451,20,18,257,2,240
2985,446,310,60.65052154195011,63.36725623582767,20,19,179,3,136
2986,446,445,60.65052154195011,61.99727891156463,20,20,58,1,1
2987,446,443,60.65052154195011,62.69387755102041,20,19,88,2,3
2988,446,445,60.65052154195011,63.36725623582767,20,20,117,3,1
2989,446,789,60.65052154195011,63.39047619047619,20,14,363,3,343
2990,446,873,60.65052154195011,62.71709750566894,20,16,436,2,427
2991,445,18,61.99727891156463,63.41369614512472,20,45,431,1,427
2992,445,310,61.99727891156463,63.36725623582767,20,19,147,1,135
2993,445,276,61.99727891156463,64.38893424036281,20,22,198,2,169
2994,445,427,61.99727891156463,64.71401360544218,20,20,118,3,18
2995,445,789,61.99727891156463,63.39047619047619,20,14,349,1,344
2996,445,873,61.99727891156463,64.06385487528345,20,16,437,2,428
2997,445,907,61.99727891156463,64.71401360544218,20,12,477,3,462
2998,443,41,62.69387755102041,65.2712925170068,19,47,417,3,402
2999,443,276,62.69387755102041,64.38893424036281,19,22,182,2,167
3000,443,427,62.69387755102041,64.71401360544218,19,20,88,2,16
3001,443,873,62.69387755102041,64.06385487528345,19,16,434,1,430
3002,443,907,62.69387755102041,64.71401360544218,19,12,472,2,464
3003,443,873,62.69387755102041,65.41061224489796,19,16,446,3,430
3004,445,41,63.36725623582767,65.2712925170068,20,47,412,2,404
3005,445,41,63.36725623582767,65.89823129251701,20,48,418,3,404
3006,445,276,63.36725623582767,64.38893424036281,20,22,175,1,169
3007,445,286,63.36725623582767,66.06077097505668,20,17,197,3,159
3008,445,427,63.36725623582767,64.71401360544218,20,20,61,1,18
3009,445,427,63.36725623582767,66.06077097505668,20,20,117,3,18
3010,445,907,63.36725623582767,64.71401360544218,20,12,466,1,462
3011,445,873,63.36725623582767,65.41061224489796,20,16,437,2,428
3012,427,41,64.71401360544218,65.89823129251701,20,48,389,1,386
3013,427,36,64.71401360544218,66.85024943310658,20,45,402,2,391
3014,427,18,64.71401360544218,67.45396825396826,20,45,426,3,409
3015,427,286,64.71401360544218,66.06077097505668,20,17,152,1,141
3016,427,219,64.71401360544218,66.80380952380952,20,15,227,2,208
3017,427,443,64.71401360544218,66.75736961451247,20,17,89,2,16
3018,427,616,64.71401360544218,66.73414965986395,20,9,208,2,189
3019,427,872,64.71401360544218,66.75736961451247,20,16,454,2,445
3020,427,18,66.06077097505668,67.45396825396826,20,45,413,1,409
3021,427,64,66.06077097505668,68.3827664399093,20,45,377,2,363
3022,427,261,66.06077097505668,67.91836734693878,20,20,184,2,166
3023,427,878,66.06077097505668,68.10412698412699,20,16,460,2,451
3024,427,907,66.06077097505668,68.75428571428571,20,11,494,3,480
3025,443,64,66.75736961451247,68.3827664399093,17,45,385,2,379
3026,443,261,66.75736961451247,67.91836734693878,17,20,189,1,182
3027,443,213,66.75736961451247,69.07936507936508,17,27,251,2,230
3028,443,427,66.75736961451247,68.75428571428571,17,21,87,2,16
3029,443,878,66.75736961451247,68.10412698412699,17,16,439,1,435
3030,443,907,66.75736961451247,68.75428571428571,17,11,472,2,464
3031,443,873,66.75736961451247,69.4508843537415,17,16,445,3,430
3032,427,49,67.4075283446712,70.12426303854875,21,42,396,3,378
3033,427,213,67.4075283446712,69.07936507936508,21,27,226,2,214
3034,427,207,67.4075283446712,70.14748299319729,21,30,250,3,220
3035,427,623,67.4075283446712,70.19392290249434,21,14,230,3,196
3036,427,907,67.4075283446712,68.75428571428571,21,11,483,1,480
3037,427,873,67.4075283446712,69.4508843537415,21,16,455,2,446
3038,427,49,68.75428571428571,70.12426303854875,21,42,383,1,378
3039,427,61,68.75428571428571,70.82086167800453,21,45,377,2,366
3040,427,207,68.75428571428571,70.14748299319729,21,30,228,1,220
3041,427,212,68.75428571428571,70.86730158730158,21,28,233,2,215
3042,427,598,68.75428571428571,71.09950113378684,21,19,199,2,171
3043,427,623,68.75428571428571,70.19392290249434,21,14,206,1,196
3044,427,623,68.75428571428571,70.4261224489796,21,19,209,2,196
3045,427,878,68.75428571428571,70.79764172335601,21,16,460,2,451
3046,427,60,70.10104308390022,72.2140589569161,21,46,378,2,367
3047,427,82,70.10104308390022,72.56235827664399,21,45,361,2,345
3048,427,209,70.10104308390022,72.19083900226758,21,29,236,2,218
3049,427,574,70.10104308390022,71.95863945578232,21,24,167,2,147
3050,427,540,70.10104308390022,72.95709750566894,21,22,167,3,113
3051,427,618,70.10104308390022,72.00507936507937,21,20,208,2,191
3052,427,633,70.10104308390022,72.91065759637188,21,17,239,3,206
3053,427,878,70.10104308390022,72.14439909297052,21,17,460,2,451
3054,427,849,70.10104308390022,72.91065759637188,21,12,439,3,422
3055,598,209,71.09950113378684,72.19083900226758,19,29,392,1,389
3056,598,215,71.09950113378684,73.32861678004535,19,34,395,2,383
3057,598,215,71.09950113378684,73.35183673469388,19,33,395,2,383
3058,598,540,71.09950113378684,72.95709750566894,19,22,99,2,58
3059,598,633,71.09950113378684,72.91065759637188,19,17,85,2,35
3060,598,741,71.09950113378684,73.42149659863945,19,16,174,2,143
3061,598,878,71.09950113378684,72.14439909297052,19,17,284,1,280
3062,598,849,71.09950113378684,72.91065759637188,19,12,263,2,251
3063,598,873,71.09950113378684,73.49115646258504,19,15,294,2,275
3064,574,215,71.95863945578232,73.32861678004535,24,34,364,1,359
3065,574,215,71.95863945578232,73.35183673469388,24,33,364,1,359
3066,574,206,71.95863945578232,74.8843537414966,24,16,389,3,368
3067,574,445,71.95863945578232,74.14131519274376,24,20,160,2,129
3068,574,444,71.95863945578232,74.83791383219955,24,18,180,3,130
3069,574,741,71.95863945578232,73.42149659863945,24,16,178,1,167
3070,574,873,71.95863945578232,73.49115646258504,24,15,306,2,299
3071,574,878,71.95863945578232,74.83791383219955,24,16,328,3,304
3072,540,206,72.95709750566894,74.8843537414966,22,16,344,2,334
3073,540,445,72.95709750566894,74.14131519274376,22,20,108,1,95
3074,540,444,72.95709750566894,74.83791383219955,22,18,126,2,96
3075,540,562,72.95709750566894,75.58095238095238,22,25,115,3,22
3076,540,623,72.95709750566894,75.53451247165533,22,22,139,3,83
3077,540,878,72.95709750566894,74.83791383219955,22,16,348,2,338
3078,445,28,74.14131519274376,75.74349206349207,20,43,423,2,417
3079,445,20,74.14131519274376,76.579410430839,20,44,438,2,425
3080,445,213,74.14131519274376,76.02213151927438,20,36,246,2,232
3081,445,381,74.14131519274376,76.34721088435374,20,22,115,2,64
3082,445,562,74.14131519274376,75.58095238095238,20,25,132,1,117
3083,445,491,74.14131519274376,76.37043083900227,20,23,106,2,46
3084,445,623,74.14131519274376,75.53451247165533,20,22,188,1,178
3085,445,668,74.14131519274376,76.34721088435374,20,18,242,2,223
3086,445,878,74.14131519274376,76.18467120181406,20,16,442,2,433
3087,445,936,74.14131519274376,76.34721088435374,20,11,500,2,491
3088,444,20,74.83791383219955,76.579410430839,18,44,431,2,424
3089,444,213,74.83791383219955,76.02213151927438,18,36,237,1,231
3090,444,381,74.83791383219955,76.34721088435374,18,22,91,2,63
3091,444,491,74.83791383219955,76.37043083900227,18,23,81,2,47
3092,444,668,74.83791383219955,76.34721088435374,18,18,233,2,224
3093,444,878,74.83791383219955,76.18467120181406,18,16,438,1,434
3094,444,936,74.83791383219955,76.34721088435374,18,11,496,2,492
3095,562,286,75.58095238095238,78.1815873015873,25,18,298,3,276
3096,562,564,75.58095238095238,78.29768707482994,25,24,117,3,2
3097,562,559,75.58095238095238,78.36734693877551,25,23,120,3,3
3098,562,652,75.58095238095238,78.29768707482994,25,20,148,3,90
3099,562,628,75.58095238095238,78.36734693877551,25,18,137,3,66
3100,562,826,75.58095238095238,78.22802721088435,25,16,288,3,264
3101,491,18,76.37043083900227,78.25124716553289,23,46,480,2,473
3102,491,82,76.37043083900227,78.57632653061225,23,42,420,2,409
3103,491,286,76.37043083900227,78.1815873015873,23,18,219,2,205
3104,491,268,76.37043083900227,78.94784580498866,23,26,249,3,223
3105,491,564,76.37043083900227,78.29768707482994,23,24,111,2,73
3106,491,559,76.37043083900227,78.36734693877551,23,23,110,2,68
3107,491,652,76.37043083900227,78.29768707482994,23,20,181,2,161
3108,491,628,76.37043083900227,78.36734693877551,23,18,162,2,137
3109,491,826,76.37043083900227,78.22802721088435,23,16,344,2,335
3110,491,873,76.37043083900227,78.90140589569161,23,16,397,3,382
3111,564,304,78.29768707482994,80.2249433106576,24,15,273,2,260
3112,564,291,78.29768707482994,80.89832199546485,24,31,295,3,273
3113,564,427,78.29768707482994,79.52834467120182,24,20,147,1,137
3114,564,427,78.29768707482994,80.87510204081633,24,20,176,3,137
3115,564,627,78.29768707482994,80.92154195011338,24,11,129,3,63
3116,564,873,78.29768707482994,80.24816326530612,24,15,320,2,309
3117,559,61,78.36734693877551,81.24662131519274,23,46,513,3,498
3118,559,304,78.36734693877551,80.2249433106576,23,15,267,2,255
3119,559,291,78.36734693877551,80.89832199546485,23,31,289,3,268
3120,559,427,78.36734693877551,79.52834467120182,23,20,141,1,132
3121,559,427,78.36734693877551,80.87510204081633,23,20,171,3,132
3122,559,627,78.36734693877551,80.92154195011338,23,11,129,3,68
3123,559,873,78.36734693877551,80.24816326530612,23,15,324,2,314
3124,559,856,78.36734693877551,81.2930612244898,23,12,323,3,297
3125,427,61,79.52834467120182,81.24662131519274,20,46,373,2,366
3126,427,61,79.52834467120182,81.94321995464853,20,45,380,2,366
3127,427,291,79.52834467120182,80.89832199546485,20,31,148,1,136
3128,427,271,79.52834467120182,82.0128798185941,20,28,189,2,156
3129,427,421,79.52834467120182,82.0128798185941,20,22,107,2,6
3130,427,627,79.52834467120182,80.92154195011338,20,11,209,1,200
3131,427,632,79.52834467120182,82.0128798185941,20,14,231,2,205
3132,427,856,79.52834467120182,81.2930612244898,20,12,436,2,429
3133,427,873,79.52834467120182,81.59492063492064,20,15,455,2,446
3134,427,61,80.87510204081633,81.94321995464853,20,45,369,1,366
3135,427,61,80.87510204081633,82.63981859410431,20,46,374,2,366
3136,427,18,80.87510204081633,83.61505668934241,20,45,426,3,409
3137,427,271,80.87510204081633,82.0128798185941,20,28,164,1,156
3138,427,218,80.87510204081633,83.35963718820862,20,38,235,2,209
3139,427,217,80.87510204081633,83.38285714285715,20,40,236,3,210
3140,427,421,80.87510204081633,82.0128798185941,20,22,49,1,6
3141,427,423,80.87510204081633,82.75591836734694,20,19,81,2,4
3142,427,533,80.87510204081633,83.56861678004535,20,23,157,3,106
3143,427,632,80.87510204081633,82.0128798185941,20,14,211,1,205
3144,427,633,80.87510204081633,82.77913832199546,20,14,222,2,206
3145,427,767,80.87510204081633,83.49895691609977,20,18,358,3,340
3146,427,873,80.87510204081633,82.94167800453515,20,16,455,2,446
3147,421,18,82.0128798185941,83.61505668934241,22,45,409,2,403
3148,421,19,82.0128798185941,84.96181405895692,22,42,422,3,402
3149,421,218,82.0128798185941,83.35963718820862,22,38,211,1,203
3150,421,217,82.0128798185941,83.38285714285715,22,40,212,1,204
3151,421,247,82.0128798185941,84.45097505668934,22,26,203,2,174
3152,421,533,82.0128798185941,83.56861678004535,22,23,131,2,112
3153,421,427,82.0128798185941,84.9385941043084,22,19,126,3,6
3154,421,767,82.0128798185941,83.49895691609977,22,18,352,1,346
3155,421,872,82.0128798185941,84.28843537414966,22,16,462,2,451
3156,421,907,82.0128798185941,84.9385941043084,22,12,502,3,486
3157,423,19,82.75591836734694,84.96181405895692,19,42,415,2,404
3158,423,247,82.75591836734694,84.45097505668934,19,26,191,2,176
3159,423,427,82.75591836734694,84.9385941043084,19,19,94,2,4
3160,423,872,82.75591836734694,84.28843537414966,19,16,454,2,449
3161,423,907,82.75591836734694,84.9385941043084,19,12,493,2,484
3162,423,873,82.75591836734694,85.63519274376418,19,16,467,3,450
3163,533,50,83.56861678004535,86.21569160997733,23,43,496,3,483
3164,533,232,83.56861678004535,86.33179138321995,23,26,324,3,301
3165,533,427,83.56861678004535,84.9385941043084,23,19,121,1,106
3166,533,427,83.56861678004535,86.2853514739229,23,20,158,3,106
3167,533,574,83.56861678004535,86.47111111111111,23,20,132,3,41
3168,533,617,83.56861678004535,86.14603174603175,23,12,139,3,84
3169,533,627,83.56861678004535,86.47111111111111,23,19,156,3,94
3170,533,907,83.56861678004535,84.9385941043084,23,12,379,1,374
3171,533,873,83.56861678004535,85.63519274376418,23,16,351,2,340
3172,533,821,83.56861678004535,86.49433106575964,23,17,314,3,288
3173,427,50,84.9385941043084,86.21569160997733,19,43,381,1,377
3174,427,56,84.9385941043084,86.58721088435374,19,47,378,2,371
3175,427,35,84.9385941043084,87.86430839002267,19,42,412,3,392
3176,427,232,84.9385941043084,86.33179138321995,19,26,204,1,195
3177,427,213,84.9385941043084,86.7265306122449,19,37,227,2,214
3178,427,269,84.9385941043084,87.42312925170069,19,25,191,2,158
3179,427,574,84.9385941043084,86.47111111111111,19,20,161,2,147
3180,427,445,84.9385941043084,87.63210884353742,19,20,117,3,18
3181,427,617,84.9385941043084,86.14603174603175,19,12,197,1,190
3182,427,627,84.9385941043084,86.47111111111111,19,19,211,2,200
3183,427,821,84.9385941043084,86.49433106575964,19,17,400,2,394
3184,427,35,86.2853514739229,87.86430839002267,20,42,398,2,392
3185,427,30,86.2853514739229,89.09496598639456,20,45,415,3,397
3186,427,269,86.2853514739229,87.42312925170069,20,25,165,1,158
3187,427,445,86.2853514739229,87.63210884353742,20,20,61,1,18
3188,427,873,86.2853514739229,88.3287074829932,20,17,455,2,446
3189,427,907,86.2853514739229,88.97886621315193,20,13,494,3,480
3190,574,299,86.47111111111111,89.37360544217687,20,30,302,3,275
3191,574,445,86.47111111111111,87.63210884353742,20,20,138,1,129
3192,574,427,86.47111111111111,88.97886621315193,20,20,182,3,147
3193,574,626,86.47111111111111,89.37360544217687,20,16,135,3,52
3194,574,873,86.47111111111111,88.3287074829932,20,17,310,2,299
3195,574,907,86.47111111111111,88.97886621315193,20,13,350,3,333
3196,445,30,87.63210884353742,89.09496598639456,20,45,420,1,415
3197,445,24,87.63210884353742,89.95410430839003,20,44,433,2,421
3198,445,299,87.63210884353742,89.37360544217687,20,30,164,2,146
3199,445,271,87.63210884353742,89.55936507936508,20,27,193,2,174
3200,445,427,87.63210884353742,88.97886621315193,20,20,61,1,18
3201,445,427,87.63210884353742,90.32562358276644,20,20,117,3,18
3202,445,626,87.63210884353742,89.37360544217687,20,16,196,2,181
3203,445,627,87.63210884353742,89.83800453514739,20,12,205,2,182
3204,445,907,87.63210884353742,88.97886621315193,20,13,466,1,462
3205,445,873,87.63210884353742,89.67546485260772,20,16,437,2,428
3206,427,54,88.97886621315193,91.41696145124716,20,45,387,2,373
3207,427,54,88.97886621315193,91.4401814058957,20,45,388,2,373
3208,427,246,88.97886621315193,91.25442176870749,20,20,206,2,181
3209,427,271,88.97886621315193,91.48662131519275,20,22,190,3,156
3210,427,443,88.97886621315193,91.02222222222223,20,18,89,2,16
3211,427,445,88.97886621315193,91.67238095238095,20,20,117,3,18
3212,427,878,88.97886621315193,91.02222222222223,20,16,460,2,451
3213,427,54,90.32562358276644,91.41696145124716,20,45,376,1,373
3214,427,54,90.32562358276644,91.4401814058957,20,45,376,1,373
3215,427,271,90.32562358276644,91.48662131519275,20,22,164,1,156
3216,427,445,90.32562358276644,91.67238095238095,20,20,61,1,18
3217,427,784,90.32562358276644,93.06557823129252,20,10,376,3,357
3218,427,878,90.32562358276644,92.36897959183673,20,16,460,2,451
3219,427,921,90.32562358276644,93.01913832199547,20,12,507,3,494
3220,443,65,91.02222222222223,93.39065759637188,18,44,392,2,378
3221,443,64,91.02222222222223,93.483537414966,18,45,394,2,379
3222,443,275,91.02222222222223,93.4138775510204,18,19,197,2,168
3223,443,253,91.02222222222223,93.97115646258504,18,32,229,3,190
3224,443,427,91.02222222222223,93.01913832199547,18,20,87,2,16
3225,443,422,91.02222222222223,93.64607709750567,18,23,115,3,21
3226,443,784,91.02222222222223,93.06557823129252,18,10,352,2,341
3227,443,878,91.02222222222223,92.36897959183673,18,16,439,1,435
3228,443,921,91.02222222222223,93.01913832199547,18,12,486,2,478
3229,443,878,91.02222222222223,93.71573696145126,18,16,450,3,435
3230,445,65,91.67238095238095,93.39065759637188,20,44,387,2,380
3231,445,64,91.67238095238095,93.483537414966,20,45,389,2,381
3232,445,275,91.67238095238095,93.4138775510204,20,19,186,2,170
3233,445,253,91.67238095238095,93.97115646258504,20,32,216,2,192
3234,445,427,91.67238095238095,93.01913832199547,20,20,61,1,18
3235,445,422,91.67238095238095,93.64607709750567,20,23,88,2,23
3236,445,410,91.67238095238095,94.59809523809524,20,25,131,3,35
3237,445,784,91.67238095238095,93.06557823129252,20,10,344,1,339
3238,445,921,91.67238095238095,93.01913832199547,20,12,480,1,476
3239,445,878,91.67238095238095,93.71573696145126,20,16,442,2,433
3240,427,61,93.01913832199547,95.41079365079365,20,46,380,2,366
3241,427,61,93.01913832199547,95.8055328798186,20,46,385,3,366
3242,427,258,93.01913832199547,94.7374149659864,20,28,184,2,169
3243,427,273,93.01913832199547,95.55011337868481,20,23,189,3,154
3244,427,410,93.01913832199547,94.59809523809524,20,25,70,2,17
3245,427,436,93.01913832199547,95.71265306122449,20,20,116,3,9
3246,427,630,93.01913832199547,94.76063492063493,20,13,216,2,203
3247,427,631,93.01913832199547,95.50367346938776,20,16,230,2,204
3248,427,878,93.01913832199547,95.06249433106576,20,15,460,2,451
3249,422,61,93.64607709750567,95.41079365079365,23,46,369,2,361
3250,422,61,93.64607709750567,95.8055328798186,23,46,373,2,361
3251,422,19,93.64607709750567,96.45569160997732,23,47,421,3,403
3252,422,258,93.64607709750567,94.7374149659864,23,28,171,1,164
3253,422,273,93.64607709750567,95.55011337868481,23,23,170,2,149
3254,422,436,93.64607709750567,95.71265306122449,23,20,90,2,14
3255,422,630,93.64607709750567,94.76063492063493,23,13,213,1,208
3256,422,631,93.64607709750567,95.50367346938776,23,16,224,2,209
3257,422,878,93.64607709750567,95.06249433106576,23,15,460,1,456
3258,422,873,93.64607709750567,96.4324716553288,23,15,467,3,451
3259,410,61,94.59809523809524,95.8055328798186,25,46,353,1,349
3260,410,19,94.59809523809524,96.45569160997732,25,47,399,2,391
3261,410,266,94.59809523809524,97.4077097505669,25,33,188,3,144
3262,410,261,94.59809523809524,97.52380952380953,25,36,195,3,149
3263,410,436,94.59809523809524,95.71265306122449,25,20,55,1,26
3264,410,445,94.59809523809524,97.05941043083901,25,20,112,2,35
3265,410,636,94.59809523809524,97.36126984126984,25,14,255,3,226
3266,410,619,94.59809523809524,97.500589569161,25,20,244,3,209
3267,410,873,94.59809523809524,96.4324716553288,25,15,470,2,463
3268,436,63,95.71265306122449,97.63990929705216,20,45,382,2,373
3269,436,266,95.71265306122449,97.4077097505669,20,33,185,2,170
3270,436,261,95.71265306122449,97.52380952380953,20,36,192,2,175
3271,436,445,95.71265306122449,97.05941043083901,20,20,59,1,9
3272,436,427,95.71265306122449,98.40616780045352,20,20,116,3,9
3273,436,636,95.71265306122449,97.36126984126984,20,14,212,2,200
3274,436,619,95.71265306122449,97.500589569161,20,20,199,2,183
3275,436,629,95.71265306122449,98.59192743764173,20,11,229,3,193
3276,436,921,95.71265306122449,97.05941043083901,20,11,488,1,485
3277,436,879,95.71265306122449,97.75600907029478,20,15,452,2,443
3278,445,66,97.05941043083901,98.82412698412699,20,44,387,2,379
3279,445,24,97.05941043083901,99.82258503401361,20,47,437,3,421
3280,445,220,97.05941043083901,99.35818594104309,20,28,246,2,225
3281,445,220,97.05941043083901,100.03156462585034,20,24,259,3,225
3282,445,427,97.05941043083901,98.40616780045352,20,20,61,1,18
3283,445,443,97.05941043083901,99.1027664399093,20,17,88,2,2
3284,445,432,97.05941043083901,99.91546485260771,20,24,124,3,13
3285,445,629,97.05941043083901,98.59192743764173,20,11,195,2,184
3286,445,873,97.05941043083901,99.12598639455783,20,16,437,2,428
3287,445,907,97.05941043083901,99.75292517006802,20,10,476,3,462
3288,427,24,98.40616780045352,99.82258503401361,20,47,408,1,403
3289,427,27,98.40616780045352,100.63528344671202,20,46,411,2,400
3290,427,220,98.40616780045352,100.03156462585034,20,24,219,2,207
3291,427,247,98.40616780045352,100.47274376417234,20,20,201,2,180
3292,427,432,98.40616780045352,99.91546485260771,20,24,65,2,5
3293,427,807,98.40616780045352,100.19410430839002,20,11,388,2,380
3294,427,907,98.40616780045352,99.75292517006802,20,10,483,1,480
3295,443,27,99.1027664399093,100.63528344671202,17,46,421,2,416
3296,443,247,99.1027664399093,100.47274376417234,17,20,205,1,196
3297,443,807,99.1027664399093,100.19410430839002,17,11,367,1,364
3298,432,56,99.91546485260771,102.37678004535148,24,48,391,2,376
3299,432,62,99.91546485260771,102.4928798185941,24,48,386,3,370
3300,432,224,99.91546485260771,102.33034013605442,24,26,233,2,208
3301,432,248,99.91546485260771,102.51609977324263,24,23,215,3,184
3302,432,477,99.91546485260771,102.26068027210884,24,18,111,2,45
3303,432,696,99.91546485260771,102.44643990929706,24,15,286,3,264
3304,432,619,99.91546485260771,102.4928798185941,24,10,217,3,187
3305,477,30,102.26068027210884,104.11827664399094,18,45,454,2,447
3306,477,24,102.26068027210884,104.95419501133787,18,43,468,3,453
3307,477,218,102.26068027210884,104.4433560090703,18,38,276,2,259
3308,477,218,102.26068027210884,104.51301587301587,18,36,277,2,259
3309,477,508,102.26068027210884,104.4433560090703,18,20,99,2,31
3310,477,436,102.26068027210884,105.13995464852609,18,20,131,3,41
3311,477,801,102.26068027210884,104.46657596371882,18,13,338,2,324
3312,477,802,102.26068027210884,104.62911564625851,18,15,341,2,325
3313,477,907,102.26068027210884,103.81641723356009,18,12,435,2,430
3314,477,873,102.26068027210884,104.51301587301587,18,18,408,2,396
3315,425,24,103.16625850340137,104.95419501133787,18,43,408,2,401
3316,425,23,103.16625850340137,106.02231292517007,18,45,420,3,402
3317,425,218,103.16625850340137,104.4433560090703,18,38,214,1,207
3318,425,218,103.16625850340137,104.51301587301587,18,36,215,1,207
3319,425,219,103.16625850340137,105.48825396825397,18,19,229,2,206
3320,425,508,103.16625850340137,104.4433560090703,18,20,100,1,83
3321,425,436,103.16625850340137,105.13995464852609,18,20,86,2,11
3322,425,489,103.16625850340137,106.11519274376417,18,24,142,3,64
3323,425,801,103.16625850340137,104.46657596371882,18,13,380,1,376
3324,425,802,103.16625850340137,104.62911564625851,18,15,382,1,377
3325,425,630,103.16625850340137,106.11519274376417,18,15,241,3,205
3326,425,873,103.16625850340137,104.51301587301587,18,18,452,1,448
3327,425,873,103.16625850340137,105.85977324263038,18,15,463,3,448
3328,508,23,104.4433560090703,106.02231292517007,20,45,490,2,485
3329,508,31,104.4433560090703,106.62603174603174,20,45,486,2,477
3330,508,219,104.4433560090703,105.48825396825397,20,19,292,1,289
3331,508,219,104.4433560090703,107.299410430839,20,37,314,3,289
3332,508,489,104.4433560090703,106.11519274376417,20,24,74,2,19
3333,508,439,104.4433560090703,107.18331065759638,20,23,137,3,69
3334,508,630,104.4433560090703,106.11519274376417,20,15,142,2,122
3335,508,656,104.4433560090703,107.27619047619048,20,12,192,3,148
3336,508,873,104.4433560090703,105.85977324263038,20,15,370,1,365
3337,508,878,104.4433560090703,107.2065306122449,20,17,389,3,370
3338,436,31,105.13995464852609,106.62603174603174,20,45,410,1,405
3339,436,83,105.13995464852609,107.67092970521543,20,46,369,3,353
3340,436,219,105.13995464852609,107.299410430839,20,37,236,2,217
3341,436,439,105.13995464852609,107.18331065759638,20,23,88,2,3
3342,436,427,105.13995464852609,107.85668934240363,20,21,117,3,9
3343,436,656,105.13995464852609,107.27619047619048,20,12,238,2,220
3344,436,878,105.13995464852609,107.2065306122449,20,17,451,2,442
3345,436,907,105.13995464852609,107.85668934240363,20,12,485,3,471
3346,489,83,106.11519274376417,107.67092970521543,24,46,411,2,406
3347,489,20,106.11519274376417,108.92480725623582,24,45,484,3,469
3348,489,219,106.11519274376417,107.299410430839,24,37,275,1,270
3349,489,229,106.11519274376417,108.32108843537415,24,31,277,2,260
3350,489,439,106.11519274376417,107.18331065759638,24,23,68,1,50
3351,489,427,106.11519274376417,107.85668934240363,24,21,97,2,62
3352,489,656,106.11519274376417,107.27619047619048,24,12,174,1,167
3353,489,668,106.11519274376417,108.39074829931972,24,12,204,2,179
3354,489,878,106.11519274376417,107.2065306122449,24,17,392,1,389
3355,489,907,106.11519274376417,107.85668934240363,24,12,425,2,418
3356,489,873,106.11519274376417,108.55328798185941,24,14,398,2,384
3357,439,20,107.18331065759638,108.92480725623582,23,45,426,2,419
3358,439,229,107.18331065759638,108.32108843537415,23,31,216,1,210
3359,439,206,107.18331065759638,109.48208616780046,23,23,253,2,233
3360,439,445,107.18331065759638,109.20344671201815,23,21,87,2,6
3361,439,425,107.18331065759638,109.90004535147392,23,18,118,3,14
3362,439,668,107.18331065759638,108.39074829931972,23,12,235,1,229
3363,439,752,107.18331065759638,109.20344671201815,23,10,325,2,313
3364,439,873,107.18331065759638,108.55328798185941,23,14,438,1,434
3365,439,872,107.18331065759638,109.90004535147392,23,16,449,3,433
3366,427,20,107.85668934240363,108.92480725623582,21,45,410,1,407
3367,427,18,107.85668934240363,110.24834467120182,21,42,422,2,409
3368,427,18,107.85668934240363,110.5966439909297,21,46,426,3,409
3369,427,206,107.85668934240363,109.48208616780046,21,23,232,2,221
3370,427,267,107.85668934240363,110.50376417233561,21,17,196,3,160
3371,427,445,107.85668934240363,109.20344671201815,21,21,61,1,18
3372,427,425,107.85668934240363,109.90004535147392,21,18,88,2,2
3373,427,752,107.85668934240363,109.20344671201815,21,10,330,1,325
3374,427,617,107.85668934240363,110.66630385487528,21,12,225,3,190
3375,427,872,107.85668934240363,109.90004535147392,21,16,454,2,445
3376,445,18,109.20344671201815,110.24834467120182,21,42,429,1,427
3377,445,18,109.20344671201815,110.5966439909297,21,46,431,1,427
3378,445,60,109.20344671201815,111.54866213151928,21,45,398,2,385
3379,445,267,109.20344671201815,110.50376417233561,21,17,187,1,178
3380,445,260,109.20344671201815,111.08426303854876,21,29,202,2,185
3381,445,427,109.20344671201815,110.55020408163266,21,20,61,1,18
3382,445,427,109.20344671201815,111.89696145124717,21,21,117,3,18
3383,445,617,109.20344671201815,110.66630385487528,21,12,183,1,172
3384,445,879,109.20344671201815,111.24680272108844,21,17,443,2,434
3385,445,907,109.20344671201815,111.89696145124717,21,12,476,3,462
3386,425,60,109.90004535147392,111.54866213151928,18,45,372,2,365
3387,425,61,109.90004535147392,112.82575963718821,18,46,385,3,364
3388,425,260,109.90004535147392,111.08426303854876,18,29,173,1,165
3389,425,231,109.90004535147392,112.47746031746031,18,35,224,3,194
3390,425,261,109.90004535147392,112.52390022675738,18,33,199,3,164
3391,425,427,109.90004535147392,111.89696145124717,18,21,86,2,2
3392,425,755,109.90004535147392,112.50068027210885,18,16,348,3,330
3393,425,644,109.90004535147392,112.7328798185941,18,15,251,3,219
3394,425,879,109.90004535147392,111.24680272108844,18,17,458,1,454
3395,425,907,109.90004535147392,111.89696145124717,18,12,490,2,482
3396,425,879,109.90004535147392,112.59356009070295,18,16,469,3,454
3397,427,61,110.55020408163266,112.82575963718821,20,46,379,2,366
3398,427,231,110.55020408163266,112.47746031746031,20,35,213,2,196
3399,427,261,110.55020408163266,112.52390022675738,20,33,186,2,166
3400,427,445,110.55020408163266,113.24371882086169,20,22,117,3,18
3401,427,755,110.55020408163266,112.50068027210885,20,16,339,2,328
3402,427,644,110.55020408163266,112.7328798185941,20,15,236,2,217
3403,427,907,110.55020408163266,111.89696145124717,20,12,483,1,480
3404,427,879,110.55020408163266,112.59356009070295,20,16,460,2,452
3405,427,93,111.89696145124717,114.42793650793651,21,45,351,3,334
3406,427,245,111.89696145124717,114.49759637188208,21,22,214,3,182
3407,427,445,111.89696145124717,113.24371882086169,21,22,61,1,18
3408,427,414,111.89696145124717,113.94031746031746,21,16,89,2,13
3409,427,428,111.89696145124717,114.5904761904762,21,20,116,3,1
3410,427,878,111.89696145124717,113.94031746031746,21,16,460,2,451
3411,445,93,113.24371882086169,114.42793650793651,22,45,356,1,352
3412,445,109,113.24371882086169,115.26385487528344,22,45,347,2,336
3413,445,18,113.24371882086169,115.98367346938775,22,44,443,3,427
3414,445,245,113.24371882086169,114.49759637188208,22,22,207,1,200
3415,445,214,113.24371882086169,114.91555555555556,22,31,242,2,231
3416,445,264,113.24371882086169,115.9372335600907,22,28,215,3,181
3417,445,428,113.24371882086169,114.5904761904762,22,20,60,1,17
3418,445,436,113.24371882086169,115.9372335600907,22,21,116,3,9
3419,445,744,113.24371882086169,115.14775510204082,22,15,310,2,299
3420,445,878,113.24371882086169,115.28707482993198,22,15,442,2,433
3421,445,907,113.24371882086169,115.9372335600907,22,11,476,3,462
3422,414,109,113.94031746031746,115.26385487528344,16,45,310,1,305
3423,414,18,113.94031746031746,115.98367346938775,16,44,406,2,396
3424,414,18,113.94031746031746,116.65705215419501,16,44,413,3,396
3425,414,264,113.94031746031746,115.9372335600907,16,28,173,2,150
3426,414,436,113.94031746031746,115.9372335600907,16,21,89,2,22
3427,414,744,113.94031746031746,115.14775510204082,16,15,334,1,330
3428,414,878,113.94031746031746,115.28707482993198,16,15,468,1,464
3429,414,907,113.94031746031746,115.9372335600907,16,11,500,2,493
3430,414,873,113.94031746031746,116.65705215419501,16,15,474,3,459
3431,428,18,114.5904761904762,115.98367346938775,20,44,414,1,410
3432,428,18,114.5904761904762,116.65705215419501,20,44,420,2,410
3433,428,264,114.5904761904762,115.9372335600907,20,28,174,1,164
3434,428,213,114.5904761904762,117.28399092970521,20,37,244,3,215
3435,428,436,114.5904761904762,115.9372335600907,20,21,59,1,8
3436,428,617,114.5904761904762,117.37687074829932,20,17,224,3,189
3437,428,907,114.5904761904762,115.9372335600907,20,11,482,1,479
3438,428,873,114.5904761904762,116.65705215419501,20,15,454,2,445
3439,436,42,115.9372335600907,118.44498866213152,21,46,409,3,394
3440,436,23,115.9372335600907,118.81650793650793,21,47,431,3,413
3441,436,213,115.9372335600907,117.28399092970521,21,37,230,1,223
3442,436,255,115.9372335600907,117.8877097505669,21,29,200,2,181
3443,436,428,115.9372335600907,117.28399092970521,21,21,59,1,8
3444,436,486,115.9372335600907,117.60907029478459,21,23,88,2,50
3445,436,445,115.9372335600907,118.63074829931973,21,20,116,3,9
3446,436,617,115.9372335600907,117.37687074829932,21,17,191,1,181
3447,436,684,115.9372335600907,117.58585034013606,21,19,258,2,248
3448,436,873,115.9372335600907,118.00380952380952,21,16,446,2,437
3449,428,42,117.28399092970521,118.44498866213152,21,46,389,1,386
3450,428,23,117.28399092970521,118.81650793650793,21,47,410,2,405
3451,428,41,117.28399092970521,119.58276643990929,21,44,399,2,387
3452,428,230,117.28399092970521,118.97904761904762,21,34,211,2,198
3453,428,205,117.28399092970521,119.58276643990929,21,24,244,2,223
3454,428,445,117.28399092970521,118.63074829931973,21,20,60,1,17
3455,428,445,117.28399092970521,119.97750566893424,21,21,117,3,17
3456,428,802,117.28399092970521,119.00226757369614,21,11,381,2,374
3457,428,724,117.28399092970521,120.00072562358277,21,10,318,3,296
3458,428,873,117.28399092970521,119.35056689342404,21,16,454,2,445
3459,428,906,117.28399092970521,119.97750566893424,21,11,492,3,478
3460,486,23,117.60907029478459,118.81650793650793,23,47,466,1,463
3461,486,41,117.60907029478459,119.58276643990929,23,44,453,2,445
3462,486,230,117.60907029478459,118.97904761904762,23,34,263,1,256
3463,486,205,117.60907029478459,119.58276643990929,23,24,294,2,281
3464,486,445,117.60907029478459,118.63074829931973,23,20,60,1,41
3465,486,445,117.60907029478459,119.97750566893424,23,21,110,2,41
3466,486,802,117.60907029478459,119.00226757369614,23,11,322,1,316
3467,486,724,117.60907029478459,120.00072562358277,23,10,259,2,238
3468,486,873,117.60907029478459,119.35056689342404,23,16,394,2,387
3469,486,906,117.60907029478459,119.97750566893424,23,11,432,2,420
3470,445,18,118.63074829931973,121.39392290249434,20,46,443,3,427
3471,445,224,118.63074829931973,121.20816326530613,20,23,247,3,221
3472,445,428,118.63074829931973,121.32426303854875,20,20,117,3,17
3473,445,724,118.63074829931973,120.00072562358277,20,10,285,1,279
3474,445,703,118.63074829931973,121.39392290249434,20,19,284,3,258
3475,445,906,118.63074829931973,119.97750566893424,20,11,465,1,461
3476,445,873,118.63074829931973,120.69732426303855,20,16,437,2,428
3477,445,18,119.97750566893424,121.39392290249434,21,46,431,1,427
3478,445,54,119.97750566893424,122.2530612244898,21,46,403,2,391
3479,445,224,119.97750566893424,121.20816326530613,21,23,227,1,221
3480,445,258,119.97750566893424,121.64934240362813,21,27,200,2,187
3481,445,428,119.97750566893424,121.32426303854875,21,20,60,1,17
3482,445,419,119.97750566893424,121.64934240362813,21,26,77,2,26
3483,445,529,119.97750566893424,122.71746031746032,21,22,145,3,84
3484,445,703,119.97750566893424,121.39392290249434,21,19,265,1,258
3485,445,651,119.97750566893424,121.76544217687075,21,15,220,2,206
3486,445,646,119.97750566893424,122.74068027210885,21,16,234,3,201
3487,445,842,119.97750566893424,121.78866213151927,21,17,405,2,397
3488,428,65,121.32426303854875,122.97287981859411,20,47,370,2,363
3489,428,49,121.32426303854875,124.27319727891157,20,44,400,3,379
3490,428,275,121.32426303854875,123.34439909297052,20,26,176,2,153
3491,428,271,121.32426303854875,123.62303854875283,20,28,186,2,157
3492,428,529,121.32426303854875,122.71746031746032,20,22,117,1,101
3493,428,445,121.32426303854875,124.0409977324263,20,20,118,3,17
3494,428,646,121.32426303854875,122.74068027210885,20,16,226,1,218
3495,428,654,121.32426303854875,123.57659863945578,20,9,246,2,226
3496,428,873,121.32426303854875,123.39083900226758,20,16,454,2,445
3497,428,907,121.32426303854875,124.0409977324263,20,10,493,3,479
3498,419,65,121.64934240362813,122.97287981859411,26,47,359,1,354
3499,419,49,121.64934240362813,124.27319727891157,26,44,387,3,370
3500,419,275,121.64934240362813,123.34439909297052,26,26,161,2,144
3501,419,271,121.64934240362813,123.62303854875283,26,28,171,2,148
3502,419,529,121.64934240362813,122.71746031746032,26,22,119,1,110
3503,419,445,121.64934240362813,124.0409977324263,26,20,106,2,26
3504,419,646,121.64934240362813,122.74068027210885,26,16,232,1,227
3505,419,654,121.64934240362813,123.57659863945578,26,9,249,2,235
3506,419,873,121.64934240362813,123.39083900226758,26,16,460,2,454
3507,419,907,121.64934240362813,124.0409977324263,26,10,499,2,488
3508,529,49,122.71746031746032,124.27319727891157,22,44,485,2,480
3509,529,304,122.71746031746032,125.57351473922903,22,19,256,3,225
3510,529,445,122.71746031746032,124.0409977324263,22,20,102,1,84
3511,529,428,122.71746031746032,125.38775510204081,22,20,153,3,101
3512,529,673,122.71746031746032,125.38775510204081,22,12,184,3,144
3513,529,907,122.71746031746032,124.0409977324263,22,10,382,1,378
3514,529,873,122.71746031746032,124.73759637188209,22,16,355,2,344
3515,445,24,124.0409977324263,125.80571428571429,20,45,428,2,421
3516,445,304,124.0409977324263,125.57351473922903,20,19,156,2,141
3517,445,284,124.0409977324263,126.40943310657596,20,25,191,2,161
3518,445,214,124.0409977324263,126.80417233560091,20,23,260,3,231
3519,445,428,124.0409977324263,125.38775510204081,20,20,60,1,17
3520,445,444,124.0409977324263,126.06113378684807,20,19,87,2,1
3521,445,673,124.0409977324263,125.38775510204081,20,12,235,1,228
3522,445,676,124.0409977324263,126.06113378684807,20,11,247,2,231
3523,445,873,124.0409977324263,126.0843537414966,20,16,437,2,428
3524,428,46,125.38775510204081,127.40789115646258,20,48,392,2,382
3525,428,46,125.38775510204081,127.73297052154196,20,47,395,2,382
3526,428,284,125.38775510204081,126.40943310657596,20,25,151,1,144
3527,428,214,125.38775510204081,126.80417233560091,20,23,223,1,214
3528,428,304,125.38775510204081,128.05804988662132,20,21,169,3,124
3529,428,445,125.38775510204081,126.73451247165534,20,19,60,1,17
3530,428,427,125.38775510204081,128.08126984126986,20,20,116,3,1
3531,428,673,125.38775510204081,127.40789115646258,20,10,260,2,245
3532,428,789,125.38775510204081,128.1277097505669,20,11,380,3,361
3533,428,873,125.38775510204081,127.43111111111111,20,15,454,2,445
3534,428,907,125.38775510204081,128.08126984126986,20,12,493,3,479
3535,444,46,126.06113378684807,127.40789115646258,19,48,402,1,398
3536,444,46,126.06113378684807,127.73297052154196,19,47,404,2,398
3537,444,304,126.06113378684807,128.05804988662132,19,21,164,2,140
3538,444,427,126.06113378684807,128.08126984126986,19,20,89,2,17
3539,444,673,126.06113378684807,127.40789115646258,19,10,236,1,229
3540,444,789,126.06113378684807,128.1277097505669,19,11,356,2,345
3541,444,873,126.06113378684807,127.43111111111111,19,15,433,1,429
3542,444,907,126.06113378684807,128.08126984126986,19,12,471,2,463
3543,444,874,126.06113378684807,128.77786848072563,19,15,446,3,430
3544,445,41,126.73451247165534,129.3815873015873,19,47,420,3,404
3545,445,304,126.73451247165534,128.05804988662132,19,21,152,1,141
3546,445,277,126.73451247165534,129.12616780045352,19,21,197,2,168
3547,445,427,126.73451247165534,128.08126984126986,19,20,61,1,18
3548,445,427,126.73451247165534,129.42802721088435,19,21,117,3,18
3549,445,789,126.73451247165534,128.1277097505669,19,11,349,1,344
3550,445,615,126.73451247165534,129.07972789115647,19,9,198,2,170
3551,445,907,126.73451247165534,128.08126984126986,19,12,466,1,462
3552,445,874,126.73451247165534,128.77786848072563,19,15,438,2,429
3553,427,41,128.08126984126986,129.3815873015873,20,47,390,1,386
3554,427,41,128.08126984126986,130.1942857142857,20,48,397,2,386
3555,427,41,128.08126984126986,130.8908843537415,20,47,405,3,386
3556,427,277,128.08126984126986,129.12616780045352,20,21,157,1,150
3557,427,206,128.08126984126986,130.2871655328798,20,22,241,2,221
3558,427,206,128.08126984126986,130.84444444444443,20,23,251,3,221
3559,427,445,128.08126984126986,130.12462585034015,20,19,90,2,18
3560,427,873,128.08126984126986,130.12462585034015,20,16,455,2,446
3561,427,41,129.42802721088435,130.8908843537415,21,47,391,1,386
3562,427,36,129.42802721088435,131.93578231292517,21,48,406,3,391
3563,427,206,129.42802721088435,130.84444444444443,21,23,229,1,221
3564,427,872,129.42802721088435,131.47138321995465,21,16,454,2,445
3565,427,907,129.42802721088435,132.12154195011337,21,11,494,3,480
3566,445,36,130.12462585034015,131.93578231292517,19,48,416,2,409
3567,445,258,130.12462585034015,132.53950113378684,19,16,214,2,187
3568,445,264,130.12462585034015,133.0271201814059,19,20,220,3,181
3569,445,427,130.12462585034015,132.12154195011337,19,20,88,2,18
3570,445,872,130.12462585034015,131.47138321995465,19,16,431,1,427
3571,445,907,130.12462585034015,132.12154195011337,19,11,470,2,462
3572,445,873,130.12462585034015,132.81814058956917,19,15,443,3,428
3573,427,36,130.77478458049887,131.93578231292517,20,48,394,1,391
3574,427,64,130.77478458049887,133.23609977324264,20,44,378,2,363
3575,427,258,130.77478458049887,132.53950113378684,20,16,185,2,169
3576,427,264,130.77478458049887,133.0271201814059,20,20,190,2,163
3577,427,907,130.77478458049887,132.12154195011337,20,11,483,1,480
3578,427,873,130.77478458049887,132.81814058956917,20,15,455,2,446
3579,427,64,132.12154195011337,133.23609977324264,20,44,366,1,363
3580,427,62,132.12154195011337,134.1184580498866,20,43,375,2,365
3581,427,213,132.12154195011337,133.81659863945578,20,27,226,2,214
3582,427,443,132.12154195011337,134.16489795918366,20,18,89,2,16
3583,427,445,132.12154195011337,134.8150566893424,20,21,117,3,18
3584,427,878,132.12154195011337,134.16489795918366,20,16,460,2,451
3585,427,27,133.4682993197279,135.1633560090703,21,44,407,2,400
3586,427,61,133.4682993197279,135.92961451247166,21,47,381,2,366
3587,427,278,133.4682993197279,135.11691609977325,21,27,165,2,149
3588,427,214,133.4682993197279,136.2314739229025,21,36,244,3,213
3589,427,445,133.4682993197279,134.8150566893424,21,21,61,1,18
3590,427,606,133.4682993197279,136.34757369614513,21,22,218,3,179
3591,427,625,133.4682993197279,135.20979591836735,21,13,212,2,198
3592,427,676,133.4682993197279,136.34757369614513,21,17,278,3,249
3593,427,872,133.4682993197279,135.51165532879818,21,15,454,2,445
3594,427,849,133.4682993197279,135.6974149659864,21,16,433,2,422
3595,443,61,134.16489795918366,135.92961451247166,18,47,389,2,382
3596,443,28,134.16489795918366,137.09061224489795,18,42,434,3,415
3597,443,214,134.16489795918366,136.2314739229025,18,36,246,2,229
3598,443,289,134.16489795918366,136.71909297052156,18,29,189,3,154
3599,443,606,134.16489795918366,136.34757369614513,18,22,188,2,163
3600,443,625,134.16489795918366,135.20979591836735,18,13,187,1,182
3601,443,676,134.16489795918366,136.34757369614513,18,17,251,2,233
3602,443,615,134.16489795918366,136.83519274376417,18,13,207,3,172
3603,443,872,134.16489795918366,135.51165532879818,18,15,433,1,429
3604,443,849,134.16489795918366,135.6974149659864,18,16,411,2,406
3605,443,873,134.16489795918366,136.88163265306122,18,16,446,3,430
3606,445,61,134.8150566893424,135.92961451247166,21,47,387,1,384
3607,445,28,134.8150566893424,137.09061224489795,21,42,428,2,417
3608,445,214,134.8150566893424,136.2314739229025,21,36,239,1,231
3609,445,289,134.8150566893424,136.71909297052156,21,29,176,2,156
3610,445,606,134.8150566893424,136.34757369614513,21,22,174,2,161
3611,445,502,134.8150566893424,137.7407709750567,21,19,138,3,57
3612,445,676,134.8150566893424,136.34757369614513,21,17,240,2,231
3613,445,615,134.8150566893424,136.83519274376417,21,13,191,2,170
3614,445,670,134.8150566893424,137.7407709750567,21,15,258,3,225
3615,445,873,134.8150566893424,136.88163265306122,21,16,437,2,428
3616,606,278,136.34757369614513,138.04263038548754,22,28,336,2,328
3617,606,445,136.34757369614513,137.50857142857143,22,20,169,1,161
3618,606,502,136.34757369614513,137.7407709750567,22,19,120,1,104
3619,606,427,136.34757369614513,138.85532879818595,22,20,209,3,179
3620,606,670,136.34757369614513,137.7407709750567,22,15,88,1,64
3621,606,619,136.34757369614513,138.8321088435374,22,14,108,2,13
3622,606,879,136.34757369614513,138.2051700680272,22,16,284,2,273
3623,445,72,137.50857142857143,138.7392290249433,20,46,377,1,373
3624,445,42,137.50857142857143,139.85378684807256,20,45,415,2,403
3625,445,205,137.50857142857143,139.48226757369613,20,33,255,2,240
3626,445,243,137.50857142857143,139.784126984127,20,31,225,2,202
3627,445,427,137.50857142857143,138.85532879818595,20,20,61,1,18
3628,445,427,137.50857142857143,140.20208616780045,20,20,117,3,18
3629,445,619,137.50857142857143,138.8321088435374,20,14,183,1,174
3630,445,773,137.50857142857143,140.08598639455784,20,15,346,3,328
3631,445,878,137.50857142857143,139.55192743764172,20,16,442,2,433
3632,445,906,137.50857142857143,140.20208616780045,20,11,475,3,461
3633,502,42,137.7407709750567,139.85378684807256,19,45,469,2,460
3634,502,205,137.7407709750567,139.48226757369613,19,33,306,2,297
3635,502,243,137.7407709750567,139.784126984127,19,31,274,2,259
3636,502,427,137.7407709750567,138.85532879818595,19,20,89,1,75
3637,502,427,137.7407709750567,140.20208616780045,19,20,130,2,75
3638,502,619,137.7407709750567,138.8321088435374,19,14,126,1,117
3639,502,773,137.7407709750567,140.08598639455784,19,15,289,2,271
3640,502,878,137.7407709750567,139.55192743764172,19,16,384,2,376
3641,502,906,137.7407709750567,140.20208616780045,19,11,418,2,404
3642,427,82,138.85532879818595,141.5720634920635,20,46,364,3,345
3643,427,290,138.85532879818595,140.82902494331066,20,28,161,2,137
3644,427,388,138.85532879818595,141.68816326530612,20,23,128,3,39
3645,427,486,138.85532879818595,141.54884353741497,20,22,130,3,59
3646,427,773,138.85532879818595,140.08598639455784,20,15,350,1,346
3647,427,636,138.85532879818595,140.9451247165533,20,16,228,2,209
3648,427,906,138.85532879818595,140.20208616780045,20,11,482,1,479
3649,427,878,138.85532879818595,140.89868480725625,20,15,460,2,451
3650,427,82,140.20208616780045,141.5720634920635,20,46,350,1,345
3651,427,82,140.20208616780045,142.12934240362813,20,45,355,2,345
3652,427,82,140.20208616780045,143.03492063492064,20,45,366,3,345
3653,427,388,140.20208616780045,141.68816326530612,20,23,75,1,39
3654,427,221,140.20208616780045,143.10458049886623,20,26,241,3,206
3655,427,486,140.20208616780045,141.54884353741497,20,22,83,1,59
3656,427,489,140.20208616780045,141.87392290249434,20,20,95,2,62
3657,427,437,140.20208616780045,142.8956009070295,20,19,116,3,10
3658,427,633,140.20208616780045,142.15256235827664,20,11,222,2,206
3659,427,873,140.20208616780045,142.26866213151928,20,15,455,2,446
3660,486,82,141.54884353741497,143.03492063492064,22,45,409,1,404
3661,486,221,141.54884353741497,143.10458049886623,22,26,273,2,265
3662,486,277,141.54884353741497,144.28879818594103,22,27,240,3,209
3663,486,437,141.54884353741497,142.8956009070295,22,19,76,1,49
3664,486,427,141.54884353741497,144.26557823129252,22,20,131,3,59
3665,486,658,141.54884353741497,143.6154195011338,22,9,194,2,172
3666,486,878,141.54884353741497,143.6154195011338,22,15,402,2,392
3667,486,907,141.54884353741497,144.26557823129252,22,11,437,3,421
3668,489,82,141.87392290249434,143.03492063492064,20,45,410,1,407
3669,489,46,141.87392290249434,144.56743764172336,20,43,458,3,443
3670,489,221,141.87392290249434,143.10458049886623,20,26,273,1,268
3671,489,277,141.87392290249434,144.28879818594103,20,27,236,2,212
3672,489,437,141.87392290249434,142.8956009070295,20,19,68,1,52
3673,489,427,141.87392290249434,144.26557823129252,20,20,120,2,62
3674,489,658,141.87392290249434,143.6154195011338,20,9,185,2,169
3675,489,878,141.87392290249434,143.6154195011338,20,15,396,2,389
3676,489,907,141.87392290249434,144.26557823129252,20,11,431,2,418
3677,437,46,142.8956009070295,144.56743764172336,19,43,398,2,391
3678,437,46,142.8956009070295,144.93895691609978,19,46,401,2,391
3679,437,277,142.8956009070295,144.28879818594103,19,27,171,1,160
3680,437,265,142.8956009070295,145.6587755102041,19,23,209,3,172
3681,437,427,142.8956009070295,144.26557823129252,19,20,60,1,10
3682,437,427,142.8956009070295,145.61233560090704,19,20,117,3,10
3683,437,622,142.8956009070295,145.42657596371882,19,10,215,3,185
3684,437,907,142.8956009070295,144.26557823129252,19,11,474,1,470
3685,437,878,142.8956009070295,144.9621768707483,19,16,450,2,441
3686,427,60,144.26557823129252,146.68045351473924,20,47,381,2,367
3687,427,60,144.26557823129252,146.70367346938775,20,45,382,2,367
3688,427,265,144.26557823129252,145.6587755102041,20,23,173,1,162
3689,427,271,144.26557823129252,146.14639455782313,20,24,176,2,156
3690,427,280,144.26557823129252,147.12163265306123,20,29,192,3,147
3691,427,444,144.26557823129252,146.28571428571428,20,18,89,2,17
3692,427,596,144.26557823129252,146.8197732426304,20,21,202,3,169
3693,427,622,144.26557823129252,145.42657596371882,20,10,201,1,195
3694,427,806,144.26557823129252,146.05351473922903,20,13,387,2,379
3695,427,873,144.26557823129252,146.30893424036282,20,16,455,2,446
3696,427,60,145.61233560090704,146.68045351473924,20,47,370,1,367
3697,427,60,145.61233560090704,146.70367346938775,20,45,370,1,367
3698,427,73,145.61233560090704,148.259410430839,20,47,372,3,354
3699,427,280,145.61233560090704,147.12163265306123,20,29,161,2,147
3700,427,279,145.61233560090704,148.5380498866213,20,29,194,3,148
3701,427,596,145.61233560090704,146.8197732426304,20,21,177,1,169
3702,427,445,145.61233560090704,148.30585034013606,20,20,117,3,18
3703,427,615,145.61233560090704,147.6324716553288,20,13,207,2,188
3704,427,652,145.61233560090704,148.5380498866213,20,22,258,3,225
3705,427,878,145.61233560090704,147.65569160997734,20,15,460,2,451
3706,444,73,146.28571428571428,148.259410430839,18,47,381,2,371
3707,444,61,146.28571428571428,149.141768707483,18,45,402,3,383
3708,444,279,146.28571428571428,148.5380498866213,18,29,191,2,165
3709,444,274,146.28571428571428,148.97922902494332,18,27,206,3,170
3710,444,445,146.28571428571428,148.30585034013606,18,20,87,2,1
3711,444,615,146.28571428571428,147.6324716553288,18,13,181,1,171
3712,444,652,146.28571428571428,148.5380498866213,18,22,230,2,208
3713,444,615,146.28571428571428,148.88634920634922,18,17,204,3,171
3714,444,878,146.28571428571428,147.65569160997734,18,15,438,1,434
3715,444,929,146.28571428571428,148.5380498866213,18,15,495,2,485
3716,444,873,146.28571428571428,149.00244897959183,18,16,445,3,429
3717,596,279,146.8197732426304,148.5380498866213,21,29,326,2,317
3718,596,274,146.8197732426304,148.97922902494332,21,27,335,2,322
3719,596,445,146.8197732426304,148.30585034013606,21,20,164,1,151
3720,596,410,146.8197732426304,149.69904761904763,21,23,224,3,186
3721,596,652,146.8197732426304,148.5380498866213,21,22,93,2,56
3722,596,615,146.8197732426304,148.88634920634922,21,17,91,2,19
3723,596,929,146.8197732426304,148.5380498866213,21,15,341,2,333
3724,596,873,146.8197732426304,149.00244897959183,21,16,293,2,277
3725,445,15,148.30585034013606,149.72226757369614,20,42,434,1,430
3726,445,46,148.30585034013606,151.16190476190476,20,47,418,3,399
3727,445,205,148.30585034013606,150.51174603174604,20,38,258,2,240
3728,445,276,148.30585034013606,150.99936507936508,20,26,205,3,169
3729,445,410,148.30585034013606,149.69904761904763,20,23,69,1,35
3730,445,410,148.30585034013606,150.27954648526077,20,24,92,2,35
3731,445,427,148.30585034013606,150.99936507936508,20,21,117,3,18
3732,445,616,148.30585034013606,150.465306122449,20,28,195,2,171
3733,445,689,148.30585034013606,151.02258503401362,20,16,271,3,244
3734,445,820,148.30585034013606,150.27954648526077,20,20,385,2,375
3735,410,46,149.69904761904763,151.16190476190476,23,47,369,1,364
3736,410,49,149.69904761904763,152.46222222222224,23,45,380,3,361
3737,410,276,149.69904761904763,150.99936507936508,23,26,145,1,134
3738,410,244,149.69904761904763,152.23002267573696,23,24,199,3,166
3739,410,427,149.69904761904763,150.99936507936508,23,21,59,1,17
3740,410,427,149.69904761904763,152.3461224489796,23,21,115,3,17
3741,410,689,149.69904761904763,151.02258503401362,23,16,285,1,279
3742,410,729,149.69904761904763,151.78884353741498,23,17,331,2,319
3743,410,873,149.69904761904763,151.69596371882088,23,15,471,2,463
3744,410,874,149.69904761904763,151.7191836734694,23,14,472,2,464
3745,410,49,150.27954648526077,152.46222222222224,24,45,373,2,361
3746,410,82,150.27954648526077,153.0659410430839,24,46,349,3,328
3747,410,244,150.27954648526077,152.23002267573696,24,24,186,2,166
3748,410,427,150.27954648526077,152.3461224489796,24,21,91,2,17
3749,410,729,150.27954648526077,151.78884353741498,24,17,326,2,319
3750,410,673,150.27954648526077,153.0659410430839,24,9,289,3,263
3751,410,873,150.27954648526077,151.69596371882088,24,15,467,1,463
3752,410,874,150.27954648526077,151.7191836734694,24,14,468,1,464
3753,410,872,150.27954648526077,153.04272108843537,24,16,477,3,462
3754,427,49,150.99936507936508,152.46222222222224,21,45,383,1,378
3755,427,82,150.99936507936508,153.0659410430839,21,46,356,2,345
3756,427,244,150.99936507936508,152.23002267573696,21,24,191,1,183
3757,427,228,150.99936507936508,153.6928798185941,21,23,230,3,199
3758,427,220,150.99936507936508,153.97151927437642,21,22,243,3,207
3759,427,445,150.99936507936508,153.6928798185941,21,20,117,3,18
3760,427,673,150.99936507936508,153.0659410430839,21,9,262,2,246
3761,427,872,150.99936507936508,153.04272108843537,21,16,454,2,445
3762,427,851,150.99936507936508,153.73931972789117,21,11,440,3,424
3763,427,46,152.3461224489796,154.18049886621316,21,49,389,2,381
3764,427,41,152.3461224489796,155.17895691609976,21,43,405,3,386
3765,427,228,152.3461224489796,153.6928798185941,21,23,207,1,199
3766,427,220,152.3461224489796,153.97151927437642,21,22,219,2,207
3767,427,445,152.3461224489796,153.6928798185941,21,20,61,1,18
3768,427,463,152.3461224489796,154.2037188208617,21,13,88,2,36
3769,427,489,152.3461224489796,154.99319727891157,21,11,130,3,62
3770,427,654,152.3461224489796,154.18049886621316,21,16,240,2,227
3771,427,851,152.3461224489796,153.73931972789117,21,11,428,1,424
3772,445,41,153.6928798185941,155.17895691609976,20,43,409,1,404
3773,445,61,153.6928798185941,156.3399546485261,20,45,401,3,384
3774,445,216,153.6928798185941,155.50403628117914,20,23,242,2,229
3775,445,213,153.6928798185941,156.4560544217687,20,27,261,3,232
3776,445,489,153.6928798185941,154.99319727891157,20,11,71,1,44
3777,445,435,153.6928798185941,156.38639455782314,20,18,116,3,10
3778,445,618,153.6928798185941,156.38639455782314,20,16,208,3,173
3779,445,943,153.6928798185941,156.38639455782314,20,11,511,3,498
3780,463,61,154.2037188208617,156.3399546485261,13,45,412,2,402
3781,463,72,154.2037188208617,157.12943310657596,13,44,411,3,391
3782,463,216,154.2037188208617,155.50403628117914,13,23,253,1,247
3783,463,213,154.2037188208617,156.4560544217687,13,27,268,2,250
3784,463,435,154.2037188208617,156.38639455782314,13,18,98,2,28
3785,463,618,154.2037188208617,156.38639455782314,13,16,181,2,155
3786,463,723,154.2037188208617,157.0829931972789,13,9,288,3,260
3787,463,943,154.2037188208617,156.38639455782314,13,11,489,2,480
3788,463,872,154.2037188208617,157.0829931972789,13,16,427,3,409
3789,489,61,154.99319727891157,156.3399546485261,11,45,432,1,428
3790,489,72,154.99319727891157,157.12943310657596,11,44,427,2,417
3791,489,61,154.99319727891157,157.8724716553288,11,46,446,3,428
3792,489,213,154.99319727891157,156.4560544217687,11,27,283,1,276
3793,489,247,154.99319727891157,157.73315192743763,11,19,269,3,242
3794,489,435,154.99319727891157,156.38639455782314,11,18,81,1,54
3795,489,428,154.99319727891157,157.73315192743763,11,20,133,3,61
3796,489,427,154.99319727891157,157.75637188208617,11,18,134,3,62
3797,489,618,154.99319727891157,156.38639455782314,11,16,142,1,129
3798,489,723,154.99319727891157,157.0829931972789,11,9,251,2,234
3799,489,943,154.99319727891157,156.38639455782314,11,11,458,1,454
3800,489,872,154.99319727891157,157.0829931972789,11,16,393,2,383
3801,435,61,156.38639455782314,157.8724716553288,18,46,379,1,374
3802,435,24,156.38639455782314,158.89414965986396,18,43,425,3,411
3803,435,247,156.38639455782314,157.73315192743763,18,19,197,1,188
3804,435,218,156.38639455782314,158.499410430839,18,36,235,2,217
3805,435,219,156.38639455782314,159.17278911564625,18,22,247,3,216
3806,435,428,156.38639455782314,157.73315192743763,18,20,58,1,7
3807,435,427,156.38639455782314,157.75637188208617,18,18,60,1,8
3808,435,436,156.38639455782314,159.07990929705215,18,22,116,3,1
3809,435,802,156.38639455782314,158.56907029478458,18,14,379,2,367
3810,435,878,156.38639455782314,158.42975056689343,18,14,452,2,443
3811,435,906,156.38639455782314,159.07990929705215,18,11,485,3,471
3812,428,24,157.73315192743763,158.89414965986396,20,43,407,1,404
3813,428,23,157.73315192743763,159.96226757369615,20,46,416,2,405
3814,428,219,157.73315192743763,159.17278911564625,20,22,218,1,209
3815,428,311,157.73315192743763,160.42666666666668,20,21,165,3,117
3816,428,436,157.73315192743763,159.07990929705215,20,22,59,1,8
3817,428,531,157.73315192743763,160.0319274376417,20,23,143,2,103
3818,428,630,157.73315192743763,160.0319274376417,20,15,225,2,202
3819,428,906,157.73315192743763,159.07990929705215,20,11,482,1,478
3820,428,873,157.73315192743763,159.79972789115646,20,15,454,2,445
3821,427,24,157.75637188208617,158.89414965986396,18,43,406,1,403
3822,427,23,157.75637188208617,159.96226757369615,18,46,415,2,404
3823,427,219,157.75637188208617,159.17278911564625,18,22,217,1,208
3824,427,311,157.75637188208617,160.42666666666668,18,21,163,3,116
3825,427,436,157.75637188208617,159.07990929705215,18,22,58,1,9
3826,427,531,157.75637188208617,160.0319274376417,18,23,143,2,104
3827,427,630,157.75637188208617,160.0319274376417,18,15,225,2,203
3828,427,906,157.75637188208617,159.07990929705215,18,11,482,1,479
3829,427,873,157.75637188208617,159.79972789115646,18,15,455,2,446
3830,436,83,159.07990929705215,161.6108843537415,22,46,369,3,353
3831,436,311,159.07990929705215,160.42666666666668,22,21,138,1,125
3832,436,219,159.07990929705215,161.10004535147394,22,35,234,2,217
3833,436,437,159.07990929705215,161.21614512471655,22,20,92,2,1
3834,436,428,159.07990929705215,161.77342403628117,22,20,116,3,8
3835,436,621,159.07990929705215,161.12326530612245,22,13,205,2,185
3836,436,873,159.07990929705215,161.146485260771,22,16,446,2,437
3837,531,83,160.0319274376417,161.6108843537415,23,46,453,2,448
3838,531,219,160.0319274376417,161.10004535147394,23,35,315,1,312
3839,531,230,160.0319274376417,162.28426303854874,23,32,316,2,301
3840,531,206,160.0319274376417,162.8647619047619,23,23,347,3,325
3841,531,437,160.0319274376417,161.21614512471655,23,20,107,1,94
3842,531,428,160.0319274376417,161.77342403628117,23,20,127,2,103
3843,531,621,160.0319274376417,161.12326530612245,23,13,102,1,90
3844,531,669,160.0319274376417,162.30748299319728,23,11,169,2,138
3845,531,873,160.0319274376417,161.146485260771,23,16,345,1,342
3846,531,873,160.0319274376417,162.49324263038548,23,15,358,2,342
3847,437,24,161.21614512471655,162.49324263038548,20,43,417,1,413
3848,437,20,161.21614512471655,162.8647619047619,20,46,423,2,417
3849,437,230,161.21614512471655,162.28426303854874,20,32,212,1,207
3850,437,206,161.21614512471655,162.8647619047619,20,23,242,2,231
3851,437,445,161.21614512471655,163.1201814058957,20,20,82,2,8
3852,437,669,161.21614512471655,162.30748299319728,20,11,237,1,232
3853,437,752,161.21614512471655,163.14340136054423,20,10,326,2,315
3854,437,873,161.21614512471655,162.49324263038548,20,15,439,1,436
3855,437,907,161.21614512471655,163.14340136054423,20,12,477,2,470
3856,437,873,161.21614512471655,163.84,20,15,450,3,436
3857,428,20,161.77342403628117,162.8647619047619,20,46,411,1,408
3858,428,18,161.77342403628117,164.53659863945578,20,47,427,3,410
3859,428,206,161.77342403628117,162.8647619047619,20,23,227,1,222
3860,428,205,161.77342403628117,164.58303854875282,20,21,254,3,223
3861,428,445,161.77342403628117,163.1201814058957,20,20,60,1,17
3862,428,752,161.77342403628117,163.14340136054423,20,10,329,1,324
3863,428,616,161.77342403628117,164.60625850340136,20,9,224,3,188
3864,428,907,161.77342403628117,163.14340136054423,20,12,483,1,479
3865,428,873,161.77342403628117,163.84,20,15,454,2,445
3866,445,18,163.1201814058957,164.53659863945578,20,47,431,1,427
3867,445,61,163.1201814058957,165.37251700680272,20,45,396,2,384
3868,445,25,163.1201814058957,165.83691609977325,20,45,436,3,420
3869,445,205,163.1201814058957,164.58303854875282,20,21,248,1,240
3870,445,261,163.1201814058957,165.0009977324263,20,29,201,2,184
3871,445,428,163.1201814058957,164.46693877551022,20,19,60,1,17
3872,445,425,163.1201814058957,165.18675736961453,20,17,91,2,20
3873,445,616,163.1201814058957,164.60625850340136,20,9,183,1,171
3874,445,629,163.1201814058957,165.18675736961453,20,11,204,2,184
3875,445,873,163.1201814058957,165.18675736961453,20,16,437,2,428
3876,428,25,164.46693877551022,165.83691609977325,19,45,407,1,403
3877,428,81,164.46693877551022,166.9514739229025,19,45,363,2,347
3878,428,263,164.46693877551022,166.37097505668933,19,36,184,2,165
3879,428,216,164.46693877551022,166.92825396825398,19,24,237,2,212
3880,428,445,164.46693877551022,165.83691609977325,19,20,61,1,17
3881,428,445,164.46693877551022,167.18367346938777,19,20,118,3,17
3882,428,756,164.46693877551022,166.44063492063492,19,15,339,2,328
3883,428,872,164.46693877551022,166.53351473922902,19,16,453,2,444
3884,428,907,164.46693877551022,167.16045351473923,19,13,493,3,479
3885,425,81,165.18675736961453,166.9514739229025,17,45,352,2,344
3886,425,263,165.18675736961453,166.37097505668933,17,36,170,1,162
3887,425,216,165.18675736961453,166.92825396825398,17,24,222,2,209
3888,425,445,165.18675736961453,167.18367346938777,17,20,88,2,20
3889,425,756,165.18675736961453,166.44063492063492,17,15,335,1,331
3890,425,675,165.18675736961453,167.46231292517007,17,11,269,2,250
3891,425,872,165.18675736961453,166.53351473922902,17,16,451,1,447
3892,425,907,165.18675736961453,167.16045351473923,17,13,489,2,482
3893,425,873,165.18675736961453,167.88027210884354,17,16,463,3,448
3894,445,81,165.83691609977325,166.9514739229025,20,45,367,1,364
3895,445,61,165.83691609977325,168.4607709750567,20,45,400,3,384
3896,445,216,165.83691609977325,166.92825396825398,20,24,234,1,229
3897,445,242,165.83691609977325,168.78585034013605,20,27,239,3,203
3898,445,243,165.83691609977325,168.8090702947846,20,27,239,3,202
3899,445,427,165.83691609977325,168.53043083900226,20,21,117,3,18
3900,445,675,165.83691609977325,167.46231292517007,20,11,240,2,230
3901,445,615,165.83691609977325,168.50721088435375,20,15,205,3,170
3902,445,907,165.83691609977325,167.16045351473923,20,13,466,1,462
3903,445,873,165.83691609977325,167.88027210884354,20,16,437,2,428
3904,445,61,167.18367346938777,168.4607709750567,20,45,388,1,384
3905,445,31,167.18367346938777,168.8322902494331,20,48,420,2,414
3906,445,72,167.18367346938777,169.8075283446712,20,44,390,3,373
3907,445,242,167.18367346938777,168.78585034013605,20,27,214,2,203
3908,445,243,167.18367346938777,168.8090702947846,20,27,214,2,202
3909,445,427,167.18367346938777,168.53043083900226,20,21,61,1,18
3910,445,414,167.18367346938777,169.22702947845806,20,17,93,2,31
3911,445,615,167.18367346938777,168.50721088435375,20,15,179,1,170
3912,445,619,167.18367346938777,169.0877097505669,20,22,192,2,174
3913,445,872,167.18367346938777,169.22702947845806,20,19,436,2,427
3914,427,72,168.53043083900226,169.8075283446712,21,44,359,1,355
3915,427,276,168.53043083900226,170.5273469387755,21,33,174,2,151
3916,427,260,168.53043083900226,171.08462585034013,21,27,200,3,167
3917,427,445,168.53043083900226,169.8771882086168,21,21,61,1,18
3918,427,783,168.53043083900226,170.48090702947846,21,13,366,2,356
3919,427,680,168.53043083900226,171.5025850340136,21,15,284,3,253
3920,427,844,168.53043083900226,171.4793650793651,21,13,436,3,417
3921,414,29,169.22702947845806,171.64190476190475,17,45,399,2,385
3922,414,276,169.22702947845806,170.5273469387755,17,33,149,1,138
3923,414,260,169.22702947845806,171.08462585034013,17,27,174,2,154
3924,414,518,169.22702947845806,171.52580498866214,17,24,144,2,104
3925,414,783,169.22702947845806,170.48090702947846,17,13,373,1,369
3926,414,680,169.22702947845806,171.5025850340136,17,15,283,2,266
3927,414,844,169.22702947845806,171.4793650793651,17,13,441,2,430
3928,414,872,169.22702947845806,171.92054421768708,17,17,472,3,458
3929,445,29,169.8771882086168,171.64190476190475,21,45,423,2,416
3930,445,109,169.8771882086168,172.43138321995465,21,45,354,3,336
3931,445,260,169.8771882086168,171.08462585034013,21,27,192,1,185
3932,445,276,169.8771882086168,172.80290249433108,21,35,211,3,169
3933,445,276,169.8771882086168,172.8261224489796,21,34,211,3,169
3934,445,518,169.8771882086168,171.52580498866214,21,24,102,2,73
3935,445,680,169.8771882086168,171.5025850340136,21,15,245,2,235
3936,445,620,169.8771882086168,172.40816326530611,21,15,206,3,175
3937,445,615,169.8771882086168,172.8261224489796,21,16,212,3,170
3938,445,844,169.8771882086168,171.4793650793651,21,13,405,2,399
3939,445,872,169.8771882086168,171.92054421768708,21,17,436,2,427
3940,518,55,171.52580498866214,173.01188208616782,24,46,467,1,463
3941,518,34,171.52580498866214,174.14965986394557,24,44,497,3,484
3942,518,276,171.52580498866214,172.80290249433108,24,35,248,1,242
3943,518,276,171.52580498866214,172.8261224489796,24,34,248,1,242
3944,518,206,171.52580498866214,174.03356009070296,24,22,330,3,312
3945,518,445,171.52580498866214,172.5707029478458,24,21,86,1,73
3946,518,461,171.52580498866214,173.2673015873016,24,17,94,2,57
3947,518,445,171.52580498866214,173.91746031746032,24,21,126,2,73
3948,518,615,171.52580498866214,172.8261224489796,24,16,112,1,97
3949,518,673,171.52580498866214,173.91746031746032,24,10,186,2,155
3950,518,878,171.52580498866214,173.2673015873016,24,15,368,2,360
3951,445,34,172.5707029478458,174.14965986394557,21,44,417,2,411
3952,445,18,172.5707029478458,175.3106575963719,21,45,443,3,427
3953,445,206,172.5707029478458,174.03356009070296,21,22,247,1,239
3954,445,404,172.5707029478458,175.51963718820863,21,26,133,3,41
3955,445,673,172.5707029478458,173.91746031746032,21,10,235,1,228
3956,445,694,172.5707029478458,175.3338775510204,21,18,276,3,249
3957,445,878,172.5707029478458,174.6140589569161,21,16,442,2,433
3958,461,18,173.2673015873016,175.3106575963719,17,45,452,2,443
3959,461,54,173.2673015873016,176.19301587301587,17,45,426,3,407
3960,461,404,173.2673015873016,175.51963718820863,17,26,113,2,57
3961,461,215,173.2673015873016,176.2162358276644,17,25,277,3,246
3962,461,419,173.2673015873016,175.5892970521542,17,25,108,2,42
3963,461,694,173.2673015873016,175.3338775510204,17,18,249,2,233
3964,461,878,173.2673015873016,174.6140589569161,17,16,421,1,417
3965,461,842,173.2673015873016,175.72861678004534,17,17,395,2,381
3966,461,879,173.2673015873016,175.96081632653062,17,16,434,3,418
3967,445,18,173.91746031746032,175.3106575963719,21,45,431,1,427
3968,445,54,173.91746031746032,176.19301587301587,21,45,403,2,391
3969,445,404,173.91746031746032,175.51963718820863,21,26,80,2,41
3970,445,215,173.91746031746032,176.2162358276644,21,25,250,2,230
3971,445,419,173.91746031746032,175.5892970521542,21,25,77,2,26
3972,445,462,173.91746031746032,176.70385487528344,21,22,121,3,17
3973,445,694,173.91746031746032,175.3338775510204,21,18,256,1,249
3974,445,673,173.91746031746032,176.70385487528344,21,15,258,3,228
3975,445,842,173.91746031746032,175.72861678004534,21,17,405,2,397
3976,445,879,173.91746031746032,175.96081632653062,21,16,443,2,434
3977,419,65,175.5892970521542,176.91283446712018,25,47,359,1,354
3978,419,71,175.5892970521542,177.86485260770976,25,45,362,2,348
3979,419,271,175.5892970521542,177.56299319727893,25,28,171,2,148
3980,419,217,175.5892970521542,178.1899319727891,25,24,231,3,202
3981,419,462,175.5892970521542,176.70385487528344,25,22,64,1,43
3982,419,489,175.5892970521542,177.05215419501135,25,20,94,1,70
3983,419,427,175.5892970521542,177.95773242630386,25,20,102,2,8
3984,419,673,175.5892970521542,176.70385487528344,25,15,258,1,254
3985,419,714,175.5892970521542,177.16825396825396,25,13,303,2,295
3986,419,878,175.5892970521542,177.30757369614514,25,16,465,2,459
3987,462,71,176.70385487528344,177.86485260770976,22,45,394,1,391
3988,462,217,176.70385487528344,178.1899319727891,22,24,253,1,245
3989,462,304,176.70385487528344,179.30448979591836,22,22,194,3,158
3990,462,427,176.70385487528344,177.95773242630386,22,20,64,1,35
3991,462,446,176.70385487528344,179.30448979591836,22,21,113,3,16
3992,462,674,176.70385487528344,179.3277097505669,22,12,240,3,212
3993,462,878,176.70385487528344,178.65433106575964,22,15,424,2,416
3994,462,866,176.70385487528344,179.30448979591836,22,11,419,3,404
3995,489,24,177.05215419501135,179.69922902494332,20,46,479,3,465
3996,489,217,177.05215419501135,178.1899319727891,20,24,276,1,272
3997,489,304,177.05215419501135,179.30448979591836,20,22,209,2,185
3998,489,446,177.05215419501135,179.30448979591836,20,21,106,2,43
3999,489,674,177.05215419501135,179.3277097505669,20,12,209,2,185
4000,489,676,177.05215419501135,180.00108843537416,20,10,226,3,187
4001,489,878,177.05215419501135,178.65433106575964,20,15,395,2,389
4002,489,866,177.05215419501135,179.30448979591836,20,11,389,2,377
4003,489,873,177.05215419501135,180.02430839002267,20,15,405,3,384
4004,427,24,177.95773242630386,179.69922902494332,20,46,410,2,403
4005,427,49,177.95773242630386,180.76734693877552,20,49,397,3,378
4006,427,304,177.95773242630386,179.30448979591836,20,22,136,1,123
4007,427,214,177.95773242630386,180.72090702947847,20,22,244,3,213
4008,427,446,177.95773242630386,179.30448979591836,20,21,61,1,19
4009,427,445,177.95773242630386,180.65124716553288,20,20,117,3,18
4010,427,674,177.95773242630386,179.3277097505669,20,12,254,1,247
4011,427,676,177.95773242630386,180.00108843537416,20,10,264,2,249
4012,427,866,177.95773242630386,179.30448979591836,20,11,443,1,439
4013,427,873,177.95773242630386,180.02430839002267,20,15,455,2,446
4014,446,49,179.30448979591836,180.76734693877552,21,49,402,1,397
4015,446,46,179.30448979591836,180.95310657596372,21,48,406,2,400
4016,446,214,179.30448979591836,180.72090702947847,21,22,240,1,232
4017,446,228,179.30448979591836,181.06920634920635,21,18,231,2,218
4018,446,304,179.30448979591836,181.97478458049886,21,21,183,3,142
4019,446,445,179.30448979591836,180.65124716553288,21,20,58,1,1
4020,446,443,179.30448979591836,181.34784580498868,21,19,88,2,3
4021,446,428,179.30448979591836,181.9980045351474,21,20,117,3,18
4022,446,692,179.30448979591836,182.0212244897959,21,12,272,3,246
4023,446,873,179.30448979591836,181.3710657596372,21,15,436,2,427
4024,445,27,180.65124716553288,182.69460317460317,20,46,427,2,418
4025,445,46,180.65124716553288,183.48408163265307,20,48,417,3,399
4026,445,304,180.65124716553288,181.97478458049886,20,21,152,1,141
4027,445,428,180.65124716553288,181.9980045351474,20,20,60,1,17
4028,445,427,180.65124716553288,183.36798185941043,20,20,118,3,18
4029,445,692,180.65124716553288,182.0212244897959,20,12,254,1,247
4030,445,796,180.65124716553288,183.04290249433106,20,9,366,2,351
4031,445,873,180.65124716553288,182.7178231292517,20,16,437,2,428
4032,445,907,180.65124716553288,183.36798185941043,20,11,477,3,462
4033,443,27,181.34784580498868,182.69460317460317,19,46,420,1,416
4034,443,46,181.34784580498868,183.48408163265307,19,48,408,2,397
4035,443,41,181.34784580498868,183.90204081632655,19,48,417,3,402
4036,443,205,181.34784580498868,183.76272108843537,19,20,260,2,238
4037,443,427,181.34784580498868,183.36798185941043,19,20,88,2,16
4038,443,796,181.34784580498868,183.04290249433106,19,9,360,2,353
4039,443,873,181.34784580498868,182.7178231292517,19,16,434,1,430
4040,443,907,181.34784580498868,183.36798185941043,19,11,472,2,464
4041,443,873,181.34784580498868,184.0645804988662,19,15,446,3,430
4042,428,46,181.9980045351474,183.48408163265307,20,48,387,1,382
4043,428,41,181.9980045351474,183.90204081632655,20,48,396,2,387
4044,428,41,181.9980045351474,184.87727891156462,20,46,406,3,387
4045,428,205,181.9980045351474,183.76272108843537,20,20,236,2,223
4046,428,206,181.9980045351474,184.761179138322,20,23,252,3,222
4047,428,206,181.9980045351474,184.9469387755102,20,21,256,3,222
4048,428,427,181.9980045351474,183.36798185941043,20,20,59,1,1
4049,428,445,181.9980045351474,184.71473922902496,20,20,118,3,17
4050,428,796,181.9980045351474,183.04290249433106,20,9,371,1,368
4051,428,907,181.9980045351474,183.36798185941043,20,11,483,1,479
4052,428,873,181.9980045351474,184.0645804988662,20,15,454,2,445
4053,427,41,183.36798185941043,184.87727891156462,20,46,391,2,386
4054,427,18,183.36798185941043,186.1079365079365,20,46,426,3,409
4055,427,206,183.36798185941043,184.761179138322,20,23,229,1,221
4056,427,206,183.36798185941043,184.9469387755102,20,21,231,2,221
4057,427,223,183.36798185941043,186.06149659863945,20,27,235,3,204
4058,427,445,183.36798185941043,184.71473922902496,20,20,61,1,18
4059,427,444,183.36798185941043,185.3881179138322,20,17,89,2,17
4060,427,445,183.36798185941043,186.06149659863945,20,21,117,3,18
4061,427,873,183.36798185941043,185.41133786848073,20,16,455,2,446
4062,445,18,184.71473922902496,186.1079365079365,20,46,431,1,427
4063,445,49,184.71473922902496,187.36181405895692,20,47,412,3,396
4064,445,223,184.71473922902496,186.06149659863945,20,27,229,1,222
4065,445,222,184.71473922902496,187.0831746031746,20,28,245,2,223
4066,445,548,184.71473922902496,187.50113378684807,20,22,158,3,103
4067,445,617,184.71473922902496,186.45623582766441,20,9,188,2,172
4068,445,618,184.71473922902496,187.50113378684807,20,14,211,3,173
4069,445,873,184.71473922902496,186.75809523809525,20,16,437,2,428
4070,445,907,184.71473922902496,187.40825396825397,20,11,476,3,462
4071,444,49,185.3881179138322,187.36181405895692,17,47,404,2,395
4072,444,222,185.3881179138322,187.0831746031746,17,28,234,2,222
4073,444,246,185.3881179138322,188.03519274376418,17,28,228,3,198
4074,444,548,185.3881179138322,187.50113378684807,17,22,138,2,104
4075,444,617,185.3881179138322,186.45623582766441,17,9,179,1,173
4076,444,618,185.3881179138322,187.50113378684807,17,14,196,2,174
4077,444,873,185.3881179138322,186.75809523809525,17,16,433,1,429
4078,444,907,185.3881179138322,187.40825396825397,17,11,471,2,463
4079,444,878,185.3881179138322,188.10485260770974,17,15,449,3,434
4080,445,49,186.06149659863945,187.36181405895692,21,47,400,1,396
4081,445,54,186.06149659863945,188.47637188208617,21,45,405,2,391
4082,445,222,186.06149659863945,187.0831746031746,21,28,227,1,223
4083,445,246,186.06149659863945,188.03519274376418,21,28,216,2,199
4084,445,548,186.06149659863945,187.50113378684807,21,22,120,1,103
4085,445,427,186.06149659863945,188.7550113378685,21,20,117,3,18
4086,445,618,186.06149659863945,187.50113378684807,21,14,184,1,173
4087,445,907,186.06149659863945,187.40825396825397,21,11,466,1,462
4088,445,878,186.06149659863945,188.10485260770974,21,15,442,2,433
4089,548,308,187.50113378684807,189.33551020408163,22,22,253,2,240
4090,548,427,187.50113378684807,188.7550113378685,22,20,133,1,121
4091,548,465,187.50113378684807,189.26585034013607,22,15,113,2,83
4092,548,758,187.50113378684807,189.26585034013607,22,17,223,2,210
4093,427,24,188.7550113378685,189.98566893424038,20,45,406,1,403
4094,427,24,188.7550113378685,190.96090702947845,20,37,414,2,403
4095,465,24,189.26585034013607,190.96090702947845,15,37,447,2,441
4096,465,31,189.26585034013607,192.07546485260772,15,28,451,3,434
4097,738,293,0.7894784580498866,2.7631746031746034,9,17,453,2,445
4098,738,306,0.7894784580498866,3.3668934240362813,9,19,446,3,432
4099,738,446,0.7894784580498866,2.670294784580499,9,19,303,2,292
4100,738,444,0.7894784580498866,3.3668934240362813,9,18,314,3,294
4101,738,672,0.7894784580498866,2.716734693877551,9,15,106,2,66
4102,738,878,0.7894784580498866,2.043356009070295,9,15,150,1,140
4103,738,873,0.7894784580498866,3.3901133786848074,9,16,175,3,135
4104,672,297,2.716734693877551,4.713650793650793,15,16,385,2,375
4105,672,210,2.716734693877551,5.410249433106576,15,29,476,3,462
4106,672,427,2.716734693877551,4.040272108843538,15,20,252,1,245
4107,672,427,2.716734693877551,5.38702947845805,15,22,271,3,245
4108,672,873,2.716734693877551,4.73687074829932,15,16,219,2,201
4109,672,921,2.716734693877551,5.38702947845805,15,10,274,3,249
4110,672,210,4.063492063492063,5.410249433106576,10,29,466,1,462
4111,672,274,4.063492063492063,6.130068027210885,10,23,408,2,398
4112,672,427,4.063492063492063,5.38702947845805,10,22,252,1,245
4113,672,536,4.063492063492063,6.362267573696145,10,21,168,2,136
4114,672,638,4.063492063492063,6.292607709750567,10,19,102,2,34
4115,672,921,4.063492063492063,5.38702947845805,10,10,255,1,249
4116,672,873,4.063492063492063,6.0836281179138325,10,15,219,2,201
4117,638,281,6.292607709750567,7.801904761904762,19,32,363,2,357
4118,638,217,6.292607709750567,8.52172335600907,19,35,432,2,421
4119,638,414,6.292607709750567,7.430385487528345,19,17,229,1,224
4120,638,531,6.292607709750567,8.150204081632653,19,23,134,2,107
4121,638,622,6.292607709750567,8.150204081632653,19,16,82,2,16
4122,638,873,6.292607709750567,7.430385487528345,19,17,240,1,235
4123,638,872,6.292607709750567,8.777142857142858,19,15,257,2,234
4124,622,217,7.198185941043084,8.52172335600907,9,35,409,1,405
4125,622,342,7.198185941043084,9.427301587301587,9,19,296,2,280
4126,622,445,7.198185941043084,9.427301587301587,9,20,201,2,177
4127,622,872,7.198185941043084,8.777142857142858,9,15,259,2,250
4128,622,907,7.198185941043084,9.427301587301587,9,13,301,2,285
4129,622,872,7.198185941043084,10.12390022675737,9,15,280,3,250
4130,622,342,8.150204081632653,9.427301587301587,16,19,285,1,280
4131,622,395,8.150204081632653,10.95981859410431,16,23,257,3,227
4132,622,292,8.150204081632653,11.052698412698414,16,24,353,3,330
4133,622,445,8.150204081632653,9.427301587301587,16,20,185,1,177
4134,622,505,8.150204081632653,10.95981859410431,16,26,168,3,117
4135,622,620,8.150204081632653,11.00625850340136,16,20,123,3,2
4136,622,616,8.150204081632653,11.052698412698414,16,15,125,3,6
4137,622,907,8.150204081632653,9.427301587301587,16,13,290,1,285
4138,622,872,8.150204081632653,10.12390022675737,16,15,264,2,250
4139,620,219,11.00625850340136,12.84063492063492,20,16,409,2,401
4140,620,268,11.00625850340136,13.746213151927439,20,22,371,3,352
4141,620,427,11.00625850340136,12.120816326530612,20,20,199,1,193
4142,620,541,11.00625850340136,13.467573696145125,20,23,132,2,79
4143,620,724,11.00625850340136,12.120816326530612,20,9,115,1,104
4144,620,713,11.00625850340136,13.444353741496599,20,19,140,2,93
4145,620,878,11.00625850340136,12.817414965986394,20,15,270,2,258
4146,620,865,11.00625850340136,13.467573696145125,20,14,267,2,245
4147,616,219,11.052698412698414,12.84063492063492,15,16,404,2,397
4148,616,268,11.052698412698414,13.746213151927439,15,22,367,3,348
4149,616,427,11.052698412698414,12.120816326530612,15,20,195,1,189
4150,616,541,11.052698412698414,13.467573696145125,15,23,128,2,75
4151,616,724,11.052698412698414,12.120816326530612,15,9,117,1,108
4152,616,713,11.052698412698414,13.444353741496599,15,19,141,2,97
4153,616,878,11.052698412698414,12.817414965986394,15,15,273,2,262
4154,616,865,11.052698412698414,13.467573696145125,15,14,270,2,249
4155,724,268,12.120816326530612,13.746213151927439,9,22,461,2,456
4156,724,268,12.120816326530612,14.09451247165533,9,20,464,2,456
4157,724,541,12.120816326530612,13.467573696145125,9,23,192,1,183
4158,724,436,12.120816326530612,14.814331065759637,9,20,310,3,288
4159,724,713,12.120816326530612,13.444353741496599,9,19,58,1,11
4160,724,784,12.120816326530612,14.164172335600908,9,9,107,2,60
4161,724,865,12.120816326530612,13.467573696145125,9,14,152,1,141
4162,724,873,12.120816326530612,14.164172335600908,9,16,173,2,149
4163,713,264,13.444353741496599,15.905668934240364,19,18,461,2,449
4164,713,274,13.444353741496599,16.23074829931973,19,30,455,3,439
4165,713,436,13.444353741496599,14.814331065759637,19,20,283,1,277
4166,713,443,13.444353741496599,15.51092970521542,19,18,284,2,270
4167,713,427,13.444353741496599,16.16108843537415,19,21,309,3,286
4168,713,629,13.444353741496599,15.534149659863946,19,10,123,2,84
4169,713,617,13.444353741496599,16.207528344671204,19,11,153,3,96
4170,713,878,13.444353741496599,15.51092970521542,19,16,187,2,165
4171,784,443,14.164172335600908,15.51092970521542,9,18,346,1,341
4172,784,427,14.164172335600908,16.16108843537415,9,21,367,2,357
4173,784,629,14.164172335600908,15.534149659863946,9,10,166,1,155
4174,784,617,14.164172335600908,16.207528344671204,9,11,189,2,167
4175,784,639,14.164172335600908,17.136326530612244,9,17,193,3,145
4176,784,878,14.164172335600908,15.51092970521542,9,16,110,1,94
4177,784,878,14.164172335600908,16.857687074829933,9,15,149,3,94
4178,629,277,15.534149659863946,17.902585034013605,10,29,366,2,352
4179,629,436,15.534149659863946,17.507845804988662,10,21,211,2,193
4180,629,639,15.534149659863946,17.136326530612244,10,17,70,2,10
4181,629,878,15.534149659863946,16.857687074829933,10,15,255,1,249
4182,629,921,15.534149659863946,17.507845804988662,10,11,304,2,292
4183,629,873,15.534149659863946,18.22766439909297,10,16,270,3,244
4184,617,277,16.207528344671204,17.902585034013605,11,29,348,2,340
4185,617,218,16.207528344671204,18.83138321995465,11,32,415,3,399
4186,617,436,16.207528344671204,17.507845804988662,11,21,189,1,181
4187,617,416,16.207528344671204,18.784943310657596,11,24,230,3,201
4188,617,620,16.207528344671204,19.017142857142858,11,19,121,3,3
4189,617,921,16.207528344671204,17.507845804988662,11,11,309,1,304
4190,617,873,16.207528344671204,18.22766439909297,11,16,270,2,256
4191,639,218,17.136326530612244,18.83138321995465,17,32,427,2,421
4192,639,216,17.136326530612244,19.272562358276645,17,34,433,2,423
4193,639,416,17.136326530612244,18.784943310657596,17,24,234,2,223
4194,639,612,17.136326530612244,19.388662131519276,17,19,101,2,27
4195,639,620,17.136326530612244,19.017142857142858,17,19,83,2,19
4196,639,617,17.136326530612244,19.458321995464853,17,21,102,2,22
4197,639,873,17.136326530612244,18.22766439909297,17,16,239,1,234
4198,639,873,17.136326530612244,19.574421768707484,17,16,256,2,234
4199,620,342,19.017142857142858,20.224580498866214,19,18,283,1,278
4200,620,445,19.017142857142858,20.20136054421769,19,21,182,1,175
4201,620,428,19.017142857142858,21.5481179138322,19,20,221,3,192
4202,620,638,19.017142857142858,21.989297052154196,19,13,129,3,18
4203,620,873,19.017142857142858,20.921179138321996,19,16,266,2,253
4204,620,907,19.017142857142858,21.571337868480725,19,11,307,3,287
4205,617,276,19.458321995464853,22.03573696145125,21,35,359,3,341
4206,617,276,19.458321995464853,22.105396825396827,21,35,360,3,341
4207,617,428,19.458321995464853,21.5481179138322,21,20,209,2,189
4208,617,638,19.458321995464853,21.989297052154196,21,13,111,3,21
4209,617,644,19.458321995464853,22.105396825396827,21,10,117,3,27
4210,617,873,19.458321995464853,20.921179138321996,21,16,264,1,256
4211,617,907,19.458321995464853,21.571337868480725,21,11,304,2,290
4212,617,873,19.458321995464853,22.267936507936508,21,15,283,3,256
4213,638,219,21.989297052154196,23.61469387755102,13,16,425,2,419
4214,638,206,21.989297052154196,24.473832199546486,13,27,445,2,432
4215,638,444,21.989297052154196,23.591473922902495,13,18,206,2,194
4216,638,489,21.989297052154196,24.264852607709752,13,23,178,2,149
4217,638,715,21.989297052154196,24.241632653061224,13,18,124,2,77
4218,638,873,21.989297052154196,23.61469387755102,13,16,245,2,235
4219,638,911,21.989297052154196,24.264852607709752,13,20,290,2,273
4220,644,219,22.105396825396827,23.61469387755102,10,16,430,2,425
4221,644,206,22.105396825396827,24.473832199546486,10,27,450,2,438
4222,644,444,22.105396825396827,23.591473922902495,10,18,210,1,200
4223,644,489,22.105396825396827,24.264852607709752,10,23,181,2,155
4224,644,715,22.105396825396827,24.241632653061224,10,18,116,2,71
4225,644,873,22.105396825396827,23.61469387755102,10,16,238,2,229
4226,644,911,22.105396825396827,24.264852607709752,10,20,283,2,267
4227,715,219,24.241632653061224,25.658049886621317,18,14,500,1,496
4228,715,305,24.241632653061224,26.28498866213152,18,14,419,2,410
4229,715,427,24.241632653061224,25.611609977324264,18,20,294,1,288
4230,715,427,24.241632653061224,26.958367346938775,18,20,311,3,288
4231,715,629,24.241632653061224,26.33142857142857,18,9,124,2,86
4232,715,907,24.241632653061224,25.611609977324264,18,11,201,1,192
4233,715,873,24.241632653061224,26.308208616780046,18,16,181,2,158
4234,629,225,26.33142857142857,27.654965986394558,9,15,408,1,404
4235,629,260,26.33142857142857,28.93206349206349,9,23,386,3,369
4236,629,443,26.33142857142857,27.654965986394558,9,17,195,1,186
4237,629,422,26.33142857142857,28.93206349206349,9,24,235,3,207
4238,629,784,26.33142857142857,28.35156462585034,9,10,178,2,155
4239,629,878,26.33142857142857,27.654965986394558,9,15,255,1,249
4240,629,873,26.33142857142857,29.00172335600907,9,16,270,3,244
4241,784,427,28.35156462585034,29.651882086167802,10,20,361,1,357
4242,784,436,28.35156462585034,30.998639455782314,10,21,366,3,348
4243,784,630,28.35156462585034,30.046621315192745,10,15,170,2,154
4244,784,631,28.35156462585034,30.78965986394558,10,16,186,2,153
4245,784,855,28.35156462585034,29.559002267573696,10,11,88,1,71
4246,784,878,28.35156462585034,30.348480725623585,10,14,127,2,94
4247,630,275,30.046621315192745,31.207619047619048,15,18,359,1,355
4248,630,261,30.046621315192745,32.76335600907029,15,36,387,3,369
4249,630,443,30.046621315192745,31.695238095238096,15,18,200,2,187
4250,630,427,30.046621315192745,32.345396825396826,15,21,226,2,203
4251,630,619,30.046621315192745,32.786575963718825,15,21,119,3,11
4252,630,872,30.046621315192745,31.695238095238096,15,15,252,2,242
4253,631,261,30.78965986394558,32.76335600907029,16,36,380,2,370
4254,631,427,30.78965986394558,32.345396825396826,16,21,215,2,204
4255,631,445,30.78965986394558,33.69215419501134,16,21,224,3,186
4256,631,619,30.78965986394558,32.786575963718825,16,21,87,2,12
4257,631,635,30.78965986394558,33.552834467120185,16,17,119,3,4
4258,631,878,30.78965986394558,33.04199546485261,16,15,265,2,247
4259,631,907,30.78965986394558,33.69215419501134,16,11,303,3,276
4260,619,264,32.786575963718825,34.04045351473923,21,25,359,1,355
4261,619,221,32.786575963718825,34.644172335600906,21,26,406,2,398
4262,619,219,32.786575963718825,35.294331065759636,21,24,414,3,400
4263,619,462,32.786575963718825,34.89959183673469,21,21,181,2,157
4264,619,432,32.786575963718825,35.20145124716554,21,24,214,2,187
4265,619,808,32.786575963718825,35.48009070294785,21,11,222,3,189
4266,619,872,32.786575963718825,34.38875283446712,21,16,262,2,253
4267,619,957,32.786575963718825,35.48009070294785,21,9,357,3,338
4268,635,221,33.552834467120185,34.644172335600906,17,26,417,1,414
4269,635,219,33.552834467120185,35.294331065759636,17,24,423,2,416
4270,635,462,33.552834467120185,34.89959183673469,17,21,182,1,173
4271,635,432,33.552834467120185,35.20145124716554,17,24,215,2,203
4272,635,808,33.552834467120185,35.48009070294785,17,11,192,2,173
4273,635,957,33.552834467120185,35.48009070294785,17,9,333,2,322
4274,808,443,35.48009070294785,37.73242630385488,11,19,378,2,365
4275,808,619,35.48009070294785,37.755646258503404,11,15,213,2,189
4276,808,943,35.48009070294785,37.73242630385488,11,12,166,2,135
4277,808,873,35.48009070294785,38.45224489795918,11,15,144,3,65
4278,619,276,37.755646258503404,39.14884353741497,15,21,348,1,343
4279,619,218,37.755646258503404,39.72934240362812,15,38,410,2,401
4280,619,306,37.755646258503404,40.51882086167801,15,18,335,3,313
4281,619,428,37.755646258503404,39.07918367346939,15,19,199,1,191
4282,619,512,37.755646258503404,39.65968253968254,15,20,135,2,107
4283,619,428,37.755646258503404,40.4259410430839,15,20,223,3,191
4284,619,672,37.755646258503404,39.10240362811791,15,12,79,1,53
4285,619,802,37.755646258503404,39.91510204081633,15,16,205,2,183
4286,619,874,37.755646258503404,39.7990022675737,15,15,270,2,255
4287,672,306,39.10240362811791,40.51882086167801,12,18,371,1,366
4288,672,271,39.10240362811791,41.86557823129252,12,19,418,3,401
4289,672,428,39.10240362811791,40.4259410430839,12,20,251,1,244
4290,672,489,39.10240362811791,41.40117913832199,12,25,208,2,183
4291,672,660,39.10240362811791,41.40117913832199,12,15,100,2,12
4292,672,873,39.10240362811791,41.145759637188206,12,15,219,2,201
4293,672,854,39.10240362811791,41.40117913832199,12,11,207,2,182
4294,802,489,39.91510204081633,41.40117913832199,16,25,319,1,313
4295,802,660,39.91510204081633,41.40117913832199,16,15,156,1,142
4296,802,621,39.91510204081633,42.4692970521542,16,12,212,3,181
4297,802,873,39.91510204081633,41.145759637188206,16,15,89,1,71
4298,802,854,39.91510204081633,41.40117913832199,16,11,82,1,52
4299,802,873,39.91510204081633,42.49251700680272,16,17,132,3,71
4300,660,219,41.40117913832199,42.49251700680272,15,35,443,1,441
4301,660,229,41.40117913832199,43.6302947845805,15,30,442,2,431
4302,660,427,41.40117913832199,43.14267573696145,15,20,245,2,233
4303,660,425,41.40117913832199,43.83927437641724,15,17,257,2,235
4304,660,621,41.40117913832199,42.4692970521542,15,12,60,1,39
4305,660,668,41.40117913832199,43.67673469387755,15,12,98,2,8
4306,660,873,41.40117913832199,42.49251700680272,15,17,218,1,213
4307,660,873,41.40117913832199,43.83927437641724,15,16,237,2,213
4308,621,229,42.4692970521542,43.6302947845805,12,30,395,1,392
4309,621,312,42.4692970521542,44.489433106575966,12,16,321,2,309
4310,621,425,42.4692970521542,43.83927437641724,12,17,205,1,196
4311,621,427,42.4692970521542,44.489433106575966,12,20,213,2,194
4312,621,668,42.4692970521542,43.67673469387755,12,12,70,1,47
4313,621,752,42.4692970521542,44.489433106575966,12,10,157,2,131
4314,621,873,42.4692970521542,43.83927437641724,12,16,259,1,252
4315,621,872,42.4692970521542,45.186031746031745,12,16,277,3,251
4316,668,267,43.67673469387755,45.81297052154195,12,21,411,2,401
4317,668,261,43.67673469387755,46.34702947845805,12,29,423,3,407
4318,668,438,43.67673469387755,45.81297052154195,12,20,248,2,230
4319,668,617,43.67673469387755,45.952290249433105,12,12,110,2,51
4320,668,872,43.67673469387755,45.186031746031745,12,16,214,2,204
4321,668,907,43.67673469387755,45.836190476190474,12,12,256,2,239
4322,668,878,43.67673469387755,46.53278911564626,12,18,243,3,210
4323,752,267,44.489433106575966,45.81297052154195,10,21,488,1,485
4324,752,261,44.489433106575966,46.34702947845805,10,29,497,2,491
4325,752,438,44.489433106575966,45.81297052154195,10,20,319,1,314
4326,752,427,44.489433106575966,47.18294784580499,10,21,345,3,325
4327,752,617,44.489433106575966,45.952290249433105,10,12,149,1,135
4328,752,633,44.489433106575966,47.09006802721088,10,10,163,3,119
4329,752,907,44.489433106575966,45.836190476190474,10,12,165,1,155
4330,752,878,44.489433106575966,46.53278911564626,10,18,154,2,126
4331,617,263,45.952290249433105,47.71700680272109,12,35,362,2,354
4332,617,243,45.952290249433105,48.29750566893424,12,23,387,2,374
4333,617,427,45.952290249433105,47.18294784580499,12,21,197,1,190
4334,617,444,45.952290249433105,47.85632653061224,12,17,191,2,173
4335,617,427,45.952290249433105,48.529705215419504,12,20,220,3,190
4336,617,633,45.952290249433105,47.09006802721088,12,10,52,1,16
4337,617,755,45.952290249433105,47.78666666666667,12,16,159,2,138
4338,617,700,45.952290249433105,48.50648526077098,12,11,138,3,83
4339,617,878,45.952290249433105,47.879546485260775,12,17,274,2,261
4340,633,243,47.09006802721088,48.29750566893424,10,23,393,1,390
4341,633,427,47.09006802721088,48.529705215419504,10,20,215,1,206
4342,633,445,47.09006802721088,49.87646258503401,10,21,223,3,188
4343,633,700,47.09006802721088,48.50648526077098,10,11,91,1,67
4344,633,673,47.09006802721088,49.89968253968254,10,10,127,3,40
4345,633,911,47.09006802721088,49.20308390022676,10,12,293,2,278
4346,633,878,47.09006802721088,49.22630385487528,10,16,262,2,245
4347,755,445,47.78666666666667,49.87646258503401,16,21,323,2,310
4348,755,673,47.78666666666667,49.89968253968254,16,10,122,2,82
4349,755,743,47.78666666666667,50.43374149659864,16,16,115,3,12
4350,755,911,47.78666666666667,49.20308390022676,16,12,168,1,156
4351,755,878,47.78666666666667,49.22630385487528,16,16,138,1,123
4352,755,872,47.78666666666667,50.5730612244898,16,16,168,3,117
4353,700,214,48.50648526077098,50.178321995464856,11,27,491,2,486
4354,700,254,48.50648526077098,50.24798185941043,11,33,452,2,446
4355,700,264,48.50648526077098,51.316099773242634,11,24,452,3,436
4356,700,445,48.50648526077098,49.87646258503401,11,21,262,1,255
4357,700,445,48.50648526077098,51.22321995464853,11,21,281,3,255
4358,700,556,48.50648526077098,51.24643990929705,11,19,186,3,144
4359,700,673,48.50648526077098,49.89968253968254,11,10,66,1,27
4360,700,743,48.50648526077098,50.43374149659864,11,16,93,2,43
4361,700,872,48.50648526077098,50.5730612244898,11,16,194,2,172
4362,673,264,49.89968253968254,51.316099773242634,10,24,414,1,409
4363,673,218,49.89968253968254,52.45387755102041,10,37,468,3,455
4364,673,445,49.89968253968254,51.22321995464853,10,21,235,1,228
4365,673,556,49.89968253968254,51.24643990929705,10,19,131,1,117
4366,673,684,49.89968253968254,52.848616780045354,10,20,127,3,11
4367,673,878,49.89968253968254,51.919818594104306,10,15,223,2,205
4368,743,486,50.43374149659864,52.895056689342404,16,22,278,2,257
4369,743,673,50.43374149659864,51.89659863945578,16,11,94,1,70
4370,743,684,50.43374149659864,52.848616780045354,16,20,120,2,59
4371,743,878,50.43374149659864,51.919818594104306,16,15,149,1,135
4372,743,849,50.43374149659864,52.895056689342404,16,13,150,2,106
4373,743,872,50.43374149659864,53.26657596371882,16,16,178,3,129
4374,673,231,51.89659863945578,54.218594104308394,11,31,453,2,442
4375,673,230,51.89659863945578,54.24181405895692,11,33,454,2,443
4376,673,445,51.89659863945578,53.91673469387755,11,21,244,2,228
4377,673,543,51.89659863945578,54.61333333333334,11,18,175,3,130
4378,673,807,51.89659863945578,54.218594104308394,11,10,167,2,134
4379,673,872,51.89659863945578,53.26657596371882,11,16,208,1,199
4380,673,878,51.89659863945578,54.61333333333334,11,14,236,3,205
4381,684,231,52.848616780045354,54.218594104308394,20,31,457,1,453
4382,684,230,52.848616780045354,54.24181405895692,20,33,458,1,454
4383,684,445,52.848616780045354,53.91673469387755,20,21,243,1,239
4384,684,543,52.848616780045354,54.61333333333334,20,18,160,2,141
4385,684,427,52.848616780045354,55.263492063492066,20,22,277,2,257
4386,684,807,52.848616780045354,54.218594104308394,20,10,136,1,123
4387,684,673,52.848616780045354,54.61333333333334,20,12,77,2,11
4388,684,878,52.848616780045354,54.61333333333334,20,14,208,2,194
4389,807,404,54.218594104308394,56.86566893424036,10,25,419,3,403
4390,807,427,54.218594104308394,55.263492063492066,10,22,383,1,380
4391,807,419,54.218594104308394,56.93532879818594,10,24,405,3,388
4392,807,616,54.218594104308394,55.960090702947845,10,10,205,2,191
4393,807,622,54.218594104308394,56.65668934240363,10,20,213,2,185
4394,807,872,54.218594104308394,55.960090702947845,10,15,99,2,65
4395,807,842,54.218594104308394,57.0746485260771,10,19,128,3,35
4396,673,219,54.61333333333334,55.98331065759637,12,17,458,1,454
4397,673,404,54.61333333333334,56.86566893424036,12,25,286,2,269
4398,673,215,54.61333333333334,57.58548752834467,12,24,476,3,458
4399,673,419,54.61333333333334,56.93532879818594,12,24,273,2,254
4400,673,616,54.61333333333334,55.960090702947845,12,10,81,1,57
4401,673,622,54.61333333333334,56.65668934240363,12,20,102,2,51
4402,673,872,54.61333333333334,55.960090702947845,12,15,207,1,199
4403,673,842,54.61333333333334,57.0746485260771,12,19,199,2,169
4404,673,878,54.61333333333334,57.30684807256236,12,16,236,3,205
4405,616,215,55.960090702947845,57.58548752834467,10,24,407,2,401
4406,616,271,55.960090702947845,58.90902494331066,10,28,368,3,345
4407,616,462,55.960090702947845,58.049886621315196,10,22,178,2,154
4408,616,561,55.960090702947845,58.42140589569161,10,18,119,2,55
4409,616,646,55.960090702947845,58.02666666666667,10,17,94,2,30
4410,616,697,55.960090702947845,58.42140589569161,10,14,133,2,81
4411,616,842,55.960090702947845,57.0746485260771,10,19,231,1,226
4412,616,878,55.960090702947845,57.30684807256236,10,16,268,1,262
4413,616,873,55.960090702947845,58.6768253968254,10,16,282,3,257
4414,622,271,56.65668934240363,58.90902494331066,20,28,364,2,351
4415,622,217,56.65668934240363,59.53596371882086,20,23,424,3,405
4416,622,462,56.65668934240363,58.049886621315196,20,22,171,1,160
4417,622,561,56.65668934240363,58.42140589569161,20,18,97,2,61
4418,622,445,56.65668934240363,59.303764172335605,20,21,211,3,177
4419,622,646,56.65668934240363,58.02666666666667,20,17,64,1,24
4420,622,697,56.65668934240363,58.42140589569161,20,14,107,2,75
4421,622,873,56.65668934240363,58.6768253968254,20,16,266,2,251
4422,646,217,58.02666666666667,59.53596371882086,17,23,434,2,429
4423,646,350,58.02666666666667,60.67374149659864,17,18,317,3,296
4424,646,445,58.02666666666667,59.303764172335605,17,21,208,1,201
4425,646,446,58.02666666666667,60.65052154195011,17,20,230,3,200
4426,646,633,58.02666666666667,60.02358276643991,17,10,87,2,13
4427,646,670,58.02666666666667,60.65052154195011,17,12,116,3,24
4428,646,873,58.02666666666667,60.02358276643991,17,16,243,2,227
4429,646,907,58.02666666666667,60.67374149659864,17,11,285,3,261
4430,697,217,58.42140589569161,59.53596371882086,14,23,482,1,480
4431,697,350,58.42140589569161,60.67374149659864,14,18,360,2,347
4432,697,446,58.42140589569161,60.65052154195011,14,20,269,2,251
4433,697,633,58.42140589569161,60.02358276643991,14,10,94,2,64
4434,697,670,58.42140589569161,60.65052154195011,14,12,100,2,27
4435,697,675,58.42140589569161,61.3471201814059,14,11,128,3,22
4436,697,873,58.42140589569161,60.02358276643991,14,16,189,2,176
4437,697,907,58.42140589569161,60.67374149659864,14,11,231,2,210
4438,697,873,58.42140589569161,61.37034013605442,14,16,217,3,176
4439,633,286,60.02358276643991,61.69541950113379,10,25,354,2,347
4440,633,206,60.02358276643991,62.78675736961451,10,18,443,3,427
4441,633,445,60.02358276643991,61.99727891156463,10,20,206,2,188
4442,633,443,60.02358276643991,62.69387755102041,10,19,222,3,190
4443,633,675,60.02358276643991,61.3471201814059,10,11,71,1,42
4444,633,873,60.02358276643991,61.37034013605442,10,16,247,1,240
4445,633,873,60.02358276643991,62.71709750566894,10,16,267,3,240
4446,670,286,60.65052154195011,61.69541950113379,12,25,387,1,384
4447,670,206,60.65052154195011,62.78675736961451,12,18,473,2,464
4448,670,310,60.65052154195011,63.36725623582767,12,19,379,3,360
4449,670,445,60.65052154195011,61.99727891156463,12,20,232,1,225
4450,670,443,60.65052154195011,62.69387755102041,12,19,243,2,227
4451,670,445,60.65052154195011,63.36725623582767,12,20,254,3,225
4452,670,789,60.65052154195011,63.39047619047619,12,14,168,3,119
4453,670,873,60.65052154195011,62.71709750566894,12,16,222,2,203
4454,675,206,61.3471201814059,62.78675736961451,11,18,473,1,469
4455,675,310,61.3471201814059,63.36725623582767,11,19,375,2,365
4456,675,443,61.3471201814059,62.69387755102041,11,19,239,1,232
4457,675,445,61.3471201814059,63.36725623582767,11,20,246,2,230
4458,675,789,61.3471201814059,63.39047619047619,11,14,144,2,114
4459,675,873,61.3471201814059,62.71709750566894,11,16,207,1,198
4460,675,873,61.3471201814059,64.06385487528345,11,16,230,3,198
4461,789,427,63.39047619047619,64.71401360544218,14,20,366,1,362
4462,789,427,63.39047619047619,66.06077097505668,14,20,380,3,362
4463,789,907,63.39047619047619,64.71401360544218,14,12,131,1,118
4464,789,873,63.39047619047619,65.41061224489796,14,16,121,2,84
4465,616,261,66.73414965986395,67.91836734693878,9,20,359,1,355
4466,616,213,66.73414965986395,69.07936507936508,9,27,415,2,403
4467,616,427,66.73414965986395,68.75428571428571,9,21,208,2,189
4468,616,878,66.73414965986395,68.10412698412699,9,16,269,1,262
4469,616,907,66.73414965986395,68.75428571428571,9,11,304,2,291
4470,616,873,66.73414965986395,69.4508843537415,9,16,282,3,257
4471,623,209,70.19392290249434,72.19083900226758,14,29,423,2,414
4472,623,574,70.19392290249434,71.95863945578232,14,24,90,2,49
4473,623,540,70.19392290249434,72.95709750566894,14,22,145,3,83
4474,623,618,70.19392290249434,72.00507936507937,14,20,78,2,5
4475,623,633,70.19392290249434,72.91065759637188,14,17,117,3,10
4476,623,878,70.19392290249434,72.14439909297052,14,17,268,2,255
4477,623,849,70.19392290249434,72.91065759637188,14,12,254,3,226
4478,623,209,70.4261224489796,72.19083900226758,19,29,421,2,414
4479,623,215,70.4261224489796,73.32861678004535,19,34,427,3,408
4480,623,215,70.4261224489796,73.35183673469388,19,33,427,3,408
4481,623,574,70.4261224489796,71.95863945578232,19,24,82,2,49
4482,623,540,70.4261224489796,72.95709750566894,19,22,137,3,83
4483,623,618,70.4261224489796,72.00507936507937,19,20,68,2,5
4484,623,633,70.4261224489796,72.91065759637188,19,17,107,2,10
4485,623,878,70.4261224489796,72.14439909297052,19,17,266,2,255
4486,623,849,70.4261224489796,72.91065759637188,19,12,250,2,226
4487,618,215,72.00507936507937,73.32861678004535,20,34,407,1,403
4488,618,215,72.00507936507937,73.35183673469388,20,33,407,1,403
4489,618,206,72.00507936507937,74.8843537414966,20,16,430,3,412
4490,618,445,72.00507936507937,74.14131519274376,20,20,196,2,173
4491,618,444,72.00507936507937,74.83791383219955,20,18,213,3,174
4492,618,741,72.00507936507937,73.42149659863945,20,16,137,1,123
4493,618,873,72.00507936507937,73.49115646258504,20,15,263,1,255
4494,618,878,72.00507936507937,74.83791383219955,20,16,287,3,260
4495,633,206,72.91065759637188,74.8843537414966,17,16,435,2,427
4496,633,445,72.91065759637188,74.14131519274376,17,20,195,1,188
4497,633,444,72.91065759637188,74.83791383219955,17,18,206,2,189
4498,633,562,72.91065759637188,75.58095238095238,17,25,135,3,71
4499,633,623,72.91065759637188,75.53451247165533,17,22,113,3,10
4500,633,878,72.91065759637188,74.83791383219955,17,16,259,2,245
4501,741,381,73.42149659863945,76.34721088435374,16,22,381,3,360
4502,741,444,73.42149659863945,74.83791383219955,16,18,303,1,297
4503,741,562,73.42149659863945,75.58095238095238,16,25,202,2,179
4504,741,491,73.42149659863945,76.37043083900227,16,23,280,3,250
4505,741,623,73.42149659863945,75.53451247165533,16,22,149,2,118
4506,741,668,73.42149659863945,76.34721088435374,16,18,146,3,73
4507,741,878,73.42149659863945,74.83791383219955,16,16,150,1,137
4508,741,878,73.42149659863945,76.18467120181406,16,16,181,3,137
4509,741,936,73.42149659863945,76.34721088435374,16,11,232,3,195
4510,623,286,75.53451247165533,78.1815873015873,22,18,356,3,337
4511,623,564,75.53451247165533,78.29768707482994,22,24,133,3,59
4512,623,559,75.53451247165533,78.36734693877551,22,23,138,3,64
4513,623,652,75.53451247165533,78.29768707482994,22,20,122,3,29
4514,623,628,75.53451247165533,78.36734693877551,22,18,122,3,5
4515,623,826,75.53451247165533,78.22802721088435,22,16,234,3,203
4516,668,286,76.34721088435374,78.1815873015873,18,18,390,2,382
4517,668,268,76.34721088435374,78.94784580498866,18,26,415,3,400
4518,668,564,76.34721088435374,78.29768707482994,18,24,134,2,104
4519,668,559,76.34721088435374,78.36734693877551,18,23,139,2,109
4520,668,652,76.34721088435374,78.29768707482994,18,20,86,2,16
4521,668,628,76.34721088435374,78.36734693877551,18,18,96,2,40
4522,668,826,76.34721088435374,78.22802721088435,18,16,178,2,158
4523,668,873,76.34721088435374,78.90140589569161,18,16,233,3,205
4524,652,304,78.29768707482994,80.2249433106576,20,15,358,2,348
4525,652,291,78.29768707482994,80.89832199546485,20,31,378,3,361
4526,652,427,78.29768707482994,79.52834467120182,20,20,231,1,225
4527,652,427,78.29768707482994,80.87510204081633,20,20,251,3,225
4528,652,627,78.29768707482994,80.92154195011338,20,11,116,3,25
4529,652,873,78.29768707482994,80.24816326530612,20,15,236,2,221
4530,628,304,78.36734693877551,80.2249433106576,18,15,334,2,324
4531,628,291,78.36734693877551,80.89832199546485,18,31,354,3,337
4532,628,427,78.36734693877551,79.52834467120182,18,20,207,1,201
4533,628,427,78.36734693877551,80.87510204081633,18,20,228,3,201
4534,628,627,78.36734693877551,80.92154195011338,18,11,110,3,1
4535,628,873,78.36734693877551,80.24816326530612,18,15,258,2,245
4536,628,856,78.36734693877551,81.2930612244898,18,12,260,3,228
4537,627,271,80.92154195011338,82.0128798185941,11,28,359,1,356
4538,627,218,80.92154195011338,83.35963718820862,11,38,422,2,409
4539,627,217,80.92154195011338,83.38285714285715,11,40,423,2,410
4540,627,421,80.92154195011338,82.0128798185941,11,22,211,1,206
4541,627,423,80.92154195011338,82.75591836734694,11,19,219,2,204
4542,627,533,80.92154195011338,83.56861678004535,11,23,148,3,94
4543,627,632,80.92154195011338,82.0128798185941,11,14,47,1,5
4544,627,633,80.92154195011338,82.77913832199546,11,14,80,2,6
4545,627,767,80.92154195011338,83.49895691609977,11,18,179,3,140
4546,627,873,80.92154195011338,82.94167800453515,11,16,261,2,246
4547,632,218,82.0128798185941,83.35963718820862,14,38,418,1,414
4548,632,217,82.0128798185941,83.38285714285715,14,40,419,1,415
4549,632,247,82.0128798185941,84.45097505668934,14,26,399,2,385
4550,632,533,82.0128798185941,83.56861678004535,14,23,120,2,99
4551,632,427,82.0128798185941,84.9385941043084,14,19,241,3,205
4552,632,767,82.0128798185941,83.49895691609977,14,18,149,1,135
4553,632,872,82.0128798185941,84.28843537414966,14,16,259,2,240
4554,632,907,82.0128798185941,84.9385941043084,14,12,302,3,275
4555,633,247,82.77913832199546,84.45097505668934,14,26,393,2,386
4556,633,427,82.77913832199546,84.9385941043084,14,19,226,2,206
4557,633,872,82.77913832199546,84.28843537414966,14,16,248,2,239
4558,633,907,82.77913832199546,84.9385941043084,14,12,289,2,274
4559,633,873,82.77913832199546,85.63519274376418,14,16,270,3,240
4560,767,427,83.49895691609977,84.9385941043084,18,19,346,1,340
4561,767,427,83.49895691609977,86.2853514739229,18,20,361,3,340
4562,767,574,83.49895691609977,86.47111111111111,18,20,232,3,193
4563,767,617,83.49895691609977,86.14603174603175,18,12,188,3,150
4564,767,627,83.49895691609977,86.47111111111111,18,19,190,3,140
4565,767,907,83.49895691609977,84.9385941043084,18,12,153,1,140
4566,767,873,83.49895691609977,85.63519274376418,18,16,140,2,106
4567,617,269,86.14603174603175,87.42312925170069,12,25,352,1,348
4568,617,445,86.14603174603175,87.63210884353742,12,20,184,1,172
4569,617,427,86.14603174603175,88.97886621315193,12,20,226,3,190
4570,617,873,86.14603174603175,88.3287074829932,12,17,273,2,256
4571,617,907,86.14603174603175,88.97886621315193,12,13,315,3,290
4572,627,299,86.47111111111111,89.37360544217687,19,30,351,3,328
4573,627,445,86.47111111111111,87.63210884353742,19,20,189,1,182
4574,627,427,86.47111111111111,88.97886621315193,19,20,227,3,200
4575,627,626,86.47111111111111,89.37360544217687,19,16,125,3,1
4576,627,873,86.47111111111111,88.3287074829932,19,17,259,2,246
4577,627,907,86.47111111111111,88.97886621315193,19,13,300,3,280
4578,626,246,89.37360544217687,91.25442176870749,16,20,389,2,380
4579,626,271,89.37360544217687,91.48662131519275,16,22,366,2,355
4580,626,443,89.37360544217687,91.02222222222223,16,18,196,2,183
4581,626,445,89.37360544217687,91.67238095238095,16,20,206,2,181
4582,626,878,89.37360544217687,91.02222222222223,16,16,262,2,252
4583,627,246,89.83800453514739,91.25442176870749,12,20,386,1,381
4584,627,271,89.83800453514739,91.48662131519275,12,22,363,2,356
4585,627,443,89.83800453514739,91.02222222222223,12,18,191,1,184
4586,627,445,89.83800453514739,91.67238095238095,12,20,198,2,182
4587,627,878,89.83800453514739,91.02222222222223,12,16,256,1,251
4588,627,878,89.83800453514739,92.36897959183673,12,16,274,3,251
4589,784,410,93.06557823129252,94.59809523809524,10,25,380,2,374
4590,784,436,93.06557823129252,95.71265306122449,10,20,366,3,348
4591,784,630,93.06557823129252,94.76063492063493,10,13,170,2,154
4592,784,631,93.06557823129252,95.50367346938776,10,16,186,2,153
4593,784,878,93.06557823129252,95.06249433106576,10,15,127,2,94
4594,630,266,94.76063492063493,97.4077097505669,13,33,381,3,364
4595,630,261,94.76063492063493,97.52380952380953,13,36,388,3,369
4596,630,445,94.76063492063493,97.05941043083901,13,20,210,2,185
4597,630,636,94.76063492063493,97.36126984126984,13,14,112,3,6
4598,630,619,94.76063492063493,97.500589569161,13,20,119,3,11
4599,630,873,94.76063492063493,96.4324716553288,13,15,253,2,243
4600,630,921,94.76063492063493,97.05941043083901,13,11,307,2,291
4601,631,266,95.50367346938776,97.4077097505669,16,33,374,2,365
4602,631,261,95.50367346938776,97.52380952380953,16,36,380,2,370
4603,631,445,95.50367346938776,97.05941043083901,16,20,198,2,186
4604,631,427,95.50367346938776,98.40616780045352,16,20,239,3,204
4605,631,636,95.50367346938776,97.36126984126984,16,14,80,2,5
4606,631,619,95.50367346938776,97.500589569161,16,20,87,2,12
4607,631,921,95.50367346938776,97.05941043083901,16,11,298,2,290
4608,631,879,95.50367346938776,97.75600907029478,16,15,266,2,248
4609,636,220,97.36126984126984,99.35818594104309,14,28,425,2,416
4610,636,220,97.36126984126984,100.03156462585034,14,24,432,3,416
4611,636,427,97.36126984126984,98.40616780045352,14,20,214,1,209
4612,636,443,97.36126984126984,99.1027664399093,14,17,207,2,193
4613,636,432,97.36126984126984,99.91546485260771,14,24,232,3,204
4614,636,629,97.36126984126984,98.59192743764173,14,11,53,1,7
4615,636,807,97.36126984126984,100.19410430839002,14,11,210,3,171
4616,636,873,97.36126984126984,99.12598639455783,14,16,249,2,237
4617,636,907,97.36126984126984,99.75292517006802,14,10,290,2,271
4618,619,220,97.500589569161,99.35818594104309,20,28,407,2,399
4619,619,220,97.500589569161,100.03156462585034,20,24,414,3,399
4620,619,247,97.500589569161,100.47274376417234,20,20,393,3,372
4621,619,443,97.500589569161,99.1027664399093,20,17,189,2,176
4622,619,432,97.500589569161,99.91546485260771,20,24,214,2,187
4623,619,629,97.500589569161,98.59192743764173,20,11,48,1,10
4624,619,807,97.500589569161,100.19410430839002,20,11,221,3,188
4625,619,873,97.500589569161,99.12598639455783,20,16,263,2,254
4626,619,907,97.500589569161,99.75292517006802,20,10,304,2,288
4627,629,220,98.59192743764173,100.03156462585034,11,24,414,1,409
4628,629,247,98.59192743764173,100.47274376417234,11,20,390,2,382
4629,629,432,98.59192743764173,99.91546485260771,11,24,205,1,197
4630,629,807,98.59192743764173,100.19410430839002,11,11,191,2,178
4631,629,907,98.59192743764173,99.75292517006802,11,10,282,1,278
4632,807,477,100.19410430839002,102.26068027210884,11,18,342,2,330
4633,807,425,100.19410430839002,103.16625850340137,11,18,403,3,382
4634,807,696,100.19410430839002,102.44643990929706,11,15,147,2,111
4635,807,619,100.19410430839002,102.4928798185941,11,10,212,2,188
4636,807,943,100.19410430839002,102.44643990929706,11,11,167,2,136
4637,807,873,100.19410430839002,103.16625850340137,11,16,144,3,66
4638,696,218,102.44643990929706,104.4433560090703,15,38,486,2,478
4639,696,218,102.44643990929706,104.51301587301587,15,36,486,2,478
4640,696,508,102.44643990929706,104.4433560090703,15,20,207,2,188
4641,696,436,102.44643990929706,105.13995464852609,15,20,285,3,260
4642,696,801,102.44643990929706,104.46657596371882,15,13,136,2,105
4643,696,802,102.44643990929706,104.62911564625851,15,15,142,2,106
4644,696,907,102.44643990929706,103.81641723356009,15,12,219,1,211
4645,696,873,102.44643990929706,104.51301587301587,15,18,198,2,177
4646,619,218,102.4928798185941,104.4433560090703,10,38,410,2,401
4647,619,218,102.4928798185941,104.51301587301587,10,36,410,2,401
4648,619,508,102.4928798185941,104.4433560090703,10,20,139,2,111
4649,619,436,102.4928798185941,105.13995464852609,10,20,216,3,183
4650,619,801,102.4928798185941,104.46657596371882,10,13,201,2,182
4651,619,802,102.4928798185941,104.62911564625851,10,15,205,2,183
4652,619,907,102.4928798185941,103.81641723356009,10,12,294,1,288
4653,619,873,102.4928798185941,104.51301587301587,10,18,268,2,254
4654,801,489,104.46657596371882,106.11519274376417,13,24,320,2,312
4655,801,439,104.46657596371882,107.18331065759638,13,23,380,3,362
4656,801,630,104.46657596371882,106.11519274376417,13,15,185,2,171
4657,801,656,104.46657596371882,107.27619047619048,13,12,189,3,145
4658,801,873,104.46657596371882,105.85977324263038,13,15,94,1,72
4659,801,878,104.46657596371882,107.2065306122449,13,17,141,3,77
4660,802,489,104.62911564625851,106.11519274376417,15,24,319,1,313
4661,802,439,104.62911564625851,107.18331065759638,15,23,379,3,363
4662,802,630,104.62911564625851,106.11519274376417,15,15,184,1,172
4663,802,656,104.62911564625851,107.27619047619048,15,12,185,3,146
4664,802,873,104.62911564625851,105.85977324263038,15,15,89,1,71
4665,802,878,104.62911564625851,107.2065306122449,15,17,135,3,76
4666,630,219,106.11519274376417,107.299410430839,15,37,414,1,411
4667,630,229,106.11519274376417,108.32108843537415,15,31,412,2,401
4668,630,439,106.11519274376417,107.18331065759638,15,23,196,1,191
4669,630,427,106.11519274376417,107.85668934240363,15,21,216,2,203
4670,630,656,106.11519274376417,107.27619047619048,15,12,56,1,26
4671,630,668,106.11519274376417,108.39074829931972,15,12,105,2,38
4672,630,878,106.11519274376417,107.2065306122449,15,17,252,1,248
4673,630,907,106.11519274376417,107.85668934240363,15,12,287,2,277
4674,630,873,106.11519274376417,108.55328798185941,15,14,265,2,243
4675,656,229,107.27619047619048,108.32108843537415,12,31,429,1,427
4676,656,206,107.27619047619048,109.48208616780046,12,23,460,2,450
4677,656,445,107.27619047619048,109.20344671201815,12,21,227,2,211
4678,656,425,107.27619047619048,109.90004535147392,12,18,257,3,231
4679,656,668,107.27619047619048,108.39074829931972,12,12,49,1,12
4680,656,752,107.27619047619048,109.20344671201815,12,10,127,2,96
4681,656,873,107.27619047619048,108.55328798185941,12,14,224,1,217
4682,656,872,107.27619047619048,109.90004535147392,12,16,244,3,216
4683,668,206,108.39074829931972,109.48208616780046,12,23,464,1,462
4684,668,267,108.39074829931972,110.50376417233561,12,17,411,2,401
4685,668,260,108.39074829931972,111.08426303854876,12,29,424,3,408
4686,668,425,108.39074829931972,109.90004535147392,12,18,252,2,243
4687,668,427,108.39074829931972,110.55020408163266,12,20,258,2,241
4688,668,617,108.39074829931972,110.66630385487528,12,12,110,2,51
4689,668,872,108.39074829931972,109.90004535147392,12,16,214,2,204
4690,668,879,108.39074829931972,111.24680272108844,12,17,244,3,211
4691,752,267,109.20344671201815,110.50376417233561,10,17,488,1,485
4692,752,260,109.20344671201815,111.08426303854876,10,29,499,2,492
4693,752,427,109.20344671201815,110.55020408163266,10,20,330,1,325
4694,752,427,109.20344671201815,111.89696145124717,10,21,345,3,325
4695,752,617,109.20344671201815,110.66630385487528,10,12,149,1,135
4696,752,879,109.20344671201815,111.24680272108844,10,17,155,2,127
4697,752,907,109.20344671201815,111.89696145124717,10,12,194,3,155
4698,617,231,110.66630385487528,112.47746031746031,12,35,394,2,386
4699,617,261,110.66630385487528,112.52390022675738,12,33,365,2,356
4700,617,427,110.66630385487528,111.89696145124717,12,21,197,1,190
4701,617,445,110.66630385487528,113.24371882086169,12,22,205,3,172
4702,617,755,110.66630385487528,112.50068027210885,12,16,159,2,138
4703,617,644,110.66630385487528,112.7328798185941,12,15,93,2,27
4704,617,907,110.66630385487528,111.89696145124717,12,12,295,1,290
4705,617,879,110.66630385487528,112.59356009070295,12,16,275,2,262
4706,755,414,112.50068027210885,113.94031746031746,16,16,347,1,341
4707,755,428,112.50068027210885,114.5904761904762,16,20,339,2,327
4708,755,744,112.50068027210885,115.14775510204082,16,15,115,3,11
4709,755,878,112.50068027210885,113.94031746031746,16,16,138,1,123
4710,755,878,112.50068027210885,115.28707482993198,16,15,172,3,123
4711,644,245,112.7328798185941,114.49759637188208,15,22,406,2,399
4712,644,214,112.7328798185941,114.91555555555556,15,31,440,2,430
4713,644,414,112.7328798185941,113.94031746031746,15,16,236,1,230
4714,644,428,112.7328798185941,114.5904761904762,15,20,230,2,216
4715,644,744,112.7328798185941,115.14775510204082,15,15,144,2,100
4716,644,878,112.7328798185941,113.94031746031746,15,16,240,1,234
4717,644,878,112.7328798185941,115.28707482993198,15,15,259,3,234
4718,744,255,115.14775510204082,117.8877097505669,15,29,503,3,489
4719,744,428,115.14775510204082,117.28399092970521,15,21,329,2,316
4720,744,486,115.14775510204082,117.60907029478459,15,23,279,2,258
4721,744,617,115.14775510204082,117.37687074829932,15,17,159,2,127
4722,744,684,115.14775510204082,117.58585034013606,15,19,121,2,60
4723,744,873,115.14775510204082,116.65705215419501,15,15,144,2,129
4724,744,873,115.14775510204082,118.00380952380952,15,16,178,3,129
4725,617,230,117.37687074829932,118.97904761904762,17,34,393,2,387
4726,617,205,117.37687074829932,119.58276643990929,17,24,423,2,412
4727,617,445,117.37687074829932,118.63074829931973,17,20,180,1,172
4728,617,445,117.37687074829932,119.97750566893424,17,21,205,3,172
4729,617,802,117.37687074829932,119.00226757369614,17,11,198,2,185
4730,617,724,117.37687074829932,120.00072562358277,17,10,156,3,107
4731,617,873,117.37687074829932,119.35056689342404,17,16,270,2,256
4732,617,906,117.37687074829932,119.97750566893424,17,11,310,3,289
4733,684,230,117.58585034013606,118.97904761904762,19,34,458,1,454
4734,684,205,117.58585034013606,119.58276643990929,19,24,487,2,479
4735,684,445,117.58585034013606,118.63074829931973,19,20,243,1,239
4736,684,445,117.58585034013606,119.97750566893424,19,21,260,2,239
4737,684,802,117.58585034013606,119.00226757369614,19,11,133,1,118
4738,684,724,117.58585034013606,120.00072562358277,19,10,111,2,40
4739,684,873,117.58585034013606,119.35056689342404,19,16,204,2,189
4740,684,906,117.58585034013606,119.97750566893424,19,11,245,2,222
4741,802,428,119.00226757369614,121.32426303854875,11,20,387,2,374
4742,802,419,119.00226757369614,121.64934240362813,11,26,400,3,383
4743,802,703,119.00226757369614,121.39392290249434,11,19,143,2,99
4744,802,651,119.00226757369614,121.76544217687075,11,15,192,3,151
4745,802,873,119.00226757369614,120.69732426303855,11,16,102,2,71
4746,802,842,119.00226757369614,121.78866213151927,11,17,126,3,40
4747,724,258,120.00072562358277,121.64934240362813,10,27,471,2,466
4748,724,428,120.00072562358277,121.32426303854875,10,20,301,1,296
4749,724,419,120.00072562358277,121.64934240362813,10,26,313,2,305
4750,724,529,120.00072562358277,122.71746031746032,10,22,227,3,195
4751,724,703,120.00072562358277,121.39392290249434,10,19,64,1,21
4752,724,651,120.00072562358277,121.76544217687075,10,15,105,2,73
4753,724,646,120.00072562358277,122.74068027210885,10,16,141,3,78
4754,724,842,120.00072562358277,121.78866213151927,10,17,141,2,118
4755,703,275,121.39392290249434,123.34439909297052,19,26,436,2,428
4756,703,271,121.39392290249434,123.62303854875283,19,28,443,2,432
4757,703,529,121.39392290249434,122.71746031746032,19,22,183,1,174
4758,703,445,121.39392290249434,124.0409977324263,19,20,282,3,258
4759,703,646,121.39392290249434,122.74068027210885,19,16,81,1,57
4760,703,654,121.39392290249434,123.57659863945578,19,9,106,2,49
4761,703,873,121.39392290249434,123.39083900226758,19,16,191,2,170
4762,703,907,121.39392290249434,124.0409977324263,19,10,234,3,204
4763,651,275,121.76544217687075,123.34439909297052,15,26,382,2,376
4764,651,271,121.76544217687075,123.62303854875283,15,28,388,2,380
4765,651,445,121.76544217687075,124.0409977324263,15,20,228,2,206
4766,651,654,121.76544217687075,123.57659863945578,15,9,78,2,3
4767,651,873,121.76544217687075,123.39083900226758,15,16,233,2,222
4768,651,907,121.76544217687075,124.0409977324263,15,10,274,2,256
4769,651,873,121.76544217687075,124.73759637188209,15,16,256,3,222
4770,646,304,122.74068027210885,125.57351473922903,16,19,363,3,342
4771,646,445,122.74068027210885,124.0409977324263,16,20,209,1,201
4772,646,428,122.74068027210885,125.38775510204081,16,20,246,3,218
4773,646,673,122.74068027210885,125.38775510204081,16,12,117,3,27
4774,646,907,122.74068027210885,124.0409977324263,16,10,267,1,261
4775,646,873,122.74068027210885,124.73759637188209,16,16,243,2,227
4776,654,304,123.57659863945578,125.57351473922903,9,19,360,2,350
4777,654,284,123.57659863945578,126.40943310657596,9,25,390,3,370
4778,654,428,123.57659863945578,125.38775510204081,9,20,239,2,226
4779,654,444,123.57659863945578,126.06113378684807,9,19,236,2,210
4780,654,673,123.57659863945578,125.38775510204081,9,12,80,2,19
4781,654,676,123.57659863945578,126.06113378684807,9,11,109,2,22
4782,654,873,123.57659863945578,124.73759637188209,9,16,225,1,219
4783,654,873,123.57659863945578,126.0843537414966,9,16,244,3,219
4784,673,284,125.38775510204081,126.40943310657596,12,25,391,1,389
4785,673,214,125.38775510204081,126.80417233560091,12,23,463,1,459
4786,673,304,125.38775510204081,128.05804988662132,12,21,387,3,369
4787,673,445,125.38775510204081,126.73451247165534,12,19,235,1,228
4788,673,427,125.38775510204081,128.08126984126986,12,20,272,3,246
4789,673,789,125.38775510204081,128.1277097505669,12,11,165,3,116
4790,673,873,125.38775510204081,127.43111111111111,12,15,219,2,200
4791,673,907,125.38775510204081,128.08126984126986,12,12,261,3,234
4792,676,304,126.06113378684807,128.05804988662132,11,21,382,2,372
4793,676,427,126.06113378684807,128.08126984126986,11,20,264,2,249
4794,676,673,126.06113378684807,127.40789115646258,11,10,58,1,3
4795,676,789,126.06113378684807,128.1277097505669,11,11,144,2,113
4796,676,873,126.06113378684807,127.43111111111111,11,15,206,1,197
4797,676,907,126.06113378684807,128.08126984126986,11,12,247,2,231
4798,676,874,126.06113378684807,128.77786848072563,11,15,230,3,198
4799,673,277,127.40789115646258,129.12616780045352,10,21,403,2,396
4800,673,206,127.40789115646258,130.2871655328798,10,22,483,3,467
4801,673,427,127.40789115646258,129.42802721088435,10,21,261,2,246
4802,673,445,127.40789115646258,130.12462585034015,10,19,256,3,228
4803,673,615,127.40789115646258,129.07972789115647,10,9,92,2,58
4804,673,874,127.40789115646258,128.77786848072563,10,15,209,1,201
4805,673,873,127.40789115646258,130.12462585034015,10,16,232,3,200
4806,789,427,128.1277097505669,129.42802721088435,11,21,366,1,362
4807,789,445,128.1277097505669,130.12462585034015,11,19,355,2,344
4808,789,427,128.1277097505669,130.77478458049887,11,20,380,3,362
4809,789,873,128.1277097505669,130.12462585034015,11,16,120,2,84
4810,615,206,129.07972789115647,130.2871655328798,9,22,412,1,409
4811,615,206,129.07972789115647,130.84444444444443,9,23,416,2,409
4812,615,445,129.07972789115647,130.12462585034015,9,19,176,1,170
4813,615,427,129.07972789115647,130.77478458049887,9,20,202,2,188
4814,615,873,129.07972789115647,130.12462585034015,9,16,262,1,258
4815,615,872,129.07972789115647,131.47138321995465,9,16,277,2,257
4816,625,214,135.20979591836735,136.2314739229025,13,36,413,1,411
4817,625,289,135.20979591836735,136.71909297052156,13,29,342,2,336
4818,625,278,135.20979591836735,138.04263038548754,13,28,368,3,347
4819,625,606,135.20979591836735,136.34757369614513,13,22,53,1,19
4820,625,445,135.20979591836735,137.50857142857143,13,20,205,2,180
4821,625,502,135.20979591836735,137.7407709750567,13,19,164,3,123
4822,625,676,135.20979591836735,136.34757369614513,13,17,71,1,51
4823,625,615,135.20979591836735,136.83519274376417,13,13,71,2,10
4824,625,670,135.20979591836735,137.7407709750567,13,15,118,3,45
4825,625,873,135.20979591836735,136.88163265306122,13,16,258,2,248
4826,676,278,136.34757369614513,138.04263038548754,17,28,405,2,398
4827,676,445,136.34757369614513,137.50857142857143,17,20,236,1,231
4828,676,502,136.34757369614513,137.7407709750567,17,19,184,1,174
4829,676,427,136.34757369614513,138.85532879818595,17,20,271,3,249
4830,676,670,136.34757369614513,137.7407709750567,17,15,60,1,6
4831,676,619,136.34757369614513,138.8321088435374,17,14,121,2,57
4832,676,879,136.34757369614513,138.2051700680272,17,16,218,2,203
4833,615,278,136.83519274376417,138.04263038548754,13,28,341,1,337
4834,615,205,136.83519274376417,139.48226757369613,13,33,426,3,410
4835,615,243,136.83519274376417,139.784126984127,13,31,393,3,372
4836,615,427,136.83519274376417,138.85532879818595,13,20,207,2,188
4837,615,619,136.83519274376417,138.8321088435374,13,14,86,2,4
4838,615,879,136.83519274376417,138.2051700680272,13,16,271,1,264
4839,615,878,136.83519274376417,139.55192743764172,13,16,288,3,263
4840,670,205,137.7407709750567,139.48226757369613,15,33,471,2,465
4841,670,243,137.7407709750567,139.784126984127,15,31,436,2,427
4842,670,427,137.7407709750567,138.85532879818595,15,20,248,1,243
4843,670,427,137.7407709750567,140.20208616780045,15,20,265,2,243
4844,670,619,137.7407709750567,138.8321088435374,15,14,69,1,51
4845,670,773,137.7407709750567,140.08598639455784,15,15,144,2,103
4846,670,878,137.7407709750567,139.55192743764172,15,16,222,2,208
4847,670,906,137.7407709750567,140.20208616780045,15,11,259,2,236
4848,619,290,138.8321088435374,140.82902494331066,14,28,340,2,329
4849,619,388,138.8321088435374,141.68816326530612,14,23,262,3,231
4850,619,427,138.8321088435374,140.20208616780045,14,20,201,1,192
4851,619,486,138.8321088435374,141.54884353741497,14,22,177,3,133
4852,619,773,138.8321088435374,140.08598639455784,14,15,163,1,154
4853,619,636,138.8321088435374,140.9451247165533,14,16,93,2,17
4854,619,906,138.8321088435374,140.20208616780045,14,11,293,1,287
4855,619,878,138.8321088435374,140.89868480725625,14,15,274,2,259
4856,773,388,140.08598639455784,141.68816326530612,15,23,391,2,385
4857,773,486,140.08598639455784,141.54884353741497,15,22,294,1,287
4858,773,489,140.08598639455784,141.87392290249434,15,20,294,2,284
4859,773,437,140.08598639455784,142.8956009070295,15,19,357,3,336
4860,773,633,140.08598639455784,142.15256235827664,15,11,166,2,140
4861,773,873,140.08598639455784,142.26866213151928,15,15,137,2,100
4862,636,221,140.9451247165533,143.10458049886623,16,26,425,2,415
4863,636,437,140.9451247165533,142.8956009070295,16,19,216,2,199
4864,636,633,140.9451247165533,142.15256235827664,16,11,52,1,3
4865,636,658,140.9451247165533,143.6154195011338,16,9,117,3,22
4866,636,873,140.9451247165533,142.26866213151928,16,15,244,1,237
4867,636,878,140.9451247165533,143.6154195011338,16,15,268,3,242
4868,633,277,142.15256235827664,144.28879818594103,11,27,368,2,356
4869,633,427,142.15256235827664,144.26557823129252,11,20,225,2,206
4870,633,658,142.15256235827664,143.6154195011338,11,9,68,1,25
4871,633,878,142.15256235827664,143.6154195011338,11,15,253,1,245
4872,633,907,142.15256235827664,144.26557823129252,11,11,289,2,274
4873,633,878,142.15256235827664,144.9621768707483,11,16,273,3,245
4874,658,265,143.6154195011338,145.6587755102041,9,23,403,2,393
4875,658,271,143.6154195011338,146.14639455782313,9,24,402,3,387
4876,658,427,143.6154195011338,145.61233560090704,9,20,246,2,231
4877,658,444,143.6154195011338,146.28571428571428,9,18,243,3,214
4878,658,622,143.6154195011338,145.42657596371882,9,10,86,2,36
4879,658,806,143.6154195011338,146.05351473922903,9,13,181,2,148
4880,658,878,143.6154195011338,144.9621768707483,9,16,228,1,220
4881,658,873,143.6154195011338,146.30893424036282,9,16,244,3,215
4882,622,280,145.42657596371882,147.12163265306123,10,29,350,2,342
4883,622,596,145.42657596371882,146.8197732426304,10,21,65,1,26
4884,622,445,145.42657596371882,148.30585034013606,10,20,216,3,177
4885,622,615,145.42657596371882,147.6324716553288,10,13,95,2,7
4886,622,878,145.42657596371882,147.65569160997734,10,15,273,2,256
4887,806,445,146.05351473922903,148.30585034013606,13,20,374,2,361
4888,806,615,146.05351473922903,147.6324716553288,13,13,203,2,191
4889,806,652,146.05351473922903,148.5380498866213,13,22,188,2,154
4890,806,615,146.05351473922903,148.88634920634922,13,17,227,3,191
4891,806,878,146.05351473922903,147.65569160997734,13,15,100,2,72
4892,806,929,146.05351473922903,148.5380498866213,13,15,163,2,123
4893,806,873,146.05351473922903,149.00244897959183,13,16,144,3,67
4894,615,274,147.6324716553288,148.97922902494332,13,27,346,1,341
4895,615,205,147.6324716553288,150.51174603174604,13,38,428,3,410
4896,615,410,147.6324716553288,149.69904761904763,13,23,223,2,205
4897,615,410,147.6324716553288,150.27954648526077,13,24,235,3,205
4898,615,616,147.6324716553288,150.465306122449,13,28,122,3,1
4899,615,873,147.6324716553288,149.00244897959183,13,16,265,1,258
4900,615,820,147.6324716553288,150.27954648526077,13,20,235,3,205
4901,652,205,148.5380498866213,150.51174603174604,22,38,455,2,447
4902,652,276,148.5380498866213,150.99936507936508,22,26,391,2,376
4903,652,410,148.5380498866213,149.69904761904763,22,23,247,1,242
4904,652,410,148.5380498866213,150.27954648526077,22,24,253,2,242
4905,652,427,148.5380498866213,150.99936507936508,22,21,249,2,225
4906,652,616,148.5380498866213,150.465306122449,22,28,90,2,36
4907,652,689,148.5380498866213,151.02258503401362,22,16,113,2,37
4908,652,820,148.5380498866213,150.27954648526077,22,20,184,2,168
4909,615,205,148.88634920634922,150.51174603174604,17,38,416,2,410
4910,615,276,148.88634920634922,150.99936507936508,17,26,351,2,339
4911,615,410,148.88634920634922,150.27954648526077,17,24,214,1,205
4912,615,427,148.88634920634922,150.99936507936508,17,21,209,2,188
4913,615,616,148.88634920634922,150.465306122449,17,28,68,2,1
4914,615,689,148.88634920634922,151.02258503401362,17,16,118,2,74
4915,615,729,148.88634920634922,151.78884353741498,17,17,169,3,114
4916,615,820,148.88634920634922,150.27954648526077,17,20,214,1,205
4917,615,873,148.88634920634922,151.69596371882088,17,15,285,3,258
4918,615,874,148.88634920634922,151.7191836734694,17,14,286,3,259
4919,616,244,150.465306122449,152.23002267573696,28,24,380,2,372
4920,616,427,150.465306122449,152.3461224489796,28,21,206,2,189
4921,616,729,150.465306122449,151.78884353741498,28,17,127,1,113
4922,616,673,150.465306122449,153.0659410430839,28,9,126,3,57
4923,616,873,150.465306122449,151.69596371882088,28,15,262,1,257
4924,616,874,150.465306122449,151.7191836734694,28,14,264,1,258
4925,616,872,150.465306122449,153.04272108843537,28,16,279,3,256
4926,689,244,151.02258503401362,152.23002267573696,16,24,448,1,445
4927,689,228,151.02258503401362,153.6928798185941,16,23,475,3,461
4928,689,220,151.02258503401362,153.97151927437642,16,22,486,3,469
4929,689,427,151.02258503401362,152.3461224489796,16,21,268,1,262
4930,689,445,151.02258503401362,153.6928798185941,16,20,270,3,244
4931,689,673,151.02258503401362,153.0659410430839,16,9,89,2,16
4932,689,872,151.02258503401362,153.04272108843537,16,16,203,2,183
4933,689,851,151.02258503401362,153.73931972789117,16,11,200,3,162
4934,729,445,151.78884353741498,153.6928798185941,17,20,296,2,284
4935,729,463,151.78884353741498,154.2037188208617,17,13,286,2,266
4936,729,673,151.78884353741498,153.0659410430839,17,9,78,1,56
4937,729,654,151.78884353741498,154.18049886621316,17,16,127,2,75
4938,729,872,151.78884353741498,153.04272108843537,17,16,153,1,143
4939,729,851,151.78884353741498,153.73931972789117,17,11,148,2,122
4940,673,216,153.0659410430839,155.50403628117914,9,23,469,2,457
4941,673,463,153.0659410430839,154.2037188208617,9,13,216,1,210
4942,673,489,153.0659410430839,154.99319727891157,9,11,202,2,184
4943,673,654,153.0659410430839,154.18049886621316,9,16,52,1,19
4944,654,216,154.18049886621316,155.50403628117914,16,23,442,1,438
4945,654,213,154.18049886621316,156.4560544217687,16,27,452,2,441
4946,654,435,154.18049886621316,156.38639455782314,16,18,239,2,219
4947,654,618,154.18049886621316,156.38639455782314,16,16,102,2,36
4948,654,723,154.18049886621316,157.0829931972789,16,9,143,3,69
4949,654,943,154.18049886621316,156.38639455782314,16,11,304,2,289
4950,654,872,154.18049886621316,157.0829931972789,16,16,251,3,218
4951,618,247,156.38639455782314,157.73315192743763,16,19,376,1,371
4952,618,218,156.38639455782314,158.499410430839,16,36,410,2,400
4953,618,219,156.38639455782314,159.17278911564625,16,22,417,3,399
4954,618,428,156.38639455782314,157.73315192743763,16,20,199,1,190
4955,618,427,156.38639455782314,157.75637188208617,16,18,200,1,191
4956,618,436,156.38639455782314,159.07990929705215,16,22,216,3,182
4957,618,802,156.38639455782314,158.56907029478458,16,14,207,2,184
4958,618,878,156.38639455782314,158.42975056689343,16,14,274,2,260
4959,618,906,156.38639455782314,159.07990929705215,16,11,310,3,288
4960,723,436,157.0829931972789,159.07990929705215,9,22,300,2,287
4961,723,531,157.0829931972789,160.0319274376417,9,23,230,3,192
4962,723,802,157.0829931972789,158.56907029478458,9,14,102,1,79
4963,723,630,157.0829931972789,160.0319274376417,9,15,157,3,93
4964,723,878,157.0829931972789,158.42975056689343,9,14,165,1,155
4965,723,906,157.0829931972789,159.07990929705215,9,11,202,2,183
4966,723,873,157.0829931972789,159.79972789115646,9,15,190,3,150
4967,802,311,158.56907029478458,160.42666666666668,14,21,497,2,491
4968,802,531,158.56907029478458,160.0319274376417,14,23,278,1,271
4969,802,437,158.56907029478458,161.21614512471655,14,20,382,3,365
4970,802,630,158.56907029478458,160.0319274376417,14,15,183,1,172
4971,802,621,158.56907029478458,161.12326530612245,14,13,212,3,181
4972,802,873,158.56907029478458,159.79972789115646,14,15,89,1,71
4973,802,873,158.56907029478458,161.146485260771,14,16,132,3,71
4974,630,219,160.0319274376417,161.10004535147394,15,35,414,1,411
4975,630,230,160.0319274376417,162.28426303854874,15,32,412,2,400
4976,630,206,160.0319274376417,162.8647619047619,15,23,441,3,424
4977,630,437,160.0319274376417,161.21614512471655,15,20,200,1,193
4978,630,428,160.0319274376417,161.77342403628117,15,20,215,2,202
4979,630,621,160.0319274376417,161.12326530612245,15,13,48,1,9
4980,630,669,160.0319274376417,162.30748299319728,15,11,105,2,39
4981,630,873,160.0319274376417,161.146485260771,15,16,248,1,243
4982,630,873,160.0319274376417,162.49324263038548,15,15,265,2,243
4983,621,230,161.12326530612245,162.28426303854874,13,32,394,1,391
4984,621,206,161.12326530612245,162.8647619047619,13,23,422,2,415
4985,621,445,161.12326530612245,163.1201814058957,13,20,196,2,176
4986,621,669,161.12326530612245,162.30748299319728,13,11,70,1,48
4987,621,752,161.12326530612245,163.14340136054423,13,10,157,2,131
4988,621,873,161.12326530612245,162.49324263038548,13,15,259,1,252
4989,621,907,161.12326530612245,163.14340136054423,13,12,299,2,286
4990,621,873,161.12326530612245,163.84,13,15,278,3,252
4991,669,205,162.30748299319728,164.58303854875282,11,21,474,2,464
4992,669,261,162.30748299319728,165.0009977324263,11,29,424,3,408
4993,669,428,162.30748299319728,164.46693877551022,11,19,258,2,241
4994,669,425,162.30748299319728,165.18675736961453,11,17,274,3,244
4995,669,616,162.30748299319728,164.60625850340136,11,9,112,2,53
4996,669,629,162.30748299319728,165.18675736961453,11,11,130,3,40
4997,669,873,162.30748299319728,163.84,11,15,214,2,204
4998,669,873,162.30748299319728,165.18675736961453,11,16,239,3,204
4999,752,261,163.14340136054423,165.0009977324263,10,29,497,2,491
5000,752,428,163.14340136054423,164.46693877551022,10,19,329,1,324
5001,752,425,163.14340136054423,165.18675736961453,10,17,339,2,327
5002,752,445,163.14340136054423,165.83691609977325,10,20,328,3,307
5003,752,616,163.14340136054423,164.60625850340136,10,9,150,1,136
5004,752,629,163.14340136054423,165.18675736961453,10,11,151,2,123
5005,752,873,163.14340136054423,165.18675736961453,10,16,150,2,121
5006,616,263,164.60625850340136,166.37097505668933,9,36,361,2,353
5007,616,216,164.60625850340136,166.92825396825398,9,24,412,2,400
5008,616,445,164.60625850340136,165.83691609977325,9,20,179,1,171
5009,616,445,164.60625850340136,167.18367346938777,9,20,204,3,171
5010,616,756,164.60625850340136,166.44063492063492,9,15,161,2,140
5011,616,675,164.60625850340136,167.46231292517007,9,11,136,3,59
5012,616,872,164.60625850340136,166.53351473922902,9,16,269,2,256
5013,616,907,164.60625850340136,167.16045351473923,9,13,311,3,291
5014,629,263,165.18675736961453,166.37097505668933,11,36,370,1,366
5015,629,216,165.18675736961453,166.92825396825398,11,24,420,2,413
5016,629,445,165.18675736961453,167.18367346938777,11,20,203,2,184
5017,629,756,165.18675736961453,166.44063492063492,11,15,138,1,127
5018,629,675,165.18675736961453,167.46231292517007,11,11,108,2,46
5019,629,872,165.18675736961453,166.53351473922902,11,16,250,1,243
5020,629,907,165.18675736961453,167.16045351473923,11,13,291,2,278
5021,629,873,165.18675736961453,167.88027210884354,11,16,270,3,244
5022,756,427,166.44063492063492,168.53043083900226,15,21,341,2,329
5023,756,414,166.44063492063492,169.22702947845806,15,17,362,3,342
5024,756,675,166.44063492063492,167.46231292517007,15,11,92,1,81
5025,756,615,166.44063492063492,168.50721088435375,15,15,167,2,141
5026,756,619,166.44063492063492,169.0877097505669,15,22,178,3,137
5027,756,873,166.44063492063492,167.88027210884354,15,16,132,1,117
5028,756,872,166.44063492063492,169.22702947845806,15,19,167,3,116
5029,675,242,167.46231292517007,168.78585034013605,11,27,437,1,433
5030,675,243,167.46231292517007,168.8090702947846,11,27,436,1,432
5031,675,427,167.46231292517007,168.53043083900226,11,21,252,1,248
5032,675,414,167.46231292517007,169.22702947845806,11,17,272,2,261
5033,675,445,167.46231292517007,169.8771882086168,11,21,252,2,230
5034,675,615,167.46231292517007,168.50721088435375,11,15,75,1,60
5035,675,619,167.46231292517007,169.0877097505669,11,22,90,2,56
5036,675,872,167.46231292517007,169.22702947845806,11,19,211,2,197
5037,675,961,167.46231292517007,170.08616780045352,11,17,308,3,286
5038,615,276,168.50721088435375,170.5273469387755,15,33,350,2,339
5039,615,260,168.50721088435375,171.08462585034013,15,27,372,3,355
5040,615,445,168.50721088435375,169.8771882086168,15,21,180,1,170
5041,615,783,168.50721088435375,170.48090702947846,15,13,188,2,168
5042,615,961,168.50721088435375,170.08616780045352,15,17,353,2,346
5043,615,844,168.50721088435375,171.4793650793651,15,13,262,3,229
5044,619,276,169.0877097505669,170.5273469387755,22,33,349,1,343
5045,619,260,169.0877097505669,171.08462585034013,22,27,369,2,359
5046,619,518,169.0877097505669,171.52580498866214,22,24,146,2,101
5047,619,783,169.0877097505669,170.48090702947846,22,13,175,1,164
5048,619,680,169.0877097505669,171.5025850340136,22,15,121,2,61
5049,619,844,169.0877097505669,171.4793650793651,22,13,247,2,225
5050,619,872,169.0877097505669,171.92054421768708,22,17,281,3,253
5051,783,518,170.48090702947846,171.52580498866214,13,24,269,1,265
5052,783,445,170.48090702947846,172.5707029478458,13,21,350,2,338
5053,783,461,170.48090702947846,173.2673015873016,13,17,344,3,322
5054,783,680,170.48090702947846,171.5025850340136,13,15,112,1,103
5055,783,620,170.48090702947846,172.40816326530611,13,15,183,2,163
5056,783,615,170.48090702947846,172.8261224489796,13,16,196,2,168
5057,783,872,170.48090702947846,171.92054421768708,13,17,108,1,89
5058,783,878,170.48090702947846,173.2673015873016,13,15,153,3,95
5059,680,276,171.5025850340136,172.80290249433108,15,35,408,1,404
5060,680,276,171.5025850340136,172.8261224489796,15,34,408,1,404
5061,680,206,171.5025850340136,174.03356009070296,15,22,486,3,474
5062,680,445,171.5025850340136,172.5707029478458,15,21,239,1,235
5063,680,461,171.5025850340136,173.2673015873016,15,17,232,2,219
5064,680,445,171.5025850340136,173.91746031746032,15,21,257,2,235
5065,680,615,171.5025850340136,172.8261224489796,15,16,86,1,65
5066,680,673,171.5025850340136,173.91746031746032,15,10,104,2,7
5067,680,878,171.5025850340136,173.2673015873016,15,15,212,2,198
5068,620,206,172.40816326530611,174.03356009070296,15,22,420,2,414
5069,620,445,172.40816326530611,173.91746031746032,15,21,187,2,175
5070,620,673,172.40816326530611,173.91746031746032,15,10,84,2,53
5071,620,694,172.40816326530611,175.3338775510204,15,18,146,3,74
5072,620,878,172.40816326530611,174.6140589569161,15,16,275,2,258
5073,615,206,172.8261224489796,174.03356009070296,16,22,412,1,409
5074,615,404,172.8261224489796,175.51963718820863,16,26,241,3,211
5075,615,445,172.8261224489796,173.91746031746032,16,21,176,1,170
5076,615,419,172.8261224489796,175.5892970521542,16,25,229,3,196
5077,615,673,172.8261224489796,173.91746031746032,16,10,75,1,58
5078,615,694,172.8261224489796,175.3338775510204,16,18,134,3,79
5079,615,878,172.8261224489796,174.6140589569161,16,16,274,2,263
5080,615,842,172.8261224489796,175.72861678004534,16,17,259,3,227
5081,673,404,173.91746031746032,175.51963718820863,10,26,278,2,269
5082,673,215,173.91746031746032,176.2162358276644,10,25,469,2,458
5083,673,419,173.91746031746032,175.5892970521542,10,25,264,2,254
5084,673,462,173.91746031746032,176.70385487528344,10,22,243,3,211
5085,673,694,173.91746031746032,175.3338775510204,10,18,65,1,21
5086,673,842,173.91746031746032,175.72861678004534,10,17,186,2,169
5087,673,879,173.91746031746032,175.96081632653062,10,16,224,2,206
5088,694,271,175.3338775510204,177.56299319727893,18,28,434,2,423
5089,694,217,175.3338775510204,178.1899319727891,18,24,493,3,477
5090,694,462,175.3338775510204,176.70385487528344,18,22,239,1,232
5091,694,489,175.3338775510204,177.05215419501135,18,20,218,2,205
5092,694,427,175.3338775510204,177.95773242630386,18,20,290,3,267
5093,694,673,175.3338775510204,176.70385487528344,18,15,63,1,21
5094,694,714,175.3338775510204,177.16825396825396,18,13,81,2,20
5095,694,878,175.3338775510204,177.30757369614514,18,16,203,2,184
5096,673,217,176.70385487528344,178.1899319727891,15,24,460,1,456
5097,673,304,176.70385487528344,179.30448979591836,15,22,386,3,369
5098,673,427,176.70385487528344,177.95773242630386,15,20,252,1,246
5099,673,446,176.70385487528344,179.30448979591836,15,21,253,3,227
5100,673,674,176.70385487528344,179.3277097505669,15,12,113,3,1
5101,673,878,176.70385487528344,178.65433106575964,15,15,222,2,205
5102,673,866,176.70385487528344,179.30448979591836,15,11,223,3,193
5103,714,217,177.16825396825396,178.1899319727891,13,24,499,1,497
5104,714,304,177.16825396825396,179.30448979591836,13,22,420,2,410
5105,714,446,177.16825396825396,179.30448979591836,13,21,283,2,268
5106,714,674,177.16825396825396,179.3277097505669,13,12,101,2,40
5107,714,676,177.16825396825396,180.00108843537416,13,10,128,3,38
5108,714,878,177.16825396825396,178.65433106575964,13,15,176,1,164
5109,714,866,177.16825396825396,179.30448979591836,13,11,178,2,152
5110,714,873,177.16825396825396,180.02430839002267,13,15,201,3,159
5111,674,214,179.3277097505669,180.72090702947847,12,22,464,1,460
5112,674,228,179.3277097505669,181.06920634920635,12,18,452,2,446
5113,674,304,179.3277097505669,181.97478458049886,12,21,387,3,370
5114,674,445,179.3277097505669,180.65124716553288,12,20,236,1,229
5115,674,443,179.3277097505669,181.34784580498868,12,19,247,2,231
5116,674,428,179.3277097505669,181.9980045351474,12,20,272,3,246
5117,674,692,179.3277097505669,182.0212244897959,12,12,117,3,18
5118,674,873,179.3277097505669,181.3710657596372,12,15,218,2,199
5119,676,228,180.00108843537416,181.06920634920635,10,18,450,1,448
5120,676,304,180.00108843537416,181.97478458049886,10,21,382,2,372
5121,676,443,180.00108843537416,181.34784580498868,10,19,240,1,233
5122,676,428,180.00108843537416,181.9980045351474,10,20,262,2,248
5123,676,692,180.00108843537416,182.0212244897959,10,12,88,2,16
5124,676,873,180.00108843537416,181.3710657596372,10,15,206,1,197
5125,676,873,180.00108843537416,182.7178231292517,10,16,229,3,197
5126,692,205,182.0212244897959,183.76272108843537,12,20,493,2,487
5127,692,206,182.0212244897959,184.761179138322,12,23,500,3,486
5128,692,206,182.0212244897959,184.9469387755102,12,21,502,3,486
5129,692,427,182.0212244897959,183.36798185941043,12,20,271,1,265
5130,692,445,182.0212244897959,184.71473922902496,12,20,273,3,247
5131,692,796,182.0212244897959,183.04290249433106,12,9,113,1,104
5132,692,907,182.0212244897959,183.36798185941043,12,11,223,1,215
5133,692,873,182.0212244897959,184.0645804988662,12,15,201,2,181
5134,796,445,183.04290249433106,184.71473922902496,9,20,358,2,351
5135,796,444,183.04290249433106,185.3881179138322,9,17,366,2,352
5136,796,873,183.04290249433106,184.0645804988662,9,15,89,1,77
5137,796,873,183.04290249433106,185.41133786848073,9,16,128,2,77
5138,617,246,186.45623582766441,188.03519274376418,9,28,377,2,371
5139,617,308,186.45623582766441,189.33551020408163,9,22,333,3,309
5140,617,548,186.45623582766441,187.50113378684807,9,22,82,1,69
5141,617,427,186.45623582766441,188.7550113378685,9,20,214,2,190
5142,617,465,186.45623582766441,189.26585034013607,9,15,194,3,152
5143,617,618,186.45623582766441,187.50113378684807,9,14,45,1,1
5144,617,758,186.45623582766441,189.26585034013607,9,17,186,3,141
5145,617,878,186.45623582766441,188.10485260770974,9,15,270,2,261
5146,618,308,187.50113378684807,189.33551020408163,14,22,320,2,310
5147,618,427,187.50113378684807,188.7550113378685,14,20,198,1,191
5148,618,465,187.50113378684807,189.26585034013607,14,15,171,2,153
5149,618,758,187.50113378684807,189.26585034013607,14,17,159,2,140
5150,873,446,0.6965986394557824,2.670294784580499,15,19,435,2,427
5151,873,444,0.6965986394557824,3.3668934240362813,15,18,444,3,429
5152,873,672,0.6965986394557824,2.716734693877551,15,15,219,2,201
5153,873,878,0.6965986394557824,2.043356009070295,15,15,58,1,5
5154,907,446,1.3467573696145125,2.670294784580499,10,19,465,1,461
5155,907,444,1.3467573696145125,3.3668934240362813,10,18,471,2,463
5156,907,427,1.3467573696145125,4.040272108843538,10,20,494,3,480
5157,907,672,1.3467573696145125,2.716734693877551,10,15,242,1,235
5158,907,672,1.3467573696145125,4.063492063492063,10,10,263,3,235
5159,907,873,1.3467573696145125,3.3901133786848074,10,16,94,2,34
5160,878,444,2.043356009070295,3.3668934240362813,15,18,438,1,434
5161,878,427,2.043356009070295,4.040272108843538,15,20,459,2,451
5162,878,672,2.043356009070295,4.063492063492063,15,10,224,2,206
5163,878,873,2.043356009070295,3.3901133786848074,15,16,58,1,5
5164,878,873,2.043356009070295,4.73687074829932,15,16,116,3,5
5165,873,427,3.3901133786848074,5.38702947845805,16,22,454,2,446
5166,873,536,3.3901133786848074,6.362267573696145,16,21,360,3,337
5167,873,638,3.3901133786848074,6.292607709750567,16,19,266,3,235
5168,873,921,3.3901133786848074,5.38702947845805,16,10,98,2,48
5169,873,536,4.73687074829932,6.362267573696145,16,21,344,2,337
5170,873,414,4.73687074829932,7.430385487528345,16,17,473,3,459
5171,873,638,4.73687074829932,6.292607709750567,16,19,244,2,235
5172,873,622,4.73687074829932,7.198185941043084,16,9,272,2,251
5173,921,531,5.38702947845805,8.150204081632653,10,23,408,3,390
5174,921,622,5.38702947845805,7.198185941043084,10,9,309,2,299
5175,921,622,5.38702947845805,8.150204081632653,10,16,322,3,299
5176,921,873,5.38702947845805,7.430385487528345,10,17,100,2,48
5177,873,414,6.0836281179138325,7.430385487528345,15,17,463,1,459
5178,873,531,6.0836281179138325,8.150204081632653,15,23,353,2,342
5179,873,622,6.0836281179138325,7.198185941043084,15,9,256,1,251
5180,873,622,6.0836281179138325,8.150204081632653,15,16,266,2,251
5181,873,872,6.0836281179138325,8.777142857142858,15,15,116,3,1
5182,873,445,7.430385487528345,9.427301587301587,17,20,437,2,428
5183,873,872,7.430385487528345,8.777142857142858,17,15,58,1,1
5184,873,907,7.430385487528345,9.427301587301587,17,13,92,2,34
5185,873,872,7.430385487528345,10.12390022675737,17,15,116,3,1
5186,872,395,8.777142857142858,10.95981859410431,15,23,486,2,477
5187,872,505,8.777142857142858,10.95981859410431,15,26,379,2,367
5188,872,443,8.777142857142858,11.470657596371883,15,18,444,3,429
5189,872,620,8.777142857142858,11.00625850340136,15,20,270,2,252
5190,872,616,8.777142857142858,11.052698412698414,15,15,274,2,256
5191,872,878,8.777142857142858,11.470657596371883,15,16,116,3,6
5192,907,505,9.427301587301587,10.95981859410431,13,26,407,2,402
5193,907,443,9.427301587301587,11.470657596371883,13,18,472,2,464
5194,907,427,9.427301587301587,12.120816326530612,13,20,494,3,480
5195,907,620,9.427301587301587,11.00625850340136,13,20,295,2,287
5196,907,616,9.427301587301587,11.052698412698414,13,15,299,2,291
5197,907,724,9.427301587301587,12.120816326530612,13,9,217,3,183
5198,907,878,9.427301587301587,11.470657596371883,13,16,93,2,29
5199,872,443,10.12390022675737,11.470657596371883,15,18,433,1,429
5200,872,427,10.12390022675737,12.120816326530612,15,20,453,2,445
5201,872,724,10.12390022675737,12.120816326530612,15,9,171,2,148
5202,872,878,10.12390022675737,11.470657596371883,15,16,58,1,6
5203,872,878,10.12390022675737,12.817414965986394,15,15,116,3,6
5204,878,541,11.470657596371883,13.467573696145125,16,23,348,2,337
5205,878,713,11.470657596371883,13.444353741496599,16,19,186,2,165
5206,878,784,11.470657596371883,14.164172335600908,16,9,149,3,94
5207,878,865,11.470657596371883,13.467573696145125,16,14,87,2,13
5208,878,873,11.470657596371883,14.164172335600908,16,16,116,3,5
5209,878,436,12.817414965986394,14.814331065759637,15,20,450,2,442
5210,878,443,12.817414965986394,15.51092970521542,15,18,450,3,435
5211,878,784,12.817414965986394,14.164172335600908,15,9,110,1,94
5212,878,629,12.817414965986394,15.534149659863946,15,10,275,3,249
5213,878,873,12.817414965986394,14.164172335600908,15,16,58,1,5
5214,865,436,13.467573696145125,14.814331065759637,14,20,433,1,429
5215,865,443,13.467573696145125,15.51092970521542,14,18,431,2,422
5216,865,427,13.467573696145125,16.16108843537415,14,21,453,3,438
5217,865,629,13.467573696145125,15.534149659863946,14,10,252,2,236
5218,865,617,13.467573696145125,16.207528344671204,14,11,275,3,248
5219,865,878,13.467573696145125,15.51092970521542,14,16,89,2,13
5220,873,443,14.164172335600908,15.51092970521542,16,18,434,1,430
5221,873,427,14.164172335600908,16.16108843537415,16,21,454,2,446
5222,873,629,14.164172335600908,15.534149659863946,16,10,251,1,244
5223,873,617,14.164172335600908,16.207528344671204,16,11,271,2,256
5224,873,639,14.164172335600908,17.136326530612244,16,17,267,3,234
5225,873,878,14.164172335600908,15.51092970521542,16,16,58,1,5
5226,873,878,14.164172335600908,16.857687074829933,16,15,116,3,5
5227,878,436,15.51092970521542,17.507845804988662,16,21,450,2,442
5228,878,639,15.51092970521542,17.136326530612244,16,17,249,2,239
5229,878,921,15.51092970521542,17.507845804988662,16,11,96,2,43
5230,878,873,15.51092970521542,18.22766439909297,16,16,117,3,5
5231,878,416,16.857687074829933,18.784943310657596,15,24,469,2,462
5232,878,612,16.857687074829933,19.388662131519276,15,19,287,3,266
5233,878,620,16.857687074829933,19.017142857142858,15,19,274,2,258
5234,878,617,16.857687074829933,19.458321995464853,15,21,284,3,261
5235,878,873,16.857687074829933,18.22766439909297,15,16,59,1,5
5236,878,873,16.857687074829933,19.574421768707484,15,16,117,3,5
5237,921,612,17.507845804988662,19.388662131519276,11,19,319,2,309
5238,921,445,17.507845804988662,20.20136054421769,11,21,490,3,476
5239,921,620,17.507845804988662,19.017142857142858,11,19,308,2,301
5240,921,617,17.507845804988662,19.458321995464853,11,21,315,2,304
5241,921,873,17.507845804988662,19.574421768707484,11,16,101,2,48
5242,873,612,18.22766439909297,19.388662131519276,16,19,266,1,261
5243,873,445,18.22766439909297,20.20136054421769,16,21,436,2,428
5244,873,617,18.22766439909297,19.458321995464853,16,21,261,1,256
5245,873,428,19.574421768707484,21.5481179138322,16,20,453,2,445
5246,873,638,19.574421768707484,21.989297052154196,16,13,257,2,235
5247,873,644,19.574421768707484,22.105396825396827,16,10,254,3,229
5248,873,907,19.574421768707484,21.571337868480725,16,11,92,2,34
5249,873,427,20.921179138321996,22.918095238095237,16,20,454,2,446
5250,873,444,20.921179138321996,23.591473922902495,16,18,444,3,429
5251,873,638,20.921179138321996,21.989297052154196,16,13,239,1,235
5252,873,644,20.921179138321996,22.105396825396827,16,10,235,1,229
5253,907,427,21.571337868480725,22.918095238095237,11,20,483,1,480
5254,907,444,21.571337868480725,23.591473922902495,11,18,471,2,463
5255,907,489,21.571337868480725,24.264852607709752,11,23,434,3,418
5256,907,715,21.571337868480725,24.241632653061224,11,18,224,3,192
5257,907,873,21.571337868480725,23.61469387755102,11,16,94,2,34
5258,907,911,21.571337868480725,24.264852607709752,11,20,116,3,4
5259,873,444,22.267936507936508,23.591473922902495,15,18,433,1,429
5260,873,489,22.267936507936508,24.264852607709752,15,23,394,2,384
5261,873,715,22.267936507936508,24.241632653061224,15,18,179,2,158
5262,873,911,22.267936507936508,24.264852607709752,15,20,94,2,38
5263,873,427,23.61469387755102,25.611609977324264,16,20,454,2,446
5264,873,629,23.61469387755102,26.33142857142857,16,9,271,3,244
5265,873,907,23.61469387755102,25.611609977324264,16,11,92,2,34
5266,911,427,24.264852607709752,25.611609977324264,20,20,487,1,484
5267,911,427,24.264852607709752,26.958367346938775,20,20,498,3,484
5268,911,629,24.264852607709752,26.33142857142857,20,9,296,2,282
5269,911,907,24.264852607709752,25.611609977324264,20,11,58,1,4
5270,911,873,24.264852607709752,26.308208616780046,20,16,96,2,38
5271,907,427,25.611609977324264,26.958367346938775,11,20,483,1,480
5272,907,443,25.611609977324264,27.654965986394558,11,17,472,2,464
5273,907,784,25.611609977324264,28.35156462585034,11,10,170,3,123
5274,907,878,25.611609977324264,27.654965986394558,11,15,93,2,29
5275,873,443,26.308208616780046,27.654965986394558,16,17,434,1,430
5276,873,422,26.308208616780046,28.93206349206349,16,24,465,3,451
5277,873,784,26.308208616780046,28.35156462585034,16,10,125,2,89
5278,873,878,26.308208616780046,27.654965986394558,16,15,58,1,5
5279,878,422,27.654965986394558,28.93206349206349,15,24,459,1,456
5280,878,427,27.654965986394558,29.651882086167802,15,20,459,2,451
5281,878,630,27.654965986394558,30.046621315192745,15,15,269,2,248
5282,878,873,27.654965986394558,29.00172335600907,15,16,58,1,5
5283,878,855,27.654965986394558,29.559002267573696,15,11,85,2,23
5284,873,436,29.00172335600907,30.998639455782314,16,21,445,2,437
5285,873,443,29.00172335600907,31.695238095238096,16,18,445,3,430
5286,873,630,29.00172335600907,30.046621315192745,16,15,247,1,243
5287,873,631,29.00172335600907,30.78965986394558,16,16,254,2,242
5288,873,878,29.00172335600907,30.348480725623585,16,14,58,1,5
5289,873,872,29.00172335600907,31.695238095238096,16,15,116,3,1
5290,855,436,29.559002267573696,30.998639455782314,11,21,424,1,419
5291,855,443,29.559002267573696,31.695238095238096,11,18,422,2,412
5292,855,427,29.559002267573696,32.345396825396826,11,21,445,3,428
5293,855,631,29.559002267573696,30.78965986394558,11,16,230,1,224
5294,855,872,29.559002267573696,31.695238095238096,11,15,94,2,17
5295,878,443,30.348480725623585,31.695238095238096,14,18,439,1,435
5296,878,427,30.348480725623585,32.345396825396826,14,21,459,2,451
5297,878,619,30.348480725623585,32.786575963718825,14,21,279,2,259
5298,878,872,30.348480725623585,31.695238095238096,14,15,58,1,6
5299,872,445,31.695238095238096,33.69215419501134,15,21,436,2,427
5300,872,619,31.695238095238096,32.786575963718825,15,21,257,1,253
5301,872,635,31.695238095238096,33.552834467120185,15,17,250,2,237
5302,872,878,31.695238095238096,33.04199546485261,15,15,58,1,6
5303,872,907,31.695238095238096,33.69215419501134,15,11,93,2,35
5304,878,462,33.04199546485261,34.89959183673469,15,21,424,2,416
5305,878,432,33.04199546485261,35.20145124716554,15,24,456,2,446
5306,878,808,33.04199546485261,35.48009070294785,15,11,126,2,70
5307,878,872,33.04199546485261,34.38875283446712,15,16,58,1,6
5308,878,957,33.04199546485261,35.48009070294785,15,9,131,2,79
5309,907,462,33.69215419501134,34.89959183673469,11,21,448,1,445
5310,907,432,33.69215419501134,35.20145124716554,11,24,479,2,475
5311,907,808,33.69215419501134,35.48009070294785,11,11,125,2,99
5312,907,957,33.69215419501134,35.48009070294785,11,9,92,2,50
5313,872,808,34.38875283446712,35.48009070294785,16,11,79,1,64
5314,872,957,34.38875283446712,35.48009070294785,16,9,97,1,85
5315,957,619,35.48009070294785,37.755646258503404,9,15,352,2,338
5316,957,943,35.48009070294785,37.73242630385488,9,12,98,2,14
5317,957,873,35.48009070294785,38.45224489795918,9,15,153,3,84
5318,943,512,37.73242630385488,39.65968253968254,12,20,439,2,431
5319,943,672,37.73242630385488,39.10240362811791,12,12,277,1,271
5320,943,802,37.73242630385488,39.91510204081633,12,16,169,2,141
5321,943,874,37.73242630385488,39.7990022675737,12,15,113,2,69
5322,873,512,38.45224489795918,39.65968253968254,15,20,365,1,361
5323,873,428,38.45224489795918,40.4259410430839,15,20,453,2,445
5324,873,489,38.45224489795918,41.40117913832199,15,25,404,3,384
5325,873,802,38.45224489795918,39.91510204081633,15,16,95,1,71
5326,873,660,38.45224489795918,41.40117913832199,15,15,248,3,213
5327,873,874,38.45224489795918,39.7990022675737,15,15,58,1,1
5328,873,854,38.45224489795918,41.40117913832199,15,11,128,3,19
5329,874,489,39.7990022675737,41.40117913832199,15,25,391,2,385
5330,874,660,39.7990022675737,41.40117913832199,15,15,225,2,214
5331,874,621,39.7990022675737,42.4692970521542,15,12,278,3,253
5332,874,873,39.7990022675737,41.145759637188206,15,15,58,1,1
5333,874,854,39.7990022675737,41.40117913832199,15,11,72,2,20
5334,874,873,39.7990022675737,42.49251700680272,15,17,116,3,1
5335,873,427,41.145759637188206,43.14267573696145,15,20,454,2,446
5336,873,425,41.145759637188206,43.83927437641724,15,17,463,3,448
5337,873,621,41.145759637188206,42.4692970521542,15,12,258,1,252
5338,873,668,41.145759637188206,43.67673469387755,15,12,232,3,205
5339,854,427,41.40117913832199,43.14267573696145,11,20,434,2,427
5340,854,425,41.40117913832199,43.83927437641724,11,17,442,2,429
5341,854,621,41.40117913832199,42.4692970521542,11,12,237,1,233
5342,854,668,41.40117913832199,43.67673469387755,11,12,210,2,186
5343,854,873,41.40117913832199,42.49251700680272,11,17,51,1,19
5344,854,873,41.40117913832199,43.83927437641724,11,16,107,2,19
5345,873,425,42.49251700680272,43.83927437641724,17,17,452,1,448
5346,873,427,42.49251700680272,44.489433106575966,17,20,454,2,446
5347,873,668,42.49251700680272,43.67673469387755,17,12,211,1,205
5348,873,752,42.49251700680272,44.489433106575966,17,10,148,2,121
5349,873,872,42.49251700680272,45.186031746031745,17,16,116,3,1
5350,873,438,43.83927437641724,45.81297052154195,16,20,443,2,435
5351,873,617,43.83927437641724,45.952290249433105,16,12,272,2,256
5352,873,872,43.83927437641724,45.186031746031745,16,16,58,1,1
5353,873,907,43.83927437641724,45.836190476190474,16,12,92,2,34
5354,873,878,43.83927437641724,46.53278911564626,16,18,116,3,5
5355,872,427,45.186031746031745,47.18294784580499,16,21,453,2,445
5356,872,444,45.186031746031745,47.85632653061224,16,17,443,3,428
5357,872,633,45.186031746031745,47.09006802721088,16,10,253,2,239
5358,872,755,45.186031746031745,47.78666666666667,16,16,162,3,117
5359,872,878,45.186031746031745,46.53278911564626,16,18,58,1,6
5360,872,878,45.186031746031745,47.879546485260775,16,17,116,3,6
5361,907,427,45.836190476190474,47.18294784580499,12,21,483,1,480
5362,907,444,45.836190476190474,47.85632653061224,12,17,471,2,463
5363,907,427,45.836190476190474,48.529705215419504,12,20,494,3,480
5364,907,633,45.836190476190474,47.09006802721088,12,10,279,1,274
5365,907,755,45.836190476190474,47.78666666666667,12,16,174,2,152
5366,907,700,45.836190476190474,48.50648526077098,12,11,237,3,207
5367,907,878,45.836190476190474,47.879546485260775,12,17,93,2,29
5368,878,444,46.53278911564626,47.85632653061224,18,17,438,1,434
5369,878,427,46.53278911564626,48.529705215419504,18,20,459,2,451
5370,878,755,46.53278911564626,47.78666666666667,18,16,134,1,123
5371,878,700,46.53278911564626,48.50648526077098,18,11,197,2,178
5372,878,911,46.53278911564626,49.20308390022676,18,12,120,3,33
5373,878,445,47.879546485260775,49.87646258503401,17,21,441,2,433
5374,878,673,47.879546485260775,49.89968253968254,17,10,223,2,205
5375,878,743,47.879546485260775,50.43374149659864,17,16,174,3,135
5376,878,911,47.879546485260775,49.20308390022676,17,12,66,1,33
5377,878,872,47.879546485260775,50.5730612244898,17,16,116,3,6
5378,911,445,49.20308390022676,51.22321995464853,12,21,474,2,466
5379,911,556,49.20308390022676,51.24643990929705,12,19,366,2,355
5380,911,743,49.20308390022676,50.43374149659864,12,16,176,1,168
5381,911,673,49.20308390022676,51.89659863945578,12,11,265,3,238
5382,911,872,49.20308390022676,50.5730612244898,12,16,71,1,39
5383,911,878,49.20308390022676,51.919818594104306,12,15,122,3,33
5384,878,445,49.22630385487528,51.22321995464853,16,21,441,2,433
5385,878,556,49.22630385487528,51.24643990929705,16,19,334,2,322
5386,878,743,49.22630385487528,50.43374149659864,16,16,145,1,135
5387,878,673,49.22630385487528,51.89659863945578,16,11,235,3,205
5388,878,872,49.22630385487528,50.5730612244898,16,16,58,1,6
5389,872,486,50.5730612244898,52.895056689342404,16,22,399,2,386
5390,872,673,50.5730612244898,51.89659863945578,16,11,207,1,199
5391,872,684,50.5730612244898,52.848616780045354,16,20,212,2,188
5392,872,878,50.5730612244898,51.919818594104306,16,15,58,1,6
5393,872,849,50.5730612244898,52.895056689342404,16,13,103,2,23
5394,878,445,51.919818594104306,53.91673469387755,15,21,441,2,433
5395,878,543,51.919818594104306,54.61333333333334,15,18,355,3,335
5396,878,807,51.919818594104306,54.218594104308394,15,10,122,2,71
5397,878,673,51.919818594104306,54.61333333333334,15,12,236,3,205
5398,878,872,51.919818594104306,53.26657596371882,15,16,58,1,6
5399,849,445,52.895056689342404,53.91673469387755,13,21,406,1,404
5400,849,543,52.895056689342404,54.61333333333334,13,18,315,2,306
5401,849,427,52.895056689342404,55.263492063492066,13,22,434,2,422
5402,849,807,52.895056689342404,54.218594104308394,13,10,71,1,42
5403,849,673,52.895056689342404,54.61333333333334,13,12,191,2,176
5404,849,878,52.895056689342404,54.61333333333334,13,14,79,2,29
5405,872,543,53.26657596371882,54.61333333333334,16,18,334,1,329
5406,872,427,53.26657596371882,55.263492063492066,16,22,453,2,445
5407,872,673,53.26657596371882,54.61333333333334,16,12,207,1,199
5408,872,616,53.26657596371882,55.960090702947845,16,10,281,3,256
5409,872,878,53.26657596371882,54.61333333333334,16,14,58,1,6
5410,878,404,54.61333333333334,56.86566893424036,14,25,484,2,474
5411,878,419,54.61333333333334,56.93532879818594,14,24,470,2,459
5412,878,616,54.61333333333334,55.960090702947845,14,10,268,1,262
5413,878,622,54.61333333333334,56.65668934240363,14,20,271,2,256
5414,878,872,54.61333333333334,55.960090702947845,14,15,58,1,6
5415,878,842,54.61333333333334,57.0746485260771,14,19,112,2,36
5416,872,462,55.960090702947845,58.049886621315196,15,22,420,2,410
5417,872,561,55.960090702947845,58.42140589569161,15,18,329,2,311
5418,872,646,55.960090702947845,58.02666666666667,15,17,243,2,226
5419,872,697,55.960090702947845,58.42140589569161,15,14,205,2,175
5420,872,842,55.960090702947845,57.0746485260771,15,19,57,1,30
5421,872,878,55.960090702947845,57.30684807256236,15,16,58,1,6
5422,872,873,55.960090702947845,58.6768253968254,15,16,117,3,1
5423,842,561,57.0746485260771,58.42140589569161,19,18,287,1,281
5424,842,445,57.0746485260771,59.303764172335605,19,21,408,2,397
5425,842,697,57.0746485260771,58.42140589569161,19,14,156,1,145
5426,842,633,57.0746485260771,60.02358276643991,19,10,245,3,209
5427,842,873,57.0746485260771,58.6768253968254,19,16,76,2,31
5428,842,873,57.0746485260771,60.02358276643991,19,16,131,3,31
5429,878,561,57.30684807256236,58.42140589569161,16,18,321,1,317
5430,878,445,57.30684807256236,59.303764172335605,16,21,441,2,433
5431,878,697,57.30684807256236,58.42140589569161,16,14,187,1,181
5432,878,633,57.30684807256236,60.02358276643991,16,10,272,3,245
5433,878,873,57.30684807256236,58.6768253968254,16,16,59,1,5
5434,878,873,57.30684807256236,60.02358276643991,16,16,117,3,5
5435,873,446,58.6768253968254,60.65052154195011,16,20,435,2,427
5436,873,633,58.6768253968254,60.02358276643991,16,10,247,1,240
5437,873,670,58.6768253968254,60.65052154195011,16,12,220,2,203
5438,873,675,58.6768253968254,61.3471201814059,16,11,229,3,198
5439,873,907,58.6768253968254,60.67374149659864,16,11,92,2,34
5440,873,445,60.02358276643991,61.99727891156463,16,20,436,2,428
5441,873,443,60.02358276643991,62.69387755102041,16,19,445,3,430
5442,873,675,60.02358276643991,61.3471201814059,16,11,206,1,198
5443,907,445,60.67374149659864,61.99727891156463,11,20,466,1,462
5444,907,443,60.67374149659864,62.69387755102041,11,19,472,2,464
5445,907,445,60.67374149659864,63.36725623582767,11,20,476,3,462
5446,907,789,60.67374149659864,63.39047619047619,11,14,166,3,118
5447,907,873,60.67374149659864,62.71709750566894,11,16,94,2,34
5448,873,443,61.37034013605442,62.69387755102041,16,19,434,1,430
5449,873,445,61.37034013605442,63.36725623582767,16,20,437,2,428
5450,873,789,61.37034013605442,63.39047619047619,16,14,121,2,84
5451,873,427,62.71709750566894,64.71401360544218,16,20,454,2,446
5452,873,907,62.71709750566894,64.71401360544218,16,12,92,2,34
5453,873,427,64.06385487528345,66.06077097505668,16,20,454,2,446
5454,873,443,64.06385487528345,66.75736961451247,16,17,445,3,430
5455,873,616,64.06385487528345,66.73414965986395,16,9,282,3,257
5456,873,872,64.06385487528345,66.75736961451247,16,16,116,3,1
5457,907,427,64.71401360544218,66.06077097505668,12,20,483,1,480
5458,907,443,64.71401360544218,66.75736961451247,12,17,472,2,464
5459,907,427,64.71401360544218,67.4075283446712,12,21,494,3,480
5460,907,616,64.71401360544218,66.73414965986395,12,9,304,2,291
5461,907,872,64.71401360544218,66.75736961451247,12,16,95,2,35
5462,873,443,65.41061224489796,66.75736961451247,16,17,434,1,430
5463,873,427,65.41061224489796,67.4075283446712,16,21,454,2,446
5464,873,616,65.41061224489796,66.73414965986395,16,9,263,1,257
5465,873,872,65.41061224489796,66.75736961451247,16,16,58,1,1
5466,873,878,65.41061224489796,68.10412698412699,16,16,116,3,5
5467,872,427,66.75736961451247,68.75428571428571,16,21,453,2,445
5468,872,878,66.75736961451247,68.10412698412699,16,16,58,1,6
5469,872,907,66.75736961451247,68.75428571428571,16,11,93,2,35
5470,872,873,66.75736961451247,69.4508843537415,16,16,116,3,1
5471,878,427,68.10412698412699,70.10104308390022,16,21,459,2,451
5472,878,623,68.10412698412699,70.19392290249434,16,14,270,2,255
5473,878,623,68.10412698412699,70.4261224489796,16,19,274,2,255
5474,878,873,68.10412698412699,69.4508843537415,16,16,58,1,5
5475,907,427,68.75428571428571,70.10104308390022,11,21,483,1,480
5476,907,598,68.75428571428571,71.09950113378684,11,19,325,2,309
5477,907,623,68.75428571428571,70.19392290249434,11,14,291,1,284
5478,907,623,68.75428571428571,70.4261224489796,11,19,293,2,284
5479,907,878,68.75428571428571,70.79764172335601,11,16,93,2,29
5480,873,598,69.4508843537415,71.09950113378684,16,19,284,2,275
5481,873,574,69.4508843537415,71.95863945578232,16,24,318,3,299
5482,873,618,69.4508843537415,72.00507936507937,16,20,278,3,255
5483,873,878,69.4508843537415,70.79764172335601,16,16,58,1,5
5484,873,878,69.4508843537415,72.14439909297052,16,17,116,3,5
5485,878,574,70.79764172335601,71.95863945578232,16,24,308,1,304
5486,878,540,70.79764172335601,72.95709750566894,16,22,351,2,338
5487,878,618,70.79764172335601,72.00507936507937,16,20,265,1,260
5488,878,633,70.79764172335601,72.91065759637188,16,17,261,2,245
5489,878,741,70.79764172335601,73.42149659863945,16,16,178,3,137
5490,878,849,70.79764172335601,72.91065759637188,16,12,96,2,29
5491,878,873,70.79764172335601,73.49115646258504,16,15,116,3,5
5492,878,445,72.14439909297052,74.14131519274376,17,20,441,2,433
5493,878,444,72.14439909297052,74.83791383219955,17,18,449,3,434
5494,878,741,72.14439909297052,73.42149659863945,17,16,148,1,137
5495,878,873,72.14439909297052,73.49115646258504,17,15,58,1,5
5496,849,445,72.91065759637188,74.14131519274376,12,20,407,1,404
5497,849,444,72.91065759637188,74.83791383219955,12,18,413,2,405
5498,849,562,72.91065759637188,75.58095238095238,12,25,309,3,287
5499,849,623,72.91065759637188,75.53451247165533,12,22,253,3,226
5500,849,878,72.91065759637188,74.83791383219955,12,16,88,2,29
5501,873,381,73.49115646258504,76.34721088435374,15,22,507,3,492
5502,873,444,73.49115646258504,74.83791383219955,15,18,433,1,429
5503,873,562,73.49115646258504,75.58095238095238,15,25,324,2,311
5504,873,491,73.49115646258504,76.37043083900227,15,23,402,3,382
5505,873,623,73.49115646258504,75.53451247165533,15,22,265,2,250
5506,873,668,73.49115646258504,76.34721088435374,15,18,239,3,205
5507,873,878,73.49115646258504,74.83791383219955,15,16,58,1,5
5508,873,878,73.49115646258504,76.18467120181406,15,16,116,3,5
5509,873,936,73.49115646258504,76.34721088435374,15,11,138,3,63
5510,878,381,74.83791383219955,76.34721088435374,16,22,501,2,497
5511,878,491,74.83791383219955,76.37043083900227,16,23,393,2,387
5512,878,668,74.83791383219955,76.34721088435374,16,18,220,2,210
5513,878,936,74.83791383219955,76.34721088435374,16,11,87,2,58
5514,878,564,76.18467120181406,78.29768707482994,16,24,327,2,314
5515,878,559,76.18467120181406,78.36734693877551,16,23,333,2,319
5516,878,652,76.18467120181406,78.29768707482994,16,20,244,2,226
5517,878,628,76.18467120181406,78.36734693877551,16,18,267,2,250
5518,878,826,76.18467120181406,78.22802721088435,16,16,102,2,52
5519,878,873,76.18467120181406,78.90140589569161,16,16,117,3,5
5520,936,564,76.34721088435374,78.29768707482994,11,24,381,2,372
5521,936,559,76.34721088435374,78.36734693877551,11,23,387,2,377
5522,936,652,76.34721088435374,78.29768707482994,11,20,296,2,284
5523,936,628,76.34721088435374,78.36734693877551,11,18,320,2,308
5524,936,826,76.34721088435374,78.22802721088435,11,16,137,2,110
5525,936,873,76.34721088435374,78.90140589569161,11,16,127,3,63
5526,826,427,78.22802721088435,79.52834467120182,16,20,403,1,399
5527,826,427,78.22802721088435,80.87510204081633,16,20,415,3,399
5528,826,627,78.22802721088435,80.92154195011338,16,11,230,3,199
5529,826,873,78.22802721088435,80.24816326530612,16,15,99,2,47
5530,873,427,78.90140589569161,80.87510204081633,16,20,454,2,446
5531,873,627,78.90140589569161,80.92154195011338,16,11,261,2,246
5532,873,856,78.90140589569161,81.2930612244898,16,12,104,2,17
5533,873,421,80.24816326530612,82.0128798185941,15,22,458,2,452
5534,873,423,80.24816326530612,82.75591836734694,15,19,463,3,450
5535,873,632,80.24816326530612,82.0128798185941,15,14,253,2,241
5536,873,633,80.24816326530612,82.77913832199546,15,14,264,3,240
5537,873,856,80.24816326530612,81.2930612244898,15,12,48,1,17
5538,856,423,81.2930612244898,82.75591836734694,12,19,438,1,433
5539,856,533,81.2930612244898,83.56861678004535,12,23,338,2,323
5540,856,633,81.2930612244898,82.77913832199546,12,14,232,1,223
5541,856,767,81.2930612244898,83.49895691609977,12,18,130,2,89
5542,856,873,81.2930612244898,82.94167800453515,12,16,73,2,17
5543,873,423,81.59492063492064,82.75591836734694,15,19,453,1,450
5544,873,533,81.59492063492064,83.56861678004535,15,23,350,2,340
5545,873,633,81.59492063492064,82.77913832199546,15,14,245,1,240
5546,873,767,81.59492063492064,83.49895691609977,15,18,134,2,106
5547,873,872,81.59492063492064,84.28843537414966,15,16,116,3,1
5548,873,427,82.94167800453515,84.9385941043084,16,19,454,2,446
5549,873,872,82.94167800453515,84.28843537414966,16,16,58,1,1
5550,873,907,82.94167800453515,84.9385941043084,16,12,92,2,34
5551,872,427,84.28843537414966,86.2853514739229,16,20,453,2,445
5552,872,574,84.28843537414966,86.47111111111111,16,20,312,2,298
5553,872,617,84.28843537414966,86.14603174603175,16,12,267,2,255
5554,872,627,84.28843537414966,86.47111111111111,16,19,262,2,245
5555,872,873,84.28843537414966,85.63519274376418,16,16,58,1,1
5556,872,821,84.28843537414966,86.49433106575964,16,17,108,2,51
5557,907,427,84.9385941043084,86.2853514739229,12,20,483,1,480
5558,907,574,84.9385941043084,86.47111111111111,12,20,339,2,333
5559,907,445,84.9385941043084,87.63210884353742,12,20,476,3,462
5560,907,617,84.9385941043084,86.14603174603175,12,12,295,1,290
5561,907,627,84.9385941043084,86.47111111111111,12,19,288,2,280
5562,907,821,84.9385941043084,86.49433106575964,12,17,109,2,86
5563,873,445,85.63519274376418,87.63210884353742,16,20,437,2,428
5564,821,445,86.49433106575964,87.63210884353742,17,20,379,1,376
5565,821,427,86.49433106575964,88.97886621315193,17,20,408,2,394
5566,821,626,86.49433106575964,89.37360544217687,17,16,231,3,195
5567,821,873,86.49433106575964,88.3287074829932,17,17,95,2,52
5568,821,907,86.49433106575964,88.97886621315193,17,13,137,2,86
5569,873,427,88.3287074829932,90.32562358276644,17,20,454,2,446
5570,873,443,88.3287074829932,91.02222222222223,17,18,445,3,430
5571,873,626,88.3287074829932,89.37360544217687,17,16,251,1,247
5572,873,627,88.3287074829932,89.83800453514739,17,12,254,2,246
5573,873,878,88.3287074829932,91.02222222222223,17,16,116,3,5
5574,907,427,88.97886621315193,90.32562358276644,13,20,483,1,480
5575,907,443,88.97886621315193,91.02222222222223,13,18,472,2,464
5576,907,445,88.97886621315193,91.67238095238095,13,20,476,3,462
5577,907,878,88.97886621315193,91.02222222222223,13,16,93,2,29
5578,873,443,89.67546485260772,91.02222222222223,16,18,434,1,430
5579,873,445,89.67546485260772,91.67238095238095,16,20,437,2,428
5580,873,878,89.67546485260772,91.02222222222223,16,16,58,1,5
5581,873,878,89.67546485260772,92.36897959183673,16,16,116,3,5
5582,878,427,91.02222222222223,93.01913832199547,16,20,459,2,451
5583,878,422,91.02222222222223,93.64607709750567,16,23,470,3,456
5584,878,784,91.02222222222223,93.06557823129252,16,10,129,2,94
5585,878,921,91.02222222222223,93.01913832199547,16,12,96,2,43
5586,878,422,92.36897959183673,93.64607709750567,16,23,459,1,456
5587,878,410,92.36897959183673,94.59809523809524,16,25,478,2,468
5588,878,630,92.36897959183673,94.76063492063493,16,13,269,2,248
5589,921,436,93.01913832199547,95.71265306122449,12,20,499,3,485
5590,921,630,93.01913832199547,94.76063492063493,12,13,301,2,291
5591,921,631,93.01913832199547,95.50367346938776,12,16,309,2,290
5592,921,878,93.01913832199547,95.06249433106576,12,15,98,2,43
5593,878,436,93.71573696145126,95.71265306122449,16,20,450,2,442
5594,878,630,93.71573696145126,94.76063492063493,16,13,252,1,248
5595,878,631,93.71573696145126,95.50367346938776,16,16,259,2,247
5596,878,873,93.71573696145126,96.4324716553288,16,15,117,3,5
5597,878,445,95.06249433106576,97.05941043083901,15,20,441,2,433
5598,878,636,95.06249433106576,97.36126984126984,15,14,261,2,242
5599,878,619,95.06249433106576,97.500589569161,15,20,279,2,259
5600,878,873,95.06249433106576,96.4324716553288,15,15,59,1,5
5601,878,921,95.06249433106576,97.05941043083901,15,11,96,2,43
5602,878,879,95.06249433106576,97.75600907029478,15,15,116,3,1
5603,873,427,96.4324716553288,98.40616780045352,15,20,454,2,446
5604,873,443,96.4324716553288,99.1027664399093,15,17,445,3,430
5605,873,619,96.4324716553288,97.500589569161,15,20,258,1,254
5606,873,629,96.4324716553288,98.59192743764173,15,11,261,2,244
5607,873,879,96.4324716553288,97.75600907029478,15,15,57,1,6
5608,921,427,97.05941043083901,98.40616780045352,11,20,497,1,494
5609,921,443,97.05941043083901,99.1027664399093,11,17,486,2,478
5610,921,432,97.05941043083901,99.91546485260771,11,24,504,3,489
5611,921,629,97.05941043083901,98.59192743764173,11,11,299,2,292
5612,921,873,97.05941043083901,99.12598639455783,11,16,101,2,48
5613,921,907,97.05941043083901,99.75292517006802,11,10,117,3,14
5614,879,443,97.75600907029478,99.1027664399093,15,17,440,1,436
5615,879,432,97.75600907029478,99.91546485260771,15,24,457,2,447
5616,879,807,97.75600907029478,100.19410430839002,15,11,127,2,72
5617,879,873,97.75600907029478,99.12598639455783,15,16,59,1,6
5618,879,907,97.75600907029478,99.75292517006802,15,10,90,2,28
5619,873,807,99.12598639455783,100.19410430839002,16,11,80,1,66
5620,907,477,99.75292517006802,102.26068027210884,10,18,443,3,430
5621,907,696,99.75292517006802,102.44643990929706,10,15,241,3,211
5622,907,619,99.75292517006802,102.4928798185941,10,10,311,3,288
5623,907,943,99.75292517006802,102.44643990929706,10,11,121,3,36
5624,943,508,102.44643990929706,104.4433560090703,11,20,443,2,435
5625,943,801,102.44643990929706,104.46657596371882,11,13,167,2,142
5626,943,802,102.44643990929706,104.62911564625851,11,15,169,2,141
5627,943,907,102.44643990929706,103.81641723356009,11,12,69,1,36
5628,943,873,102.44643990929706,104.51301587301587,11,18,113,2,70
5629,873,508,103.16625850340137,104.4433560090703,16,20,369,1,365
5630,873,436,103.16625850340137,105.13995464852609,16,20,445,2,437
5631,873,489,103.16625850340137,106.11519274376417,16,24,404,3,384
5632,873,801,103.16625850340137,104.46657596371882,16,13,91,1,72
5633,873,802,103.16625850340137,104.62911564625851,16,15,95,1,71
5634,873,630,103.16625850340137,106.11519274376417,16,15,274,3,243
5635,907,436,103.81641723356009,105.13995464852609,12,20,474,1,471
5636,907,489,103.81641723356009,106.11519274376417,12,24,430,2,418
5637,907,630,103.81641723356009,106.11519274376417,12,15,294,2,277
5638,907,873,103.81641723356009,105.85977324263038,12,15,94,2,34
5639,873,489,104.51301587301587,106.11519274376417,18,24,390,2,384
5640,873,439,104.51301587301587,107.18331065759638,18,23,449,3,434
5641,873,630,104.51301587301587,106.11519274376417,18,15,253,2,243
5642,873,656,104.51301587301587,107.27619047619048,18,12,247,3,217
5643,873,878,104.51301587301587,107.2065306122449,18,17,116,3,5
5644,873,439,105.85977324263038,107.18331065759638,15,23,438,1,434
5645,873,427,105.85977324263038,107.85668934240363,15,21,454,2,446
5646,873,656,105.85977324263038,107.27619047619048,15,12,225,1,217
5647,873,668,105.85977324263038,108.39074829931972,15,12,232,3,205
5648,873,878,105.85977324263038,107.2065306122449,15,17,58,1,5
5649,873,907,105.85977324263038,107.85668934240363,15,12,92,2,34
5650,878,445,107.2065306122449,109.20344671201815,17,21,441,2,433
5651,878,425,107.2065306122449,109.90004535147392,17,18,468,3,453
5652,878,668,107.2065306122449,108.39074829931972,17,12,216,1,210
5653,878,752,107.2065306122449,109.20344671201815,17,10,153,2,126
5654,878,873,107.2065306122449,108.55328798185941,17,14,58,1,5
5655,878,872,107.2065306122449,109.90004535147392,17,16,116,3,6
5656,907,445,107.85668934240363,109.20344671201815,12,21,466,1,462
5657,907,425,107.85668934240363,109.90004535147392,12,18,490,2,482
5658,907,427,107.85668934240363,110.55020408163266,12,20,494,3,480
5659,907,752,107.85668934240363,109.20344671201815,12,10,165,1,155
5660,907,617,107.85668934240363,110.66630385487528,12,12,314,3,290
5661,907,872,107.85668934240363,109.90004535147392,12,16,95,2,35
5662,873,425,108.55328798185941,109.90004535147392,14,18,452,1,448
5663,873,427,108.55328798185941,110.55020408163266,14,20,454,2,446
5664,873,617,108.55328798185941,110.66630385487528,14,12,272,2,256
5665,873,872,108.55328798185941,109.90004535147392,14,16,58,1,1
5666,873,879,108.55328798185941,111.24680272108844,14,17,116,3,6
5667,872,427,109.90004535147392,111.89696145124717,16,21,453,2,445
5668,872,755,109.90004535147392,112.50068027210885,16,16,162,3,117
5669,872,644,109.90004535147392,112.7328798185941,16,15,259,3,228
5670,872,879,109.90004535147392,111.24680272108844,16,17,58,1,7
5671,872,907,109.90004535147392,111.89696145124717,16,12,93,2,35
5672,872,879,109.90004535147392,112.59356009070295,16,16,116,3,7
5673,879,445,111.24680272108844,113.24371882086169,17,22,442,2,434
5674,879,414,111.24680272108844,113.94031746031746,17,16,479,3,465
5675,879,755,111.24680272108844,112.50068027210885,17,16,135,1,124
5676,879,644,111.24680272108844,112.7328798185941,17,15,244,1,235
5677,879,878,111.24680272108844,113.94031746031746,17,16,116,3,1
5678,907,445,111.89696145124717,113.24371882086169,12,22,466,1,462
5679,907,414,111.89696145124717,113.94031746031746,12,16,501,2,493
5680,907,428,111.89696145124717,114.5904761904762,12,20,493,3,479
5681,907,878,111.89696145124717,113.94031746031746,12,16,93,2,29
5682,879,414,112.59356009070295,113.94031746031746,16,16,469,1,465
5683,879,428,112.59356009070295,114.5904761904762,16,20,459,2,451
5684,879,744,112.59356009070295,115.14775510204082,16,15,174,3,135
5685,879,878,112.59356009070295,113.94031746031746,16,16,58,1,1
5686,879,878,112.59356009070295,115.28707482993198,16,15,116,3,1
5687,878,436,113.94031746031746,115.9372335600907,16,21,450,2,442
5688,878,744,113.94031746031746,115.14775510204082,16,15,144,1,134
5689,878,907,113.94031746031746,115.9372335600907,16,11,91,2,29
5690,878,873,113.94031746031746,116.65705215419501,16,15,117,3,5
5691,878,428,115.28707482993198,117.28399092970521,15,21,458,2,450
5692,878,486,115.28707482993198,117.60907029478459,15,23,405,2,392
5693,878,617,115.28707482993198,117.37687074829932,15,17,276,2,261
5694,878,684,115.28707482993198,117.58585034013606,15,19,218,2,194
5695,878,873,115.28707482993198,116.65705215419501,15,15,59,1,5
5696,878,873,115.28707482993198,118.00380952380952,15,16,117,3,5
5697,907,428,115.9372335600907,117.28399092970521,11,21,482,1,479
5698,907,486,115.9372335600907,117.60907029478459,11,23,427,2,421
5699,907,445,115.9372335600907,118.63074829931973,11,20,476,3,462
5700,907,617,115.9372335600907,117.37687074829932,11,17,297,1,290
5701,907,684,115.9372335600907,117.58585034013606,11,19,234,2,223
5702,907,873,115.9372335600907,118.00380952380952,11,16,95,2,34
5703,873,445,116.65705215419501,118.63074829931973,15,20,436,2,428
5704,873,802,116.65705215419501,119.00226757369614,15,11,123,2,71
5705,873,445,118.00380952380952,119.97750566893424,16,21,436,2,428
5706,873,724,118.00380952380952,120.00072562358277,16,10,172,2,149
5707,873,906,118.00380952380952,119.97750566893424,16,11,91,2,33
5708,873,428,119.35056689342404,121.32426303854875,16,20,453,2,445
5709,873,419,119.35056689342404,121.64934240362813,16,26,465,2,454
5710,873,703,119.35056689342404,121.39392290249434,16,19,191,2,170
5711,873,651,119.35056689342404,121.76544217687075,16,15,245,2,222
5712,873,842,119.35056689342404,121.78866213151927,16,17,109,2,31
5713,906,428,119.97750566893424,121.32426303854875,11,20,482,1,478
5714,906,419,119.97750566893424,121.64934240362813,11,26,492,2,487
5715,906,529,119.97750566893424,122.71746031746032,11,22,395,3,377
5716,906,703,119.97750566893424,121.39392290249434,11,19,212,1,203
5717,906,651,119.97750566893424,121.76544217687075,11,15,266,2,255
5718,906,646,119.97750566893424,122.74068027210885,11,16,286,3,260
5719,906,842,119.97750566893424,121.78866213151927,11,17,101,2,64
5720,873,529,120.69732426303855,122.71746031746032,16,22,355,2,344
5721,873,651,120.69732426303855,121.76544217687075,16,15,227,1,222
5722,873,646,120.69732426303855,122.74068027210885,16,16,243,2,227
5723,873,654,120.69732426303855,123.57659863945578,16,9,252,3,219
5724,873,842,120.69732426303855,121.78866213151927,16,17,56,1,31
5725,842,445,121.78866213151927,124.0409977324263,17,20,409,2,397
5726,842,654,121.78866213151927,123.57659863945578,17,9,203,2,188
5727,842,873,121.78866213151927,123.39083900226758,17,16,76,2,31
5728,842,907,121.78866213151927,124.0409977324263,17,10,117,2,65
5729,842,873,121.78866213151927,124.73759637188209,17,16,131,3,31
5730,873,428,123.39083900226758,125.38775510204081,16,20,453,2,445
5731,873,444,123.39083900226758,126.06113378684807,16,19,444,3,429
5732,873,673,123.39083900226758,125.38775510204081,16,12,218,2,200
5733,873,676,123.39083900226758,126.06113378684807,16,11,228,3,197
5734,907,428,124.0409977324263,125.38775510204081,10,20,482,1,479
5735,907,444,124.0409977324263,126.06113378684807,10,19,471,2,463
5736,907,445,124.0409977324263,126.73451247165534,10,19,476,3,462
5737,907,673,124.0409977324263,125.38775510204081,10,12,241,1,234
5738,907,676,124.0409977324263,126.06113378684807,10,11,247,2,231
5739,907,873,124.0409977324263,126.0843537414966,10,16,94,2,34
5740,873,444,124.73759637188209,126.06113378684807,16,19,433,1,429
5741,873,445,124.73759637188209,126.73451247165534,16,19,437,2,428
5742,873,676,124.73759637188209,126.06113378684807,16,11,205,1,197
5743,873,673,124.73759637188209,127.40789115646258,16,10,231,3,200
5744,873,427,126.0843537414966,128.08126984126986,16,20,454,2,446
5745,873,673,126.0843537414966,127.40789115646258,16,10,208,1,200
5746,873,789,126.0843537414966,128.1277097505669,16,11,122,2,84
5747,873,907,126.0843537414966,128.08126984126986,16,12,92,2,34
5748,873,874,126.0843537414966,128.77786848072563,16,15,116,3,1
5749,873,427,127.43111111111111,129.42802721088435,15,21,454,2,446
5750,873,445,127.43111111111111,130.12462585034015,15,19,443,3,428
5751,873,615,127.43111111111111,129.07972789115647,15,9,268,2,258
5752,873,874,127.43111111111111,128.77786848072563,15,15,58,1,1
5753,907,427,128.08126984126986,129.42802721088435,12,21,483,1,480
5754,907,445,128.08126984126986,130.12462585034015,12,19,470,2,462
5755,907,427,128.08126984126986,130.77478458049887,12,20,494,3,480
5756,907,873,128.08126984126986,130.12462585034015,12,16,94,2,34
5757,874,445,128.77786848072563,130.12462585034015,15,19,433,1,429
5758,874,427,128.77786848072563,130.77478458049887,15,20,455,2,447
5759,874,873,128.77786848072563,130.12462585034015,15,16,58,1,1
5760,874,872,128.77786848072563,131.47138321995465,15,16,116,3,2
5761,873,427,130.12462585034015,132.12154195011337,16,20,454,2,446
5762,873,872,130.12462585034015,131.47138321995465,16,16,58,1,1
5763,873,907,130.12462585034015,132.12154195011337,16,11,92,2,34
5764,872,427,131.47138321995465,133.4682993197279,16,21,453,2,445
5765,872,443,131.47138321995465,134.16489795918366,16,18,444,3,429
5766,872,873,131.47138321995465,132.81814058956917,16,15,58,1,1
5767,872,878,131.47138321995465,134.16489795918366,16,16,116,3,6
5768,907,427,132.12154195011337,133.4682993197279,11,21,483,1,480
5769,907,443,132.12154195011337,134.16489795918366,11,18,472,2,464
5770,907,445,132.12154195011337,134.8150566893424,11,21,476,3,462
5771,907,878,132.12154195011337,134.16489795918366,11,16,93,2,29
5772,873,443,132.81814058956917,134.16489795918366,15,18,434,1,430
5773,873,445,132.81814058956917,134.8150566893424,15,21,437,2,428
5774,873,625,132.81814058956917,135.20979591836735,15,13,269,2,248
5775,873,878,132.81814058956917,134.16489795918366,15,16,58,1,5
5776,873,872,132.81814058956917,135.51165532879818,15,15,116,3,1
5777,873,849,132.81814058956917,135.6974149659864,15,16,126,3,24
5778,878,606,134.16489795918366,136.34757369614513,16,22,288,2,272
5779,878,625,134.16489795918366,135.20979591836735,16,13,257,1,253
5780,878,676,134.16489795918366,136.34757369614513,16,17,223,2,202
5781,878,615,134.16489795918366,136.83519274376417,16,13,287,3,263
5782,878,872,134.16489795918366,135.51165532879818,16,15,58,1,6
5783,878,849,134.16489795918366,135.6974149659864,16,16,72,2,29
5784,878,873,134.16489795918366,136.88163265306122,16,16,117,3,5
5785,872,445,135.51165532879818,137.50857142857143,15,20,436,2,427
5786,872,502,135.51165532879818,137.7407709750567,15,19,382,2,370
5787,872,615,135.51165532879818,136.83519274376417,15,13,263,1,257
5788,872,670,135.51165532879818,137.7407709750567,15,15,224,2,202
5789,872,873,135.51165532879818,136.88163265306122,15,16,59,1,1
5790,872,879,135.51165532879818,138.2051700680272,15,16,116,3,7
5791,849,445,135.6974149659864,137.50857142857143,16,20,411,2,404
5792,849,502,135.6974149659864,137.7407709750567,16,19,358,2,347
5793,849,615,135.6974149659864,136.83519274376417,16,13,239,1,234
5794,849,670,135.6974149659864,137.7407709750567,16,15,199,2,179
5795,849,873,135.6974149659864,136.88163265306122,16,16,56,1,24
5796,849,879,135.6974149659864,138.2051700680272,16,16,112,3,30
5797,873,427,136.88163265306122,138.85532879818595,16,20,454,2,446
5798,873,619,136.88163265306122,138.8321088435374,16,14,268,2,254
5799,873,879,136.88163265306122,138.2051700680272,16,16,57,1,6
5800,873,878,136.88163265306122,139.55192743764172,16,16,115,3,5
5801,879,427,138.2051700680272,140.20208616780045,16,20,460,2,452
5802,879,773,138.2051700680272,140.08598639455784,16,15,133,2,106
5803,879,636,138.2051700680272,140.9451247165533,16,16,270,3,243
5804,879,878,138.2051700680272,139.55192743764172,16,16,58,1,1
5805,879,906,138.2051700680272,140.20208616780045,16,11,90,2,27
5806,879,878,138.2051700680272,140.89868480725625,16,15,116,3,1
5807,878,388,139.55192743764172,141.68816326530612,16,23,499,2,490
5808,878,486,139.55192743764172,141.54884353741497,16,22,401,2,392
5809,878,489,139.55192743764172,141.87392290249434,16,20,402,2,389
5810,878,636,139.55192743764172,140.9451247165533,16,16,249,1,242
5811,878,633,139.55192743764172,142.15256235827664,16,11,269,3,245
5812,878,873,139.55192743764172,142.26866213151928,16,15,117,3,5
5813,906,486,140.20208616780045,141.54884353741497,11,22,424,1,420
5814,906,489,140.20208616780045,141.87392290249434,11,20,423,2,417
5815,906,437,140.20208616780045,142.8956009070295,11,19,483,3,469
5816,906,633,140.20208616780045,142.15256235827664,11,11,286,2,273
5817,906,873,140.20208616780045,142.26866213151928,11,15,95,2,33
5818,878,437,140.89868480725625,142.8956009070295,15,19,449,2,441
5819,878,633,140.89868480725625,142.15256235827664,15,11,251,1,245
5820,878,658,140.89868480725625,143.6154195011338,15,9,249,3,220
5821,878,873,140.89868480725625,142.26866213151928,15,15,59,1,5
5822,873,427,142.26866213151928,144.26557823129252,15,20,454,2,446
5823,873,658,142.26866213151928,143.6154195011338,15,9,223,1,215
5824,873,878,142.26866213151928,143.6154195011338,15,15,58,1,5
5825,873,907,142.26866213151928,144.26557823129252,15,11,92,2,34
5826,873,878,142.26866213151928,144.9621768707483,15,16,116,3,5
5827,878,427,143.6154195011338,145.61233560090704,15,20,459,2,451
5828,878,444,143.6154195011338,146.28571428571428,15,18,449,3,434
5829,878,622,143.6154195011338,145.42657596371882,15,10,268,2,256
5830,878,806,143.6154195011338,146.05351473922903,15,13,127,2,72
5831,878,873,143.6154195011338,146.30893424036282,15,16,116,3,5
5832,907,427,144.26557823129252,145.61233560090704,11,20,483,1,480
5833,907,444,144.26557823129252,146.28571428571428,11,18,471,2,463
5834,907,596,144.26557823129252,146.8197732426304,11,21,330,3,311
5835,907,622,144.26557823129252,145.42657596371882,11,10,289,1,285
5836,907,806,144.26557823129252,146.05351473922903,11,13,127,2,101
5837,907,873,144.26557823129252,146.30893424036282,11,16,94,2,34
5838,878,444,144.9621768707483,146.28571428571428,16,18,438,1,434
5839,878,596,144.9621768707483,146.8197732426304,16,21,293,2,282
5840,878,806,144.9621768707483,146.05351473922903,16,13,86,1,72
5841,878,615,144.9621768707483,147.6324716553288,16,13,287,3,263
5842,878,873,144.9621768707483,146.30893424036282,16,16,58,1,5
5843,873,445,146.30893424036282,148.30585034013606,16,20,437,2,428
5844,873,615,146.30893424036282,147.6324716553288,16,13,264,1,258
5845,873,652,146.30893424036282,148.5380498866213,16,22,241,2,221
5846,873,615,146.30893424036282,148.88634920634922,16,17,281,3,258
5847,873,878,146.30893424036282,147.65569160997734,16,15,58,1,5
5848,873,929,146.30893424036282,148.5380498866213,16,15,111,2,56
5849,878,410,147.65569160997734,149.69904761904763,15,23,476,2,468
5850,878,410,147.65569160997734,150.27954648526077,15,24,481,3,468
5851,878,615,147.65569160997734,148.88634920634922,15,17,268,1,263
5852,878,616,147.65569160997734,150.465306122449,15,28,289,3,262
5853,878,873,147.65569160997734,149.00244897959183,15,16,58,1,5
5854,878,820,147.65569160997734,150.27954648526077,15,20,127,3,58
5855,929,616,148.5380498866213,150.465306122449,15,28,324,2,313
5856,929,689,148.5380498866213,151.02258503401362,15,16,263,2,240
5857,929,820,148.5380498866213,150.27954648526077,15,20,132,2,109
5858,873,410,149.00244897959183,150.27954648526077,16,24,466,1,463
5859,873,427,149.00244897959183,150.99936507936508,16,21,454,2,446
5860,873,616,149.00244897959183,150.465306122449,16,28,265,1,257
5861,873,689,149.00244897959183,151.02258503401362,16,16,204,2,184
5862,873,729,149.00244897959183,151.78884353741498,16,17,187,3,144
5863,873,820,149.00244897959183,150.27954648526077,16,20,76,1,53
5864,873,874,149.00244897959183,151.7191836734694,16,14,117,3,1
5865,820,427,150.27954648526077,152.3461224489796,20,21,403,2,393
5866,820,729,150.27954648526077,151.78884353741498,20,17,112,2,91
5867,820,673,150.27954648526077,153.0659410430839,20,9,190,3,147
5868,820,873,150.27954648526077,151.69596371882088,20,15,81,1,53
5869,820,874,150.27954648526077,151.7191836734694,20,14,82,1,54
5870,820,872,150.27954648526077,153.04272108843537,20,16,130,3,52
5871,873,445,151.69596371882088,153.6928798185941,15,20,437,2,428
5872,873,463,151.69596371882088,154.2037188208617,15,13,424,3,410
5873,873,673,151.69596371882088,153.0659410430839,15,9,209,1,200
5874,873,654,151.69596371882088,154.18049886621316,15,16,244,2,219
5875,873,872,151.69596371882088,153.04272108843537,15,16,58,1,1
5876,873,851,151.69596371882088,153.73931972789117,15,11,91,2,22
5877,874,445,151.7191836734694,153.6928798185941,14,20,437,2,429
5878,874,463,151.7191836734694,154.2037188208617,14,13,425,2,411
5879,874,673,151.7191836734694,153.0659410430839,14,9,209,1,201
5880,874,654,151.7191836734694,154.18049886621316,14,16,244,2,220
5881,874,872,151.7191836734694,153.04272108843537,14,16,57,1,2
5882,874,851,151.7191836734694,153.73931972789117,14,11,90,2,23
5883,872,463,153.04272108843537,154.2037188208617,16,13,412,1,409
5884,872,489,153.04272108843537,154.99319727891157,16,11,392,2,383
5885,872,654,153.04272108843537,154.18049886621316,16,16,223,1,218
5886,851,489,153.73931972789117,154.99319727891157,11,11,366,1,362
5887,851,435,153.73931972789117,156.38639455782314,11,18,431,3,416
5888,851,618,153.73931972789117,156.38639455782314,11,16,259,3,233
5889,851,943,153.73931972789117,156.38639455782314,11,11,146,3,92
5890,943,802,156.38639455782314,158.56907029478458,11,14,169,2,141
5891,943,878,156.38639455782314,158.42975056689343,11,14,109,2,65
5892,943,906,156.38639455782314,159.07990929705215,11,11,122,3,37
5893,872,436,157.0829931972789,159.07990929705215,16,22,444,2,436
5894,872,531,157.0829931972789,160.0319274376417,16,23,364,3,341
5895,872,802,157.0829931972789,158.56907029478458,16,14,95,1,70
5896,872,630,157.0829931972789,160.0319274376417,16,15,273,3,242
5897,872,878,157.0829931972789,158.42975056689343,16,14,58,1,6
5898,872,906,157.0829931972789,159.07990929705215,16,11,92,2,34
5899,872,873,157.0829931972789,159.79972789115646,16,15,117,3,1
5900,878,531,158.42975056689343,160.0319274376417,14,23,354,2,347
5901,878,437,158.42975056689343,161.21614512471655,14,20,457,3,441
5902,878,630,158.42975056689343,160.0319274376417,14,15,257,2,248
5903,878,621,158.42975056689343,161.12326530612245,14,13,282,3,257
5904,878,873,158.42975056689343,159.79972789115646,14,15,59,1,5
5905,878,873,158.42975056689343,161.146485260771,14,16,117,3,5
5906,906,437,159.07990929705215,161.21614512471655,11,20,478,2,469
5907,906,428,159.07990929705215,161.77342403628117,11,20,492,3,478
5908,906,621,159.07990929705215,161.12326530612245,11,13,298,2,285
5909,906,873,159.07990929705215,161.146485260771,11,16,95,2,33
5910,873,437,159.79972789115646,161.21614512471655,15,20,440,1,436
5911,873,428,159.79972789115646,161.77342403628117,15,20,453,2,445
5912,873,621,159.79972789115646,161.12326530612245,15,13,258,1,252
5913,873,669,159.79972789115646,162.30748299319728,15,11,231,3,204
5914,873,445,161.146485260771,163.1201814058957,16,20,436,2,428
5915,873,669,161.146485260771,162.30748299319728,16,11,210,1,204
5916,873,752,161.146485260771,163.14340136054423,16,10,148,2,121
5917,873,907,161.146485260771,163.14340136054423,16,12,92,2,34
5918,873,428,162.49324263038548,164.46693877551022,15,19,453,2,445
5919,873,425,162.49324263038548,165.18675736961453,15,17,463,3,448
5920,873,616,162.49324263038548,164.60625850340136,15,9,273,2,257
5921,873,629,162.49324263038548,165.18675736961453,15,11,270,3,244
5922,907,428,163.14340136054423,164.46693877551022,12,19,482,1,479
5923,907,425,163.14340136054423,165.18675736961453,12,17,490,2,482
5924,907,445,163.14340136054423,165.83691609977325,12,20,476,3,462
5925,907,616,163.14340136054423,164.60625850340136,12,9,298,1,291
5926,907,629,163.14340136054423,165.18675736961453,12,11,292,2,278
5927,907,873,163.14340136054423,165.18675736961453,12,16,94,2,34
5928,873,425,163.84,165.18675736961453,15,17,452,1,448
5929,873,445,163.84,165.83691609977325,15,20,437,2,428
5930,873,629,163.84,165.18675736961453,15,11,251,1,244
5931,873,756,163.84,166.44063492063492,15,15,162,3,117
5932,873,872,163.84,166.53351473922902,15,16,116,3,1
5933,873,445,165.18675736961453,167.18367346938777,16,20,437,2,428
5934,873,756,165.18675736961453,166.44063492063492,16,15,129,1,117
5935,873,675,165.18675736961453,167.46231292517007,16,11,221,2,198
5936,873,872,165.18675736961453,166.53351473922902,16,16,58,1,1
5937,873,907,165.18675736961453,167.16045351473923,16,13,92,2,34
5938,872,427,166.53351473922902,168.53043083900226,16,21,453,2,445
5939,872,414,166.53351473922902,169.22702947845806,16,17,472,3,458
5940,872,615,166.53351473922902,168.50721088435375,16,15,271,2,257
5941,872,619,166.53351473922902,169.0877097505669,16,22,276,3,253
5942,872,873,166.53351473922902,167.88027210884354,16,16,58,1,1
5943,907,427,167.16045351473923,168.53043083900226,13,21,484,1,480
5944,907,414,167.16045351473923,169.22702947845806,13,17,501,2,493
5945,907,445,167.16045351473923,169.8771882086168,13,21,477,3,462
5946,907,615,167.16045351473923,168.50721088435375,13,15,298,1,292
5947,907,619,167.16045351473923,169.0877097505669,13,22,300,2,288
5948,907,872,167.16045351473923,169.22702947845806,13,19,96,2,35
5949,907,961,167.16045351473923,170.08616780045352,13,17,137,3,54
5950,873,414,167.88027210884354,169.22702947845806,16,17,463,1,459
5951,873,445,167.88027210884354,169.8771882086168,16,21,437,2,428
5952,873,619,167.88027210884354,169.0877097505669,16,22,259,1,254
5953,873,783,167.88027210884354,170.48090702947846,16,13,144,3,90
5954,873,872,167.88027210884354,169.22702947845806,16,19,58,1,1
5955,873,961,167.88027210884354,170.08616780045352,16,17,129,2,88
5956,872,518,169.22702947845806,171.52580498866214,19,24,368,2,354
5957,872,783,169.22702947845806,170.48090702947846,19,13,104,1,89
5958,872,680,169.22702947845806,171.5025850340136,19,15,216,2,192
5959,872,844,169.22702947845806,171.4793650793651,19,13,101,2,28
5960,961,518,170.08616780045352,171.52580498866214,17,24,447,1,443
5961,961,680,170.08616780045352,171.5025850340136,17,15,288,1,281
5962,961,620,170.08616780045352,172.40816326530611,17,15,355,2,341
5963,961,615,170.08616780045352,172.8261224489796,17,16,366,3,346
5964,961,844,170.08616780045352,171.4793650793651,17,13,131,1,117
5965,961,872,170.08616780045352,171.92054421768708,17,17,119,2,89
5966,844,445,171.4793650793651,172.5707029478458,13,21,402,1,399
5967,844,461,171.4793650793651,173.2673015873016,13,17,391,2,383
5968,844,445,171.4793650793651,173.91746031746032,13,21,413,2,399
5969,844,615,171.4793650793651,172.8261224489796,13,16,236,1,229
5970,844,673,171.4793650793651,173.91746031746032,13,10,201,2,171
5971,844,878,171.4793650793651,173.2673015873016,13,15,84,2,34
5972,872,461,171.92054421768708,173.2673015873016,17,17,415,1,411
5973,872,445,171.92054421768708,173.91746031746032,17,21,436,2,427
5974,872,673,171.92054421768708,173.91746031746032,17,10,217,2,199
5975,872,878,171.92054421768708,173.2673015873016,17,15,58,1,6
5976,872,878,171.92054421768708,174.6140589569161,17,16,116,3,6
5977,878,404,173.2673015873016,175.51963718820863,15,26,484,2,474
5978,878,419,173.2673015873016,175.5892970521542,15,25,470,2,459
5979,878,694,173.2673015873016,175.3338775510204,15,18,204,2,184
5980,878,842,173.2673015873016,175.72861678004534,15,17,112,2,36
5981,878,879,173.2673015873016,175.96081632653062,15,16,116,3,1
5982,878,462,174.6140589569161,176.70385487528344,16,22,426,2,416
5983,878,489,174.6140589569161,177.05215419501135,16,20,403,2,389
5984,878,673,174.6140589569161,176.70385487528344,16,15,224,2,205
5985,878,714,174.6140589569161,177.16825396825396,16,13,197,3,164
5986,878,842,174.6140589569161,175.72861678004534,16,17,60,1,36
5987,878,879,174.6140589569161,175.96081632653062,16,16,58,1,1
5988,842,489,175.72861678004534,177.05215419501135,17,20,358,1,353
5989,842,427,175.72861678004534,177.95773242630386,17,20,426,2,415
5990,842,714,175.72861678004534,177.16825396825396,17,13,142,1,128
5991,842,878,175.72861678004534,177.30757369614514,17,16,77,2,36
5992,842,878,175.72861678004534,178.65433106575964,17,15,131,3,36
5993,879,489,175.96081632653062,177.05215419501135,16,20,393,1,390
5994,879,427,175.96081632653062,177.95773242630386,16,20,460,2,452
5995,879,714,175.96081632653062,177.16825396825396,16,13,173,1,165
5996,879,878,175.96081632653062,177.30757369614514,16,16,58,1,1
5997,879,878,175.96081632653062,178.65433106575964,16,15,116,3,1
5998,878,446,177.30757369614514,179.30448979591836,16,21,440,2,432
5999,878,674,177.30757369614514,179.3277097505669,16,12,222,2,204
6000,878,676,177.30757369614514,180.00108843537416,16,10,233,3,202
6001,878,866,177.30757369614514,179.30448979591836,16,11,87,2,12
6002,878,873,177.30757369614514,180.02430839002267,16,15,117,3,5
6003,878,445,178.65433106575964,180.65124716553288,15,20,441,2,433
6004,878,443,178.65433106575964,181.34784580498868,15,19,450,3,435
6005,878,676,178.65433106575964,180.00108843537416,15,10,210,1,202
6006,878,873,178.65433106575964,180.02430839002267,15,15,59,1,5
6007,878,873,178.65433106575964,181.3710657596372,15,15,117,3,5
6008,866,445,179.30448979591836,180.65124716553288,11,20,425,1,421
6009,866,443,179.30448979591836,181.34784580498868,11,19,432,2,423
6010,866,428,179.30448979591836,181.9980045351474,11,20,453,3,438
6011,866,692,179.30448979591836,182.0212244897959,11,12,210,3,174
6012,866,873,179.30448979591836,181.3710657596372,11,15,89,2,7
6013,873,443,180.02430839002267,181.34784580498868,15,19,434,1,430
6014,873,428,180.02430839002267,181.9980045351474,15,20,453,2,445
6015,873,692,180.02430839002267,182.0212244897959,15,12,200,2,181
6016,873,427,181.3710657596372,183.36798185941043,15,20,454,2,446
6017,873,796,181.3710657596372,183.04290249433106,15,9,105,2,77
6018,873,907,181.3710657596372,183.36798185941043,15,11,92,2,34
6019,873,445,182.7178231292517,184.71473922902496,16,20,437,2,428
6020,873,444,182.7178231292517,185.3881179138322,16,17,444,3,429
6021,907,445,183.36798185941043,184.71473922902496,11,20,466,1,462
6022,907,444,183.36798185941043,185.3881179138322,11,17,471,2,463
6023,907,445,183.36798185941043,186.06149659863945,11,21,476,3,462
6024,907,873,183.36798185941043,185.41133786848073,11,16,94,2,34
6025,873,444,184.0645804988662,185.3881179138322,15,17,433,1,429
6026,873,445,184.0645804988662,186.06149659863945,15,21,437,2,428
6027,873,617,184.0645804988662,186.45623582766441,15,9,276,2,256
6028,873,548,185.41133786848073,187.50113378684807,16,22,337,2,325
6029,873,617,185.41133786848073,186.45623582766441,16,9,260,1,256
6030,873,618,185.41133786848073,187.50113378684807,16,14,270,2,255
6031,873,907,185.41133786848073,187.40825396825397,16,11,92,2,34
6032,873,878,185.41133786848073,188.10485260770974,16,15,116,3,5
6033,873,427,186.75809523809525,188.7550113378685,16,20,454,2,446
6034,873,465,186.75809523809525,189.26585034013607,16,15,422,3,408
6035,873,758,186.75809523809525,189.26585034013607,16,17,158,3,115
6036,873,878,186.75809523809525,188.10485260770974,16,15,58,1,5
6037,907,427,187.40825396825397,188.7550113378685,11,20,483,1,480
6038,907,465,187.40825396825397,189.26585034013607,11,15,449,2,442
6039,907,758,187.40825396825397,189.26585034013607,11,17,169,2,149
6040,878,465,188.10485260770974,189.26585034013607,15,15,416,1,413
6041,878,758,188.10485260770974,189.26585034013607,15,17,130,1,120
