,f0,f1,t0,t1,dB0,dB1,dist,utime,ufreq
0,8,36,1.8575963718820863,4.783310657596372,17,36,129,3,28
1,8,36,2.020136054421769,4.783310657596372,18,36,122,3,28
2,8,36,3.0650340136054424,4.783310657596372,17,36,79,2,28
3,8,36,3.0650340136054424,5.317369614512471,17,33,101,2,28
4,36,14,5.317369614512471,7.987664399092971,33,23,117,3,22
5,36,14,6.130068027210885,7.987664399092971,27,23,83,2,22
6,36,10,6.130068027210885,8.846802721088435,27,45,120,3,26
7,36,10,6.130068027210885,9.079002267573696,27,44,130,3,26
8,36,292,6.130068027210885,8.800362811791384,27,22,281,3,256
9,36,309,6.130068027210885,9.009342403628118,27,18,300,3,273
10,36,422,6.130068027210885,8.568163265306122,27,19,400,2,386
11,36,480,6.130068027210885,9.009342403628118,27,17,461,3,444
12,14,10,7.987664399092971,9.079002267573696,23,44,47,1,4
13,14,15,7.987664399092971,10.309659863945578,23,43,100,2,1
14,14,309,7.987664399092971,9.009342403628118,23,18,298,1,295
15,14,274,7.987664399092971,10.24,23,21,278,2,260
16,14,480,7.987664399092971,9.009342403628118,23,17,468,1,466
17,14,426,7.987664399092971,10.263219954648527,23,19,423,2,412
18,10,15,8.846802721088435,10.309659863945578,45,43,63,1,5
19,10,14,8.846802721088435,11.586757369614512,45,42,118,3,4
20,10,274,8.846802721088435,10.24,45,21,271,1,264
21,10,426,8.846802721088435,10.263219954648527,45,19,420,1,416
22,10,15,9.079002267573696,10.309659863945578,44,43,53,1,5
23,10,14,9.079002267573696,11.586757369614512,44,42,108,3,4
24,10,274,9.079002267573696,10.24,44,21,269,1,264
25,10,426,9.079002267573696,10.263219954648527,44,19,419,1,416
26,15,14,10.309659863945578,11.586757369614512,43,42,55,1,1
27,15,12,10.309659863945578,12.631655328798185,43,43,100,2,3
28,15,208,10.309659863945578,12.817414965986394,43,33,221,3,193
29,15,432,10.309659863945578,12.956734693877552,43,18,432,3,417
30,14,12,11.586757369614512,12.631655328798185,42,43,45,1,2
31,14,208,11.586757369614512,12.817414965986394,42,33,201,1,194
32,14,205,11.586757369614512,13.699773242630386,42,25,212,2,191
33,14,213,11.586757369614512,14.187392290249434,42,23,228,3,199
34,14,432,11.586757369614512,12.956734693877552,42,18,422,1,418
35,14,474,11.586757369614512,13.537233560090703,42,21,468,2,460
36,14,486,11.586757369614512,14.55891156462585,42,23,489,3,472
37,12,14,12.631655328798185,13.885532879818594,43,41,54,1,2
38,12,14,12.631655328798185,14.373151927437641,43,44,75,2,2
39,12,205,12.631655328798185,13.699773242630386,43,25,198,1,193
40,12,213,12.631655328798185,14.187392290249434,43,23,212,2,201
41,12,486,12.631655328798185,14.55891156462585,43,23,481,2,474
42,14,12,13.885532879818594,15.673469387755102,41,44,77,2,2
43,14,254,13.885532879818594,16.27718820861678,41,27,261,2,240
44,14,415,13.885532879818594,16.27718820861678,41,19,414,2,401
45,14,12,14.373151927437641,15.673469387755102,44,44,56,1,2
46,14,10,14.373151927437641,16.973786848072564,44,44,112,3,4
47,14,10,14.373151927437641,17.136326530612244,44,44,119,3,4
48,14,254,14.373151927437641,16.27718820861678,44,27,254,2,240
49,14,292,14.373151927437641,17.136326530612244,44,18,302,3,278
50,14,415,14.373151927437641,16.27718820861678,44,19,409,2,401
51,14,460,14.373151927437641,17.29886621315193,44,13,463,3,446
52,12,10,15.673469387755102,16.973786848072564,44,44,56,1,2
53,12,10,15.673469387755102,17.136326530612244,44,44,63,1,2
54,12,292,15.673469387755102,17.136326530612244,44,18,287,1,280
55,12,210,15.673469387755102,18.599183673469387,44,21,235,3,198
56,12,460,15.673469387755102,17.29886621315193,44,13,453,2,448
57,12,414,15.673469387755102,18.413424036281178,44,21,419,3,402
58,10,12,16.973786848072564,18.204444444444444,44,43,53,1,2
59,10,14,16.973786848072564,19.71374149659864,44,44,118,3,4
60,10,210,16.973786848072564,18.599183673469387,44,21,212,2,200
61,10,414,16.973786848072564,18.413424036281178,44,21,409,1,404
62,10,12,17.136326530612244,18.204444444444444,44,43,46,1,2
63,10,14,17.136326530612244,19.71374149659864,44,44,111,3,4
64,10,210,17.136326530612244,18.599183673469387,44,21,210,1,200
65,10,414,17.136326530612244,18.413424036281178,44,21,408,1,404
66,12,14,18.204444444444444,19.71374149659864,43,44,65,2,2
67,12,14,18.204444444444444,21.037278911564627,43,43,122,3,2
68,12,334,18.204444444444444,20.712199546485262,43,20,340,3,322
69,14,12,19.71374149659864,20.758639455782312,44,44,45,1,2
70,14,299,19.71374149659864,21.91963718820862,44,26,300,2,285
71,14,355,19.71374149659864,22.221496598639455,44,23,358,3,341
72,14,421,19.71374149659864,22.267936507936508,44,18,422,3,407
73,12,14,20.758639455782312,22.569795918367348,44,45,78,2,2
74,12,299,20.758639455782312,21.91963718820862,44,26,291,1,287
75,12,355,20.758639455782312,22.221496598639455,44,23,349,1,343
76,12,421,20.758639455782312,22.267936507936508,44,18,414,2,409
77,14,12,21.037278911564627,23.1502947845805,43,44,91,2,2
78,14,355,21.037278911564627,22.221496598639455,43,23,345,1,341
79,14,421,21.037278911564627,22.267936507936508,43,18,410,1,407
80,14,12,22.569795918367348,24.055873015873015,45,44,64,1,2
81,14,295,22.569795918367348,25.007891156462584,45,24,300,2,281
82,14,417,22.569795918367348,25.007891156462584,45,17,416,2,403
83,12,10,23.1502947845805,25.86702947845805,44,44,117,3,2
84,12,295,23.1502947845805,25.007891156462584,44,24,294,2,283
85,12,218,23.1502947845805,25.98312925170068,44,28,239,3,206
86,12,245,23.1502947845805,26.05278911564626,44,24,264,3,233
87,12,417,23.1502947845805,25.007891156462584,44,17,413,2,405
88,12,433,23.1502947845805,26.029569160997735,44,18,439,3,421
89,12,433,23.1502947845805,26.05278911564626,44,19,439,3,421
90,12,10,24.055873015873015,25.86702947845805,44,44,78,2,2
91,12,218,24.055873015873015,25.98312925170068,44,28,222,2,206
92,12,245,24.055873015873015,26.05278911564626,44,24,248,2,233
93,12,433,24.055873015873015,26.029569160997735,44,18,429,2,421
94,12,433,24.055873015873015,26.05278911564626,44,19,430,2,421
95,10,14,25.86702947845805,27.23700680272109,44,44,59,1,4
96,10,14,25.86702947845805,28.142585034013607,44,43,98,2,4
97,10,216,25.86702947845805,27.445986394557824,44,23,217,2,206
98,10,416,25.86702947845805,27.260226757369615,44,15,410,1,406
99,12,14,26.3546485260771,28.142585034013607,45,43,77,2,2
100,12,11,26.3546485260771,29.280362811791385,45,43,126,3,1
101,12,216,26.3546485260771,27.445986394557824,45,23,209,1,204
102,12,308,26.3546485260771,28.95528344671202,45,23,316,3,296
103,14,11,27.23700680272109,29.280362811791385,44,43,88,2,3
104,14,90,27.23700680272109,30.093061224489798,44,40,145,3,76
105,14,308,27.23700680272109,28.95528344671202,44,23,303,2,294
106,14,210,27.23700680272109,29.53578231292517,44,28,220,2,196
107,14,475,27.23700680272109,29.83764172335601,44,15,474,3,461
108,14,11,28.142585034013607,29.280362811791385,43,43,49,1,3
109,14,90,28.142585034013607,30.093061224489798,43,40,113,2,76
110,14,210,28.142585034013607,29.53578231292517,43,28,205,1,196
111,14,318,28.142585034013607,30.812879818594105,43,24,325,3,304
112,14,475,28.142585034013607,29.83764172335601,43,15,467,2,461
113,14,411,28.142585034013607,30.65034013605442,43,15,411,3,397
114,11,83,29.280362811791385,32.066757369614514,43,41,140,3,72
115,11,318,29.280362811791385,30.812879818594105,43,24,314,2,307
116,11,295,29.280362811791385,31.7881179138322,43,25,304,3,284
117,11,411,29.280362811791385,30.65034013605442,43,15,404,1,400
118,11,414,29.280362811791385,31.648798185941043,43,20,416,2,403
119,90,83,30.093061224489798,32.066757369614514,40,41,85,2,7
120,90,83,30.093061224489798,32.345396825396826,40,41,97,2,7
121,90,295,30.093061224489798,31.7881179138322,40,25,218,2,205
122,90,277,30.093061224489798,32.48471655328798,40,22,213,2,187
123,90,414,30.093061224489798,31.648798185941043,40,20,331,2,324
124,90,414,30.093061224489798,32.46149659863946,40,20,340,2,324
125,83,5,32.066757369614514,33.73859410430839,41,45,106,2,78
126,83,6,32.066757369614514,34.22621315192744,41,50,121,2,77
127,83,213,32.066757369614514,33.99401360544218,41,35,154,2,130
128,83,208,32.066757369614514,34.69061224489796,41,26,169,3,125
129,83,427,32.066757369614514,33.99401360544218,41,22,354,2,344
130,83,499,32.066757369614514,34.71383219954649,41,22,431,3,416
131,83,5,32.345396825396826,33.73859410430839,41,45,98,1,78
132,83,6,32.345396825396826,34.22621315192744,41,50,112,2,77
133,83,6,32.345396825396826,35.247891156462586,41,49,147,3,77
134,83,213,32.345396825396826,33.99401360544218,41,35,148,2,130
135,83,208,32.345396825396826,34.69061224489796,41,26,161,2,125
136,83,337,32.345396825396826,35.131791383219955,41,29,281,3,254
137,83,427,32.345396825396826,33.99401360544218,41,22,351,2,344
138,83,499,32.345396825396826,34.71383219954649,41,22,428,2,416
139,5,6,33.73859410430839,35.247891156462586,45,49,65,2,1
140,5,6,33.73859410430839,36.24634920634921,45,50,108,3,1
141,5,337,33.73859410430839,35.131791383219955,45,29,337,1,332
142,5,499,33.73859410430839,35.735510204081635,45,21,501,2,494
143,6,213,34.22621315192744,36.73396825396826,50,27,233,3,207
144,6,499,34.22621315192744,35.735510204081635,50,21,497,2,493
145,6,213,35.247891156462586,36.73396825396826,49,27,217,1,207
146,6,327,35.247891156462586,38.080725623582765,49,27,343,3,321
147,6,438,35.247891156462586,37.755646258503404,49,18,445,3,432
148,6,327,36.24634920634921,38.080725623582765,50,27,331,2,321
149,6,217,36.24634920634921,39.05596371882086,50,36,243,3,211
150,6,438,36.24634920634921,37.755646258503404,50,18,437,2,432
151,6,435,36.24634920634921,38.521904761904764,50,22,440,2,429
152,6,217,37.268027210884355,39.05596371882086,51,36,225,2,211
153,6,215,37.268027210884355,39.497142857142855,51,37,230,2,209
154,6,332,37.268027210884355,40.12408163265306,51,26,348,3,326
155,6,435,37.268027210884355,38.521904761904764,51,22,432,1,429
156,6,429,37.268027210884355,39.7990022675737,51,23,437,3,423
157,6,215,38.2897052154195,39.497142857142855,50,37,215,1,209
158,6,332,38.2897052154195,40.12408163265306,50,26,335,2,326
159,6,429,38.2897052154195,39.7990022675737,50,23,428,2,423
160,6,478,38.2897052154195,40.79746031746032,50,20,484,3,472
161,6,278,39.31138321995465,41.633378684807255,50,29,290,2,272
162,6,478,39.31138321995465,40.79746031746032,50,20,476,1,472
163,6,278,40.30984126984127,41.633378684807255,49,29,278,1,272
164,6,214,40.30984126984127,42.49251700680272,49,27,228,2,208
165,6,429,40.30984126984127,42.840816326530614,49,19,437,3,423
166,6,214,41.33151927437642,42.49251700680272,50,27,214,1,208
167,6,301,41.33151927437642,43.444535147392294,50,27,309,2,295
168,6,429,41.33151927437642,42.840816326530614,50,19,428,2,423
169,6,301,42.353197278911566,43.444535147392294,50,27,299,1,295
170,6,292,42.353197278911566,44.55909297052154,50,32,301,2,286
171,6,415,42.353197278911566,44.489433106575966,50,25,419,2,409
172,6,292,43.37487528344671,44.55909297052154,50,32,291,1,286
173,6,218,43.37487528344671,45.97551020408164,50,32,240,3,212
174,6,415,43.37487528344671,44.489433106575966,50,25,412,1,409
175,6,218,44.39655328798186,45.97551020408164,49,32,223,2,212
176,6,364,44.39655328798186,46.602448979591834,49,31,370,2,358
177,6,449,44.39655328798186,46.9275283446712,49,20,456,3,443
178,6,364,45.39501133786848,46.602448979591834,49,31,362,1,358
179,6,215,45.39501133786848,47.391927437641726,49,34,226,2,209
180,6,219,45.39501133786848,48.29750566893424,49,28,247,3,213
181,6,449,45.39501133786848,46.9275283446712,49,20,448,2,443
182,6,438,45.39501133786848,47.925986394557825,49,23,446,3,432
183,6,219,46.41668934240363,48.29750566893424,50,28,228,2,213
184,6,438,46.41668934240363,47.925986394557825,50,23,437,2,432
185,6,423,46.41668934240363,48.92444444444445,50,19,431,3,417
186,6,293,47.438367346938776,50.062222222222225,50,27,308,3,287
187,6,423,47.438367346938776,48.92444444444445,50,19,422,1,417
188,6,499,47.438367346938776,49.96934240362812,50,19,505,3,493
189,6,293,48.46004535147392,50.062222222222225,51,27,295,2,287
190,6,220,48.46004535147392,50.549841269841274,51,37,232,2,214
191,6,499,48.46004535147392,49.96934240362812,51,19,497,2,493
192,6,436,48.46004535147392,50.80526077097506,51,21,442,2,430
193,6,220,49.48172335600907,50.549841269841274,50,37,219,1,214
194,6,227,49.48172335600907,51.7340589569161,50,32,241,2,221
195,6,436,49.48172335600907,50.80526077097506,50,21,434,1,430
196,6,437,49.48172335600907,51.98947845804989,50,20,444,3,431
197,6,227,50.48018140589569,51.7340589569161,50,32,228,1,221
198,6,230,50.48018140589569,52.98793650793651,50,27,249,3,224
199,6,437,50.48018140589569,51.98947845804989,50,20,436,2,431
200,6,440,50.48018140589569,52.98793650793651,50,20,447,3,434
201,6,230,51.50185941043084,52.98793650793651,50,27,233,1,224
202,6,230,51.50185941043084,54.00961451247166,50,25,249,3,224
203,6,227,51.50185941043084,54.31147392290249,50,35,252,3,221
204,6,440,51.50185941043084,52.98793650793651,50,20,439,1,434
205,6,443,51.50185941043084,54.00961451247166,50,19,450,3,437
206,6,230,52.523537414965986,54.00961451247166,50,25,233,1,224
207,6,227,52.523537414965986,54.31147392290249,50,35,234,2,221
208,6,443,52.523537414965986,54.00961451247166,50,19,442,1,437
209,6,429,52.523537414965986,55.031292517006804,50,21,437,3,423
210,6,213,53.54521541950113,55.77433106575964,50,31,228,2,207
211,6,211,53.54521541950113,56.21551020408163,50,30,235,3,205
212,6,429,53.54521541950113,55.031292517006804,50,21,428,1,423
213,6,491,53.54521541950113,56.029750566893426,50,21,497,2,485
214,6,213,54.56689342403628,55.77433106575964,50,31,213,1,207
215,6,211,54.56689342403628,56.21551020408163,50,30,217,2,205
216,6,491,54.56689342403628,56.029750566893426,50,21,489,1,485
217,6,429,54.56689342403628,57.05142857142857,50,18,436,2,423
218,6,245,55.5653514739229,58.07310657596372,49,31,262,3,239
219,6,241,55.5653514739229,58.212426303854876,49,31,261,3,235
220,6,429,55.5653514739229,57.05142857142857,49,18,428,1,423
221,6,429,55.5653514739229,58.096326530612245,49,21,437,3,423
222,6,245,56.58702947845805,58.07310657596372,50,31,247,1,239
223,6,241,56.58702947845805,58.212426303854876,50,31,245,2,235
224,6,209,56.58702947845805,59.512743764172335,50,27,239,3,203
225,6,429,56.58702947845805,58.096326530612245,50,21,428,2,423
226,6,412,56.58702947845805,59.025124716553286,50,25,419,2,406
227,6,423,56.58702947845805,59.55918367346939,50,20,436,3,417
228,6,8,57.608707482993196,60.48798185941043,50,46,124,3,2
229,6,209,57.608707482993196,59.512743764172335,50,27,219,2,203
230,6,412,57.608707482993196,59.025124716553286,50,25,411,1,406
231,6,423,57.608707482993196,59.55918367346939,50,20,425,2,417
232,6,8,58.63038548752834,60.48798185941043,50,46,80,2,2
233,6,266,58.63038548752834,61.045260770975055,50,33,280,2,260
234,6,410,58.63038548752834,61.11492063492064,50,17,418,2,404
235,6,266,59.65206349206349,61.045260770975055,50,33,267,1,260
236,6,216,59.65206349206349,61.99727891156463,50,27,233,2,210
237,6,410,59.65206349206349,61.11492063492064,50,17,409,1,404
238,6,418,59.65206349206349,61.881179138322,50,22,423,2,412
239,6,414,59.65206349206349,62.15981859410431,50,20,422,3,408
240,8,6,60.48798185941043,61.67219954648526,46,50,51,1,2
241,8,6,60.48798185941043,62.69387755102041,46,50,95,2,2
242,8,216,60.48798185941043,61.99727891156463,46,27,218,2,208
243,8,205,60.48798185941043,62.64743764172336,46,24,218,2,197
244,8,418,60.48798185941043,61.881179138322,46,22,414,1,410
245,8,414,60.48798185941043,62.15981859410431,46,20,412,2,406
246,6,205,61.67219954648526,63.947755102040816,50,25,222,2,199
247,6,456,61.67219954648526,64.1102947845805,50,20,462,2,450
248,6,463,61.67219954648526,64.17995464852608,50,20,470,3,457
249,6,205,62.69387755102041,63.947755102040816,50,25,206,1,199
250,6,205,62.69387755102041,64.76045351473923,50,24,218,2,199
251,6,205,62.69387755102041,65.66603174603175,50,27,237,3,199
252,6,456,62.69387755102041,64.1102947845805,50,20,454,1,450
253,6,463,62.69387755102041,64.17995464852608,50,20,461,1,457
254,6,205,63.715555555555554,64.76045351473923,50,24,204,1,199
255,6,205,63.715555555555554,65.66603174603175,50,27,216,2,199
256,6,387,63.715555555555554,66.20009070294785,50,23,396,2,381
257,6,428,63.715555555555554,65.68925170068027,50,19,430,2,422
258,6,438,63.715555555555554,66.22331065759637,50,21,445,3,432
259,6,387,64.7372335600907,66.20009070294785,50,23,386,1,381
260,6,438,64.7372335600907,66.22331065759637,50,21,437,1,432
261,6,438,64.7372335600907,67.24498866213152,50,21,445,3,432
262,6,205,65.73569160997732,67.96480725623583,50,24,221,2,199
263,6,438,65.73569160997732,67.24498866213152,50,21,437,2,432
264,6,205,66.75736961451247,67.96480725623583,50,24,206,1,199
265,6,244,66.75736961451247,69.14902494331066,50,32,259,2,238
266,6,267,66.75736961451247,69.19546485260771,50,28,281,2,261
267,6,432,66.75736961451247,68.98648526077098,50,22,437,2,426
268,6,467,66.75736961451247,69.40444444444445,50,16,475,3,461
269,6,244,67.77904761904762,69.14902494331066,51,32,245,1,238
270,6,267,67.77904761904762,69.19546485260771,51,28,268,1,261
271,6,432,67.77904761904762,68.98648526077098,51,22,429,1,426
272,6,467,67.77904761904762,69.40444444444445,51,16,466,2,461
273,6,367,68.28988662131519,71.0530612244898,49,29,380,3,361
274,6,220,68.28988662131519,71.26204081632653,49,31,249,3,214
275,6,467,68.28988662131519,69.40444444444445,49,16,463,1,461
276,6,367,69.82240362811791,71.0530612244898,50,29,365,1,361
277,6,220,69.82240362811791,71.26204081632653,50,31,223,1,214
278,6,223,69.82240362811791,72.2140589569161,50,19,240,2,217
279,6,415,69.82240362811791,71.28526077097506,50,14,414,1,409
280,6,444,69.82240362811791,72.28371882086168,50,15,451,2,438
281,6,223,70.82086167800453,72.2140589569161,50,19,225,1,217
282,6,288,70.82086167800453,73.21251700680273,50,23,300,2,282
283,6,444,70.82086167800453,72.28371882086168,50,15,443,1,438
284,6,288,71.84253968253968,73.21251700680273,50,23,288,1,282
285,6,460,71.84253968253968,74.3502947845805,50,23,467,3,454
286,6,280,72.35337868480725,75.16299319727891,51,27,300,3,274
287,6,218,72.35337868480725,75.3255328798186,51,27,248,3,212
288,6,460,72.35337868480725,74.3502947845805,51,23,462,2,454
289,6,280,73.3750566893424,75.16299319727891,50,27,285,2,274
290,6,218,73.3750566893424,75.3255328798186,50,27,228,2,212
291,6,451,73.3750566893424,75.60417233560091,50,15,455,2,445
292,6,208,74.39673469387755,76.64907029478458,50,15,224,2,202
293,6,451,74.39673469387755,75.60417233560091,50,15,448,1,445
294,6,413,74.39673469387755,77.29922902494332,50,14,426,3,407
295,6,207,75.90603174603174,77.57786848072563,50,30,214,2,201
296,6,306,75.90603174603174,78.32090702947846,50,18,318,2,300
297,6,413,75.90603174603174,77.29922902494332,50,14,411,1,407
298,6,467,75.90603174603174,78.76208616780046,50,21,477,3,461
299,6,306,76.92770975056689,78.32090702947846,50,18,306,1,300
300,6,244,76.92770975056689,79.87664399092971,50,25,270,3,238
301,6,467,76.92770975056689,78.76208616780046,50,21,468,2,461
302,6,412,76.92770975056689,79.43546485260771,50,19,420,3,406
303,6,244,77.43854875283446,79.87664399092971,50,25,260,2,238
304,6,290,77.43854875283446,80.2249433106576,50,18,308,3,284
305,6,467,77.43854875283446,78.76208616780046,50,21,465,1,461
306,6,412,77.43854875283446,79.43546485260771,50,19,415,2,406
307,6,290,78.97106575963718,80.2249433106576,51,18,289,1,284
308,6,444,78.97106575963718,81.92,51,19,456,3,438
309,6,209,79.48190476190476,81.96643990929705,50,34,229,2,203
310,6,444,79.48190476190476,81.92,50,19,450,2,438
311,6,422,79.48190476190476,82.361179138322,50,14,434,3,416
312,6,249,80.99120181405895,82.94167800453515,50,24,257,2,243
313,6,233,80.99120181405895,83.4292970521542,50,26,250,2,227
314,6,422,80.99120181405895,82.361179138322,50,14,420,1,416
315,6,233,82.0128798185941,83.4292970521542,50,26,235,1,227
316,6,206,82.0128798185941,84.7760544217687,50,17,233,3,200
317,6,206,82.52371882086167,84.7760544217687,51,17,222,2,200
318,6,206,83.54539682539682,84.7760544217687,51,17,207,1,200
319,6,320,83.54539682539682,85.98349206349206,51,24,331,2,314
320,6,218,83.54539682539682,86.40145124716554,51,32,245,3,212
321,6,320,84.56707482993197,85.98349206349206,50,24,320,1,314
322,6,218,84.56707482993197,86.40145124716554,50,32,226,2,212
323,6,274,84.56707482993197,87.42312925170069,50,22,295,3,268
324,6,425,84.56707482993197,86.819410430839,50,18,430,2,419
325,6,274,86.07637188208616,87.42312925170069,49,22,274,1,268
326,6,213,86.07637188208616,88.42158730158731,49,29,230,2,207
327,6,413,86.07637188208616,89.02530612244898,49,15,426,3,407
328,6,213,87.09804988662131,88.42158730158731,51,29,215,1,207
329,6,321,87.09804988662131,89.90766439909297,51,18,337,3,315
330,6,413,87.09804988662131,89.02530612244898,51,15,415,2,407
331,6,321,87.60888888888888,89.90766439909297,50,18,330,2,315
332,6,230,87.60888888888888,90.51138321995465,50,36,257,3,224
333,6,413,87.60888888888888,89.02530612244898,50,15,412,1,407
334,6,413,87.60888888888888,90.48816326530613,50,23,425,3,407
335,6,321,88.63056689342403,89.90766439909297,50,18,320,1,315
336,6,230,88.63056689342403,90.51138321995465,50,36,238,2,224
337,6,413,88.63056689342403,90.48816326530613,50,23,415,2,407
338,6,298,89.65224489795918,91.64916099773242,50,30,304,2,292
339,6,412,89.65224489795918,91.64916099773242,50,24,415,2,406
340,6,414,89.65224489795918,92.34575963718821,50,26,424,3,408
341,6,15,91.16154195011337,93.22811791383221,50,45,89,2,9
342,6,15,91.16154195011337,93.73895691609978,50,45,111,3,9
343,6,245,91.16154195011337,92.81015873015873,50,30,249,2,239
344,6,320,91.16154195011337,93.3209977324263,50,26,327,2,314
345,6,414,91.16154195011337,92.34575963718821,50,26,411,1,408
346,6,421,91.16154195011337,93.39065759637188,50,22,426,2,415
347,6,15,91.67238095238095,93.22811791383221,50,45,68,2,9
348,6,15,91.67238095238095,93.73895691609978,50,45,89,2,9
349,6,245,91.67238095238095,92.81015873015873,50,30,244,1,239
350,6,320,91.67238095238095,93.3209977324263,50,26,322,2,314
351,6,421,91.67238095238095,93.39065759637188,50,22,422,2,415
352,15,6,93.22811791383221,95.22503401360544,45,49,86,2,9
353,15,215,93.22811791383221,95.01605442176871,45,35,214,2,200
354,15,364,93.22811791383221,95.38757369614513,45,30,361,2,349
355,15,6,93.73895691609978,95.22503401360544,45,49,65,1,9
356,15,6,93.73895691609978,96.24671201814058,45,50,108,3,9
357,15,5,93.73895691609978,96.26993197278912,45,49,109,3,10
358,15,215,93.73895691609978,95.01605442176871,45,35,207,1,200
359,15,364,93.73895691609978,95.38757369614513,45,30,356,2,349
360,6,5,95.22503401360544,96.26993197278912,49,49,45,1,1
361,6,219,95.22503401360544,96.73433106575963,49,26,223,2,213
362,6,218,95.22503401360544,97.57024943310658,49,28,235,2,212
363,6,415,95.22503401360544,97.22195011337868,49,22,418,2,409
364,6,218,96.24671201814058,97.57024943310658,50,28,220,1,212
365,6,326,96.24671201814058,99.12598639455783,50,32,343,3,320
366,5,6,96.26993197278912,98.29006802721089,49,51,87,2,1
367,5,218,96.26993197278912,97.57024943310658,49,28,220,1,213
368,5,326,96.26993197278912,99.12598639455783,49,32,344,3,321
369,6,326,97.26839002267575,99.12598639455783,50,32,330,2,320
370,6,216,97.26839002267575,100.19410430839002,50,39,245,3,210
371,6,5,98.29006802721089,100.33342403628119,51,49,88,2,1
372,6,216,98.29006802721089,100.19410430839002,51,39,225,2,210
373,6,211,98.29006802721089,100.54240362811791,51,41,227,2,205
374,6,5,99.31174603174604,100.33342403628119,50,49,44,1,1
375,6,211,99.31174603174604,100.54240362811791,50,41,212,1,205
376,6,216,99.31174603174604,101.44798185941043,50,36,229,2,210
377,6,428,99.31174603174604,102.1213605442177,50,21,439,3,422
378,5,6,100.33342403628119,102.35356009070296,49,51,87,2,1
379,5,216,100.33342403628119,101.44798185941043,49,36,216,1,211
380,5,278,100.33342403628119,102.65541950113379,49,29,291,2,273
381,5,428,100.33342403628119,102.1213605442177,49,21,430,2,423
382,6,278,101.33188208616781,102.65541950113379,49,29,278,1,272
383,6,215,101.33188208616781,103.51455782312925,49,28,229,2,209
384,6,215,102.35356009070296,103.51455782312925,51,28,215,1,209
385,6,244,102.35356009070296,104.86131519274376,51,27,261,3,238
386,6,5,103.3752380952381,105.4185941043084,50,49,88,2,1
387,6,244,103.3752380952381,104.86131519274376,50,27,246,1,238
388,6,212,103.3752380952381,105.8829931972789,50,33,233,3,206
389,6,415,103.3752380952381,105.48825396825397,50,24,419,2,409
390,6,5,104.39691609977325,105.4185941043084,50,49,44,1,1
391,6,212,104.39691609977325,105.8829931972789,50,33,216,1,206
392,6,219,104.39691609977325,106.99755102040817,50,37,241,3,213
393,6,415,104.39691609977325,105.48825396825397,50,24,412,1,409
394,6,411,104.39691609977325,107.04399092970522,50,24,421,3,405
395,5,6,105.4185941043084,107.43873015873017,49,50,87,2,1
396,5,219,105.4185941043084,106.99755102040817,49,37,225,2,214
397,5,306,105.4185941043084,107.3922902494331,49,34,313,2,301
398,5,221,105.4185941043084,108.32108843537415,49,36,250,3,216
399,5,411,105.4185941043084,107.04399092970522,49,24,412,2,406
400,5,476,105.4185941043084,107.92634920634922,49,19,483,3,471
401,6,221,106.41705215419502,108.32108843537415,50,36,230,2,215
402,6,476,106.41705215419502,107.92634920634922,50,19,474,2,470
403,6,456,106.41705215419502,108.92480725623582,50,18,463,3,450
404,6,218,107.43873015873017,109.94648526077098,50,30,238,3,212
405,6,456,107.43873015873017,108.92480725623582,50,18,455,1,450
406,6,5,108.46040816326531,110.50376417233561,51,49,88,2,1
407,6,218,108.46040816326531,109.94648526077098,51,30,221,1,212
408,6,219,108.46040816326531,111.27002267573697,51,30,245,3,213
409,6,414,108.46040816326531,110.96816326530613,51,18,422,3,408
410,6,5,109.48208616780046,110.50376417233561,51,49,44,1,1
411,6,219,109.48208616780046,111.27002267573697,51,30,226,2,213
412,6,219,109.48208616780046,111.5718820861678,51,39,231,2,213
413,6,414,109.48208616780046,110.96816326530613,51,18,413,1,408
414,6,436,109.48208616780046,111.82730158730159,51,22,442,2,430
415,5,6,110.50376417233561,112.52390022675738,49,50,87,2,1
416,5,219,110.50376417233561,111.5718820861678,49,39,219,1,214
417,5,227,110.50376417233561,112.75609977324264,49,32,242,2,222
418,5,436,110.50376417233561,111.82730158730159,49,22,435,1,431
419,5,425,110.50376417233561,112.98829931972789,49,19,433,2,420
420,6,227,111.50222222222223,112.75609977324264,50,32,228,1,221
421,6,218,111.50222222222223,114.19573696145125,50,28,242,3,212
422,6,221,111.50222222222223,114.42793650793651,50,32,249,3,215
423,6,425,111.50222222222223,112.98829931972789,50,19,424,1,419
424,6,496,111.50222222222223,113.7081179138322,50,21,499,2,490
425,6,218,112.52390022675738,114.19573696145125,50,28,224,2,212
426,6,221,112.52390022675738,114.42793650793651,50,32,230,2,215
427,6,216,112.52390022675738,115.4031746031746,50,35,244,3,210
428,6,496,112.52390022675738,113.7081179138322,50,21,493,1,490
429,6,501,112.52390022675738,114.52081632653062,50,17,502,2,495
430,6,442,112.52390022675738,115.37995464852608,50,19,453,3,436
431,6,216,113.54557823129252,115.4031746031746,50,35,225,2,210
432,6,442,113.54557823129252,115.37995464852608,50,19,443,2,436
433,6,214,114.56725623582767,116.74993197278911,50,32,228,2,208
434,6,493,114.56725623582767,117.0053514739229,50,19,498,2,487
435,6,216,116.07655328798187,117.95736961451247,49,29,225,2,210
436,6,300,116.07655328798187,119.02548752834467,49,30,320,3,294
437,6,441,116.07655328798187,117.77160997732426,49,18,441,2,435
438,6,300,117.09823129251701,119.02548752834467,50,30,305,2,294
439,6,217,117.09823129251701,119.53632653061224,50,30,236,2,211
440,6,423,117.09823129251701,119.16480725623583,50,21,426,2,417
441,6,410,117.09823129251701,119.4898866213152,50,21,417,2,404
442,6,300,117.60907029478459,119.02548752834467,51,30,300,1,294
443,6,217,117.60907029478459,119.53632653061224,51,30,227,2,211
444,6,209,117.60907029478459,120.55800453514739,51,36,239,3,203
445,6,423,117.60907029478459,119.16480725623583,51,21,422,2,417
446,6,410,117.60907029478459,119.4898866213152,51,21,412,2,404
447,6,8,118.63074829931973,121.25460317460318,50,44,113,3,2
448,6,209,118.63074829931973,120.55800453514739,50,36,219,2,203
449,6,413,118.63074829931973,120.6508843537415,50,22,416,2,407
450,6,8,119.65242630385488,121.25460317460318,50,44,69,2,2
451,6,13,119.65242630385488,122.18340136054422,50,46,109,3,7
452,6,269,119.65242630385488,122.02086167800454,50,32,282,2,263
453,6,221,119.65242630385488,122.57814058956916,50,32,249,3,215
454,6,470,119.65242630385488,121.95120181405896,50,23,474,2,464
455,8,6,121.25460317460318,122.6942403628118,44,50,62,1,2
456,8,6,121.25460317460318,123.71591836734694,44,50,106,2,2
457,8,221,121.25460317460318,122.57814058956916,44,32,220,1,213
458,8,218,121.25460317460318,124.203537414966,44,25,245,3,210
459,8,470,121.25460317460318,122.90321995464853,44,23,467,2,462
460,8,505,121.25460317460318,123.87845804988662,44,22,510,3,497
461,13,6,122.18340136054422,123.71591836734694,46,50,66,2,7
462,13,6,122.18340136054422,124.73759637188209,46,49,110,3,7
463,13,218,122.18340136054422,124.203537414966,46,25,223,2,205
464,13,221,122.18340136054422,124.94657596371883,46,26,240,3,208
465,13,505,122.18340136054422,123.87845804988662,46,22,497,2,492
466,13,470,122.18340136054422,124.99301587301588,46,24,473,3,457
467,6,218,122.6942403628118,124.203537414966,50,25,222,2,212
468,6,221,122.6942403628118,124.94657596371883,50,26,236,2,215
469,6,505,122.6942403628118,123.87845804988662,50,22,502,1,499
470,6,470,122.6942403628118,124.99301587301588,50,24,474,2,464
471,6,221,123.71591836734694,124.94657596371883,50,26,221,1,215
472,6,220,123.71591836734694,126.22367346938776,50,26,240,3,214
473,6,470,123.71591836734694,124.99301587301588,50,24,467,1,464
474,6,462,123.71591836734694,126.22367346938776,50,21,469,3,456
475,6,411,123.71591836734694,126.38621315192744,50,24,421,3,405
476,6,220,124.73759637188209,126.22367346938776,49,26,223,1,214
477,6,220,124.73759637188209,127.24535147392291,49,26,240,3,214
478,6,462,124.73759637188209,126.22367346938776,49,21,460,1,456
479,6,411,124.73759637188209,126.38621315192744,49,24,411,2,405
480,6,329,126.24689342403629,128.01160997732427,49,24,332,2,323
481,6,374,126.24689342403629,129.1958276643991,49,27,389,3,368
482,6,492,126.24689342403629,129.03328798185942,49,23,501,3,486
483,6,329,126.75773242630386,128.01160997732427,50,24,327,1,323
484,6,374,126.75773242630386,129.1958276643991,50,27,383,2,368
485,6,492,126.75773242630386,129.03328798185942,50,23,496,2,486
486,6,218,128.29024943310657,129.84598639455783,50,28,222,2,212
487,6,311,128.29024943310657,131.21596371882086,50,28,330,3,305
488,6,450,128.29024943310657,129.89242630385488,50,22,449,2,444
489,6,477,128.29024943310657,130.4497052154195,50,22,480,2,471
490,6,218,128.80108843537414,129.84598639455783,50,28,217,1,212
491,6,311,128.80108843537414,131.21596371882086,50,28,322,2,305
492,6,450,128.80108843537414,129.89242630385488,50,22,446,1,444
493,6,477,128.80108843537414,130.4497052154195,50,22,476,2,471
494,6,311,129.8227664399093,131.21596371882086,49,28,311,1,305
495,6,218,129.8227664399093,132.3305215419501,49,28,238,3,212
496,6,499,129.8227664399093,132.3305215419501,49,18,505,3,493
497,6,218,130.82122448979592,132.3305215419501,50,28,222,2,212
498,6,211,130.82122448979592,133.09678004535147,50,26,227,2,205
499,6,499,130.82122448979592,132.3305215419501,50,18,497,2,493
500,6,469,130.82122448979592,133.12,50,27,473,2,463
501,6,211,131.84290249433107,133.09678004535147,50,26,212,1,205
502,6,238,131.84290249433107,134.3506575963719,50,24,256,3,232
503,6,469,131.84290249433107,133.12,50,27,466,1,463
504,6,7,132.86458049886622,134.88471655328797,50,50,87,2,1
505,6,238,132.86458049886622,134.3506575963719,50,24,241,1,232
506,6,217,132.86458049886622,135.1633560090703,50,26,233,2,211
507,6,218,132.86458049886622,135.37233560090704,50,25,238,3,212
508,6,428,132.86458049886622,134.83827664399092,50,26,430,2,422
509,6,421,132.86458049886622,135.37233560090704,50,22,429,3,415
510,6,7,133.88625850340136,136.4172335600907,50,47,109,3,1
511,6,217,133.88625850340136,135.1633560090703,50,26,218,1,211
512,6,218,133.88625850340136,135.37233560090704,50,25,221,1,212
513,6,313,133.88625850340136,136.71909297052156,50,25,330,3,307
514,6,421,133.88625850340136,135.37233560090704,50,22,420,1,415
515,7,6,134.88471655328797,135.90639455782312,50,49,44,1,1
516,7,6,134.88471655328797,137.43891156462584,50,50,110,3,1
517,7,313,134.88471655328797,136.71909297052156,50,25,316,2,306
518,7,244,134.88471655328797,137.3924716553288,50,24,260,3,237
519,6,244,135.90639455782312,137.3924716553288,49,24,246,1,238
520,6,420,135.90639455782312,138.2051700680272,49,20,426,2,414
521,6,423,135.90639455782312,138.41414965986394,49,19,431,3,417
522,7,6,136.4172335600907,137.43891156462584,47,50,44,1,1
523,7,6,136.4172335600907,138.460589569161,47,49,88,2,1
524,7,216,136.4172335600907,139.27328798185943,47,26,243,3,209
525,7,420,136.4172335600907,138.2051700680272,47,20,420,2,413
526,7,423,136.4172335600907,138.41414965986394,47,19,425,2,416
527,6,23,137.43891156462584,139.76090702947846,50,41,101,2,17
528,6,216,137.43891156462584,139.27328798185943,50,26,224,2,210
529,6,247,137.43891156462584,139.9002267573696,50,26,263,2,241
530,6,413,137.43891156462584,139.8770068027211,50,17,420,2,407
531,6,23,138.460589569161,139.76090702947846,49,41,59,1,17
532,6,14,138.460589569161,141.0380045351474,49,43,111,3,8
533,6,247,138.460589569161,139.9002267573696,49,26,249,1,241
534,6,212,138.460589569161,141.33986394557823,49,22,240,3,206
535,6,413,138.460589569161,139.8770068027211,49,17,412,1,407
536,6,424,138.460589569161,141.33986394557823,49,15,436,3,418
537,6,410,138.460589569161,141.38630385487528,49,15,423,3,404
538,23,14,139.76090702947846,141.0380045351474,41,43,56,1,9
539,23,82,139.76090702947846,141.89714285714285,41,42,109,2,59
540,23,212,139.76090702947846,141.33986394557823,41,22,201,2,189
541,23,291,139.76090702947846,142.0132426303855,41,23,285,2,268
542,23,424,139.76090702947846,141.33986394557823,41,15,407,2,401
543,23,410,139.76090702947846,141.38630385487528,41,15,393,2,387
544,14,46,141.0380045351474,143.33678004535147,43,43,104,2,32
545,14,46,141.0380045351474,143.40643990929706,43,42,107,2,32
546,14,207,141.0380045351474,143.36,43,29,217,2,193
547,14,207,141.0380045351474,143.40643990929706,43,27,218,2,193
548,14,480,141.0380045351474,143.75473922902495,43,15,480,3,466
549,82,46,141.89714285714285,143.33678004535147,42,43,72,1,36
550,82,46,141.89714285714285,143.40643990929706,42,42,74,2,36
551,82,23,141.89714285714285,144.7764172335601,42,41,137,3,59
552,82,207,141.89714285714285,143.36,42,29,140,1,125
553,82,207,141.89714285714285,143.40643990929706,42,27,141,2,125
554,82,480,141.89714285714285,143.75473922902495,42,15,406,2,398
555,82,410,141.89714285714285,144.5906575963719,42,27,348,3,328
556,46,23,143.33678004535147,144.7764172335601,43,41,66,1,23
557,46,381,143.33678004535147,145.14793650793652,43,30,344,2,335
558,46,390,143.33678004535147,145.63555555555556,43,30,358,2,344
559,46,410,143.33678004535147,144.5906575963719,43,27,368,1,364
560,46,414,143.33678004535147,145.7748752834467,43,29,383,2,368
561,46,23,143.40643990929706,144.7764172335601,42,41,63,1,23
562,46,83,143.40643990929706,146.35537414965987,42,45,132,3,37
563,46,381,143.40643990929706,145.14793650793652,42,30,343,2,335
564,46,390,143.40643990929706,145.63555555555556,42,30,357,2,344
565,46,410,143.40643990929706,144.5906575963719,42,27,368,1,364
566,46,414,143.40643990929706,145.7748752834467,42,29,382,2,368
567,23,83,144.7764172335601,146.35537414965987,41,45,91,2,60
568,23,15,144.7764172335601,146.44825396825397,41,46,72,2,8
569,23,301,144.7764172335601,146.70367346938775,41,25,290,2,278
570,23,416,144.7764172335601,146.49469387755101,41,18,400,2,393
571,83,6,146.35537414965987,148.12009070294786,45,50,108,2,77
572,83,6,146.35537414965987,149.141768707483,45,50,143,3,77
573,83,366,146.35537414965987,148.23619047619047,45,31,294,2,283
574,83,307,146.35537414965987,148.95600907029478,45,31,250,3,224
575,83,418,146.35537414965987,148.07365079365078,45,24,343,2,335
576,83,424,146.35537414965987,149.09532879818593,45,22,361,3,341
577,15,6,146.44825396825397,148.12009070294786,46,50,73,2,9
578,15,6,146.44825396825397,149.141768707483,46,50,116,3,9
579,15,366,146.44825396825397,148.23619047619047,46,31,359,2,351
580,15,307,146.44825396825397,148.95600907029478,46,31,311,3,292
581,15,418,146.44825396825397,148.07365079365078,46,24,409,2,403
582,15,424,146.44825396825397,149.09532879818593,46,22,425,3,409
583,6,205,148.12009070294786,149.44362811791385,50,27,207,1,199
584,6,218,148.12009070294786,150.465306122449,50,30,235,2,212
585,6,428,148.12009070294786,150.11700680272108,50,23,431,2,422
586,6,218,149.141768707483,150.465306122449,50,30,220,1,212
587,6,427,149.141768707483,151.11546485260772,50,19,429,2,421
588,6,273,150.16344671201816,152.3693424036281,49,36,283,2,267
589,6,410,150.16344671201816,152.3693424036281,49,25,415,2,404
590,6,273,151.16190476190476,152.3693424036281,50,36,272,1,267
591,6,215,151.16190476190476,153.39102040816326,50,40,230,2,209
592,6,214,151.16190476190476,153.4142403628118,50,38,230,2,208
593,6,410,151.16190476190476,152.3693424036281,50,25,407,1,404
594,6,428,151.16190476190476,153.158820861678,50,21,431,2,422
595,6,215,152.1835827664399,153.39102040816326,50,40,215,1,209
596,6,214,152.1835827664399,153.4142403628118,50,38,215,1,208
597,6,206,152.1835827664399,154.43591836734694,50,25,222,2,200
598,6,419,152.1835827664399,154.15727891156462,50,21,422,2,413
599,6,206,153.20526077097506,154.43591836734694,50,25,207,1,200
600,6,370,153.20526077097506,156.0148752834467,50,30,384,3,364
601,6,429,153.20526077097506,155.17895691609976,50,22,431,2,423
602,6,370,154.2269387755102,156.0148752834467,49,30,372,2,364
603,6,335,154.2269387755102,157.1526530612245,49,32,352,3,329
604,6,429,154.2269387755102,156.2006349206349,49,22,431,2,423
605,6,335,155.24861678004535,157.1526530612245,50,32,339,2,329
606,6,205,155.24861678004535,157.59383219954648,50,27,223,2,199
607,6,429,155.24861678004535,157.22231292517006,50,23,431,2,423
608,6,205,156.247074829932,157.59383219954648,50,27,207,1,199
609,6,218,156.247074829932,158.59229024943312,50,30,235,2,212
610,6,429,156.247074829932,158.2439909297052,50,22,432,2,423
611,6,447,156.247074829932,158.75482993197278,50,21,454,3,441
612,6,218,157.26875283446714,158.59229024943312,50,30,220,1,212
613,6,218,157.26875283446714,159.59074829931973,50,38,234,2,212
614,6,447,157.26875283446714,158.75482993197278,50,21,446,1,441
615,6,5,158.29043083900228,160.33378684807258,50,49,88,2,1
616,6,218,158.29043083900228,159.59074829931973,50,38,219,1,212
617,6,218,158.29043083900228,161.19292517006804,50,35,246,3,212
618,6,425,158.29043083900228,160.264126984127,50,24,428,2,419
619,6,5,159.31210884353743,160.33378684807258,50,49,44,1,1
620,6,218,159.31210884353743,161.19292517006804,50,35,227,2,212
621,6,219,159.31210884353743,161.7037641723356,50,32,237,2,213
622,5,6,160.33378684807258,162.35392290249433,49,50,87,2,1
623,5,219,160.33378684807258,161.7037641723356,49,32,222,1,214
624,5,223,160.33378684807258,163.2130612244898,49,27,251,3,218
625,5,422,160.33378684807258,162.70222222222222,49,21,429,2,417
626,6,223,161.33224489795919,163.2130612244898,50,27,232,2,217
627,6,422,161.33224489795919,162.70222222222222,50,21,420,1,416
628,6,215,162.35392290249433,164.44371882086168,50,37,228,2,209
629,6,216,162.35392290249433,164.46693877551022,50,36,229,2,210
630,6,425,162.35392290249433,164.35083900226758,50,24,428,2,419
631,6,450,162.35392290249433,164.86167800453515,50,21,457,3,444
632,6,215,163.37560090702948,164.44371882086168,50,37,214,1,209
633,6,216,163.37560090702948,164.46693877551022,50,36,215,1,210
634,6,214,163.37560090702948,165.6975963718821,50,39,231,2,208
635,6,450,163.37560090702948,164.86167800453515,50,21,449,1,444
636,6,417,163.37560090702948,165.58149659863946,50,27,422,2,411
637,6,214,164.39727891156463,165.6975963718821,49,39,215,1,208
638,6,220,164.39727891156463,167.0443537414966,49,38,242,3,214
639,6,417,164.39727891156463,165.58149659863946,49,27,414,1,411
640,6,496,164.39727891156463,166.62639455782312,49,24,499,2,490
641,6,5,165.39573696145126,167.46231292517007,49,48,89,2,1
642,6,220,165.39573696145126,167.0443537414966,49,38,225,2,214
643,6,246,165.39573696145126,168.20535147392292,49,34,269,3,240
644,6,496,165.39573696145126,166.62639455782312,49,24,493,1,490
645,6,5,166.4174149659864,167.46231292517007,50,48,45,1,1
646,6,246,166.4174149659864,168.20535147392292,50,34,252,2,240
647,6,329,166.4174149659864,169.13414965986394,50,30,344,3,323
648,6,428,166.4174149659864,168.41433106575965,50,24,431,2,422
649,6,329,167.43909297052156,169.13414965986394,50,30,331,2,323
650,6,211,167.43909297052156,169.7843083900227,50,38,229,2,205
651,6,428,167.43909297052156,169.4360090702948,50,21,431,2,422
652,6,490,167.43909297052156,169.94684807256237,50,21,496,3,484
653,5,6,167.46231292517007,169.48244897959185,48,50,87,2,1
654,5,329,167.46231292517007,169.13414965986394,48,30,332,2,324
655,5,211,167.46231292517007,169.7843083900227,48,38,229,2,206
656,5,428,167.46231292517007,169.4360090702948,48,21,431,2,423
657,5,490,167.46231292517007,169.94684807256237,48,21,497,2,485
658,6,211,168.4607709750567,169.7843083900227,50,38,213,1,205
659,6,214,168.4607709750567,170.85242630385488,50,37,232,2,208
660,6,490,168.4607709750567,169.94684807256237,50,21,488,1,484
661,6,493,168.4607709750567,171.17750566893423,50,20,501,3,487
662,6,214,169.48244897959185,170.85242630385488,50,37,216,1,208
663,6,274,169.48244897959185,172.08308390022677,50,36,290,3,268
664,6,493,169.48244897959185,171.17750566893423,50,20,492,2,487
665,6,427,169.48244897959185,172.08308390022677,50,25,436,3,421
666,6,274,170.48090702947846,172.08308390022677,49,36,277,2,268
667,6,206,170.48090702947846,173.42984126984126,49,35,237,3,200
668,6,427,170.48090702947846,172.08308390022677,49,25,427,2,421
669,6,411,170.48090702947846,173.17442176870748,49,29,421,3,405
670,6,206,171.5025850340136,173.42984126984126,50,35,217,2,200
671,6,224,171.5025850340136,173.87102040816328,50,33,241,2,218
672,6,411,171.5025850340136,173.17442176870748,50,29,411,2,405
673,6,428,171.5025850340136,173.49950113378685,50,20,431,2,422
674,6,224,172.52426303854875,173.87102040816328,50,33,226,1,218
675,6,209,172.52426303854875,174.91591836734693,50,36,228,2,203
676,6,430,172.52426303854875,174.4979591836735,50,20,432,2,424
677,6,209,173.5459410430839,174.91591836734693,50,36,211,1,203
678,6,273,173.5459410430839,176.14657596371882,50,37,290,3,267
679,6,425,173.5459410430839,176.10013605442177,50,26,433,3,419
680,6,273,174.56761904761905,176.14657596371882,50,37,276,2,267
681,6,297,174.56761904761905,177.42367346938775,50,29,316,3,291
682,6,425,174.56761904761905,176.10013605442177,50,26,424,2,419
683,6,411,174.56761904761905,177.00571428571428,50,26,418,2,405
684,6,11,175.56607709750568,177.86485260770976,50,41,99,2,5
685,6,297,175.56607709750568,177.42367346938775,50,29,302,2,291
686,6,296,175.56607709750568,177.67909297052154,50,34,304,2,290
687,6,411,175.56607709750568,177.00571428571428,50,26,410,1,405
688,6,417,175.56607709750568,177.74875283446713,50,19,422,2,411
689,6,11,176.58775510204083,177.86485260770976,50,41,55,1,5
690,6,5,176.58775510204083,178.63111111111112,50,48,88,2,1
691,6,296,176.58775510204083,177.67909297052154,50,34,294,1,290
692,6,218,176.58775510204083,178.95619047619047,50,40,235,2,212
693,6,417,176.58775510204083,177.74875283446713,50,19,414,1,411
694,6,426,176.58775510204083,179.04907029478457,50,25,433,2,420
695,11,6,177.86485260770976,179.65278911564627,41,49,77,2,5
696,11,218,177.86485260770976,178.95619047619047,41,40,212,1,207
697,11,206,177.86485260770976,179.97786848072562,41,32,215,2,195
698,11,426,177.86485260770976,179.04907029478457,41,25,418,1,415
699,11,445,177.86485260770976,179.861768707483,41,23,442,2,434
700,5,6,178.63111111111112,179.65278911564627,48,49,44,1,1
701,5,6,178.63111111111112,181.16208616780045,48,48,109,3,1
702,5,206,178.63111111111112,179.97786848072562,48,32,209,1,201
703,5,205,178.63111111111112,181.06920634920635,48,30,226,2,200
704,5,445,178.63111111111112,179.861768707483,48,23,443,1,440
705,6,205,179.65278911564627,181.06920634920635,49,30,208,1,199
706,6,205,179.65278911564627,182.41596371882088,49,30,232,3,199
707,6,452,179.65278911564627,182.04444444444445,49,24,458,2,446
708,6,205,181.16208616780045,182.41596371882088,48,30,206,1,199
709,6,214,181.16208616780045,183.1590022675737,48,29,225,2,208
710,6,374,181.16208616780045,183.53052154195012,48,33,382,2,368
711,6,412,181.16208616780045,183.39120181405897,48,21,417,2,406
712,6,412,181.16208616780045,183.9717006802721,48,21,424,3,406
713,6,214,181.67292517006803,183.1590022675737,49,29,218,1,208
714,6,374,181.67292517006803,183.53052154195012,49,33,377,2,368
715,6,412,181.67292517006803,183.39120181405897,49,21,413,2,406
716,6,412,181.67292517006803,183.9717006802721,49,21,418,2,406
717,6,218,182.69460317460317,184.78439909297052,49,25,230,2,212
718,6,412,182.69460317460317,183.9717006802721,49,21,410,1,406
719,6,218,183.71628117913832,184.78439909297052,50,25,217,1,212
720,6,214,183.71628117913832,186.03827664399094,50,27,231,2,208
721,6,491,183.71628117913832,185.96861678004535,50,20,495,2,485
722,6,214,184.73795918367347,186.03827664399094,49,27,215,1,208
723,6,218,184.73795918367347,187.03673469387755,49,38,234,2,212
724,6,221,184.73795918367347,187.66367346938776,49,31,249,3,215
725,6,491,184.73795918367347,185.96861678004535,49,20,488,1,485
726,6,450,184.73795918367347,186.85097505668935,49,20,453,2,444
727,6,218,185.7364172335601,187.03673469387755,49,38,219,1,212
728,6,221,185.7364172335601,187.66367346938776,49,31,230,2,215
729,6,205,185.7364172335601,188.5924716553288,49,29,234,3,199
730,6,450,185.7364172335601,186.85097505668935,49,20,447,1,444
731,6,427,185.7364172335601,188.29061224489797,49,19,435,3,421
732,6,205,187.26893424036282,188.5924716553288,49,29,207,1,199
733,6,235,187.26893424036282,190.05532879818594,49,30,259,3,229
734,6,427,187.26893424036282,188.29061224489797,49,19,423,1,421
735,6,455,187.26893424036282,190.21786848072563,49,25,467,3,449
736,6,235,187.7797732426304,190.05532879818594,49,30,249,2,229
737,6,455,187.7797732426304,190.21786848072563,49,25,461,2,449
738,6,5,188.80145124716555,190.84480725623584,49,49,88,2,1
739,6,235,188.80145124716555,190.05532879818594,49,30,235,1,229
740,6,216,188.80145124716555,191.37886621315192,49,31,238,3,210
741,6,455,188.80145124716555,190.21786848072563,49,25,453,1,449
742,6,490,188.80145124716555,191.47174603174602,49,20,497,3,484
743,6,5,189.8231292517007,190.84480725623584,49,49,44,1,1
744,6,216,189.8231292517007,191.37886621315192,49,31,220,2,210
745,6,317,189.8231292517007,192.28444444444446,49,29,329,2,311
746,6,490,189.8231292517007,191.47174603174602,49,20,489,2,484
747,6,432,189.8231292517007,192.14512471655328,49,25,438,2,426
748,5,6,190.84480725623584,192.8649433106576,49,49,87,2,1
749,5,317,190.84480725623584,192.28444444444446,49,29,318,1,312
750,5,252,190.84480725623584,193.35256235827666,49,26,270,3,247
751,5,432,190.84480725623584,192.14512471655328,49,25,431,1,427
752,5,429,190.84480725623584,192.81850340136054,49,20,432,2,424
753,6,252,191.84326530612245,193.35256235827666,50,26,254,2,246
754,6,333,191.84326530612245,193.8401814058957,50,25,338,2,327
755,6,4,192.8649433106576,195.5352380952381,49,40,115,3,2
756,6,220,192.8649433106576,194.86185941043084,49,23,231,2,214
757,6,368,192.8649433106576,195.76743764172335,49,27,383,3,362
758,6,411,192.8649433106576,195.21015873015872,49,20,417,2,405
759,6,413,192.8649433106576,195.76743764172335,49,25,426,3,407
760,6,4,193.88662131519274,195.5352380952381,49,40,71,2,2
761,6,368,193.88662131519274,195.76743764172335,49,27,371,2,362
762,6,411,193.88662131519274,195.21015873015872,49,20,409,1,405
763,6,413,193.88662131519274,195.76743764172335,49,25,415,2,407
764,6,16,195.39591836734695,197.11419501133787,49,32,75,2,10
765,6,16,195.39591836734695,197.6714739229025,49,30,99,2,10
766,4,16,195.5352380952381,197.11419501133787,40,32,69,2,12
767,4,16,195.5352380952381,197.6714739229025,40,30,93,2,12
768,16,31,197.11419501133787,199.06467120181406,32,28,85,2,15
769,16,31,197.6714739229025,199.06467120181406,30,28,62,1,15
770,16,6,197.6714739229025,200.45786848072564,30,40,120,3,10
771,16,6,197.6714739229025,200.59718820861679,30,41,126,3,10
772,16,220,197.6714739229025,200.4114285714286,30,15,236,3,204
773,16,226,197.6714739229025,200.59718820861679,30,17,245,3,210
774,31,6,199.06467120181406,200.45786848072564,28,40,65,1,25
775,31,6,199.06467120181406,200.59718820861679,28,41,71,2,25
776,31,220,199.06467120181406,200.4114285714286,28,15,198,1,189
777,31,226,199.06467120181406,200.59718820861679,28,17,206,2,195
778,292,15,8.800362811791384,10.309659863945578,22,43,285,2,277
779,292,14,8.800362811791384,11.586757369614512,22,42,303,3,278
780,292,274,8.800362811791384,10.24,22,21,65,1,18
781,292,426,8.800362811791384,10.263219954648527,22,19,148,1,134
782,292,638,8.800362811791384,10.216780045351474,22,13,351,1,346
783,309,15,9.009342403628118,10.309659863945578,18,43,299,1,294
784,309,14,9.009342403628118,11.586757369614512,18,42,315,3,295
785,309,274,9.009342403628118,10.24,18,21,64,1,35
786,309,426,9.009342403628118,10.263219954648527,18,19,129,1,117
787,309,638,9.009342403628118,10.216780045351474,18,13,333,1,329
788,274,14,10.24,11.586757369614512,21,42,266,1,260
789,274,12,10.24,12.631655328798185,21,43,282,2,262
790,274,208,10.24,12.817414965986394,21,33,129,3,66
791,274,432,10.24,12.956734693877552,21,18,197,3,158
792,274,761,10.24,12.585215419501134,21,14,497,2,487
793,208,14,12.817414965986394,13.885532879818594,33,41,199,1,194
794,208,14,12.817414965986394,14.373151927437641,33,44,205,2,194
795,208,12,12.817414965986394,15.673469387755102,33,44,231,3,196
796,208,213,12.817414965986394,14.187392290249434,33,23,59,1,5
797,208,486,12.817414965986394,14.55891156462585,33,23,288,2,278
798,208,622,12.817414965986394,14.489251700680272,33,14,420,2,414
799,205,12,13.699773242630386,15.673469387755102,25,44,211,2,193
800,205,254,13.699773242630386,16.27718820861678,25,27,121,3,49
801,205,415,13.699773242630386,16.27718820861678,25,19,238,3,210
802,213,12,14.187392290249434,15.673469387755102,23,44,211,1,201
803,213,10,14.187392290249434,16.973786848072564,23,44,236,3,203
804,213,10,14.187392290249434,17.136326530612244,23,44,239,3,203
805,213,254,14.187392290249434,16.27718820861678,23,27,99,2,41
806,213,292,14.187392290249434,17.136326530612244,23,18,150,3,79
807,213,415,14.187392290249434,16.27718820861678,23,19,221,2,202
808,254,12,16.27718820861678,18.204444444444444,27,43,256,2,242
809,254,210,16.27718820861678,18.599183673469387,27,21,109,2,44
810,254,460,16.27718820861678,17.29886621315193,27,13,211,1,206
811,254,414,16.27718820861678,18.413424036281178,27,21,185,2,160
812,292,12,17.136326530612244,18.204444444444444,18,43,284,1,280
813,292,14,17.136326530612244,19.71374149659864,18,44,299,3,278
814,292,210,17.136326530612244,18.599183673469387,18,21,103,1,82
815,292,414,17.136326530612244,18.413424036281178,18,21,134,1,122
816,292,773,17.136326530612244,18.18122448979592,18,15,483,1,481
817,210,14,18.599183673469387,19.71374149659864,21,44,202,1,196
818,210,12,18.599183673469387,20.758639455782312,21,44,219,2,198
819,210,14,18.599183673469387,21.037278911564627,21,43,222,2,196
820,210,334,18.599183673469387,20.712199546485262,21,20,154,2,124
821,210,514,18.599183673469387,20.503219954648525,21,18,315,2,304
822,334,14,20.712199546485262,22.569795918367348,20,45,330,2,320
823,334,12,20.712199546485262,23.1502947845805,20,44,339,2,322
824,334,299,20.712199546485262,21.91963718820862,20,26,63,1,35
825,334,355,20.712199546485262,22.221496598639455,20,23,68,2,21
826,334,421,20.712199546485262,22.267936507936508,20,18,110,2,87
827,334,628,20.712199546485262,22.19827664399093,20,14,301,1,294
828,299,12,21.91963718820862,23.1502947845805,26,44,292,1,287
829,299,12,21.91963718820862,24.055873015873015,26,44,301,2,287
830,355,12,22.221496598639455,24.055873015873015,23,44,352,2,343
831,355,295,22.221496598639455,25.007891156462584,23,24,134,3,60
832,355,417,22.221496598639455,25.007891156462584,23,17,135,3,62
833,295,12,25.007891156462584,26.3546485260771,24,45,289,1,283
834,295,14,25.007891156462584,27.23700680272109,24,44,297,2,281
835,295,245,25.007891156462584,26.05278911564626,24,24,67,1,50
836,295,216,25.007891156462584,27.445986394557824,24,23,131,2,79
837,295,433,25.007891156462584,26.029569160997735,24,18,145,1,138
838,295,433,25.007891156462584,26.05278911564626,24,19,145,1,138
839,295,416,25.007891156462584,27.260226757369615,24,15,155,2,121
840,295,658,25.007891156462584,26.076009070294784,24,14,366,1,363
841,218,14,25.98312925170068,27.23700680272109,28,44,211,1,204
842,218,14,25.98312925170068,28.142585034013607,28,43,224,2,204
843,218,216,25.98312925170068,27.445986394557824,28,23,63,1,2
844,218,308,25.98312925170068,28.95528344671202,28,23,156,3,90
845,218,416,25.98312925170068,27.260226757369615,28,15,205,1,198
846,218,514,25.98312925170068,28.81596371882086,28,21,320,3,296
847,218,636,25.98312925170068,28.81596371882086,28,15,435,3,418
848,245,14,26.05278911564626,27.23700680272109,24,44,237,1,231
849,245,14,26.05278911564626,28.142585034013607,24,43,248,2,231
850,245,216,26.05278911564626,27.445986394557824,24,23,67,1,29
851,245,308,26.05278911564626,28.95528344671202,24,23,140,3,63
852,245,416,26.05278911564626,27.260226757369615,24,15,179,1,171
853,245,514,26.05278911564626,28.81596371882086,24,21,294,3,269
854,245,636,26.05278911564626,28.81596371882086,24,15,409,3,391
855,216,11,27.445986394557824,29.280362811791385,23,43,220,2,205
856,216,90,27.445986394557824,30.093061224489798,23,40,170,3,126
857,216,308,27.445986394557824,28.95528344671202,23,23,113,2,92
858,216,210,27.445986394557824,29.53578231292517,23,28,90,2,6
859,216,514,27.445986394557824,28.81596371882086,23,21,304,1,298
860,216,475,27.445986394557824,29.83764172335601,23,15,279,2,259
861,216,636,27.445986394557824,28.81596371882086,23,15,424,1,420
862,308,90,28.95528344671202,30.093061224489798,23,40,223,1,218
863,308,318,28.95528344671202,30.812879818594105,23,24,81,2,10
864,308,295,28.95528344671202,31.7881179138322,23,25,123,3,13
865,308,411,28.95528344671202,30.65034013605442,23,15,126,2,103
866,308,414,28.95528344671202,31.648798185941043,23,20,157,3,106
867,308,625,28.95528344671202,31.71845804988662,23,13,339,3,317
868,210,83,29.53578231292517,32.066757369614514,28,41,167,3,127
869,210,83,29.53578231292517,32.345396825396826,28,41,175,3,127
870,210,318,29.53578231292517,30.812879818594105,28,24,121,1,108
871,210,295,29.53578231292517,31.7881179138322,28,25,129,2,85
872,210,277,29.53578231292517,32.48471655328798,28,22,144,3,67
873,210,411,29.53578231292517,30.65034013605442,28,15,207,1,201
874,210,414,29.53578231292517,31.648798185941043,28,20,223,2,204
875,210,414,29.53578231292517,32.46149659863946,28,20,240,3,204
876,210,625,29.53578231292517,31.71845804988662,28,13,426,2,415
877,318,83,30.812879818594105,32.066757369614514,24,41,241,1,235
878,318,83,30.812879818594105,32.345396825396826,24,41,244,2,235
879,318,5,30.812879818594105,33.73859410430839,24,45,337,3,313
880,318,277,30.812879818594105,32.48471655328798,24,22,83,2,41
881,318,414,30.812879818594105,32.46149659863946,24,20,119,2,96
882,318,646,30.812879818594105,33.69215419501134,24,19,351,3,328
883,295,5,31.7881179138322,33.73859410430839,25,45,302,2,290
884,295,6,31.7881179138322,34.22621315192744,25,50,307,2,289
885,295,213,31.7881179138322,33.99401360544218,25,35,125,2,82
886,295,208,31.7881179138322,34.69061224489796,25,26,152,3,87
887,295,427,31.7881179138322,33.99401360544218,25,22,163,2,132
888,295,499,31.7881179138322,34.71383219954649,25,22,240,3,204
889,295,646,31.7881179138322,33.69215419501134,25,19,360,2,351
890,295,771,31.7881179138322,34.644172335600906,25,23,492,3,476
891,277,5,32.48471655328798,33.73859410430839,22,45,277,1,272
892,277,6,32.48471655328798,34.22621315192744,22,50,281,2,271
893,277,6,32.48471655328798,35.247891156462586,22,49,296,3,271
894,277,213,32.48471655328798,33.99401360544218,22,35,91,2,64
895,277,208,32.48471655328798,34.69061224489796,22,26,117,2,69
896,277,337,32.48471655328798,35.131791383219955,22,29,129,3,60
897,277,427,32.48471655328798,33.99401360544218,22,22,163,2,150
898,277,499,32.48471655328798,34.71383219954649,22,22,242,2,222
899,277,646,32.48471655328798,33.69215419501134,22,19,373,1,369
900,277,771,32.48471655328798,34.644172335600906,22,23,503,2,494
901,213,6,33.99401360544218,35.247891156462586,35,49,214,1,207
902,213,6,33.99401360544218,36.24634920634921,35,50,229,2,207
903,213,337,33.99401360544218,35.131791383219955,35,29,133,1,124
904,213,499,33.99401360544218,35.735510204081635,35,21,296,2,286
905,213,538,33.99401360544218,36.664308390022676,35,23,345,3,325
906,213,687,33.99401360544218,35.71229024943311,35,15,480,2,474
907,213,630,33.99401360544218,36.5946485260771,35,20,432,3,417
908,208,6,34.69061224489796,36.24634920634921,26,50,213,2,202
909,208,6,34.69061224489796,37.268027210884355,26,51,230,3,202
910,208,213,34.69061224489796,36.73396825396826,26,27,88,2,5
911,208,499,34.69061224489796,35.735510204081635,26,21,294,1,291
912,208,538,34.69061224489796,36.664308390022676,26,23,341,2,330
913,208,687,34.69061224489796,35.71229024943311,26,15,481,1,479
914,208,630,34.69061224489796,36.5946485260771,26,20,430,2,422
915,337,6,35.131791383219955,36.24634920634921,29,50,334,1,331
916,337,6,35.131791383219955,37.268027210884355,29,51,344,2,331
917,337,213,35.131791383219955,36.73396825396826,29,27,142,2,124
918,337,327,35.131791383219955,38.080725623582765,29,27,127,3,10
919,337,538,35.131791383219955,36.664308390022676,29,23,212,2,201
920,337,438,35.131791383219955,37.755646258503404,29,18,152,3,101
921,337,630,35.131791383219955,36.5946485260771,29,20,300,1,293
922,337,687,35.131791383219955,37.755646258503404,29,18,368,3,350
923,213,6,36.73396825396826,38.2897052154195,27,50,218,2,207
924,213,6,36.73396825396826,39.31138321995465,27,50,235,3,207
925,213,327,36.73396825396826,38.080725623582765,27,27,128,1,114
926,213,217,36.73396825396826,39.05596371882086,27,36,100,2,4
927,213,215,36.73396825396826,39.497142857142855,27,37,119,3,2
928,213,438,36.73396825396826,37.755646258503404,27,18,229,1,225
929,213,435,36.73396825396826,38.521904761904764,27,22,235,2,222
930,213,687,36.73396825396826,37.755646258503404,27,18,476,1,474
931,213,637,36.73396825396826,38.846984126984125,27,22,434,2,424
932,327,6,38.080725623582765,39.31138321995465,27,50,325,1,321
933,327,6,38.080725623582765,40.30984126984127,27,49,335,2,321
934,327,215,38.080725623582765,39.497142857142855,27,37,128,1,112
935,327,332,38.080725623582765,40.12408163265306,27,26,88,2,5
936,327,429,38.080725623582765,39.7990022675737,27,23,126,2,102
937,327,478,38.080725623582765,40.79746031746032,27,20,191,3,151
938,327,718,38.080725623582765,39.9847619047619,27,15,400,2,391
939,327,753,38.080725623582765,40.84390022675737,27,13,442,3,426
940,217,6,39.05596371882086,40.30984126984127,36,49,218,1,211
941,217,6,39.05596371882086,41.33151927437642,36,50,233,2,211
942,217,332,39.05596371882086,40.12408163265306,36,26,124,1,115
943,217,278,39.05596371882086,41.633378684807255,36,29,127,3,61
944,217,478,39.05596371882086,40.79746031746032,36,20,272,2,261
945,217,545,39.05596371882086,41.56371882086168,36,25,345,3,328
946,217,626,39.05596371882086,41.56371882086168,36,19,423,3,409
947,215,6,39.497142857142855,41.33151927437642,37,50,223,2,209
948,215,6,39.497142857142855,42.353197278911566,37,50,243,3,209
949,215,278,39.497142857142855,41.633378684807255,37,29,112,2,63
950,215,478,39.497142857142855,40.79746031746032,37,20,269,1,263
951,215,545,39.497142857142855,41.56371882086168,37,25,342,2,330
952,215,626,39.497142857142855,41.56371882086168,37,19,421,2,411
953,215,682,39.497142857142855,42.306757369614516,37,15,482,3,467
954,332,6,40.12408163265306,41.33151927437642,26,50,330,1,326
955,332,6,40.12408163265306,42.353197278911566,26,50,340,2,326
956,332,278,40.12408163265306,41.633378684807255,26,29,85,2,54
957,332,214,40.12408163265306,42.49251700680272,26,27,156,2,118
958,332,545,40.12408163265306,41.56371882086168,26,25,222,1,213
959,332,429,40.12408163265306,42.840816326530614,26,19,152,3,97
960,332,626,40.12408163265306,41.56371882086168,26,19,300,1,294
961,332,682,40.12408163265306,42.306757369614516,26,15,362,2,350
962,278,6,41.633378684807255,43.37487528344671,29,50,282,2,272
963,278,6,41.633378684807255,44.39655328798186,29,49,297,3,272
964,278,301,41.633378684807255,43.444535147392294,29,27,81,2,23
965,278,292,41.633378684807255,44.55909297052154,29,32,127,3,14
966,278,429,41.633378684807255,42.840816326530614,29,19,160,1,151
967,278,512,41.633378684807255,43.769614512471655,29,23,251,2,234
968,278,415,41.633378684807255,44.489433106575966,29,25,184,3,137
969,278,661,41.633378684807255,43.86249433106576,29,14,395,2,383
970,214,6,42.49251700680272,44.39655328798186,27,49,224,2,208
971,214,6,42.49251700680272,45.39501133786848,27,49,243,3,208
972,214,292,42.49251700680272,44.55909297052154,27,32,118,2,78
973,214,512,42.49251700680272,43.769614512471655,27,23,303,1,298
974,214,415,42.49251700680272,44.489433106575966,27,25,219,2,201
975,214,661,42.49251700680272,43.86249433106576,27,14,451,1,447
976,301,6,43.444535147392294,45.39501133786848,27,49,307,2,295
977,301,6,43.444535147392294,46.41668934240363,27,50,322,3,295
978,301,292,43.444535147392294,44.55909297052154,27,32,49,1,9
979,301,218,43.444535147392294,45.97551020408164,27,32,137,3,83
980,301,415,43.444535147392294,44.489433106575966,27,25,123,1,114
981,301,547,43.444535147392294,45.60399092970522,27,23,263,2,246
982,301,750,43.444535147392294,44.76807256235828,27,18,453,1,449
983,301,743,43.444535147392294,45.627210884353744,27,23,452,2,442
984,292,6,44.55909297052154,46.41668934240363,32,50,297,2,286
985,292,6,44.55909297052154,47.438367346938776,32,50,312,3,286
986,292,218,44.55909297052154,45.97551020408164,32,32,96,1,74
987,292,364,44.55909297052154,46.602448979591834,32,31,114,2,72
988,292,215,44.55909297052154,47.391927437641726,32,34,144,3,77
989,292,547,44.55909297052154,45.60399092970522,32,23,259,1,255
990,292,449,44.55909297052154,46.9275283446712,32,20,187,2,157
991,292,743,44.55909297052154,45.627210884353744,32,23,453,1,451
992,292,687,44.55909297052154,46.90430839002268,32,17,408,2,395
993,292,624,44.55909297052154,47.18294784580499,32,23,351,3,332
994,218,6,45.97551020408164,47.438367346938776,32,50,221,1,212
995,218,6,45.97551020408164,48.46004535147392,32,51,237,2,212
996,218,215,45.97551020408164,47.391927437641726,32,34,61,1,3
997,218,219,45.97551020408164,48.29750566893424,32,28,100,2,1
998,218,438,45.97551020408164,47.925986394557825,32,23,235,2,220
999,218,423,45.97551020408164,48.92444444444445,32,19,241,3,205
1000,218,624,45.97551020408164,47.18294784580499,32,23,409,1,406
1001,218,621,45.97551020408164,48.92444444444445,32,16,423,3,403
1002,364,6,46.602448979591834,48.46004535147392,31,51,367,2,358
1003,364,6,46.602448979591834,49.48172335600907,31,50,379,3,358
1004,364,219,46.602448979591834,48.29750566893424,31,28,162,2,145
1005,364,438,46.602448979591834,47.925986394557825,31,23,93,1,74
1006,364,423,46.602448979591834,48.92444444444445,31,19,116,2,59
1007,364,621,46.602448979591834,48.92444444444445,31,16,276,2,257
1008,364,633,46.602448979591834,49.22630385487528,31,17,292,3,269
1009,215,6,47.391927437641726,48.46004535147392,34,51,214,1,209
1010,215,6,47.391927437641726,49.48172335600907,34,50,228,2,209
1011,215,293,47.391927437641726,50.062222222222225,34,27,139,3,78
1012,215,423,47.391927437641726,48.92444444444445,34,19,218,2,208
1013,215,499,47.391927437641726,49.96934240362812,34,19,305,3,284
1014,215,621,47.391927437641726,48.92444444444445,34,16,411,2,406
1015,215,633,47.391927437641726,49.22630385487528,34,17,425,2,418
1016,219,6,48.29750566893424,49.48172335600907,28,50,219,1,213
1017,219,6,48.29750566893424,50.48018140589569,28,50,233,2,213
1018,219,293,48.29750566893424,50.062222222222225,28,27,106,2,74
1019,219,220,48.29750566893424,50.549841269841274,28,37,97,2,1
1020,219,499,48.29750566893424,49.96934240362812,28,19,289,2,280
1021,219,436,48.29750566893424,50.80526077097506,28,21,242,3,217
1022,293,6,50.062222222222225,51.50185941043084,27,50,294,1,287
1023,293,6,50.062222222222225,52.523537414965986,27,50,306,2,287
1024,293,227,50.062222222222225,51.7340589569161,27,32,98,2,66
1025,293,230,50.062222222222225,52.98793650793651,27,27,141,3,63
1026,293,437,50.062222222222225,51.98947845804989,27,20,166,2,144
1027,293,440,50.062222222222225,52.98793650793651,27,20,194,3,147
1028,293,682,50.062222222222225,51.66439909297052,27,21,395,2,389
1029,293,647,50.062222222222225,53.011156462585035,27,16,376,3,354
1030,220,6,50.549841269841274,52.523537414965986,37,50,230,2,214
1031,220,227,50.549841269841274,51.7340589569161,37,32,51,1,7
1032,220,230,50.549841269841274,52.98793650793651,37,27,105,2,10
1033,220,437,50.549841269841274,51.98947845804989,37,20,226,1,217
1034,220,440,50.549841269841274,52.98793650793651,37,20,244,2,220
1035,220,682,50.549841269841274,51.66439909297052,37,21,464,1,462
1036,220,647,50.549841269841274,53.011156462585035,37,16,440,2,427
1037,227,6,51.7340589569161,53.54521541950113,32,50,234,2,221
1038,227,6,51.7340589569161,54.56689342403628,32,50,252,3,221
1039,227,230,51.7340589569161,52.98793650793651,32,27,54,1,3
1040,227,230,51.7340589569161,54.00961451247166,32,25,98,2,3
1041,227,440,51.7340589569161,52.98793650793651,32,20,220,1,213
1042,227,443,51.7340589569161,54.00961451247166,32,19,237,2,216
1043,227,647,51.7340589569161,53.011156462585035,32,16,424,1,420
1044,227,646,51.7340589569161,54.03283446712018,32,14,431,2,419
1045,230,6,52.98793650793651,54.56689342403628,27,50,234,2,224
1046,230,6,52.98793650793651,55.5653514739229,27,49,250,3,224
1047,230,227,52.98793650793651,54.31147392290249,27,35,57,1,3
1048,230,213,52.98793650793651,55.77433106575964,27,31,121,3,17
1049,230,443,52.98793650793651,54.00961451247166,27,19,217,1,213
1050,230,429,52.98793650793651,55.031292517006804,27,21,218,2,199
1051,230,646,52.98793650793651,54.03283446712018,27,14,418,1,416
1052,230,647,52.98793650793651,55.05451247165533,27,17,426,2,417
1053,230,6,54.00961451247166,55.5653514739229,25,49,234,2,224
1054,230,6,54.00961451247166,56.58702947845805,25,50,250,3,224
1055,230,213,54.00961451247166,55.77433106575964,25,31,78,2,17
1056,230,211,54.00961451247166,56.21551020408163,25,30,97,2,19
1057,230,429,54.00961451247166,55.031292517006804,25,21,204,1,199
1058,230,491,54.00961451247166,56.029750566893426,25,21,275,2,261
1059,230,647,54.00961451247166,55.05451247165533,25,17,419,1,417
1060,227,6,54.31147392290249,55.5653514739229,35,49,228,1,221
1061,227,6,54.31147392290249,56.58702947845805,35,50,242,2,221
1062,227,213,54.31147392290249,55.77433106575964,35,31,65,1,14
1063,227,211,54.31147392290249,56.21551020408163,35,30,84,2,16
1064,227,491,54.31147392290249,56.029750566893426,35,21,274,2,264
1065,227,429,54.31147392290249,57.05142857142857,35,18,234,3,202
1066,227,620,54.31147392290249,57.05142857142857,35,13,410,3,393
1067,213,6,55.77433106575964,57.608707482993196,31,50,222,2,207
1068,213,6,55.77433106575964,58.63038548752834,31,50,241,3,207
1069,213,245,55.77433106575964,58.07310657596372,31,31,104,2,32
1070,213,241,55.77433106575964,58.212426303854876,31,31,109,2,28
1071,213,429,55.77433106575964,57.05142857142857,31,18,223,1,216
1072,213,429,55.77433106575964,58.096326530612245,31,21,238,2,216
1073,213,620,55.77433106575964,57.05142857142857,31,13,411,1,407
1074,211,6,56.21551020408163,57.608707482993196,30,50,214,1,205
1075,211,6,56.21551020408163,58.63038548752834,30,50,230,2,205
1076,211,245,56.21551020408163,58.07310657596372,30,31,87,2,34
1077,211,241,56.21551020408163,58.212426303854876,30,31,91,2,30
1078,211,429,56.21551020408163,58.096326530612245,30,21,233,2,218
1079,211,412,56.21551020408163,59.025124716553286,30,25,235,3,201
1080,245,6,58.07310657596372,59.65206349206349,31,50,248,2,239
1081,245,8,58.07310657596372,60.48798185941043,31,46,259,2,237
1082,245,209,58.07310657596372,59.512743764172335,31,27,72,1,36
1083,245,266,58.07310657596372,61.045260770975055,31,33,130,3,21
1084,245,423,58.07310657596372,59.55918367346939,31,20,189,1,178
1085,245,615,58.07310657596372,59.60562358276644,31,14,376,2,370
1086,241,6,58.212426303854876,59.65206349206349,31,50,243,1,235
1087,241,8,58.212426303854876,60.48798185941043,31,46,253,2,233
1088,241,209,58.212426303854876,59.512743764172335,31,27,64,1,32
1089,241,266,58.212426303854876,61.045260770975055,31,33,125,3,25
1090,241,423,58.212426303854876,59.55918367346939,31,20,191,1,182
1091,241,410,58.212426303854876,61.11492063492064,31,17,210,3,169
1092,241,615,58.212426303854876,59.60562358276644,31,14,379,1,374
1093,209,6,59.512743764172335,61.67219954648526,27,50,223,2,203
1094,209,266,59.512743764172335,61.045260770975055,27,33,87,2,57
1095,209,216,59.512743764172335,61.99727891156463,27,27,107,2,7
1096,209,410,59.512743764172335,61.11492063492064,27,17,213,2,201
1097,209,418,59.512743764172335,61.881179138322,27,22,233,2,209
1098,209,414,59.512743764172335,62.15981859410431,27,20,235,3,205
1099,266,6,61.045260770975055,62.69387755102041,33,50,270,2,260
1100,266,6,61.045260770975055,63.715555555555554,33,50,284,3,260
1101,266,205,61.045260770975055,62.64743764172336,33,24,92,2,61
1102,266,205,61.045260770975055,63.947755102040816,33,25,139,3,61
1103,266,414,61.045260770975055,62.15981859410431,33,20,156,1,148
1104,266,651,61.045260770975055,63.947755102040816,33,17,405,3,385
1105,216,6,61.99727891156463,63.715555555555554,27,50,223,2,210
1106,216,6,61.99727891156463,64.7372335600907,27,50,241,3,210
1107,216,205,61.99727891156463,63.947755102040816,27,25,85,2,11
1108,216,205,61.99727891156463,64.76045351473923,27,24,120,3,11
1109,216,456,61.99727891156463,64.1102947845805,27,20,257,2,240
1110,216,463,61.99727891156463,64.17995464852608,27,20,264,2,247
1111,216,651,61.99727891156463,63.947755102040816,27,17,443,2,435
1112,216,646,61.99727891156463,64.2031746031746,27,16,440,2,430
1113,205,6,62.64743764172336,63.715555555555554,24,50,204,1,199
1114,205,6,62.64743764172336,64.7372335600907,24,50,218,2,199
1115,205,456,62.64743764172336,64.1102947845805,24,20,259,1,251
1116,205,463,62.64743764172336,64.17995464852608,24,20,266,2,258
1117,205,651,62.64743764172336,63.947755102040816,24,17,450,1,446
1118,205,646,62.64743764172336,64.2031746031746,24,16,446,2,441
1119,205,655,62.64743764172336,65.48027210884354,24,20,466,3,450
1120,205,6,63.947755102040816,65.73569160997732,25,50,213,2,199
1121,205,6,63.947755102040816,66.75736961451247,25,50,233,3,199
1122,205,387,63.947755102040816,66.20009070294785,25,23,206,2,182
1123,205,428,63.947755102040816,65.68925170068027,25,19,235,2,223
1124,205,438,63.947755102040816,66.22331065759637,25,21,253,2,233
1125,205,655,63.947755102040816,65.48027210884354,25,20,455,2,450
1126,205,645,63.947755102040816,66.22331065759637,25,13,451,2,440
1127,205,6,64.76045351473923,66.75736961451247,24,50,217,2,199
1128,205,387,64.76045351473923,66.20009070294785,24,23,192,1,182
1129,205,438,64.76045351473923,66.22331065759637,24,21,241,1,233
1130,205,438,64.76045351473923,67.24498866213152,24,21,256,2,233
1131,205,645,64.76045351473923,66.22331065759637,24,13,444,1,440
1132,205,6,65.66603174603175,66.75736961451247,27,50,204,1,199
1133,205,6,65.66603174603175,67.77904761904762,27,51,219,2,199
1134,205,6,65.66603174603175,68.28988662131519,27,49,229,3,199
1135,205,438,65.66603174603175,67.24498866213152,27,21,243,2,233
1136,205,640,65.66603174603175,68.08090702947845,27,15,447,2,435
1137,387,6,66.20009070294785,67.77904761904762,23,51,387,2,381
1138,387,6,66.20009070294785,68.28988662131519,23,49,391,2,381
1139,387,205,66.20009070294785,67.96480725623583,23,24,197,2,182
1140,387,244,66.20009070294785,69.14902494331066,23,32,191,3,143
1141,387,438,66.20009070294785,67.24498866213152,23,21,68,1,51
1142,387,432,66.20009070294785,68.98648526077098,23,22,128,3,45
1143,387,640,66.20009070294785,68.08090702947845,23,15,266,2,253
1144,387,658,66.20009070294785,68.94004535147393,23,17,296,3,271
1145,205,6,67.96480725623583,69.82240362811791,24,50,214,2,199
1146,205,6,67.96480725623583,70.82086167800453,24,50,234,3,199
1147,205,244,67.96480725623583,69.14902494331066,24,32,64,1,39
1148,205,267,67.96480725623583,69.19546485260771,24,28,82,1,62
1149,205,432,67.96480725623583,68.98648526077098,24,22,231,1,227
1150,205,467,67.96480725623583,69.40444444444445,24,16,269,1,262
1151,205,517,67.96480725623583,70.6118820861678,24,20,332,3,312
1152,244,6,69.14902494331066,70.82086167800453,32,50,249,2,238
1153,244,6,69.14902494331066,71.84253968253968,32,50,265,3,238
1154,244,367,69.14902494331066,71.0530612244898,32,29,148,2,123
1155,244,220,69.14902494331066,71.26204081632653,32,31,94,2,24
1156,244,517,69.14902494331066,70.6118820861678,32,20,280,1,273
1157,244,415,69.14902494331066,71.28526077097506,32,14,194,2,171
1158,244,655,69.14902494331066,71.02984126984127,32,17,419,2,411
1159,244,732,69.14902494331066,71.28526077097506,32,14,497,2,488
1160,267,6,69.19546485260771,70.82086167800453,28,50,270,2,261
1161,267,6,69.19546485260771,71.84253968253968,28,50,285,3,261
1162,267,367,69.19546485260771,71.0530612244898,28,29,128,2,100
1163,267,220,69.19546485260771,71.26204081632653,28,31,101,2,47
1164,267,517,69.19546485260771,70.6118820861678,28,20,257,1,250
1165,267,415,69.19546485260771,71.28526077097506,28,14,173,2,148
1166,267,655,69.19546485260771,71.02984126984127,28,17,396,2,388
1167,267,732,69.19546485260771,71.28526077097506,28,14,474,2,465
1168,367,6,71.0530612244898,72.35337868480725,29,51,365,1,361
1169,367,6,71.0530612244898,73.3750566893424,29,50,375,2,361
1170,367,223,71.0530612244898,72.2140589569161,29,19,152,1,144
1171,367,288,71.0530612244898,73.21251700680273,29,23,122,2,79
1172,367,444,71.0530612244898,72.28371882086168,29,15,93,1,77
1173,367,543,71.0530612244898,73.32861678004535,29,23,201,2,176
1174,367,627,71.0530612244898,73.32861678004535,29,18,278,2,260
1175,220,6,71.26204081632653,72.35337868480725,31,51,219,1,214
1176,220,6,71.26204081632653,73.3750566893424,31,50,233,2,214
1177,220,288,71.26204081632653,73.21251700680273,31,23,108,2,68
1178,220,444,71.26204081632653,72.28371882086168,31,15,228,1,224
1179,220,543,71.26204081632653,73.32861678004535,31,23,335,2,323
1180,220,627,71.26204081632653,73.32861678004535,31,18,417,2,407
1181,223,6,72.2140589569161,73.3750566893424,19,50,223,1,217
1182,223,6,72.2140589569161,74.39673469387755,19,50,236,2,217
1183,223,280,72.2140589569161,75.16299319727891,19,27,139,3,57
1184,223,543,72.2140589569161,73.32861678004535,19,23,324,1,320
1185,223,460,72.2140589569161,74.3502947845805,19,23,254,2,237
1186,223,627,72.2140589569161,73.32861678004535,19,18,407,1,404
1187,223,621,72.2140589569161,75.11655328798186,19,16,417,3,398
1188,288,6,73.21251700680273,74.39673469387755,23,50,287,1,282
1189,288,6,73.21251700680273,75.90603174603174,23,50,305,3,282
1190,288,280,73.21251700680273,75.16299319727891,23,27,84,2,8
1191,288,218,73.21251700680273,75.3255328798186,23,27,115,2,70
1192,288,460,73.21251700680273,74.3502947845805,23,23,179,1,172
1193,288,451,73.21251700680273,75.60417233560091,23,15,193,2,163
1194,288,621,73.21251700680273,75.11655328798186,23,16,343,2,333
1195,280,6,75.16299319727891,76.92770975056689,27,50,284,2,274
1196,280,6,75.16299319727891,77.43854875283446,27,50,291,2,274
1197,280,208,75.16299319727891,76.64907029478458,27,15,96,1,72
1198,280,207,75.16299319727891,77.57786848072563,27,30,127,2,73
1199,280,413,75.16299319727891,77.29922902494332,27,14,162,2,133
1200,218,6,75.3255328798186,76.92770975056689,27,50,223,2,212
1201,218,6,75.3255328798186,77.43854875283446,27,50,231,2,212
1202,218,208,75.3255328798186,76.64907029478458,27,15,58,1,10
1203,218,207,75.3255328798186,77.57786848072563,27,30,98,2,11
1204,218,413,75.3255328798186,77.29922902494332,27,14,213,2,195
1205,208,6,76.64907029478458,78.97106575963718,15,51,225,2,202
1206,208,6,76.64907029478458,79.48190476190476,15,50,236,3,202
1207,208,306,76.64907029478458,78.32090702947846,15,18,122,2,98
1208,208,467,76.64907029478458,78.76208616780046,15,21,275,2,259
1209,208,412,76.64907029478458,79.43546485260771,15,19,237,3,204
1210,208,657,76.64907029478458,78.78530612244899,15,14,458,2,449
1211,207,6,77.57786848072563,78.97106575963718,30,51,210,1,201
1212,207,6,77.57786848072563,79.48190476190476,30,50,217,2,201
1213,207,244,77.57786848072563,79.87664399092971,30,25,106,2,37
1214,207,290,77.57786848072563,80.2249433106576,30,18,141,3,83
1215,207,467,77.57786848072563,78.76208616780046,30,21,265,1,260
1216,207,412,77.57786848072563,79.43546485260771,30,19,220,2,205
1217,207,657,77.57786848072563,78.78530612244899,30,14,453,1,450
1218,306,6,78.32090702947846,79.48190476190476,18,50,304,1,300
1219,306,6,78.32090702947846,80.99120181405895,18,50,321,3,300
1220,306,244,78.32090702947846,79.87664399092971,18,25,91,2,62
1221,306,290,78.32090702947846,80.2249433106576,18,18,84,2,16
1222,306,412,78.32090702947846,79.43546485260771,18,19,116,1,106
1223,244,6,79.87664399092971,80.99120181405895,25,50,243,1,238
1224,244,6,79.87664399092971,82.0128798185941,25,50,255,2,238
1225,244,6,79.87664399092971,82.52371882086167,25,51,264,3,238
1226,244,209,79.87664399092971,81.96643990929705,25,34,97,2,35
1227,244,444,79.87664399092971,81.92,25,19,219,2,200
1228,244,422,79.87664399092971,82.361179138322,25,14,208,2,178
1229,290,6,80.2249433106576,82.0128798185941,18,50,294,2,284
1230,290,6,80.2249433106576,82.52371882086167,18,51,301,2,284
1231,290,209,80.2249433106576,81.96643990929705,18,34,110,2,81
1232,290,249,80.2249433106576,82.94167800453515,18,24,124,3,41
1233,290,444,80.2249433106576,81.92,18,19,170,2,154
1234,290,422,80.2249433106576,82.361179138322,18,14,161,2,132
1235,209,6,81.96643990929705,83.54539682539682,34,51,214,2,203
1236,209,6,81.96643990929705,84.56707482993197,34,50,232,3,203
1237,209,233,81.96643990929705,83.4292970521542,34,26,67,1,24
1238,209,206,81.96643990929705,84.7760544217687,34,17,121,3,3
1239,209,507,81.96643990929705,83.73115646258503,34,22,308,2,298
1240,209,654,81.96643990929705,83.73115646258503,34,18,451,2,445
1241,249,6,82.94167800453515,84.56707482993197,24,50,253,2,243
1242,249,206,82.94167800453515,84.7760544217687,24,17,90,2,43
1243,249,523,82.94167800453515,85.8441723356009,24,20,301,3,274
1244,249,717,82.94167800453515,85.72807256235828,24,16,483,3,468
1245,233,6,83.4292970521542,84.56707482993197,26,50,232,1,227
1246,233,6,83.4292970521542,86.07637188208616,26,49,254,3,227
1247,233,206,83.4292970521542,84.7760544217687,26,17,64,1,27
1248,233,320,83.4292970521542,85.98349206349206,26,24,140,3,87
1249,233,218,83.4292970521542,86.40145124716554,26,32,129,3,15
1250,233,523,83.4292970521542,85.8441723356009,26,20,308,2,290
1251,233,717,83.4292970521542,85.72807256235828,26,16,494,2,484
1252,206,6,84.7760544217687,86.07637188208616,17,49,208,1,200
1253,206,6,84.7760544217687,87.09804988662131,17,51,224,2,200
1254,206,6,84.7760544217687,87.60888888888888,17,50,234,3,200
1255,206,320,84.7760544217687,85.98349206349206,17,24,125,1,114
1256,206,218,84.7760544217687,86.40145124716554,17,32,71,2,12
1257,206,274,84.7760544217687,87.42312925170069,17,22,133,3,68
1258,206,523,84.7760544217687,85.8441723356009,17,20,320,1,317
1259,206,425,84.7760544217687,86.819410430839,17,18,236,2,219
1260,206,615,84.7760544217687,87.00517006802721,17,14,420,2,409
1261,320,6,85.98349206349206,87.09804988662131,24,51,318,1,314
1262,320,6,85.98349206349206,87.60888888888888,24,50,322,2,314
1263,320,6,85.98349206349206,88.63056689342403,24,50,334,3,314
1264,320,274,85.98349206349206,87.42312925170069,24,22,77,1,46
1265,320,213,85.98349206349206,88.42158730158731,24,29,150,2,107
1266,320,615,85.98349206349206,87.00517006802721,24,14,298,1,295
1267,320,777,85.98349206349206,87.86430839002267,24,14,464,2,457
1268,320,631,85.98349206349206,88.51446712018141,24,17,330,3,311
1269,218,6,86.40145124716554,87.60888888888888,32,50,218,1,212
1270,218,6,86.40145124716554,88.63056689342403,32,50,233,2,212
1271,218,274,86.40145124716554,87.42312925170069,32,22,71,1,56
1272,218,213,86.40145124716554,88.42158730158731,32,29,87,2,5
1273,218,413,86.40145124716554,89.02530612244898,32,15,225,3,195
1274,218,631,86.40145124716554,88.51446712018141,32,17,423,2,413
1275,274,6,87.42312925170069,88.63056689342403,22,50,273,1,268
1276,274,6,87.42312925170069,89.65224489795918,22,50,285,2,268
1277,274,321,87.42312925170069,89.90766439909297,22,18,117,2,47
1278,274,413,87.42312925170069,89.02530612244898,22,15,155,2,139
1279,274,598,87.42312925170069,89.79156462585034,22,22,340,2,324
1280,274,631,87.42312925170069,88.51446712018141,22,17,360,1,357
1281,274,629,87.42312925170069,89.79156462585034,22,22,369,2,355
1282,213,6,88.42158730158731,89.65224489795918,29,50,214,1,207
1283,213,6,88.42158730158731,91.16154195011337,29,50,238,3,207
1284,213,321,88.42158730158731,89.90766439909297,29,18,126,1,108
1285,213,230,88.42158730158731,90.51138321995465,29,36,92,2,17
1286,213,598,88.42158730158731,89.79156462585034,29,22,389,1,385
1287,213,413,88.42158730158731,90.48816326530613,29,23,219,2,200
1288,213,629,88.42158730158731,89.79156462585034,29,22,420,1,416
1289,321,6,89.90766439909297,91.16154195011337,18,50,320,1,315
1290,321,6,89.90766439909297,91.67238095238095,18,50,324,2,315
1291,321,298,89.90766439909297,91.64916099773242,18,30,78,2,23
1292,321,245,89.90766439909297,92.81015873015873,18,30,146,3,76
1293,321,412,89.90766439909297,91.64916099773242,18,24,118,2,91
1294,321,414,89.90766439909297,92.34575963718821,18,26,140,2,93
1295,230,6,90.51138321995465,91.67238095238095,36,50,230,1,224
1296,230,15,90.51138321995465,93.22811791383221,36,45,245,3,215
1297,230,298,90.51138321995465,91.64916099773242,36,30,84,1,68
1298,230,245,90.51138321995465,92.81015873015873,36,30,100,2,15
1299,230,320,90.51138321995465,93.3209977324263,36,26,151,3,90
1300,230,412,90.51138321995465,91.64916099773242,36,24,188,1,182
1301,230,414,90.51138321995465,92.34575963718821,36,26,200,2,184
1302,230,421,90.51138321995465,93.39065759637188,36,22,228,3,191
1303,298,15,91.64916099773242,93.22811791383221,30,45,291,2,283
1304,298,15,91.64916099773242,93.73895691609978,30,45,297,2,283
1305,298,245,91.64916099773242,92.81015873015873,30,30,73,1,53
1306,298,320,91.64916099773242,93.3209977324263,30,26,75,2,22
1307,298,421,91.64916099773242,93.39065759637188,30,22,144,2,123
1308,245,6,92.81015873015873,95.22503401360544,30,49,261,2,239
1309,245,215,92.81015873015873,95.01605442176871,30,35,100,2,30
1310,245,364,92.81015873015873,95.38757369614513,30,30,163,3,119
1311,245,533,92.81015873015873,94.69097505668934,30,19,299,2,288
1312,245,516,92.81015873015873,95.71265306122449,30,21,298,3,271
1313,245,652,92.81015873015873,94.69097505668934,30,16,415,2,407
1314,320,6,93.3209977324263,95.22503401360544,26,49,325,2,314
1315,320,6,93.3209977324263,96.24671201814058,26,50,338,3,314
1316,320,5,93.3209977324263,96.26993197278912,26,49,340,3,315
1317,320,215,93.3209977324263,95.01605442176871,26,35,128,2,105
1318,320,364,93.3209977324263,95.38757369614513,26,30,99,2,44
1319,320,533,93.3209977324263,94.69097505668934,26,19,221,1,213
1320,320,516,93.3209977324263,95.71265306122449,26,21,221,2,196
1321,320,652,93.3209977324263,94.69097505668934,26,16,337,1,332
1322,320,777,93.3209977324263,95.66621315192744,26,22,468,2,457
1323,215,6,95.01605442176871,96.24671201814058,35,50,216,1,209
1324,215,5,95.01605442176871,96.26993197278912,35,49,217,1,210
1325,215,6,95.01605442176871,97.26839002267575,35,50,230,2,209
1326,215,219,95.01605442176871,96.73433106575963,35,26,74,2,4
1327,215,218,95.01605442176871,97.57024943310658,35,28,110,3,3
1328,215,415,95.01605442176871,97.22195011337868,35,22,221,2,200
1329,215,538,95.01605442176871,97.6863492063492,35,23,343,3,323
1330,215,619,95.01605442176871,96.73433106575963,35,15,411,2,404
1331,215,630,95.01605442176871,97.61668934240363,35,21,430,3,415
1332,364,6,95.38757369614513,97.26839002267575,30,50,367,2,358
1333,364,6,95.38757369614513,98.29006802721089,30,51,379,3,358
1334,364,219,95.38757369614513,96.73433106575963,30,26,156,1,145
1335,364,218,95.38757369614513,97.57024943310658,30,28,174,2,146
1336,364,415,95.38757369614513,97.22195011337868,30,22,94,2,51
1337,364,538,95.38757369614513,97.6863492063492,30,23,200,2,174
1338,364,619,95.38757369614513,96.73433106575963,30,15,262,1,255
1339,364,630,95.38757369614513,97.61668934240363,30,21,283,2,266
1340,219,6,96.73433106575963,98.29006802721089,26,51,223,2,213
1341,219,6,96.73433106575963,99.31174603174604,26,50,240,3,213
1342,219,326,96.73433106575963,99.12598639455783,26,32,149,2,107
1343,219,523,96.73433106575963,98.80090702947847,26,19,317,2,304
1344,219,684,96.73433106575963,98.7544671201814,26,16,473,2,465
1345,218,6,97.57024943310658,99.31174603174604,28,50,225,2,212
1346,218,5,97.57024943310658,100.33342403628119,28,49,244,3,213
1347,218,326,97.57024943310658,99.12598639455783,28,32,127,2,108
1348,218,216,97.57024943310658,100.19410430839002,28,39,113,3,2
1349,218,211,97.57024943310658,100.54240362811791,28,41,128,3,7
1350,218,523,97.57024943310658,98.80090702947847,28,19,310,1,305
1351,218,535,97.57024943310658,99.82258503401361,28,23,332,2,317
1352,218,684,97.57024943310658,98.7544671201814,28,16,469,1,466
1353,218,650,97.57024943310658,99.96190476190476,28,25,444,2,432
1354,326,5,99.12598639455783,100.33342403628119,32,49,325,1,321
1355,326,6,99.12598639455783,101.33188208616781,32,49,334,2,320
1356,326,216,99.12598639455783,100.19410430839002,32,39,119,1,110
1357,326,211,99.12598639455783,100.54240362811791,32,41,130,1,115
1358,326,216,99.12598639455783,101.44798185941043,32,36,149,2,110
1359,326,523,99.12598639455783,100.82104308390024,32,18,210,2,197
1360,326,696,99.12598639455783,100.82104308390024,32,17,377,2,370
1361,216,6,100.19410430839002,101.33188208616781,39,49,216,1,210
1362,216,6,100.19410430839002,102.35356009070296,39,51,230,2,210
1363,216,278,100.19410430839002,102.65541950113379,39,29,123,2,62
1364,216,428,100.19410430839002,102.1213605442177,39,21,228,2,212
1365,216,545,100.19410430839002,102.56253968253968,39,23,344,2,329
1366,216,648,100.19410430839002,102.1213605442177,39,22,440,2,432
1367,216,644,100.19410430839002,102.56253968253968,39,19,440,2,428
1368,211,6,100.54240362811791,102.35356009070296,41,51,219,2,205
1369,211,6,100.54240362811791,103.3752380952381,41,50,239,3,205
1370,211,278,100.54240362811791,102.65541950113379,41,29,113,2,67
1371,211,215,100.54240362811791,103.51455782312925,41,28,128,3,4
1372,211,428,100.54240362811791,102.1213605442177,41,21,227,2,217
1373,211,545,100.54240362811791,102.56253968253968,41,23,345,2,334
1374,211,648,100.54240362811791,102.1213605442177,41,22,442,2,437
1375,211,644,100.54240362811791,102.56253968253968,41,19,442,2,433
1376,211,646,100.54240362811791,103.32879818594104,41,16,451,3,435
1377,216,6,101.44798185941043,103.3752380952381,36,50,226,2,210
1378,216,6,101.44798185941043,104.39691609977325,36,50,245,3,210
1379,216,278,101.44798185941043,102.65541950113379,36,29,81,1,62
1380,216,215,101.44798185941043,103.51455782312925,36,28,89,2,1
1381,216,545,101.44798185941043,102.56253968253968,36,23,332,1,329
1382,216,526,101.44798185941043,104.07183673469387,36,19,330,3,310
1383,216,644,101.44798185941043,102.56253968253968,36,19,431,1,428
1384,216,646,101.44798185941043,103.32879818594104,36,16,438,2,430
1385,278,6,102.65541950113379,104.39691609977325,29,50,282,2,272
1386,278,5,102.65541950113379,105.4185941043084,29,49,298,3,273
1387,278,244,102.65541950113379,104.86131519274376,29,27,101,2,34
1388,278,526,102.65541950113379,104.07183673469387,29,19,255,1,248
1389,278,512,102.65541950113379,104.76843537414966,29,22,251,2,234
1390,278,415,102.65541950113379,105.48825396825397,29,24,183,3,137
1391,278,618,102.65541950113379,104.90775510204082,29,15,354,2,340
1392,215,5,103.51455782312925,105.4185941043084,28,49,225,2,210
1393,215,6,103.51455782312925,106.41705215419502,28,50,244,3,209
1394,215,244,103.51455782312925,104.86131519274376,28,27,65,1,29
1395,215,212,103.51455782312925,105.8829931972789,28,33,102,2,3
1396,215,512,103.51455782312925,104.76843537414966,28,22,302,1,297
1397,215,415,103.51455782312925,105.48825396825397,28,24,217,2,200
1398,215,618,103.51455782312925,104.90775510204082,28,15,407,1,403
1399,244,6,104.86131519274376,106.41705215419502,27,50,247,2,238
1400,244,6,104.86131519274376,107.43873015873017,27,50,263,3,238
1401,244,212,104.86131519274376,105.8829931972789,27,33,54,1,32
1402,244,219,104.86131519274376,106.99755102040817,27,37,95,2,25
1403,244,306,104.86131519274376,107.3922902494331,27,34,125,3,62
1404,244,411,104.86131519274376,107.04399092970522,27,24,192,2,167
1405,244,731,104.86131519274376,105.8829931972789,27,16,489,1,487
1406,244,742,104.86131519274376,106.62603174603174,27,15,504,2,498
1407,212,6,105.8829931972789,107.43873015873017,33,50,217,2,206
1408,212,6,105.8829931972789,108.46040816326531,33,51,234,3,206
1409,212,219,105.8829931972789,106.99755102040817,33,37,49,1,7
1410,212,306,105.8829931972789,107.3922902494331,33,34,114,2,94
1411,212,221,105.8829931972789,108.32108843537415,33,36,105,2,9
1412,212,411,105.8829931972789,107.04399092970522,33,24,205,1,199
1413,212,476,105.8829931972789,107.92634920634922,33,19,278,2,264
1414,219,6,106.99755102040817,108.46040816326531,37,51,222,1,213
1415,219,6,106.99755102040817,109.48208616780046,37,51,238,2,213
1416,219,221,106.99755102040817,108.32108843537415,37,36,57,1,2
1417,219,218,106.99755102040817,109.94648526077098,37,30,127,3,1
1418,219,456,106.99755102040817,108.92480725623582,37,18,251,2,237
1419,219,652,106.99755102040817,108.92480725623582,37,16,441,2,433
1420,306,6,107.3922902494331,108.46040816326531,34,51,304,1,300
1421,306,6,107.3922902494331,109.48208616780046,34,51,313,2,300
1422,306,218,107.3922902494331,109.94648526077098,34,30,141,3,88
1423,306,456,107.3922902494331,108.92480725623582,34,18,164,2,150
1424,306,549,107.3922902494331,110.15546485260771,34,22,271,3,243
1425,306,652,107.3922902494331,108.92480725623582,34,16,352,2,346
1426,306,649,107.3922902494331,110.2251247165533,34,22,364,3,343
1427,306,632,107.3922902494331,110.29478458049887,34,17,349,3,326
1428,221,6,108.32108843537415,109.48208616780046,36,51,221,1,215
1429,221,5,108.32108843537415,110.50376417233561,36,49,236,2,216
1430,221,218,108.32108843537415,109.94648526077098,36,30,70,2,3
1431,221,219,108.32108843537415,111.27002267573697,36,30,127,3,2
1432,221,549,108.32108843537415,110.15546485260771,36,22,337,2,328
1433,221,414,108.32108843537415,110.96816326530613,36,18,224,3,193
1434,221,649,108.32108843537415,110.2251247165533,36,22,436,2,428
1435,221,632,108.32108843537415,110.29478458049887,36,17,420,2,411
1436,218,6,109.94648526077098,111.50222222222223,30,50,222,2,212
1437,218,6,109.94648526077098,112.52390022675738,30,50,239,3,212
1438,218,219,109.94648526077098,111.27002267573697,30,30,57,1,1
1439,218,219,109.94648526077098,111.5718820861678,30,39,70,2,1
1440,218,227,109.94648526077098,112.75609977324264,30,32,121,3,9
1441,218,414,109.94648526077098,110.96816326530613,30,18,201,1,196
1442,218,436,109.94648526077098,111.82730158730159,30,22,233,2,218
1443,218,682,109.94648526077098,112.66321995464853,30,21,479,3,464
1444,219,6,111.27002267573697,112.52390022675738,30,50,220,1,213
1445,219,6,111.27002267573697,113.54557823129252,30,50,234,2,213
1446,219,227,111.27002267573697,112.75609977324264,30,32,64,1,8
1447,219,218,111.27002267573697,114.19573696145125,30,28,126,3,1
1448,219,425,111.27002267573697,112.98829931972789,30,19,219,2,206
1449,219,496,111.27002267573697,113.7081179138322,30,21,296,2,277
1450,219,682,111.27002267573697,112.66321995464853,30,21,467,1,463
1451,219,646,111.27002267573697,113.49913832199547,30,14,438,2,427
1452,219,6,111.5718820861678,113.54557823129252,39,50,229,2,213
1453,219,227,111.5718820861678,112.75609977324264,39,32,52,1,8
1454,219,218,111.5718820861678,114.19573696145125,39,28,113,3,1
1455,219,221,111.5718820861678,114.42793650793651,39,32,123,3,2
1456,219,425,111.5718820861678,112.98829931972789,39,19,215,1,206
1457,219,496,111.5718820861678,113.7081179138322,39,21,292,2,277
1458,219,501,111.5718820861678,114.52081632653062,39,17,309,3,282
1459,219,682,111.5718820861678,112.66321995464853,39,21,465,1,463
1460,219,646,111.5718820861678,113.49913832199547,39,14,435,2,427
1461,227,6,112.75609977324264,114.56725623582767,32,50,234,2,221
1462,227,218,112.75609977324264,114.19573696145125,32,28,63,1,9
1463,227,221,112.75609977324264,114.42793650793651,32,32,72,2,6
1464,227,216,112.75609977324264,115.4031746031746,32,35,115,3,11
1465,227,501,112.75609977324264,114.52081632653062,32,17,284,2,274
1466,227,442,112.75609977324264,115.37995464852608,32,19,243,3,215
1467,227,686,112.75609977324264,115.0316553287982,32,14,469,2,459
1468,218,6,114.19573696145125,116.07655328798187,28,49,227,2,212
1469,218,6,114.19573696145125,117.09823129251701,28,50,246,3,212
1470,218,216,114.19573696145125,115.4031746031746,28,35,52,1,2
1471,218,214,114.19573696145125,116.74993197278911,28,32,110,3,4
1472,218,442,114.19573696145125,115.37995464852608,28,19,230,1,224
1473,218,493,114.19573696145125,117.0053514739229,28,19,300,3,275
1474,218,683,114.19573696145125,116.05333333333334,28,14,472,2,465
1475,218,684,114.19573696145125,117.07501133786849,28,15,482,3,466
1476,221,6,114.42793650793651,116.07655328798187,32,49,226,2,215
1477,221,6,114.42793650793651,117.09823129251701,32,50,244,3,215
1478,221,214,114.42793650793651,116.74993197278911,32,32,100,2,7
1479,221,493,114.42793650793651,117.0053514739229,32,19,294,3,272
1480,221,683,114.42793650793651,116.05333333333334,32,14,467,2,462
1481,221,684,114.42793650793651,117.07501133786849,32,15,477,3,463
1482,216,6,115.4031746031746,117.09823129251701,35,50,222,2,210
1483,216,6,115.4031746031746,117.60907029478459,35,51,230,2,210
1484,216,214,115.4031746031746,116.74993197278911,35,32,58,1,2
1485,216,493,115.4031746031746,117.0053514739229,35,19,285,2,277
1486,216,441,115.4031746031746,117.77160997732426,35,18,247,2,225
1487,216,684,115.4031746031746,117.07501133786849,35,15,474,2,468
1488,214,6,116.74993197278911,118.63074829931973,32,50,223,2,208
1489,214,6,116.74993197278911,119.65242630385488,32,50,243,3,208
1490,214,216,116.74993197278911,117.95736961451247,32,29,52,1,2
1491,214,300,116.74993197278911,119.02548752834467,32,30,130,2,86
1492,214,217,116.74993197278911,119.53632653061224,32,30,120,3,3
1493,214,441,116.74993197278911,117.77160997732426,32,18,231,1,227
1494,214,423,116.74993197278911,119.16480725623583,32,21,233,2,209
1495,214,410,116.74993197278911,119.4898866213152,32,21,229,3,196
1496,214,651,116.74993197278911,119.09514739229026,32,17,449,2,437
1497,216,6,117.95736961451247,119.65242630385488,29,50,222,2,210
1498,216,300,117.95736961451247,119.02548752834467,29,30,96,1,84
1499,216,217,117.95736961451247,119.53632653061224,29,30,68,2,1
1500,216,209,117.95736961451247,120.55800453514739,29,36,112,3,7
1501,216,423,117.95736961451247,119.16480725623583,29,21,213,1,207
1502,216,410,117.95736961451247,119.4898866213152,29,21,205,2,194
1503,216,413,117.95736961451247,120.6508843537415,29,22,229,3,197
1504,216,651,117.95736961451247,119.09514739229026,29,17,438,1,435
1505,216,618,117.95736961451247,119.86140589569162,29,16,410,2,402
1506,300,8,119.02548752834467,121.25460317460318,30,44,307,2,292
1507,300,209,119.02548752834467,120.55800453514739,30,36,112,2,91
1508,300,413,119.02548752834467,120.6508843537415,30,22,133,2,113
1509,300,470,119.02548752834467,121.95120181405896,30,23,212,3,170
1510,300,788,119.02548752834467,120.95274376417234,30,19,495,2,488
1511,300,713,119.02548752834467,121.95120181405896,30,18,432,3,413
1512,217,8,119.53632653061224,121.25460317460318,30,44,222,2,209
1513,217,13,119.53632653061224,122.18340136054422,30,46,234,3,204
1514,217,209,119.53632653061224,120.55800453514739,30,36,45,1,8
1515,217,269,119.53632653061224,122.02086167800454,30,32,119,2,52
1516,217,413,119.53632653061224,120.6508843537415,30,22,202,1,196
1517,217,470,119.53632653061224,121.95120181405896,30,23,274,2,253
1518,217,713,119.53632653061224,121.95120181405896,30,18,507,2,496
1519,209,13,120.55800453514739,122.18340136054422,36,46,208,2,196
1520,209,6,120.55800453514739,122.6942403628118,36,50,223,2,203
1521,209,269,120.55800453514739,122.02086167800454,36,32,87,1,60
1522,209,221,120.55800453514739,122.57814058956916,36,32,88,2,12
1523,209,470,120.55800453514739,121.95120181405896,36,23,268,1,261
1524,209,470,120.55800453514739,122.90321995464853,36,23,280,2,261
1525,269,6,122.02086167800454,123.71591836734694,32,50,273,2,263
1526,269,6,122.02086167800454,124.73759637188209,32,49,288,3,263
1527,269,218,122.02086167800454,124.203537414966,32,25,107,2,51
1528,269,221,122.02086167800454,124.94657596371883,32,26,135,3,48
1529,269,505,122.02086167800454,123.87845804988662,32,22,249,2,236
1530,269,470,122.02086167800454,124.99301587301588,32,24,238,3,201
1531,269,634,122.02086167800454,124.59827664399093,32,22,382,3,365
1532,221,6,122.57814058956916,123.71591836734694,32,50,221,1,215
1533,221,6,122.57814058956916,124.73759637188209,32,49,234,2,215
1534,221,218,122.57814058956916,124.203537414966,32,25,70,2,3
1535,221,505,122.57814058956916,123.87845804988662,32,22,289,1,284
1536,221,470,122.57814058956916,124.99301587301588,32,24,270,2,249
1537,221,634,122.57814058956916,124.59827664399093,32,22,422,2,413
1538,218,6,124.203537414966,126.24689342403629,25,49,230,2,212
1539,218,6,124.203537414966,126.75773242630386,25,50,239,3,212
1540,218,220,124.203537414966,126.22367346938776,25,26,87,2,2
1541,218,462,124.203537414966,126.22367346938776,25,21,259,2,244
1542,218,411,124.203537414966,126.38621315192744,25,24,215,2,193
1543,218,627,124.203537414966,126.24689342403629,25,17,418,2,409
1544,218,633,124.203537414966,126.50231292517007,25,21,427,2,415
1545,221,6,124.94657596371883,126.24689342403629,26,49,222,1,215
1546,221,6,124.94657596371883,126.75773242630386,26,50,229,2,215
1547,221,220,124.94657596371883,126.22367346938776,26,26,55,1,1
1548,221,220,124.94657596371883,127.24535147392291,26,26,99,2,1
1549,221,462,124.94657596371883,126.22367346938776,26,21,247,1,241
1550,221,411,124.94657596371883,126.38621315192744,26,24,200,1,190
1551,221,627,124.94657596371883,126.24689342403629,26,17,410,1,406
1552,221,633,124.94657596371883,126.50231292517007,26,21,417,2,412
1553,220,6,126.22367346938776,128.29024943310657,26,50,232,2,214
1554,220,6,126.22367346938776,128.80108843537414,26,50,241,3,214
1555,220,329,126.22367346938776,128.01160997732427,26,24,133,2,109
1556,220,374,126.22367346938776,129.1958276643991,26,27,200,3,154
1557,220,516,126.22367346938776,128.05804988662132,26,22,306,2,296
1558,220,492,126.22367346938776,129.03328798185942,26,23,298,3,272
1559,220,629,126.22367346938776,127.98839002267574,26,17,416,2,409
1560,220,628,126.22367346938776,128.661768707483,26,24,421,2,408
1561,220,6,127.24535147392291,128.29024943310657,26,50,219,1,214
1562,220,6,127.24535147392291,128.80108843537414,26,50,224,2,214
1563,220,6,127.24535147392291,129.8227664399093,26,49,241,3,214
1564,220,374,127.24535147392291,129.1958276643991,26,27,175,2,154
1565,220,218,127.24535147392291,129.84598639455783,26,28,112,3,2
1566,220,492,127.24535147392291,129.03328798185942,26,23,283,2,272
1567,220,450,127.24535147392291,129.89242630385488,26,22,257,3,230
1568,220,628,127.24535147392291,128.661768707483,26,24,413,1,408
1569,220,659,127.24535147392291,129.93886621315193,26,21,454,3,439
1570,329,6,128.01160997732427,129.8227664399093,24,49,332,2,323
1571,329,6,128.01160997732427,130.82122448979592,24,50,345,3,323
1572,329,374,128.01160997732427,129.1958276643991,24,27,68,1,45
1573,329,218,128.01160997732427,129.84598639455783,24,28,136,2,111
1574,329,492,128.01160997732427,129.03328798185942,24,23,169,1,163
1575,329,450,128.01160997732427,129.89242630385488,24,22,146,2,121
1576,329,477,128.01160997732427,130.4497052154195,24,22,181,2,148
1577,329,659,128.01160997732427,129.93886621315193,24,21,340,2,330
1578,329,825,128.01160997732427,129.102947845805,24,17,498,1,496
1579,374,6,129.1958276643991,130.82122448979592,27,50,375,2,368
1580,374,6,129.1958276643991,131.84290249433107,27,50,385,3,368
1581,374,311,129.1958276643991,131.21596371882086,27,28,107,2,63
1582,374,477,129.1958276643991,130.4497052154195,27,22,116,1,103
1583,374,785,129.1958276643991,131.12308390022676,27,19,419,2,411
1584,374,755,129.1958276643991,131.98222222222222,27,18,399,3,381
1585,218,6,129.84598639455783,131.84290249433107,28,50,229,2,212
1586,218,311,129.84598639455783,131.21596371882086,28,28,110,1,93
1587,218,499,129.84598639455783,132.3305215419501,28,18,301,2,281
1588,218,628,129.84598639455783,132.60916099773243,28,25,427,3,410
1589,311,6,131.21596371882086,132.86458049886622,28,50,313,2,305
1590,311,6,131.21596371882086,133.88625850340136,28,50,326,3,305
1591,311,218,131.21596371882086,132.3305215419501,28,28,105,1,93
1592,311,211,131.21596371882086,133.09678004535147,28,26,129,2,100
1593,311,499,131.21596371882086,132.3305215419501,28,18,194,1,188
1594,311,469,131.21596371882086,133.12,28,27,178,2,158
1595,311,524,131.21596371882086,134.0255782312925,28,22,245,3,213
1596,311,628,131.21596371882086,132.60916099773243,28,25,323,1,317
1597,311,623,131.21596371882086,134.04879818594105,28,17,335,3,312
1598,218,6,132.3305215419501,133.88625850340136,28,50,222,2,212
1599,218,7,132.3305215419501,134.88471655328797,28,50,238,3,211
1600,218,238,132.3305215419501,134.3506575963719,28,24,89,2,20
1601,218,217,132.3305215419501,135.1633560090703,28,26,122,3,1
1602,218,524,132.3305215419501,134.0255782312925,28,22,315,2,306
1603,218,428,132.3305215419501,134.83827664399092,28,26,236,3,210
1604,218,623,132.3305215419501,134.04879818594105,28,17,412,2,405
1605,211,7,133.09678004535147,134.88471655328797,26,50,218,2,204
1606,211,6,133.09678004535147,135.90639455782312,26,49,238,3,205
1607,211,238,133.09678004535147,134.3506575963719,26,24,60,1,27
1608,211,217,133.09678004535147,135.1633560090703,26,26,89,2,6
1609,211,218,133.09678004535147,135.37233560090704,26,25,98,2,7
1610,211,428,133.09678004535147,134.83827664399092,26,26,230,2,217
1611,211,421,133.09678004535147,135.37233560090704,26,22,232,2,210
1612,211,616,133.09678004535147,136.02249433106576,26,17,424,3,405
1613,238,6,134.3506575963719,135.90639455782312,24,49,241,2,232
1614,238,7,134.3506575963719,136.4172335600907,24,47,248,2,231
1615,238,218,134.3506575963719,135.37233560090704,24,25,48,1,20
1616,238,313,134.3506575963719,136.71909297052156,24,25,127,2,75
1617,238,421,134.3506575963719,135.37233560090704,24,22,188,1,183
1618,238,551,134.3506575963719,136.78875283446712,24,20,330,2,313
1619,238,616,134.3506575963719,136.02249433106576,24,17,385,2,378
1620,238,639,134.3506575963719,136.67265306122448,24,21,413,2,401
1621,217,7,135.1633560090703,136.4172335600907,26,47,217,1,210
1622,217,6,135.1633560090703,137.43891156462584,26,50,233,2,211
1623,217,313,135.1633560090703,136.71909297052156,26,25,117,2,96
1624,217,244,135.1633560090703,137.3924716553288,26,24,100,2,27
1625,217,551,135.1633560090703,136.78875283446712,26,20,341,2,334
1626,217,639,135.1633560090703,136.67265306122448,26,21,427,2,422
1627,218,7,135.37233560090704,136.4172335600907,25,47,216,1,211
1628,218,6,135.37233560090704,137.43891156462584,25,50,230,2,212
1629,218,313,135.37233560090704,136.71909297052156,25,25,111,1,95
1630,218,244,135.37233560090704,137.3924716553288,25,24,91,2,26
1631,218,551,135.37233560090704,136.78875283446712,25,20,339,1,333
1632,218,420,135.37233560090704,138.2051700680272,25,20,236,3,202
1633,218,639,135.37233560090704,136.67265306122448,25,21,425,1,421
1634,313,6,136.71909297052156,138.460589569161,25,49,316,2,307
1635,313,216,136.71909297052156,139.27328798185943,25,26,147,3,97
1636,313,420,136.71909297052156,138.2051700680272,25,20,125,1,107
1637,313,423,136.71909297052156,138.41414965986394,25,19,132,2,110
1638,313,809,136.71909297052156,138.1819501133787,25,16,500,1,496
1639,313,649,136.71909297052156,138.43736961451248,25,17,344,2,336
1640,313,625,136.71909297052156,139.45904761904762,25,13,334,3,312
1641,244,6,137.3924716553288,138.460589569161,24,49,242,1,238
1642,244,23,137.3924716553288,139.76090702947846,24,41,243,2,221
1643,244,216,137.3924716553288,139.27328798185943,24,26,86,2,28
1644,244,247,137.3924716553288,139.9002267573696,24,26,108,3,3
1645,244,423,137.3924716553288,138.41414965986394,24,19,184,1,179
1646,244,413,137.3924716553288,139.8770068027211,24,17,200,2,169
1647,244,649,137.3924716553288,138.43736961451248,24,17,407,1,405
1648,244,625,137.3924716553288,139.45904761904762,24,13,391,2,381
1649,216,14,139.27328798185943,141.0380045351474,26,43,216,2,202
1650,216,82,139.27328798185943,141.89714285714285,26,42,175,3,134
1651,216,212,139.27328798185943,141.33986394557823,26,22,89,2,4
1652,216,291,139.27328798185943,142.0132426303855,26,23,140,3,75
1653,216,424,139.27328798185943,141.33986394557823,26,15,226,2,208
1654,216,410,139.27328798185943,141.38630385487528,26,15,214,2,194
1655,247,14,139.9002267573696,141.0380045351474,26,43,238,1,233
1656,247,82,139.9002267573696,141.89714285714285,26,42,186,2,165
1657,247,212,139.9002267573696,141.33986394557823,26,22,71,1,35
1658,247,291,139.9002267573696,142.0132426303855,26,23,101,2,44
1659,247,424,139.9002267573696,141.33986394557823,26,15,188,1,177
1660,247,410,139.9002267573696,141.38630385487528,26,15,175,1,163
1661,247,531,139.9002267573696,142.68662131519275,26,20,308,3,284
1662,247,731,139.9002267573696,142.68662131519275,26,14,499,3,484
1663,212,46,141.33986394557823,143.33678004535147,22,43,187,2,166
1664,212,46,141.33986394557823,143.40643990929706,22,42,188,2,166
1665,212,207,141.33986394557823,143.36,22,29,87,2,5
1666,212,207,141.33986394557823,143.40643990929706,22,27,89,2,5
1667,212,531,141.33986394557823,142.68662131519275,22,20,324,1,319
1668,212,480,141.33986394557823,143.75473922902495,22,15,287,2,268
1669,291,46,142.0132426303855,143.33678004535147,23,43,252,1,245
1670,291,46,142.0132426303855,143.40643990929706,23,42,252,1,245
1671,291,23,142.0132426303855,144.7764172335601,23,41,293,3,268
1672,291,207,142.0132426303855,143.36,23,29,102,1,84
1673,291,207,142.0132426303855,143.40643990929706,23,27,103,1,84
1674,291,480,142.0132426303855,143.75473922902495,23,15,203,2,189
1675,291,410,142.0132426303855,144.5906575963719,23,27,163,3,119
1676,207,23,143.36,144.7764172335601,29,41,194,1,184
1677,207,381,143.36,145.14793650793652,29,30,190,2,174
1678,207,390,143.36,145.63555555555556,29,30,208,2,183
1679,207,410,143.36,144.5906575963719,29,27,210,1,203
1680,207,414,143.36,145.7748752834467,29,29,232,2,207
1681,207,23,143.40643990929706,144.7764172335601,27,41,193,1,184
1682,207,83,143.40643990929706,146.35537414965987,27,45,177,3,124
1683,207,381,143.40643990929706,145.14793650793652,27,30,189,2,174
1684,207,390,143.40643990929706,145.63555555555556,27,30,207,2,183
1685,207,410,143.40643990929706,144.5906575963719,27,27,209,1,203
1686,207,414,143.40643990929706,145.7748752834467,27,29,231,2,207
1687,381,83,145.14793650793652,146.35537414965987,30,45,303,1,298
1688,381,15,145.14793650793652,146.44825396825397,30,46,370,1,366
1689,381,6,145.14793650793652,148.12009070294786,30,50,396,3,375
1690,381,301,145.14793650793652,146.70367346938775,30,25,104,2,80
1691,381,416,145.14793650793652,146.49469387755101,30,18,68,1,35
1692,381,418,145.14793650793652,148.07365079365078,30,24,131,3,37
1693,381,654,145.14793650793652,147.58603174603175,30,16,292,2,273
1694,381,865,145.14793650793652,147.6092517006803,30,16,495,2,484
1695,390,6,145.63555555555556,148.12009070294786,30,50,399,2,384
1696,390,301,145.63555555555556,146.70367346938775,30,25,100,1,89
1697,390,366,145.63555555555556,148.23619047619047,30,31,115,3,24
1698,390,418,145.63555555555556,148.07365079365078,30,24,109,2,28
1699,390,654,145.63555555555556,147.58603174603175,30,16,277,2,264
1700,390,762,145.63555555555556,148.46839002267575,30,26,391,3,372
1701,390,865,145.63555555555556,147.6092517006803,30,16,483,2,475
1702,390,820,145.63555555555556,148.5380498866213,30,23,448,3,430
1703,301,6,146.70367346938775,148.12009070294786,25,50,301,1,295
1704,301,6,146.70367346938775,149.141768707483,25,50,313,2,295
1705,301,366,146.70367346938775,148.23619047619047,25,31,93,2,65
1706,301,307,146.70367346938775,148.95600907029478,25,31,97,2,6
1707,301,205,146.70367346938775,149.44362811791385,25,27,152,3,96
1708,301,418,146.70367346938775,148.07365079365078,25,24,131,1,117
1709,301,424,146.70367346938775,149.09532879818593,25,22,160,2,123
1710,301,762,146.70367346938775,148.46839002267575,25,26,467,2,461
1711,366,6,148.23619047619047,150.16344671201816,31,49,369,2,360
1712,366,6,148.23619047619047,151.16190476190476,31,50,381,3,360
1713,366,205,148.23619047619047,149.44362811791385,31,27,169,1,161
1714,366,218,148.23619047619047,150.465306122449,31,30,176,2,148
1715,366,428,148.23619047619047,150.11700680272108,31,23,102,2,62
1716,366,427,148.23619047619047,151.11546485260772,31,19,138,3,61
1717,366,800,148.23619047619047,150.25632653061226,31,16,443,2,434
1718,366,800,148.23619047619047,150.99936507936508,31,18,450,3,434
1719,366,838,148.23619047619047,151.13868480725623,31,15,488,3,472
1720,307,6,148.95600907029478,150.16344671201816,31,49,305,1,301
1721,307,6,148.95600907029478,151.16190476190476,31,50,316,2,301
1722,307,218,148.95600907029478,150.465306122449,31,30,110,2,89
1723,307,428,148.95600907029478,150.11700680272108,31,23,131,1,121
1724,307,427,148.95600907029478,151.11546485260772,31,19,152,2,120
1725,307,800,148.95600907029478,150.25632653061226,31,16,496,1,493
1726,307,800,148.95600907029478,150.99936507936508,31,18,501,2,493
1727,205,6,149.44362811791385,151.16190476190476,27,50,212,2,199
1728,205,6,149.44362811791385,152.1835827664399,27,50,231,3,199
1729,205,218,149.44362811791385,150.465306122449,27,30,46,1,13
1730,205,273,149.44362811791385,152.3693424036281,27,36,143,3,68
1731,205,427,149.44362811791385,151.11546485260772,27,19,233,2,222
1732,205,410,149.44362811791385,152.3693424036281,27,25,241,3,205
1733,218,6,150.465306122449,152.1835827664399,30,50,225,2,212
1734,218,6,150.465306122449,153.20526077097506,30,50,243,3,212
1735,218,273,150.465306122449,152.3693424036281,30,36,99,2,55
1736,218,215,150.465306122449,153.39102040816326,30,40,126,3,3
1737,218,214,150.465306122449,153.4142403628118,30,38,127,3,4
1738,218,410,150.465306122449,152.3693424036281,30,25,209,2,192
1739,218,428,150.465306122449,153.158820861678,30,21,240,3,210
1740,273,6,152.3693424036281,154.2269387755102,36,49,279,2,267
1741,273,6,152.3693424036281,155.24861678004535,36,50,294,3,267
1742,273,215,152.3693424036281,153.39102040816326,36,40,73,1,58
1743,273,214,152.3693424036281,153.4142403628118,36,38,74,1,59
1744,273,206,152.3693424036281,154.43591836734694,36,25,111,2,67
1745,273,419,152.3693424036281,154.15727891156462,36,21,165,2,146
1746,273,429,152.3693424036281,155.17895691609976,36,22,197,3,156
1747,273,718,152.3693424036281,153.87863945578232,36,15,450,2,445
1748,273,644,152.3693424036281,155.0164172335601,36,21,388,3,371
1749,215,6,153.39102040816326,155.24861678004535,40,50,224,2,209
1750,215,6,153.39102040816326,156.247074829932,40,50,243,3,209
1751,215,206,153.39102040816326,154.43591836734694,40,25,46,1,9
1752,215,370,153.39102040816326,156.0148752834467,40,30,192,3,155
1753,215,429,153.39102040816326,155.17895691609976,40,22,227,2,214
1754,215,429,153.39102040816326,156.2006349206349,40,22,246,3,214
1755,215,644,153.39102040816326,155.0164172335601,40,21,435,2,429
1756,215,656,153.39102040816326,155.4575963718821,40,19,450,2,441
1757,214,6,153.4142403628118,155.24861678004535,38,50,222,2,208
1758,214,6,153.4142403628118,156.247074829932,38,50,241,3,208
1759,214,206,153.4142403628118,154.43591836734694,38,25,45,1,8
1760,214,370,153.4142403628118,156.0148752834467,38,30,192,3,156
1761,214,429,153.4142403628118,155.17895691609976,38,22,228,2,215
1762,214,429,153.4142403628118,156.2006349206349,38,22,246,3,215
1763,214,644,153.4142403628118,155.0164172335601,38,21,436,2,430
1764,214,656,153.4142403628118,155.4575963718821,38,19,451,2,442
1765,206,6,154.43591836734694,156.247074829932,25,50,215,2,200
1766,206,6,154.43591836734694,157.26875283446714,25,50,234,3,200
1767,206,370,154.43591836734694,156.0148752834467,25,30,178,2,164
1768,206,335,154.43591836734694,157.1526530612245,25,32,174,3,129
1769,206,429,154.43591836734694,156.2006349206349,25,22,236,2,223
1770,206,429,154.43591836734694,157.22231292517006,25,23,253,3,223
1771,206,656,154.43591836734694,155.4575963718821,25,19,452,1,450
1772,206,654,154.43591836734694,156.73469387755102,25,19,459,2,448
1773,370,6,156.0148752834467,157.26875283446714,30,50,368,1,364
1774,370,6,156.0148752834467,158.29043083900228,30,50,377,2,364
1775,370,335,156.0148752834467,157.1526530612245,30,32,60,1,35
1776,370,205,156.0148752834467,157.59383219954648,30,27,178,2,165
1777,370,218,156.0148752834467,158.59229024943312,30,30,188,3,152
1778,370,429,156.0148752834467,157.22231292517006,30,23,79,1,59
1779,370,429,156.0148752834467,158.2439909297052,30,22,113,2,59
1780,370,447,156.0148752834467,158.75482993197278,30,21,141,3,77
1781,370,817,156.0148752834467,157.75637188208617,30,15,453,2,447
1782,370,660,156.0148752834467,158.75482993197278,30,18,313,3,290
1783,335,6,157.1526530612245,158.29043083900228,32,50,333,1,329
1784,335,6,157.1526530612245,159.31210884353743,32,50,342,2,329
1785,335,218,157.1526530612245,158.59229024943312,32,30,132,1,117
1786,335,218,157.1526530612245,159.59074829931973,32,38,157,2,117
1787,335,429,157.1526530612245,158.2439909297052,32,22,105,1,94
1788,335,447,157.1526530612245,158.75482993197278,32,21,132,2,112
1789,335,660,157.1526530612245,158.75482993197278,32,18,332,2,325
1790,335,663,157.1526530612245,159.4746485260771,32,23,343,2,328
1791,205,6,157.59383219954648,159.31210884353743,27,50,212,2,199
1792,205,5,157.59383219954648,160.33378684807258,27,49,232,3,200
1793,205,218,157.59383219954648,159.59074829931973,27,38,87,2,13
1794,205,447,157.59383219954648,158.75482993197278,27,21,247,1,242
1795,205,425,157.59383219954648,160.264126984127,27,24,248,3,220
1796,205,660,157.59383219954648,158.75482993197278,27,18,458,1,455
1797,205,663,157.59383219954648,159.4746485260771,27,23,465,2,458
1798,218,5,158.59229024943312,160.33378684807258,30,49,226,2,213
1799,218,6,158.59229024943312,161.33224489795919,30,50,243,3,212
1800,218,425,158.59229024943312,160.264126984127,30,24,219,2,207
1801,218,594,158.59229024943312,161.0536054421769,30,24,391,2,376
1802,218,628,158.59229024943312,161.0768253968254,30,21,424,2,410
1803,218,6,159.59074829931973,161.33224489795919,38,50,225,2,212
1804,218,6,159.59074829931973,162.35392290249433,38,50,243,3,212
1805,218,219,159.59074829931973,161.7037641723356,38,32,91,2,1
1806,218,594,159.59074829931973,161.0536054421769,38,24,381,1,376
1807,218,547,159.59074829931973,161.81986394557825,38,19,343,2,329
1808,218,628,159.59074829931973,161.0768253968254,38,21,415,1,410
1809,218,6,161.19292517006804,162.35392290249433,35,50,218,1,212
1810,218,6,161.19292517006804,163.37560090702948,35,50,232,2,212
1811,218,223,161.19292517006804,163.2130612244898,35,27,87,2,5
1812,218,422,161.19292517006804,162.70222222222222,35,21,214,2,204
1813,219,6,161.7037641723356,163.37560090702948,32,50,225,2,213
1814,219,6,161.7037641723356,164.39727891156463,32,49,243,3,213
1815,219,223,161.7037641723356,163.2130612244898,32,27,65,2,4
1816,219,215,161.7037641723356,164.44371882086168,32,37,118,3,4
1817,219,216,161.7037641723356,164.46693877551022,32,36,119,3,3
1818,219,425,161.7037641723356,164.35083900226758,32,24,235,3,206
1819,219,654,161.7037641723356,164.35083900226758,32,18,450,3,435
1820,223,6,163.2130612244898,164.39727891156463,27,49,223,1,217
1821,223,6,163.2130612244898,165.39573696145126,27,49,236,2,217
1822,223,215,163.2130612244898,164.44371882086168,27,37,54,1,8
1823,223,216,163.2130612244898,164.46693877551022,27,36,54,1,7
1824,223,214,163.2130612244898,165.6975963718821,27,39,107,2,9
1825,223,425,163.2130612244898,164.35083900226758,27,24,208,1,202
1826,223,450,163.2130612244898,164.86167800453515,27,21,238,2,227
1827,223,417,163.2130612244898,165.58149659863946,27,27,219,2,194
1828,223,654,163.2130612244898,164.35083900226758,27,18,434,1,431
1829,215,6,164.44371882086168,166.4174149659864,37,50,226,2,209
1830,215,214,164.44371882086168,165.6975963718821,37,39,54,1,1
1831,215,220,164.44371882086168,167.0443537414966,37,38,112,3,5
1832,215,417,164.44371882086168,165.58149659863946,37,27,208,1,202
1833,215,496,164.44371882086168,166.62639455782312,37,24,296,2,281
1834,215,661,164.44371882086168,166.90503401360544,37,16,458,2,446
1835,216,6,164.46693877551022,166.4174149659864,36,50,226,2,210
1836,216,6,164.46693877551022,167.43909297052156,36,50,246,3,210
1837,216,214,164.46693877551022,165.6975963718821,36,39,53,1,2
1838,216,220,164.46693877551022,167.0443537414966,36,38,111,3,4
1839,216,417,164.46693877551022,165.58149659863946,36,27,207,1,201
1840,216,496,164.46693877551022,166.62639455782312,36,24,295,2,280
1841,216,661,164.46693877551022,166.90503401360544,36,16,457,2,445
1842,214,6,165.6975963718821,167.43909297052156,39,50,221,2,208
1843,214,5,165.6975963718821,167.46231292517007,39,48,222,2,209
1844,214,6,165.6975963718821,168.4607709750567,39,50,240,3,208
1845,214,220,165.6975963718821,167.0443537414966,39,38,58,1,6
1846,214,246,165.6975963718821,168.20535147392292,39,34,113,3,32
1847,214,428,165.6975963718821,168.41433106575965,39,24,244,3,214
1848,214,661,165.6975963718821,166.90503401360544,39,16,450,1,447
1849,220,6,167.0443537414966,168.4607709750567,38,50,223,1,214
1850,220,6,167.0443537414966,169.48244897959185,38,50,238,2,214
1851,220,246,167.0443537414966,168.20535147392292,38,34,56,1,26
1852,220,329,167.0443537414966,169.13414965986394,38,30,141,2,109
1853,220,211,167.0443537414966,169.7843083900227,38,38,118,3,9
1854,220,428,167.0443537414966,168.41433106575965,38,24,216,1,208
1855,220,428,167.0443537414966,169.4360090702948,38,21,232,2,208
1856,220,490,167.0443537414966,169.94684807256237,38,21,298,3,270
1857,220,666,167.0443537414966,169.94684807256237,38,15,463,3,446
1858,246,6,168.20535147392292,169.48244897959185,34,50,246,1,240
1859,246,6,168.20535147392292,170.48090702947846,34,49,259,2,240
1860,246,211,168.20535147392292,169.7843083900227,34,38,76,2,35
1861,246,214,168.20535147392292,170.85242630385488,34,37,118,3,32
1862,246,428,168.20535147392292,169.4360090702948,34,21,190,1,182
1863,246,490,168.20535147392292,169.94684807256237,34,21,255,2,244
1864,246,493,168.20535147392292,171.17750566893423,34,20,278,3,247
1865,246,666,168.20535147392292,169.94684807256237,34,15,427,2,420
1866,329,6,169.13414965986394,170.48090702947846,30,49,328,1,323
1867,329,6,169.13414965986394,171.5025850340136,30,50,339,2,323
1868,329,214,169.13414965986394,170.85242630385488,30,37,137,2,115
1869,329,274,169.13414965986394,172.08308390022677,30,36,138,3,55
1870,329,493,169.13414965986394,171.17750566893423,30,20,186,2,164
1871,329,427,169.13414965986394,172.08308390022677,30,25,160,3,98
1872,329,801,169.13414965986394,171.36326530612246,30,17,482,2,472
1873,329,654,169.13414965986394,171.99020408163267,30,14,347,3,325
1874,211,6,169.7843083900227,171.5025850340136,38,50,218,2,205
1875,211,6,169.7843083900227,172.52426303854875,38,50,237,3,205
1876,211,214,169.7843083900227,170.85242630385488,38,37,46,1,3
1877,211,274,169.7843083900227,172.08308390022677,38,36,117,2,63
1878,211,493,169.7843083900227,171.17750566893423,38,20,288,1,282
1879,211,427,169.7843083900227,172.08308390022677,38,25,238,2,216
1880,211,654,169.7843083900227,171.99020408163267,38,14,453,2,443
1881,214,6,170.85242630385488,172.52426303854875,37,50,220,2,208
1882,214,6,170.85242630385488,173.5459410430839,37,50,238,3,208
1883,214,274,170.85242630385488,172.08308390022677,37,36,80,1,60
1884,214,206,170.85242630385488,173.42984126984126,37,35,111,3,8
1885,214,427,170.85242630385488,172.08308390022677,37,25,219,1,213
1886,214,411,170.85242630385488,173.17442176870748,37,29,221,2,197
1887,214,428,170.85242630385488,173.49950113378685,37,20,242,3,214
1888,214,654,170.85242630385488,171.99020408163267,37,14,443,1,440
1889,274,6,172.08308390022677,173.5459410430839,36,50,275,1,268
1890,274,6,172.08308390022677,174.56761904761905,36,50,289,2,268
1891,274,206,172.08308390022677,173.42984126984126,36,35,89,1,68
1892,274,224,172.08308390022677,173.87102040816328,36,33,92,2,50
1893,274,209,172.08308390022677,174.91591836734693,36,36,138,3,65
1894,274,411,172.08308390022677,173.17442176870748,36,29,145,1,137
1895,274,428,172.08308390022677,173.49950113378685,36,20,166,1,154
1896,274,430,172.08308390022677,174.4979591836735,36,20,187,2,156
1897,274,654,172.08308390022677,174.01034013605442,36,15,389,2,380
1898,206,6,173.42984126984126,174.56761904761905,35,50,206,1,200
1899,206,6,173.42984126984126,175.56607709750568,35,50,220,2,200
1900,206,209,173.42984126984126,174.91591836734693,35,36,64,1,3
1901,206,273,173.42984126984126,176.14657596371882,35,37,135,3,67
1902,206,430,173.42984126984126,174.4979591836735,35,20,229,1,224
1903,206,425,173.42984126984126,176.10013605442177,35,26,247,3,219
1904,224,6,173.87102040816328,175.56607709750568,33,50,230,2,218
1905,224,6,173.87102040816328,176.58775510204083,33,50,247,3,218
1906,224,209,173.87102040816328,174.91591836734693,33,36,47,1,15
1907,224,273,173.87102040816328,176.14657596371882,33,37,110,2,49
1908,224,425,173.87102040816328,176.10013605442177,33,26,223,2,201
1909,209,6,174.91591836734693,176.58775510204083,36,50,215,2,203
1910,209,11,174.91591836734693,177.86485260770976,36,41,235,3,198
1911,209,273,174.91591836734693,176.14657596371882,36,37,83,1,64
1912,209,297,174.91591836734693,177.42367346938775,36,29,139,3,88
1913,209,296,174.91591836734693,177.67909297052154,36,34,147,3,87
1914,209,425,174.91591836734693,176.10013605442177,36,26,222,1,216
1915,209,411,174.91591836734693,177.00571428571428,36,26,221,2,202
1916,209,417,174.91591836734693,177.74875283446713,36,19,241,3,208
1917,273,11,176.14657596371882,177.86485260770976,37,41,272,2,262
1918,273,5,176.14657596371882,178.63111111111112,37,48,289,2,268
1919,273,297,176.14657596371882,177.42367346938775,37,29,60,1,24
1920,273,296,176.14657596371882,177.67909297052154,37,34,70,2,23
1921,273,218,176.14657596371882,178.95619047619047,37,40,133,3,55
1922,273,417,176.14657596371882,177.74875283446713,37,19,160,2,144
1923,273,426,176.14657596371882,179.04907029478457,37,25,198,3,153
1924,273,645,176.14657596371882,179.09551020408165,37,21,393,3,372
1925,297,5,177.42367346938775,178.63111111111112,29,48,297,1,292
1926,297,6,177.42367346938775,179.65278911564627,29,49,306,2,291
1927,297,218,177.42367346938775,178.95619047619047,29,40,103,2,79
1928,297,206,177.42367346938775,179.97786848072562,29,32,143,3,91
1929,297,426,177.42367346938775,179.04907029478457,29,25,147,2,129
1930,297,445,177.42367346938775,179.861768707483,29,23,181,2,148
1931,297,645,177.42367346938775,179.09551020408165,29,21,355,2,348
1932,297,621,177.42367346938775,179.55990929705214,29,17,337,2,324
1933,296,6,177.67909297052154,179.65278911564627,34,49,302,2,290
1934,296,218,177.67909297052154,178.95619047619047,34,40,95,1,78
1935,296,206,177.67909297052154,179.97786848072562,34,32,134,2,90
1936,296,426,177.67909297052154,179.04907029478457,34,25,143,1,130
1937,296,445,177.67909297052154,179.861768707483,34,23,176,2,149
1938,296,645,177.67909297052154,179.09551020408165,34,21,354,1,349
1939,296,621,177.67909297052154,179.55990929705214,34,17,335,2,325
1940,218,6,178.95619047619047,181.16208616780045,40,48,232,2,212
1941,218,6,178.95619047619047,181.67292517006803,40,49,242,3,212
1942,218,206,178.95619047619047,179.97786848072562,40,32,46,1,12
1943,218,205,178.95619047619047,181.06920634920635,40,30,92,2,13
1944,218,537,178.95619047619047,181.41750566893424,40,19,336,2,319
1945,218,629,178.95619047619047,181.44072562358278,40,17,425,2,411
1946,218,659,178.95619047619047,181.9283446712018,40,19,459,3,441
1947,206,6,179.97786848072562,181.16208616780045,32,48,206,1,200
1948,206,6,179.97786848072562,181.67292517006803,32,49,213,2,200
1949,206,6,179.97786848072562,182.69460317460317,32,49,232,3,200
1950,206,205,179.97786848072562,181.06920634920635,32,30,47,1,1
1951,206,205,179.97786848072562,182.41596371882088,32,30,105,2,1
1952,206,537,179.97786848072562,181.41750566893424,32,19,337,1,331
1953,206,452,179.97786848072562,182.04444444444445,32,24,262,2,246
1954,206,629,179.97786848072562,181.44072562358278,32,17,428,1,423
1955,206,659,179.97786848072562,181.9283446712018,32,19,461,2,453
1956,205,6,181.06920634920635,182.69460317460317,30,49,211,2,199
1957,205,6,181.06920634920635,183.71628117913832,30,50,229,3,199
1958,205,214,181.06920634920635,183.1590022675737,30,29,90,2,9
1959,205,374,181.06920634920635,183.53052154195012,30,33,199,2,169
1960,205,412,181.06920634920635,183.39120181405897,30,21,230,2,207
1961,205,412,181.06920634920635,183.9717006802721,30,21,242,3,207
1962,205,631,181.06920634920635,183.60018140589568,30,20,440,3,426
1963,205,6,182.41596371882088,183.71628117913832,30,50,207,1,199
1964,205,6,182.41596371882088,184.73795918367347,30,49,223,2,199
1965,205,374,182.41596371882088,183.53052154195012,30,33,176,1,169
1966,205,218,182.41596371882088,184.78439909297052,30,25,103,2,13
1967,205,412,182.41596371882088,183.9717006802721,30,21,218,2,207
1968,205,508,182.41596371882088,184.97015873015874,30,19,322,3,303
1969,205,631,182.41596371882088,183.60018140589568,30,20,429,1,426
1970,205,649,182.41596371882088,184.69151927437642,30,18,455,2,444
1971,214,6,183.1590022675737,184.73795918367347,29,49,219,2,208
1972,214,6,183.1590022675737,185.7364172335601,29,49,236,3,208
1973,214,218,183.1590022675737,184.78439909297052,29,25,70,2,4
1974,214,508,183.1590022675737,184.97015873015874,29,19,304,2,294
1975,214,491,183.1590022675737,185.96861678004535,29,20,302,3,277
1976,214,649,183.1590022675737,184.69151927437642,29,18,440,2,435
1977,374,6,183.53052154195012,184.73795918367347,33,49,372,1,368
1978,374,6,183.53052154195012,185.7364172335601,33,49,380,2,368
1979,374,218,183.53052154195012,184.78439909297052,33,25,165,1,156
1980,374,214,183.53052154195012,186.03827664399094,33,27,193,3,160
1981,374,508,183.53052154195012,184.97015873015874,33,19,148,1,134
1982,374,491,183.53052154195012,185.96861678004535,33,20,157,2,117
1983,374,649,183.53052154195012,184.69151927437642,33,18,280,1,275
1984,374,806,183.53052154195012,186.1079365079365,33,21,446,3,432
1985,374,831,183.53052154195012,184.9469387755102,33,14,461,1,457
1986,218,6,184.78439909297052,187.26893424036282,25,49,237,2,212
1987,218,214,184.78439909297052,186.03827664399094,25,27,54,1,4
1988,218,221,184.78439909297052,187.66367346938776,25,31,124,3,3
1989,218,491,184.78439909297052,185.96861678004535,25,20,278,1,273
1990,218,450,184.78439909297052,186.85097505668935,25,20,248,2,232
1991,214,6,186.03827664399094,187.26893424036282,27,49,215,1,208
1992,214,6,186.03827664399094,187.7797732426304,27,49,221,2,208
1993,214,6,186.03827664399094,188.80145124716555,27,49,240,3,208
1994,214,221,186.03827664399094,187.66367346938776,27,31,70,2,7
1995,214,205,186.03827664399094,188.5924716553288,27,29,110,3,9
1996,214,427,186.03827664399094,188.29061224489797,27,19,234,2,213
1997,214,630,186.03827664399094,188.0584126984127,27,19,425,2,416
1998,218,6,187.03673469387755,188.80145124716555,38,49,225,2,212
1999,218,6,187.03673469387755,189.8231292517007,38,49,244,3,212
2000,218,205,187.03673469387755,188.5924716553288,38,29,68,2,13
2001,218,427,187.03673469387755,188.29061224489797,38,19,216,1,209
2002,218,589,187.03673469387755,189.10331065759638,38,20,382,2,371
2003,218,630,187.03673469387755,188.0584126984127,38,19,414,1,412
2004,218,619,187.03673469387755,189.10331065759638,38,22,411,2,401
2005,221,6,187.66367346938776,188.80145124716555,31,49,221,1,215
2006,221,6,187.66367346938776,189.8231292517007,31,49,234,2,215
2007,221,235,187.66367346938776,190.05532879818594,31,30,104,2,14
2008,221,589,187.66367346938776,189.10331065759638,31,20,373,1,368
2009,221,455,187.66367346938776,190.21786848072563,31,25,259,3,234
2010,221,619,187.66367346938776,189.10331065759638,31,22,403,1,398
2011,205,6,188.5924716553288,189.8231292517007,29,49,206,1,199
2012,205,5,188.5924716553288,190.84480725623584,29,49,222,2,200
2013,205,235,188.5924716553288,190.05532879818594,29,30,70,1,30
2014,205,216,188.5924716553288,191.37886621315192,29,31,121,3,11
2015,205,455,188.5924716553288,190.21786848072563,29,25,260,2,250
2016,205,490,188.5924716553288,191.47174603174602,29,20,311,3,285
2017,235,6,190.05532879818594,191.84326530612245,30,50,242,2,229
2018,235,6,190.05532879818594,192.8649433106576,30,49,259,3,229
2019,235,216,190.05532879818594,191.37886621315192,30,31,60,1,19
2020,235,317,190.05532879818594,192.28444444444446,30,29,126,2,82
2021,235,490,190.05532879818594,191.47174603174602,30,20,262,1,255
2022,235,432,190.05532879818594,192.14512471655328,30,25,217,2,197
2023,235,429,190.05532879818594,192.81850340136054,30,20,228,3,194
2024,235,649,190.05532879818594,192.84172335600908,30,17,431,3,414
2025,216,6,191.37886621315192,192.8649433106576,31,49,220,1,210
2026,216,6,191.37886621315192,193.88662131519274,31,49,236,3,210
2027,216,252,191.37886621315192,193.35256235827666,31,26,92,2,36
2028,216,333,191.37886621315192,193.8401814058957,31,25,158,2,117
2029,216,429,191.37886621315192,192.81850340136054,31,20,222,1,213
2030,216,560,191.37886621315192,193.79374149659864,31,22,359,2,344
2031,216,649,191.37886621315192,192.84172335600908,31,17,438,1,433
2032,216,679,191.37886621315192,193.81696145124718,31,18,475,2,463
2033,317,6,192.28444444444446,193.88662131519274,29,49,319,2,311
2034,317,252,192.28444444444446,193.35256235827666,29,26,80,1,65
2035,317,333,192.28444444444446,193.8401814058957,29,25,69,2,16
2036,317,220,192.28444444444446,194.86185941043084,29,23,147,3,97
2037,317,560,192.28444444444446,193.79374149659864,29,22,252,2,243
2038,317,411,192.28444444444446,195.21015873015872,29,20,157,3,94
2039,317,679,192.28444444444446,193.81696145124718,29,18,368,2,362
2040,317,631,192.28444444444446,194.88507936507938,29,15,333,3,314
2041,252,6,193.35256235827666,195.39591836734695,26,49,261,2,246
2042,252,4,193.35256235827666,195.5352380952381,26,40,265,2,248
2043,252,220,193.35256235827666,194.86185941043084,26,23,72,2,32
2044,252,368,193.35256235827666,195.76743764172335,26,27,156,2,116
2045,252,411,193.35256235827666,195.21015873015872,26,20,178,2,159
2046,252,413,193.35256235827666,195.76743764172335,26,25,192,2,161
2047,252,631,193.35256235827666,194.88507936507938,26,15,385,2,379
2048,252,648,193.35256235827666,195.81387755102043,26,24,410,2,396
2049,333,6,193.8401814058957,195.39591836734695,25,49,334,2,327
2050,333,4,193.8401814058957,195.5352380952381,25,40,337,2,329
2051,333,220,193.8401814058957,194.86185941043084,25,23,121,1,113
2052,333,368,193.8401814058957,195.76743764172335,25,27,90,2,35
2053,333,411,193.8401814058957,195.21015873015872,25,20,98,1,78
2054,333,413,193.8401814058957,195.76743764172335,25,25,115,2,80
2055,333,631,193.8401814058957,194.88507936507938,25,15,301,1,298
2056,333,648,193.8401814058957,195.81387755102043,25,24,326,2,315
2057,220,16,194.86185941043084,197.11419501133787,23,32,226,2,204
2058,220,16,194.86185941043084,197.6714739229025,23,30,237,3,204
2059,368,16,195.76743764172335,197.11419501133787,27,32,357,1,352
2060,368,16,195.76743764172335,197.6714739229025,27,30,361,2,352
2061,422,15,8.568163265306122,10.309659863945578,19,43,414,2,407
2062,422,274,8.568163265306122,10.24,19,21,165,2,148
2063,422,426,8.568163265306122,10.263219954648527,19,19,73,2,4
2064,422,638,8.568163265306122,10.216780045351474,19,13,227,2,216
2065,480,15,9.009342403628118,10.309659863945578,17,43,468,1,465
2066,480,14,9.009342403628118,11.586757369614512,17,42,479,3,466
2067,480,274,9.009342403628118,10.24,17,21,213,1,206
2068,480,426,9.009342403628118,10.263219954648527,17,19,76,1,54
2069,480,638,9.009342403628118,10.216780045351474,17,13,166,1,158
2070,426,14,10.263219954648527,11.586757369614512,19,42,416,1,412
2071,426,12,10.263219954648527,12.631655328798185,19,43,426,2,414
2072,426,208,10.263219954648527,12.817414965986394,19,33,244,3,218
2073,426,432,10.263219954648527,12.956734693877552,19,18,116,3,6
2074,426,761,10.263219954648527,12.585215419501134,19,14,350,2,335
2075,432,14,12.956734693877552,14.373151927437641,18,44,422,1,418
2076,432,12,12.956734693877552,15.673469387755102,18,44,436,3,420
2077,432,213,12.956734693877552,14.187392290249434,18,23,225,1,219
2078,432,486,12.956734693877552,14.55891156462585,18,23,88,2,54
2079,432,622,12.956734693877552,14.489251700680272,18,14,201,2,190
2080,474,12,13.537233560090703,15.673469387755102,21,44,471,2,462
2081,474,254,13.537233560090703,16.27718820861678,21,27,250,3,220
2082,474,486,13.537233560090703,14.55891156462585,21,23,46,1,12
2083,474,415,13.537233560090703,16.27718820861678,21,19,132,3,59
2084,486,12,14.55891156462585,15.673469387755102,23,44,476,1,474
2085,486,10,14.55891156462585,16.973786848072564,23,44,487,2,476
2086,486,10,14.55891156462585,17.136326530612244,23,44,489,3,476
2087,486,254,14.55891156462585,16.27718820861678,23,27,244,2,232
2088,486,292,14.55891156462585,17.136326530612244,23,18,224,3,194
2089,486,415,14.55891156462585,16.27718820861678,23,19,103,2,71
2090,486,460,14.55891156462585,17.29886621315193,23,13,121,3,26
2091,415,12,16.27718820861678,18.204444444444444,19,43,411,2,403
2092,415,210,16.27718820861678,18.599183673469387,19,21,228,2,205
2093,415,460,16.27718820861678,17.29886621315193,19,13,63,1,45
2094,415,414,16.27718820861678,18.413424036281178,19,21,92,2,1
2095,415,773,16.27718820861678,18.18122448979592,19,15,367,2,358
2096,415,821,16.27718820861678,18.18122448979592,19,15,414,2,406
2097,460,14,17.29886621315193,19.71374149659864,13,44,458,2,446
2098,460,210,17.29886621315193,18.599183673469387,13,21,256,1,250
2099,460,414,17.29886621315193,18.413424036281178,13,21,66,1,46
2100,414,14,18.413424036281178,19.71374149659864,21,44,404,1,400
2101,414,12,18.413424036281178,20.758639455782312,21,44,414,2,402
2102,414,14,18.413424036281178,21.037278911564627,21,43,416,3,400
2103,414,334,18.413424036281178,20.712199546485262,21,20,127,2,80
2104,414,514,18.413424036281178,20.503219954648525,21,18,135,2,100
2105,414,814,18.413424036281178,20.48,21,15,410,2,400
2106,414,832,18.413424036281178,20.48,21,14,427,2,418
2107,514,299,20.503219954648525,21.91963718820862,18,26,223,1,215
2108,514,355,20.503219954648525,22.221496598639455,18,23,175,2,159
2109,514,421,20.503219954648525,22.267936507936508,18,18,120,2,93
2110,514,628,20.503219954648525,22.19827664399093,18,14,135,2,114
2111,421,12,22.267936507936508,24.055873015873015,18,44,416,2,409
2112,421,295,22.267936507936508,25.007891156462584,18,24,173,3,126
2113,421,417,22.267936507936508,25.007891156462584,18,17,118,3,4
2114,417,12,25.007891156462584,26.3546485260771,17,45,409,1,405
2115,417,14,25.007891156462584,27.23700680272109,17,44,414,2,403
2116,417,245,25.007891156462584,26.05278911564626,17,24,178,1,172
2117,417,216,25.007891156462584,27.445986394557824,17,23,227,2,201
2118,417,433,25.007891156462584,26.029569160997735,17,18,47,1,16
2119,417,433,25.007891156462584,26.05278911564626,17,19,48,1,16
2120,417,416,25.007891156462584,27.260226757369615,17,15,97,2,1
2121,417,658,25.007891156462584,26.076009070294784,17,14,245,1,241
2122,433,14,26.029569160997735,27.23700680272109,18,44,422,1,419
2123,433,14,26.029569160997735,28.142585034013607,18,43,429,2,419
2124,433,216,26.029569160997735,27.445986394557824,18,23,225,1,217
2125,433,308,26.029569160997735,28.95528344671202,18,23,177,3,125
2126,433,416,26.029569160997735,27.260226757369615,18,15,56,1,17
2127,433,514,26.029569160997735,28.81596371882086,18,21,145,3,81
2128,433,636,26.029569160997735,28.81596371882086,18,15,236,3,203
2129,433,14,26.05278911564626,27.23700680272109,19,44,422,1,419
2130,433,14,26.05278911564626,28.142585034013607,19,43,429,2,419
2131,433,216,26.05278911564626,27.445986394557824,19,23,225,1,217
2132,433,308,26.05278911564626,28.95528344671202,19,23,177,3,125
2133,433,416,26.05278911564626,27.260226757369615,19,15,55,1,17
2134,433,514,26.05278911564626,28.81596371882086,19,21,144,3,81
2135,433,636,26.05278911564626,28.81596371882086,19,15,235,3,203
2136,416,11,27.260226757369615,29.280362811791385,15,43,414,2,405
2137,416,90,27.260226757369615,30.093061224489798,15,40,348,3,326
2138,416,308,27.260226757369615,28.95528344671202,15,23,130,2,108
2139,416,210,27.260226757369615,29.53578231292517,15,28,228,2,206
2140,416,514,27.260226757369615,28.81596371882086,15,21,119,2,98
2141,416,475,27.260226757369615,29.83764172335601,15,15,126,3,59
2142,416,636,27.260226757369615,28.81596371882086,15,15,230,2,220
2143,514,90,28.81596371882086,30.093061224489798,21,40,428,1,424
2144,514,318,28.81596371882086,30.812879818594105,21,24,214,2,196
2145,514,295,28.81596371882086,31.7881179138322,21,25,254,3,219
2146,514,475,28.81596371882086,29.83764172335601,21,15,59,1,39
2147,514,411,28.81596371882086,30.65034013605442,21,15,130,2,103
2148,514,414,28.81596371882086,31.648798185941043,21,20,158,3,100
2149,514,625,28.81596371882086,31.71845804988662,21,13,167,3,111
2150,475,83,29.83764172335601,32.066757369614514,15,41,404,2,392
2151,475,83,29.83764172335601,32.345396825396826,15,41,407,3,392
2152,475,295,29.83764172335601,31.7881179138322,15,25,199,2,180
2153,475,277,29.83764172335601,32.48471655328798,15,22,228,3,198
2154,475,414,29.83764172335601,31.648798185941043,15,20,99,2,61
2155,475,414,29.83764172335601,32.46149659863946,15,20,128,3,61
2156,475,625,29.83764172335601,31.71845804988662,15,13,170,2,150
2157,411,83,30.65034013605442,32.066757369614514,15,41,334,1,328
2158,411,83,30.65034013605442,32.345396825396826,15,41,336,2,328
2159,411,295,30.65034013605442,31.7881179138322,15,25,126,1,116
2160,411,277,30.65034013605442,32.48471655328798,15,22,156,2,134
2161,411,414,30.65034013605442,32.46149659863946,15,20,78,2,3
2162,411,625,30.65034013605442,31.71845804988662,15,13,219,1,214
2163,414,5,31.648798185941043,33.73859410430839,20,45,419,2,409
2164,414,6,31.648798185941043,34.22621315192744,20,50,423,3,408
2165,414,213,31.648798185941043,33.99401360544218,20,35,225,2,201
2166,414,427,31.648798185941043,33.99401360544218,20,22,102,2,13
2167,414,646,31.648798185941043,33.69215419501134,20,19,248,2,232
2168,414,853,31.648798185941043,33.668934240362816,20,13,448,2,439
2169,414,5,32.46149659863946,33.73859410430839,20,45,413,1,409
2170,414,6,32.46149659863946,34.22621315192744,20,50,415,2,408
2171,414,6,32.46149659863946,35.247891156462586,20,49,425,3,408
2172,414,213,32.46149659863946,33.99401360544218,20,35,212,2,201
2173,414,208,32.46149659863946,34.69061224489796,20,26,227,2,206
2174,414,337,32.46149659863946,35.131791383219955,20,29,138,3,77
2175,414,427,32.46149659863946,33.99401360544218,20,22,67,2,13
2176,414,499,32.46149659863946,34.71383219954649,20,22,129,2,85
2177,414,646,32.46149659863946,33.69215419501134,20,19,238,1,232
2178,414,771,32.46149659863946,34.644172335600906,20,23,369,2,357
2179,414,853,32.46149659863946,33.668934240362816,20,13,442,1,439
2180,414,826,32.46149659863946,34.644172335600906,20,22,423,2,412
2181,427,6,33.99401360544218,35.247891156462586,22,49,424,1,421
2182,427,6,33.99401360544218,36.24634920634921,22,50,432,2,421
2183,427,337,33.99401360544218,35.131791383219955,22,29,102,1,90
2184,427,213,33.99401360544218,36.73396825396826,22,27,244,3,214
2185,427,499,33.99401360544218,35.735510204081635,22,21,104,2,72
2186,427,538,33.99401360544218,36.664308390022676,22,23,160,3,111
2187,427,687,33.99401360544218,35.71229024943311,22,15,270,2,260
2188,427,630,33.99401360544218,36.5946485260771,22,20,232,3,203
2189,427,868,33.99401360544218,36.64108843537415,22,14,455,3,441
2190,499,6,34.71383219954649,36.24634920634921,22,50,497,2,493
2191,499,6,34.71383219954649,37.268027210884355,22,51,505,3,493
2192,499,213,34.71383219954649,36.73396825396826,22,27,299,2,286
2193,499,538,34.71383219954649,36.664308390022676,22,23,93,2,39
2194,499,630,34.71383219954649,36.5946485260771,22,20,154,2,131
2195,499,868,34.71383219954649,36.64108843537415,22,14,378,2,369
2196,499,6,35.735510204081635,37.268027210884355,21,51,497,2,493
2197,499,6,35.735510204081635,38.2897052154195,21,50,505,3,493
2198,499,327,35.735510204081635,38.080725623582765,21,27,199,2,172
2199,499,438,35.735510204081635,37.755646258503404,21,18,106,2,61
2200,499,435,35.735510204081635,38.521904761904764,21,22,136,3,64
2201,499,687,35.735510204081635,37.755646258503404,21,18,207,2,188
2202,538,327,36.664308390022676,38.080725623582765,23,27,220,1,211
2203,538,217,36.664308390022676,39.05596371882086,23,36,337,2,321
2204,538,215,36.664308390022676,39.497142857142855,23,37,345,3,323
2205,538,438,36.664308390022676,37.755646258503404,23,18,110,1,100
2206,538,435,36.664308390022676,38.521904761904764,23,22,130,2,103
2207,538,687,36.664308390022676,37.755646258503404,23,18,156,1,149
2208,538,637,36.664308390022676,38.846984126984125,23,22,137,2,99
2209,538,865,36.664308390022676,38.800544217687076,23,19,340,2,327
2210,438,6,37.755646258503404,39.31138321995465,18,50,437,2,432
2211,438,6,37.755646258503404,40.30984126984127,18,49,446,3,432
2212,438,217,37.755646258503404,39.05596371882086,18,36,228,1,221
2213,438,215,37.755646258503404,39.497142857142855,18,37,235,2,223
2214,438,332,37.755646258503404,40.12408163265306,18,26,147,2,106
2215,438,429,37.755646258503404,39.7990022675737,18,23,88,2,9
2216,438,637,37.755646258503404,38.846984126984125,18,22,204,1,199
2217,438,718,37.755646258503404,39.9847619047619,18,15,296,2,280
2218,438,865,37.755646258503404,38.800544217687076,18,19,429,1,427
2219,435,6,38.521904761904764,40.30984126984127,22,49,436,2,429
2220,435,6,38.521904761904764,41.33151927437642,22,50,446,3,429
2221,435,332,38.521904761904764,40.12408163265306,22,26,124,2,103
2222,435,429,38.521904761904764,39.7990022675737,22,23,55,1,6
2223,435,478,38.521904761904764,40.79746031746032,22,20,107,2,43
2224,435,718,38.521904761904764,39.9847619047619,22,15,290,1,283
2225,435,753,38.521904761904764,40.84390022675737,22,13,333,2,318
2226,429,6,39.7990022675737,41.33151927437642,23,50,428,2,423
2227,429,6,39.7990022675737,42.353197278911566,23,50,437,3,423
2228,429,278,39.7990022675737,41.633378684807255,23,29,170,2,151
2229,429,214,39.7990022675737,42.49251700680272,23,27,244,3,215
2230,429,545,39.7990022675737,41.56371882086168,23,25,139,2,116
2231,429,753,39.7990022675737,40.84390022675737,23,13,327,1,324
2232,429,626,39.7990022675737,41.56371882086168,23,19,211,2,197
2233,429,682,39.7990022675737,42.306757369614516,23,15,275,3,253
2234,429,844,39.7990022675737,41.56371882086168,23,16,422,2,415
2235,429,876,39.7990022675737,42.283537414965984,23,21,460,2,447
2236,478,6,40.79746031746032,42.353197278911566,20,50,477,2,472
2237,478,6,40.79746031746032,43.37487528344671,20,50,485,3,472
2238,478,214,40.79746031746032,42.49251700680272,20,27,274,2,264
2239,478,301,40.79746031746032,43.444535147392294,20,27,211,3,177
2240,478,429,40.79746031746032,42.840816326530614,20,19,101,2,49
2241,478,512,40.79746031746032,43.769614512471655,20,23,132,3,34
2242,478,682,40.79746031746032,42.306757369614516,20,15,214,2,204
2243,478,876,40.79746031746032,42.283537414965984,20,21,403,1,398
2244,545,301,41.56371882086168,43.444535147392294,25,27,257,2,244
2245,545,429,41.56371882086168,42.840816326530614,25,19,128,1,116
2246,545,512,41.56371882086168,43.769614512471655,25,23,101,2,33
2247,545,415,41.56371882086168,44.489433106575966,25,25,181,3,130
2248,545,661,41.56371882086168,43.86249433106576,25,14,153,2,116
2249,429,6,42.840816326530614,44.39655328798186,19,49,428,2,423
2250,429,6,42.840816326530614,45.39501133786848,19,49,437,3,423
2251,429,292,42.840816326530614,44.55909297052154,19,32,156,2,137
2252,429,415,42.840816326530614,44.489433106575966,19,25,72,2,14
2253,429,547,42.840816326530614,45.60399092970522,19,23,168,3,118
2254,429,661,42.840816326530614,43.86249433106576,19,14,236,1,232
2255,429,750,42.840816326530614,44.76807256235828,19,18,332,2,321
2256,429,743,42.840816326530614,45.627210884353744,19,23,336,3,314
2257,429,851,42.840816326530614,45.627210884353744,19,20,439,3,422
2258,512,218,43.769614512471655,45.97551020408164,23,32,309,2,294
2259,512,364,43.769614512471655,46.602448979591834,23,31,192,3,148
2260,512,547,43.769614512471655,45.60399092970522,23,23,86,2,35
2261,512,743,43.769614512471655,45.627210884353744,23,23,244,2,231
2262,512,851,43.769614512471655,45.627210884353744,23,20,348,2,339
2263,415,6,44.489433106575966,46.41668934240363,25,50,417,2,409
2264,415,6,44.489433106575966,47.438367346938776,25,50,428,3,409
2265,415,218,44.489433106575966,45.97551020408164,25,32,207,1,197
2266,415,364,44.489433106575966,46.602448979591834,25,31,104,2,51
2267,415,215,44.489433106575966,47.391927437641726,25,34,236,3,200
2268,415,547,44.489433106575966,45.60399092970522,25,23,140,1,132
2269,415,449,44.489433106575966,46.9275283446712,25,20,110,2,34
2270,415,743,44.489433106575966,45.627210884353744,25,23,332,1,328
2271,415,687,44.489433106575966,46.90430839002268,25,17,291,2,272
2272,415,624,44.489433106575966,47.18294784580499,25,23,239,3,209
2273,415,851,44.489433106575966,45.627210884353744,25,20,439,1,436
2274,415,823,44.489433106575966,47.206167800453514,25,17,424,3,408
2275,547,215,45.60399092970522,47.391927437641726,23,34,341,2,332
2276,547,219,45.60399092970522,48.29750566893424,23,28,348,3,328
2277,547,449,45.60399092970522,46.9275283446712,23,20,113,1,98
2278,547,438,45.60399092970522,47.925986394557825,23,23,148,2,109
2279,547,687,45.60399092970522,46.90430839002268,23,17,151,1,140
2280,547,624,45.60399092970522,47.18294784580499,23,23,103,2,77
2281,547,823,45.60399092970522,47.206167800453514,23,17,284,2,276
2282,449,6,46.9275283446712,48.46004535147392,20,51,448,2,443
2283,449,6,46.9275283446712,49.48172335600907,20,50,456,3,443
2284,449,219,46.9275283446712,48.29750566893424,20,28,237,1,230
2285,449,423,46.9275283446712,48.92444444444445,20,19,90,2,26
2286,449,621,46.9275283446712,48.92444444444445,20,16,192,2,172
2287,449,633,46.9275283446712,49.22630385487528,20,17,209,2,184
2288,449,927,46.9275283446712,49.20308390022676,20,17,488,2,478
2289,438,6,47.925986394557825,49.48172335600907,23,50,437,2,432
2290,438,6,47.925986394557825,50.48018140589569,23,50,446,3,432
2291,438,293,47.925986394557825,50.062222222222225,23,27,172,2,145
2292,438,220,47.925986394557825,50.549841269841274,23,37,246,3,218
2293,438,499,47.925986394557825,49.96934240362812,23,19,107,2,61
2294,438,436,47.925986394557825,50.80526077097506,23,21,124,3,2
2295,438,633,47.925986394557825,49.22630385487528,23,17,203,1,195
2296,438,814,47.925986394557825,50.874920634920635,23,20,397,3,376
2297,438,927,47.925986394557825,49.20308390022676,23,17,492,1,489
2298,423,6,48.92444444444445,50.48018140589569,19,50,422,2,417
2299,423,6,48.92444444444445,51.50185941043084,19,50,432,3,417
2300,423,293,48.92444444444445,50.062222222222225,19,27,139,1,130
2301,423,220,48.92444444444445,50.549841269841274,19,37,215,2,203
2302,423,227,48.92444444444445,51.7340589569161,19,32,230,3,196
2303,423,499,48.92444444444445,49.96934240362812,19,19,88,1,76
2304,423,436,48.92444444444445,50.80526077097506,19,21,82,2,13
2305,423,814,48.92444444444445,50.874920634920635,19,20,400,2,391
2306,423,682,48.92444444444445,51.66439909297052,19,21,285,3,259
2307,423,866,48.92444444444445,50.944580498866216,19,24,451,2,443
2308,423,821,48.92444444444445,51.61795918367347,19,16,415,3,398
2309,499,6,49.96934240362812,51.50185941043084,19,50,497,2,493
2310,499,6,49.96934240362812,52.523537414965986,19,50,505,3,493
2311,499,227,49.96934240362812,51.7340589569161,19,32,282,2,272
2312,499,437,49.96934240362812,51.98947845804989,19,20,107,2,62
2313,499,682,49.96934240362812,51.66439909297052,19,21,197,2,183
2314,499,821,49.96934240362812,51.61795918367347,19,16,330,2,322
2315,436,6,50.80526077097506,52.523537414965986,21,50,436,2,430
2316,436,6,50.80526077097506,53.54521541950113,21,50,446,3,430
2317,436,230,50.80526077097506,52.98793650793651,21,27,226,2,206
2318,436,437,50.80526077097506,51.98947845804989,21,20,51,1,1
2319,436,440,50.80526077097506,52.98793650793651,21,20,94,2,4
2320,436,647,50.80526077097506,53.011156462585035,21,16,231,2,211
2321,437,6,51.98947845804989,53.54521541950113,20,50,436,2,431
2322,437,6,51.98947845804989,54.56689342403628,20,50,445,3,431
2323,437,230,51.98947845804989,54.00961451247166,20,25,225,2,207
2324,437,227,51.98947845804989,54.31147392290249,20,35,233,2,210
2325,437,443,51.98947845804989,54.00961451247166,20,19,87,2,6
2326,437,647,51.98947845804989,53.011156462585035,20,16,215,1,210
2327,437,646,51.98947845804989,54.03283446712018,20,14,227,2,209
2328,440,6,52.98793650793651,54.56689342403628,20,50,439,2,434
2329,440,6,52.98793650793651,55.5653514739229,20,49,448,3,434
2330,440,230,52.98793650793651,54.00961451247166,20,25,215,1,210
2331,440,227,52.98793650793651,54.31147392290249,20,35,220,1,213
2332,440,213,52.98793650793651,55.77433106575964,20,31,257,3,227
2333,440,443,52.98793650793651,54.00961451247166,20,19,44,1,3
2334,440,429,52.98793650793651,55.031292517006804,20,21,89,2,11
2335,440,646,52.98793650793651,54.03283446712018,20,14,211,1,206
2336,440,647,52.98793650793651,55.05451247165533,20,17,225,2,207
2337,443,6,54.00961451247166,55.5653514739229,19,49,442,2,437
2338,443,6,54.00961451247166,56.58702947845805,19,50,451,3,437
2339,443,213,54.00961451247166,55.77433106575964,19,31,242,2,230
2340,443,211,54.00961451247166,56.21551020408163,19,30,251,2,232
2341,443,429,54.00961451247166,55.031292517006804,19,21,46,1,14
2342,443,491,54.00961451247166,56.029750566893426,19,21,99,2,48
2343,443,647,54.00961451247166,55.05451247165533,19,17,209,1,204
2344,429,6,55.031292517006804,56.58702947845805,21,50,428,2,423
2345,429,6,55.031292517006804,57.608707482993196,21,50,437,3,423
2346,429,211,55.031292517006804,56.21551020408163,21,30,224,1,218
2347,429,620,55.031292517006804,57.05142857142857,21,13,210,2,191
2348,491,6,56.029750566893426,57.608707482993196,21,50,490,2,485
2349,491,6,56.029750566893426,58.63038548752834,21,50,498,3,485
2350,491,245,56.029750566893426,58.07310657596372,21,31,261,2,246
2351,491,241,56.029750566893426,58.212426303854876,21,31,267,2,250
2352,491,429,56.029750566893426,57.05142857142857,21,18,76,1,62
2353,491,429,56.029750566893426,58.096326530612245,21,21,108,2,62
2354,491,620,56.029750566893426,57.05142857142857,21,13,136,1,129
2355,491,803,56.029750566893426,58.096326530612245,21,13,324,2,312
2356,491,726,56.029750566893426,58.816145124716556,21,15,264,3,235
2357,429,6,57.05142857142857,58.63038548752834,18,50,428,2,423
2358,429,6,57.05142857142857,59.65206349206349,18,50,438,3,423
2359,429,245,57.05142857142857,58.07310657596372,18,31,189,1,184
2360,429,241,57.05142857142857,58.212426303854876,18,31,195,1,188
2361,429,209,57.05142857142857,59.512743764172335,18,27,244,2,220
2362,429,412,57.05142857142857,59.025124716553286,18,25,87,2,17
2363,429,423,57.05142857142857,59.55918367346939,18,20,108,3,6
2364,429,803,57.05142857142857,58.096326530612245,18,13,377,1,374
2365,429,726,57.05142857142857,58.816145124716556,18,15,307,2,297
2366,429,615,57.05142857142857,59.60562358276644,18,14,216,3,186
2367,429,6,58.096326530612245,59.65206349206349,21,50,428,2,423
2368,429,8,58.096326530612245,60.48798185941043,21,46,433,2,421
2369,429,209,58.096326530612245,59.512743764172335,21,27,228,1,220
2370,429,266,58.096326530612245,61.045260770975055,21,33,207,3,163
2371,429,423,58.096326530612245,59.55918367346939,21,20,63,1,6
2372,429,615,58.096326530612245,59.60562358276644,21,14,197,2,186
2373,412,8,59.025124716553286,60.48798185941043,25,46,409,1,404
2374,412,6,59.025124716553286,61.67219954648526,25,50,422,3,406
2375,412,266,59.025124716553286,61.045260770975055,25,33,170,2,146
2376,412,216,59.025124716553286,61.99727891156463,25,27,234,3,196
2377,412,410,59.025124716553286,61.11492063492064,25,17,90,2,2
2378,412,418,59.025124716553286,61.881179138322,25,22,123,3,6
2379,412,744,59.025124716553286,61.92761904761905,25,20,355,3,332
2380,412,880,59.025124716553286,61.90439909297052,25,16,484,3,468
2381,423,6,59.55918367346939,61.67219954648526,20,50,427,2,417
2382,423,266,59.55918367346939,61.045260770975055,20,33,170,1,157
2383,423,216,59.55918367346939,61.99727891156463,20,27,232,2,207
2384,423,410,59.55918367346939,61.11492063492064,20,17,68,2,13
2385,423,418,59.55918367346939,61.881179138322,20,22,100,2,5
2386,423,414,59.55918367346939,62.15981859410431,20,20,112,3,9
2387,423,744,59.55918367346939,61.92761904761905,20,20,337,2,321
2388,423,880,59.55918367346939,61.90439909297052,20,16,468,2,457
2389,410,6,61.11492063492064,62.69387755102041,17,50,410,2,404
2390,410,6,61.11492063492064,63.715555555555554,17,50,419,3,404
2391,410,205,61.11492063492064,62.64743764172336,17,24,215,2,205
2392,410,205,61.11492063492064,63.947755102040816,17,25,239,3,205
2393,410,414,61.11492063492064,62.15981859410431,17,20,45,1,4
2394,410,651,61.11492063492064,63.947755102040816,17,17,270,3,241
2395,418,6,61.881179138322,63.715555555555554,22,50,420,2,412
2396,418,6,61.881179138322,64.7372335600907,22,50,430,3,412
2397,418,205,61.881179138322,63.947755102040816,22,25,231,2,213
2398,418,205,61.881179138322,64.76045351473923,22,24,246,3,213
2399,418,456,61.881179138322,64.1102947845805,22,20,103,2,38
2400,418,463,61.881179138322,64.17995464852608,22,20,109,2,45
2401,418,651,61.881179138322,63.947755102040816,22,17,249,2,233
2402,418,646,61.881179138322,64.2031746031746,22,16,249,2,228
2403,414,6,62.15981859410431,63.715555555555554,20,50,413,2,408
2404,414,6,62.15981859410431,64.7372335600907,20,50,423,3,408
2405,414,205,62.15981859410431,63.947755102040816,20,25,223,2,209
2406,414,205,62.15981859410431,64.76045351473923,20,24,237,3,209
2407,414,456,62.15981859410431,64.1102947845805,20,20,94,2,42
2408,414,463,62.15981859410431,64.17995464852608,20,20,100,2,49
2409,414,651,62.15981859410431,63.947755102040816,20,17,249,2,237
2410,414,646,62.15981859410431,64.2031746031746,20,16,248,2,232
2411,456,6,64.1102947845805,65.73569160997732,20,50,455,2,450
2412,456,6,64.1102947845805,66.75736961451247,20,50,464,3,450
2413,456,205,64.1102947845805,65.66603174603175,20,27,260,2,251
2414,456,387,64.1102947845805,66.20009070294785,20,23,113,2,69
2415,456,428,64.1102947845805,65.68925170068027,20,19,74,2,28
2416,456,438,64.1102947845805,66.22331065759637,20,21,93,2,18
2417,456,655,64.1102947845805,65.48027210884354,20,20,208,1,199
2418,456,645,64.1102947845805,66.22331065759637,20,13,210,2,189
2419,456,867,64.1102947845805,65.50349206349206,20,20,415,1,411
2420,463,6,64.17995464852608,65.73569160997732,20,50,462,2,457
2421,463,6,64.17995464852608,66.75736961451247,20,50,470,3,457
2422,463,205,64.17995464852608,65.66603174603175,20,27,266,1,258
2423,463,387,64.17995464852608,66.20009070294785,20,23,116,2,76
2424,463,428,64.17995464852608,65.68925170068027,20,19,74,2,35
2425,463,438,64.17995464852608,66.22331065759637,20,21,91,2,25
2426,463,655,64.17995464852608,65.48027210884354,20,20,200,1,192
2427,463,645,64.17995464852608,66.22331065759637,20,13,202,2,182
2428,463,867,64.17995464852608,65.50349206349206,20,20,408,1,404
2429,428,6,65.68925170068027,66.75736961451247,19,50,424,1,422
2430,428,6,65.68925170068027,67.77904761904762,19,51,431,2,422
2431,428,6,65.68925170068027,68.28988662131519,19,49,437,3,422
2432,428,205,65.68925170068027,67.96480725623583,19,24,244,2,223
2433,428,438,65.68925170068027,67.24498866213152,19,21,68,2,10
2434,428,640,65.68925170068027,68.08090702947845,19,15,236,2,212
2435,438,6,66.22331065759637,67.77904761904762,21,51,437,2,432
2436,438,6,66.22331065759637,68.28988662131519,21,49,441,2,432
2437,438,205,66.22331065759637,67.96480725623583,21,24,245,2,233
2438,438,244,66.22331065759637,69.14902494331066,21,32,231,3,194
2439,438,267,66.22331065759637,69.19546485260771,21,28,214,3,171
2440,438,432,66.22331065759637,68.98648526077098,21,22,119,3,6
2441,438,640,66.22331065759637,68.08090702947845,21,15,217,2,202
2442,438,658,66.22331065759637,68.94004535147393,21,17,249,3,220
2443,438,6,67.24498866213152,68.28988662131519,21,49,434,1,432
2444,438,6,67.24498866213152,69.82240362811791,21,50,446,3,432
2445,438,244,67.24498866213152,69.14902494331066,21,32,211,2,194
2446,438,267,67.24498866213152,69.19546485260771,21,28,191,2,171
2447,438,432,67.24498866213152,68.98648526077098,21,22,75,2,6
2448,438,467,67.24498866213152,69.40444444444445,21,16,97,2,29
2449,438,658,67.24498866213152,68.94004535147393,21,17,232,2,220
2450,438,798,67.24498866213152,69.5437641723356,21,15,373,2,360
2451,438,830,67.24498866213152,69.5437641723356,21,13,404,2,392
2452,432,6,68.98648526077098,70.82086167800453,22,50,433,2,426
2453,432,6,68.98648526077098,71.84253968253968,22,50,443,3,426
2454,432,367,68.98648526077098,71.0530612244898,22,29,110,2,65
2455,432,220,68.98648526077098,71.26204081632653,22,31,234,2,212
2456,432,517,68.98648526077098,70.6118820861678,22,20,110,2,85
2457,432,415,68.98648526077098,71.28526077097506,22,14,100,2,17
2458,432,655,68.98648526077098,71.02984126984127,22,17,240,2,223
2459,432,732,68.98648526077098,71.28526077097506,22,14,316,2,300
2460,467,6,69.40444444444445,70.82086167800453,16,50,465,1,461
2461,467,6,69.40444444444445,71.84253968253968,16,50,473,2,461
2462,467,6,69.40444444444445,72.35337868480725,16,51,478,3,461
2463,467,367,69.40444444444445,71.0530612244898,16,29,123,2,100
2464,467,220,69.40444444444445,71.26204081632653,16,31,260,2,247
2465,467,223,69.40444444444445,72.2140589569161,16,19,272,3,244
2466,467,517,69.40444444444445,70.6118820861678,16,20,72,1,50
2467,467,415,69.40444444444445,71.28526077097506,16,14,96,2,52
2468,467,444,69.40444444444445,72.28371882086168,16,15,126,3,23
2469,467,655,69.40444444444445,71.02984126984127,16,17,201,2,188
2470,467,732,69.40444444444445,71.28526077097506,16,14,277,2,265
2471,517,223,70.6118820861678,72.2140589569161,20,19,302,2,294
2472,517,288,70.6118820861678,73.21251700680273,20,23,255,3,229
2473,517,444,70.6118820861678,72.28371882086168,20,15,103,2,73
2474,517,543,70.6118820861678,73.32861678004535,20,23,120,3,26
2475,517,627,70.6118820861678,73.32861678004535,20,18,161,3,110
2476,415,6,71.28526077097506,72.35337868480725,14,51,412,1,409
2477,415,6,71.28526077097506,73.3750566893424,14,50,419,2,409
2478,415,288,71.28526077097506,73.21251700680273,14,23,152,2,127
2479,415,543,71.28526077097506,73.32861678004535,14,23,155,2,128
2480,415,627,71.28526077097506,73.32861678004535,14,18,230,2,212
2481,444,6,72.28371882086168,73.3750566893424,15,50,441,1,438
2482,444,6,72.28371882086168,74.39673469387755,15,50,447,2,438
2483,444,280,72.28371882086168,75.16299319727891,15,27,206,3,164
2484,444,543,72.28371882086168,73.32861678004535,15,23,109,1,99
2485,444,460,72.28371882086168,74.3502947845805,15,23,90,2,16
2486,444,627,72.28371882086168,73.32861678004535,15,18,188,1,183
2487,444,621,72.28371882086168,75.11655328798186,15,16,215,3,177
2488,543,280,73.32861678004535,75.16299319727891,23,27,275,2,263
2489,543,218,73.32861678004535,75.3255328798186,23,27,336,2,325
2490,543,460,73.32861678004535,74.3502947845805,23,23,94,1,83
2491,543,451,73.32861678004535,75.60417233560091,23,15,134,2,92
2492,543,621,73.32861678004535,75.11655328798186,23,16,110,2,78
2493,460,6,74.3502947845805,75.90603174603174,23,50,459,2,454
2494,460,6,74.3502947845805,76.92770975056689,23,50,467,3,454
2495,460,208,74.3502947845805,76.64907029478458,23,15,271,2,252
2496,460,451,74.3502947845805,75.60417233560091,23,15,55,1,9
2497,460,413,74.3502947845805,77.29922902494332,23,14,135,3,47
2498,451,6,75.60417233560091,76.92770975056689,15,50,449,1,445
2499,451,6,75.60417233560091,77.43854875283446,15,50,452,2,445
2500,451,208,75.60417233560091,76.64907029478458,15,15,247,1,243
2501,451,207,75.60417233560091,77.57786848072563,15,30,258,2,244
2502,451,306,75.60417233560091,78.32090702947846,15,18,186,3,145
2503,451,413,75.60417233560091,77.29922902494332,15,14,82,2,38
2504,413,6,77.29922902494332,78.97106575963718,14,51,413,2,407
2505,413,6,77.29922902494332,79.48190476190476,14,50,418,2,407
2506,413,306,77.29922902494332,78.32090702947846,14,18,116,1,107
2507,413,244,77.29922902494332,79.87664399092971,14,25,202,3,169
2508,413,290,77.29922902494332,80.2249433106576,14,18,176,3,123
2509,413,467,77.29922902494332,78.76208616780046,14,21,83,1,54
2510,413,412,77.29922902494332,79.43546485260771,14,19,92,2,1
2511,413,657,77.29922902494332,78.78530612244899,14,14,252,1,244
2512,467,6,78.76208616780046,80.99120181405895,21,50,471,2,461
2513,467,244,78.76208616780046,79.87664399092971,21,25,228,1,223
2514,467,290,78.76208616780046,80.2249433106576,21,18,188,1,177
2515,412,6,79.43546485260771,80.99120181405895,19,50,411,2,406
2516,412,6,79.43546485260771,82.0128798185941,19,50,421,3,406
2517,412,209,79.43546485260771,81.96643990929705,19,34,230,3,203
2518,412,444,79.43546485260771,81.92,19,19,112,2,32
2519,412,422,79.43546485260771,82.361179138322,19,14,126,3,10
2520,444,6,81.92,83.54539682539682,19,51,444,2,438
2521,444,6,81.92,84.56707482993197,19,50,453,3,438
2522,444,249,81.92,82.94167800453515,19,24,200,1,195
2523,444,233,81.92,83.4292970521542,19,26,221,2,211
2524,444,206,81.92,84.7760544217687,19,17,268,3,238
2525,444,507,81.92,83.73115646258503,19,22,100,2,63
2526,444,654,81.92,83.73115646258503,19,18,224,2,210
2527,444,836,81.92,83.70793650793651,19,15,399,2,392
2528,422,6,82.361179138322,83.54539682539682,14,51,419,1,416
2529,422,6,82.361179138322,84.56707482993197,14,50,427,2,416
2530,422,233,82.361179138322,83.4292970521542,14,26,195,1,189
2531,422,206,82.361179138322,84.7760544217687,14,17,240,2,216
2532,422,507,82.361179138322,83.73115646258503,14,22,103,1,85
2533,422,654,82.361179138322,83.73115646258503,14,18,239,1,232
2534,422,836,82.361179138322,83.70793650793651,14,15,418,1,414
2535,507,206,83.73115646258503,84.7760544217687,22,17,304,1,301
2536,507,320,83.73115646258503,85.98349206349206,22,24,211,2,187
2537,507,218,83.73115646258503,86.40145124716554,22,32,311,3,289
2538,507,523,83.73115646258503,85.8441723356009,22,20,92,2,16
2539,507,717,83.73115646258503,85.72807256235828,22,16,227,2,210
2540,523,274,85.8441723356009,87.42312925170069,20,22,258,2,249
2541,523,213,85.8441723356009,88.42158730158731,20,29,329,3,310
2542,523,615,85.8441723356009,87.00517006802721,20,14,105,1,92
2543,523,777,85.8441723356009,87.86430839002267,20,14,268,2,254
2544,523,631,85.8441723356009,88.51446712018141,20,17,158,3,108
2545,425,6,86.819410430839,88.63056689342403,18,50,426,2,419
2546,425,6,86.819410430839,89.65224489795918,18,50,436,3,419
2547,425,213,86.819410430839,88.42158730158731,18,29,223,2,212
2548,425,413,86.819410430839,89.02530612244898,18,15,96,2,12
2549,425,598,86.819410430839,89.79156462585034,18,22,215,3,173
2550,425,777,86.819410430839,87.86430839002267,18,14,355,1,352
2551,425,631,86.819410430839,88.51446712018141,18,17,219,2,206
2552,425,629,86.819410430839,89.79156462585034,18,22,241,3,204
2553,413,6,89.02530612244898,91.16154195011337,15,50,417,2,407
2554,413,6,89.02530612244898,91.67238095238095,15,50,423,3,407
2555,413,230,89.02530612244898,90.51138321995465,15,36,194,1,183
2556,413,298,89.02530612244898,91.64916099773242,15,30,161,3,115
2557,413,412,89.02530612244898,91.64916099773242,15,24,113,3,1
2558,598,298,89.79156462585034,91.64916099773242,22,30,310,2,300
2559,598,412,89.79156462585034,91.64916099773242,22,24,202,2,186
2560,598,414,89.79156462585034,92.34575963718821,22,26,214,3,184
2561,413,6,90.48816326530613,91.67238095238095,23,50,410,1,407
2562,413,15,90.48816326530613,93.22811791383221,23,45,415,3,398
2563,413,298,90.48816326530613,91.64916099773242,23,30,125,1,115
2564,413,245,90.48816326530613,92.81015873015873,23,30,196,2,168
2565,413,320,90.48816326530613,93.3209977324263,23,26,153,3,93
2566,413,412,90.48816326530613,91.64916099773242,23,24,50,1,1
2567,413,414,90.48816326530613,92.34575963718821,23,26,80,2,1
2568,413,421,90.48816326530613,93.39065759637188,23,22,125,3,8
2569,412,15,91.64916099773242,93.22811791383221,24,45,403,2,397
2570,412,15,91.64916099773242,93.73895691609978,24,45,407,2,397
2571,412,245,91.64916099773242,92.81015873015873,24,30,174,1,167
2572,412,320,91.64916099773242,93.3209977324263,24,26,117,2,92
2573,412,421,91.64916099773242,93.39065759637188,24,22,76,2,9
2574,414,15,92.34575963718821,93.73895691609978,26,45,403,1,399
2575,414,6,92.34575963718821,95.22503401360544,26,49,426,3,408
2576,414,215,92.34575963718821,95.01605442176871,26,35,230,3,199
2577,414,421,92.34575963718821,93.39065759637188,26,22,46,1,7
2578,414,533,92.34575963718821,94.69097505668934,26,19,156,2,119
2579,414,652,92.34575963718821,94.69097505668934,26,16,259,2,238
2580,414,870,92.34575963718821,95.20181405895691,26,14,472,3,456
2581,421,6,93.39065759637188,95.22503401360544,22,49,422,2,415
2582,421,6,93.39065759637188,96.24671201814058,22,50,433,3,415
2583,421,5,93.39065759637188,96.26993197278912,22,49,434,3,416
2584,421,215,93.39065759637188,95.01605442176871,22,35,218,2,206
2585,421,364,93.39065759637188,95.38757369614513,22,30,103,2,57
2586,421,533,93.39065759637188,94.69097505668934,22,19,125,1,112
2587,421,516,93.39065759637188,95.71265306122449,22,21,138,2,95
2588,421,652,93.39065759637188,94.69097505668934,22,16,238,1,231
2589,421,777,93.39065759637188,95.66621315192744,22,22,369,2,356
2590,421,870,93.39065759637188,95.20181405895691,22,14,456,2,449
2591,421,820,93.39065759637188,95.66621315192744,22,21,411,2,399
2592,533,219,94.69097505668934,96.73433106575963,19,26,326,2,314
2593,533,218,94.69097505668934,97.57024943310658,19,28,339,3,315
2594,533,516,94.69097505668934,95.71265306122449,19,21,47,1,17
2595,533,415,94.69097505668934,97.22195011337868,19,22,161,3,118
2596,533,619,94.69097505668934,96.73433106575963,19,15,123,2,86
2597,533,630,94.69097505668934,97.61668934240363,19,21,159,3,97
2598,533,869,94.69097505668934,97.22195011337868,19,13,353,3,336
2599,533,889,94.69097505668934,97.61668934240363,19,15,378,3,356
2600,516,219,95.71265306122449,96.73433106575963,21,26,300,1,297
2601,516,218,95.71265306122449,97.57024943310658,21,28,309,2,298
2602,516,415,95.71265306122449,97.22195011337868,21,22,120,2,101
2603,516,538,95.71265306122449,97.6863492063492,21,23,88,2,22
2604,516,619,95.71265306122449,96.73433106575963,21,15,112,1,103
2605,516,630,95.71265306122449,97.61668934240363,21,21,140,2,114
2606,516,869,95.71265306122449,97.22195011337868,21,13,359,2,353
2607,516,889,95.71265306122449,97.61668934240363,21,15,382,2,373
2608,415,6,97.22195011337868,98.29006802721089,22,51,412,1,409
2609,415,6,97.22195011337868,99.31174603174604,22,50,419,2,409
2610,415,326,97.22195011337868,99.12598639455783,22,32,121,2,89
2611,415,216,97.22195011337868,100.19410430839002,22,39,237,3,199
2612,415,523,97.22195011337868,98.80090702947847,22,19,128,2,108
2613,415,535,97.22195011337868,99.82258503401361,22,23,164,3,120
2614,415,684,97.22195011337868,98.7544671201814,22,16,277,2,269
2615,415,650,97.22195011337868,99.96190476190476,22,25,263,3,235
2616,415,820,97.22195011337868,99.1956462585034,22,15,414,2,405
2617,415,826,97.22195011337868,99.96190476190476,22,21,428,3,411
2618,538,326,97.6863492063492,99.12598639455783,23,32,221,1,212
2619,538,216,97.6863492063492,100.19410430839002,23,39,340,3,322
2620,538,211,97.6863492063492,100.54240362811791,23,41,349,3,327
2621,538,523,97.6863492063492,98.80090702947847,23,19,50,1,15
2622,538,535,97.6863492063492,99.82258503401361,23,23,92,2,3
2623,538,684,97.6863492063492,98.7544671201814,23,16,153,1,146
2624,538,650,97.6863492063492,99.96190476190476,23,25,149,2,112
2625,538,820,97.6863492063492,99.1956462585034,23,15,289,2,282
2626,538,826,97.6863492063492,99.96190476190476,23,21,304,2,288
2627,523,216,98.80090702947847,100.19410430839002,19,39,313,1,307
2628,523,211,98.80090702947847,100.54240362811791,19,41,321,2,312
2629,523,216,98.80090702947847,101.44798185941043,19,36,327,3,307
2630,523,535,98.80090702947847,99.82258503401361,19,23,46,1,12
2631,523,650,98.80090702947847,99.96190476190476,19,25,136,1,127
2632,523,696,98.80090702947847,100.82104308390024,19,17,194,2,173
2633,523,826,98.80090702947847,99.96190476190476,19,21,307,1,303
2634,535,216,99.82258503401361,101.44798185941043,23,36,327,2,319
2635,535,278,99.82258503401361,102.65541950113379,23,29,284,3,257
2636,535,428,99.82258503401361,102.1213605442177,23,21,146,2,107
2637,535,545,99.82258503401361,102.56253968253968,23,23,118,3,10
2638,535,648,99.82258503401361,102.1213605442177,23,22,150,2,113
2639,535,644,99.82258503401361,102.56253968253968,23,19,161,3,109
2640,535,867,99.82258503401361,102.14458049886622,23,23,347,2,332
2641,523,278,100.82104308390024,102.65541950113379,18,29,257,2,245
2642,523,215,100.82104308390024,103.51455782312925,18,28,329,3,308
2643,523,428,100.82104308390024,102.1213605442177,18,21,110,1,95
2644,523,545,100.82104308390024,102.56253968253968,18,23,78,2,22
2645,523,648,100.82104308390024,102.1213605442177,18,22,137,1,125
2646,523,644,100.82104308390024,102.56253968253968,18,19,142,2,121
2647,523,646,100.82104308390024,103.32879818594104,18,16,164,3,123
2648,523,867,100.82104308390024,102.14458049886622,18,23,349,1,344
2649,523,856,100.82104308390024,103.25913832199547,18,20,349,2,333
2650,523,875,100.82104308390024,103.30557823129251,18,20,368,2,352
2651,428,6,102.1213605442177,103.3752380952381,21,50,425,1,422
2652,428,6,102.1213605442177,104.39691609977325,21,50,433,2,422
2653,428,215,102.1213605442177,103.51455782312925,21,28,221,1,213
2654,428,244,102.1213605442177,104.86131519274376,21,27,219,3,184
2655,428,526,102.1213605442177,104.07183673469387,21,19,129,2,98
2656,428,512,102.1213605442177,104.76843537414966,21,22,142,3,84
2657,428,646,102.1213605442177,103.32879818594104,21,16,224,1,218
2658,428,618,102.1213605442177,104.90775510204082,21,15,225,3,190
2659,428,856,102.1213605442177,103.25913832199547,21,20,431,1,428
2660,428,875,102.1213605442177,103.30557823129251,21,20,450,1,447
2661,545,244,102.56253968253968,104.86131519274376,23,27,317,2,301
2662,545,526,102.56253968253968,104.07183673469387,23,19,68,2,19
2663,545,512,102.56253968253968,104.76843537414966,23,22,101,2,33
2664,545,415,102.56253968253968,105.48825396825397,23,24,181,3,130
2665,545,618,102.56253968253968,104.90775510204082,23,15,125,2,73
2666,545,930,102.56253968253968,104.35047619047619,23,13,393,2,385
2667,526,212,104.07183673469387,105.8829931972789,19,33,324,2,314
2668,526,219,104.07183673469387,106.99755102040817,19,37,332,3,307
2669,526,415,104.07183673469387,105.48825396825397,19,24,127,1,111
2670,526,411,104.07183673469387,107.04399092970522,19,24,172,3,115
2671,526,731,104.07183673469387,105.8829931972789,19,16,219,2,205
2672,526,742,104.07183673469387,106.62603174603174,19,15,242,3,216
2673,526,908,104.07183673469387,105.8829931972789,19,13,390,2,382
2674,526,887,104.07183673469387,106.90467120181407,19,15,381,3,361
2675,512,212,104.76843537414966,105.8829931972789,22,33,304,1,300
2676,512,219,104.76843537414966,106.99755102040817,22,37,308,2,293
2677,512,306,104.76843537414966,107.3922902494331,22,34,235,3,206
2678,512,411,104.76843537414966,107.04399092970522,22,24,141,2,101
2679,512,731,104.76843537414966,105.8829931972789,22,16,224,1,219
2680,512,742,104.76843537414966,106.62603174603174,22,15,244,2,230
2681,512,908,104.76843537414966,105.8829931972789,22,13,399,1,396
2682,512,887,104.76843537414966,106.90467120181407,22,15,386,2,375
2683,415,6,105.48825396825397,107.43873015873017,24,50,418,2,409
2684,415,6,105.48825396825397,108.46040816326531,24,51,429,3,409
2685,415,219,105.48825396825397,106.99755102040817,24,37,206,2,196
2686,415,306,105.48825396825397,107.3922902494331,24,34,136,2,109
2687,415,221,105.48825396825397,108.32108843537415,24,36,229,3,194
2688,415,411,105.48825396825397,107.04399092970522,24,24,67,2,4
2689,415,476,105.48825396825397,107.92634920634922,24,19,121,2,61
2690,415,742,105.48825396825397,106.62603174603174,24,15,331,1,327
2691,415,783,105.48825396825397,108.181768707483,24,16,386,3,368
2692,415,887,105.48825396825397,106.90467120181407,24,15,476,1,472
2693,415,860,105.48825396825397,108.15854875283446,24,13,460,3,445
2694,411,6,107.04399092970522,108.46040816326531,24,51,410,1,405
2695,411,6,107.04399092970522,109.48208616780046,24,51,418,2,405
2696,411,221,107.04399092970522,108.32108843537415,24,36,198,1,190
2697,411,218,107.04399092970522,109.94648526077098,24,30,230,3,193
2698,411,456,107.04399092970522,108.92480725623582,24,18,93,2,45
2699,411,783,107.04399092970522,108.181768707483,24,16,375,1,372
2700,411,652,107.04399092970522,108.92480725623582,24,16,254,2,241
2701,411,860,107.04399092970522,108.15854875283446,24,13,452,1,449
2702,411,887,107.04399092970522,108.94802721088436,24,15,483,2,476
2703,476,6,107.92634920634922,109.48208616780046,19,51,475,2,470
2704,476,5,107.92634920634922,110.50376417233561,19,49,484,3,471
2705,476,218,107.92634920634922,109.94648526077098,19,30,272,2,258
2706,476,549,107.92634920634922,110.15546485260771,19,22,121,2,73
2707,476,649,107.92634920634922,110.2251247165533,19,22,199,2,173
2708,476,632,107.92634920634922,110.29478458049887,19,17,186,2,156
2709,476,887,107.92634920634922,108.94802721088436,19,15,413,1,411
2710,476,867,107.92634920634922,110.2251247165533,19,20,403,2,391
2711,476,935,107.92634920634922,110.45732426303856,19,14,472,3,459
2712,456,5,108.92480725623582,110.50376417233561,18,49,456,2,451
2713,456,6,108.92480725623582,111.50222222222223,18,50,463,3,450
2714,456,218,108.92480725623582,109.94648526077098,18,30,242,1,238
2715,456,219,108.92480725623582,111.27002267573697,18,30,258,2,237
2716,456,219,108.92480725623582,111.5718820861678,18,39,263,3,237
2717,456,549,108.92480725623582,110.15546485260771,18,22,107,1,93
2718,456,414,108.92480725623582,110.96816326530613,18,18,98,2,42
2719,456,436,108.92480725623582,111.82730158730159,18,22,127,3,20
2720,456,649,108.92480725623582,110.2251247165533,18,22,201,1,193
2721,456,632,108.92480725623582,110.29478458049887,18,17,186,1,176
2722,456,867,108.92480725623582,110.2251247165533,18,20,415,1,411
2723,456,935,108.92480725623582,110.45732426303856,18,14,484,2,479
2724,549,219,110.15546485260771,111.27002267573697,22,30,333,1,330
2725,549,219,110.15546485260771,111.5718820861678,22,39,336,1,330
2726,549,227,110.15546485260771,112.75609977324264,22,32,341,3,322
2727,549,436,110.15546485260771,111.82730158730159,22,22,134,2,113
2728,549,425,110.15546485260771,112.98829931972789,22,19,174,3,124
2729,549,818,110.15546485260771,111.92018140589569,22,19,280,2,269
2730,549,682,110.15546485260771,112.66321995464853,22,21,171,3,133
2731,549,866,110.15546485260771,111.96662131519274,22,22,326,2,317
2732,549,821,110.15546485260771,112.64,22,17,292,2,272
2733,414,6,110.96816326530613,112.52390022675738,18,50,413,2,408
2734,414,6,110.96816326530613,113.54557823129252,18,50,423,3,408
2735,414,227,110.96816326530613,112.75609977324264,18,32,202,2,187
2736,414,425,110.96816326530613,112.98829931972789,18,19,88,2,11
2737,414,496,110.96816326530613,113.7081179138322,18,21,144,3,82
2738,414,682,110.96816326530613,112.66321995464853,18,21,278,2,268
2739,414,646,110.96816326530613,113.49913832199547,18,14,256,3,232
2740,414,821,110.96816326530613,112.64,18,17,413,2,407
2741,436,6,111.82730158730159,113.54557823129252,22,50,436,2,430
2742,436,6,111.82730158730159,114.56725623582767,22,50,446,3,430
2743,436,218,111.82730158730159,114.19573696145125,22,28,241,2,218
2744,436,221,111.82730158730159,114.42793650793651,22,32,242,3,215
2745,436,425,111.82730158730159,112.98829931972789,22,19,51,1,11
2746,436,496,111.82730158730159,113.7081179138322,22,21,101,2,60
2747,436,501,111.82730158730159,114.52081632653062,22,17,133,3,65
2748,436,646,111.82730158730159,113.49913832199547,22,14,222,2,210
2749,425,6,112.98829931972789,114.56725623582767,19,50,424,2,419
2750,425,218,112.98829931972789,114.19573696145125,19,28,213,1,207
2751,425,221,112.98829931972789,114.42793650793651,19,32,213,1,204
2752,425,216,112.98829931972789,115.4031746031746,19,35,233,2,209
2753,425,501,112.98829931972789,114.52081632653062,19,17,101,2,76
2754,425,442,112.98829931972789,115.37995464852608,19,19,104,2,17
2755,425,686,112.98829931972789,115.0316553287982,19,14,275,2,261
2756,496,6,113.7081179138322,116.07655328798187,21,49,501,2,490
2757,496,216,113.7081179138322,115.4031746031746,21,35,289,2,280
2758,496,442,113.7081179138322,115.37995464852608,21,19,90,2,54
2759,496,686,113.7081179138322,115.0316553287982,21,14,198,1,190
2760,496,683,113.7081179138322,116.05333333333334,21,14,213,2,187
2761,501,6,114.52081632653062,116.07655328798187,17,49,500,2,495
2762,501,6,114.52081632653062,117.09823129251701,17,50,507,3,495
2763,501,214,114.52081632653062,116.74993197278911,17,32,303,2,287
2764,501,493,114.52081632653062,117.0053514739229,17,19,107,2,8
2765,501,683,114.52081632653062,116.05333333333334,17,14,194,2,182
2766,501,684,114.52081632653062,117.07501133786849,17,15,214,3,183
2767,501,887,114.52081632653062,117.07501133786849,17,13,401,3,386
2768,442,6,115.37995464852608,117.09823129251701,19,50,442,2,436
2769,442,6,115.37995464852608,117.60907029478459,19,51,446,2,436
2770,442,214,115.37995464852608,116.74993197278911,19,32,236,1,228
2771,442,216,115.37995464852608,117.95736961451247,19,29,252,3,226
2772,442,493,115.37995464852608,117.0053514739229,19,19,87,2,51
2773,442,441,115.37995464852608,117.77160997732426,19,18,103,2,1
2774,442,684,115.37995464852608,117.07501133786849,19,15,253,2,242
2775,442,887,115.37995464852608,117.07501133786849,19,13,451,2,445
2776,493,6,117.0053514739229,118.63074829931973,19,50,492,2,487
2777,493,6,117.0053514739229,119.65242630385488,19,50,500,3,487
2778,493,300,117.0053514739229,119.02548752834467,19,30,212,2,193
2779,493,217,117.0053514739229,119.53632653061224,19,30,297,3,276
2780,493,423,117.0053514739229,119.16480725623583,19,21,116,2,70
2781,493,410,117.0053514739229,119.4898866213152,19,21,135,2,83
2782,493,651,117.0053514739229,119.09514739229026,19,17,182,2,158
2783,493,618,117.0053514739229,119.86140589569162,19,16,175,3,125
2784,441,6,117.77160997732426,119.65242630385488,18,50,442,2,435
2785,441,300,117.77160997732426,119.02548752834467,18,30,151,1,141
2786,441,217,117.77160997732426,119.53632653061224,18,30,237,2,224
2787,441,209,117.77160997732426,120.55800453514739,18,36,261,3,232
2788,441,423,117.77160997732426,119.16480725623583,18,21,63,1,18
2789,441,410,117.77160997732426,119.4898866213152,18,21,80,2,31
2790,441,413,117.77160997732426,120.6508843537415,18,22,127,3,28
2791,441,651,117.77160997732426,119.09514739229026,18,17,218,1,210
2792,441,618,117.77160997732426,119.86140589569162,18,16,199,2,177
2793,423,8,119.16480725623583,121.25460317460318,21,44,425,2,415
2794,423,209,119.16480725623583,120.55800453514739,21,36,222,1,214
2795,423,269,119.16480725623583,122.02086167800454,21,32,197,3,154
2796,423,413,119.16480725623583,120.6508843537415,21,22,65,1,10
2797,423,470,119.16480725623583,121.95120181405896,21,23,129,3,47
2798,423,788,119.16480725623583,120.95274376417234,21,19,373,2,365
2799,423,713,119.16480725623583,121.95120181405896,21,18,314,3,290
2800,423,853,119.16480725623583,120.79020408163265,21,19,436,2,430
2801,423,869,119.16480725623583,121.95120181405896,21,14,462,3,446
2802,410,8,119.4898866213152,121.25460317460318,21,44,409,2,402
2803,410,13,119.4898866213152,122.18340136054422,21,46,414,3,397
2804,410,209,119.4898866213152,120.55800453514739,21,36,206,1,201
2805,410,269,119.4898866213152,122.02086167800454,21,32,178,3,141
2806,410,413,119.4898866213152,120.6508843537415,21,22,50,1,3
2807,410,470,119.4898866213152,121.95120181405896,21,23,122,2,60
2808,410,788,119.4898866213152,120.95274376417234,21,19,383,1,378
2809,410,713,119.4898866213152,121.95120181405896,21,18,321,2,303
2810,410,853,119.4898866213152,120.79020408163265,21,19,447,1,443
2811,410,869,119.4898866213152,121.95120181405896,21,14,471,2,459
2812,413,13,120.6508843537415,122.18340136054422,22,46,405,2,400
2813,413,6,120.6508843537415,122.6942403628118,22,50,416,2,407
2814,413,269,120.6508843537415,122.02086167800454,22,32,156,1,144
2815,413,221,120.6508843537415,122.57814058956916,22,32,209,2,192
2816,413,470,120.6508843537415,121.95120181405896,22,23,80,1,57
2817,413,470,120.6508843537415,122.90321995464853,22,23,113,2,57
2818,413,713,120.6508843537415,121.95120181405896,22,18,305,1,300
2819,413,744,120.6508843537415,122.94965986394558,22,19,345,2,331
2820,413,869,120.6508843537415,121.95120181405896,22,14,459,1,456
2821,413,841,120.6508843537415,122.90321995464853,22,20,439,2,428
2822,470,6,121.95120181405896,123.71591836734694,23,50,470,2,464
2823,470,6,121.95120181405896,124.73759637188209,23,49,479,3,464
2824,470,218,121.95120181405896,124.203537414966,23,25,270,2,252
2825,470,505,121.95120181405896,123.87845804988662,23,22,90,2,35
2826,470,808,121.95120181405896,123.8552380952381,23,17,348,2,338
2827,470,634,121.95120181405896,124.59827664399093,23,22,200,3,164
2828,470,824,121.95120181405896,123.83201814058957,23,14,363,2,354
2829,470,6,122.90321995464853,124.73759637188209,23,49,471,2,464
2830,470,218,122.90321995464853,124.203537414966,23,25,258,1,252
2831,470,221,122.90321995464853,124.94657596371883,23,26,264,2,249
2832,470,634,122.90321995464853,124.59827664399093,23,22,180,2,164
2833,470,876,122.90321995464853,124.99301587301588,23,18,416,2,406
2834,505,6,123.87845804988662,126.24689342403629,22,49,509,2,499
2835,505,6,123.87845804988662,126.75773242630386,22,50,514,3,499
2836,505,221,123.87845804988662,124.94657596371883,22,26,288,1,284
2837,505,220,123.87845804988662,126.22367346938776,22,26,302,2,285
2838,505,470,123.87845804988662,124.99301587301588,22,24,59,1,35
2839,505,462,123.87845804988662,126.22367346938776,22,21,110,2,43
2840,505,411,123.87845804988662,126.38621315192744,22,24,143,3,94
2841,505,627,123.87845804988662,126.24689342403629,22,17,159,2,122
2842,505,633,123.87845804988662,126.50231292517007,22,21,171,3,128
2843,505,876,123.87845804988662,124.99301587301588,22,18,374,1,371
2844,505,833,123.87845804988662,126.22367346938776,22,14,343,2,328
2845,505,958,123.87845804988662,126.50231292517007,22,18,467,3,453
2846,470,6,124.99301587301588,126.24689342403629,24,49,467,1,464
2847,470,6,124.99301587301588,126.75773242630386,24,50,470,2,464
2848,470,220,124.99301587301588,126.22367346938776,24,26,256,1,250
2849,470,220,124.99301587301588,127.24535147392291,24,26,268,2,250
2850,470,462,124.99301587301588,126.22367346938776,24,21,54,1,8
2851,470,411,124.99301587301588,126.38621315192744,24,24,84,1,59
2852,470,627,124.99301587301588,126.24689342403629,24,17,166,1,157
2853,470,633,124.99301587301588,126.50231292517007,24,21,175,2,163
2854,470,833,124.99301587301588,126.22367346938776,24,14,367,1,363
2855,470,958,124.99301587301588,126.50231292517007,24,18,492,2,488
2856,462,6,126.22367346938776,128.29024943310657,21,50,465,2,456
2857,462,6,126.22367346938776,128.80108843537414,21,50,469,3,456
2858,462,220,126.22367346938776,127.24535147392291,21,26,246,1,242
2859,462,329,126.22367346938776,128.01160997732427,21,24,154,2,133
2860,462,374,126.22367346938776,129.1958276643991,21,27,155,3,88
2861,462,516,126.22367346938776,128.05804988662132,21,22,96,2,54
2862,462,492,126.22367346938776,129.03328798185942,21,23,125,3,30
2863,462,629,126.22367346938776,127.98839002267574,21,17,183,2,167
2864,462,628,126.22367346938776,128.661768707483,21,24,196,2,166
2865,462,837,126.22367346938776,128.26702947845806,21,14,385,2,375
2866,462,825,126.22367346938776,129.102947845805,21,17,384,3,363
2867,411,6,126.38621315192744,128.29024943310657,24,50,413,2,405
2868,411,6,126.38621315192744,128.80108843537414,24,50,418,2,405
2869,411,329,126.38621315192744,128.01160997732427,24,24,108,2,82
2870,411,374,126.38621315192744,129.1958276643991,24,27,127,3,37
2871,411,516,126.38621315192744,128.05804988662132,24,22,127,2,105
2872,411,492,126.38621315192744,129.03328798185942,24,23,140,3,81
2873,411,629,126.38621315192744,127.98839002267574,24,17,229,2,218
2874,411,628,126.38621315192744,128.661768707483,24,24,238,2,217
2875,411,837,126.38621315192744,128.26702947845806,24,14,434,2,426
2876,411,825,126.38621315192744,129.102947845805,24,17,430,3,414
2877,516,374,128.05804988662132,129.1958276643991,22,27,150,1,142
2878,516,218,128.05804988662132,129.84598639455783,22,28,308,2,298
2879,516,450,128.05804988662132,129.89242630385488,22,22,103,2,66
2880,516,477,128.05804988662132,130.4497052154195,22,22,110,2,39
2881,516,659,128.05804988662132,129.93886621315193,22,21,164,2,143
2882,516,825,128.05804988662132,129.102947845805,22,17,312,1,309
2883,516,859,128.05804988662132,130.03174603174602,22,14,353,2,343
2884,516,957,128.05804988662132,130.56580498866214,22,20,454,3,441
2885,492,6,129.03328798185942,130.82122448979592,23,50,492,2,486
2886,492,6,129.03328798185942,131.84290249433107,23,50,501,3,486
2887,492,311,129.03328798185942,131.21596371882086,23,28,204,2,181
2888,492,477,129.03328798185942,130.4497052154195,23,22,63,1,15
2889,492,785,129.03328798185942,131.12308390022676,23,19,307,2,293
2890,492,755,129.03328798185942,131.98222222222222,23,18,292,3,263
2891,492,957,129.03328798185942,130.56580498866214,23,20,470,2,465
2892,450,6,129.89242630385488,131.84290249433107,22,50,452,2,444
2893,450,6,129.89242630385488,132.86458049886622,22,50,462,3,444
2894,450,311,129.89242630385488,131.21596371882086,22,28,150,1,139
2895,450,218,129.89242630385488,132.3305215419501,22,28,255,2,232
2896,450,499,129.89242630385488,132.3305215419501,22,18,116,2,49
2897,450,785,129.89242630385488,131.12308390022676,22,19,339,1,335
2898,450,755,129.89242630385488,131.98222222222222,22,18,318,2,305
2899,450,628,129.89242630385488,132.60916099773243,22,25,213,3,178
2900,450,833,129.89242630385488,132.3305215419501,22,15,397,2,383
2901,450,867,129.89242630385488,132.60916099773243,22,19,433,3,417
2902,477,6,130.4497052154195,131.84290249433107,22,50,475,1,471
2903,477,6,130.4497052154195,132.86458049886622,22,50,482,2,471
2904,477,218,130.4497052154195,132.3305215419501,22,28,271,2,259
2905,477,211,130.4497052154195,133.09678004535147,22,26,289,3,266
2906,477,499,130.4497052154195,132.3305215419501,22,18,84,2,22
2907,477,469,130.4497052154195,133.12,22,27,115,3,8
2908,477,755,130.4497052154195,131.98222222222222,22,18,286,2,278
2909,477,628,130.4497052154195,132.60916099773243,22,25,177,2,151
2910,477,833,130.4497052154195,132.3305215419501,22,15,365,2,356
2911,477,867,130.4497052154195,132.60916099773243,22,19,401,2,390
2912,477,820,130.4497052154195,133.3754195011338,22,15,365,3,343
2913,499,6,132.3305215419501,133.88625850340136,18,50,498,2,493
2914,499,7,132.3305215419501,134.88471655328797,18,50,504,3,492
2915,499,238,132.3305215419501,134.3506575963719,18,24,275,2,261
2916,499,217,132.3305215419501,135.1633560090703,18,26,307,3,282
2917,499,524,132.3305215419501,134.0255782312925,18,22,77,2,25
2918,499,428,132.3305215419501,134.83827664399092,18,26,129,3,71
2919,499,623,132.3305215419501,134.04879818594105,18,17,144,2,124
2920,499,721,132.3305215419501,135.1633560090703,18,18,253,3,222
2921,499,820,132.3305215419501,133.3754195011338,18,15,324,1,321
2922,499,838,132.3305215419501,135.18657596371884,18,20,361,3,339
2923,469,7,133.12,134.88471655328797,27,50,468,2,462
2924,469,6,133.12,135.90639455782312,27,49,478,3,463
2925,469,238,133.12,134.3506575963719,27,24,237,1,231
2926,469,217,133.12,135.1633560090703,27,26,267,2,252
2927,469,218,133.12,135.37233560090704,27,25,269,2,251
2928,469,428,133.12,134.83827664399092,27,26,85,2,41
2929,469,421,133.12,135.37233560090704,27,22,108,2,48
2930,469,721,133.12,135.1633560090703,27,18,267,2,252
2931,469,616,133.12,136.02249433106576,27,17,193,3,147
2932,469,838,133.12,135.18657596371884,27,20,380,2,369
2933,469,888,133.12,135.8831746031746,27,15,436,3,419
2934,524,217,134.0255782312925,135.1633560090703,22,26,311,1,307
2935,524,218,134.0255782312925,135.37233560090704,22,25,311,1,306
2936,524,313,134.0255782312925,136.71909297052156,22,25,241,3,211
2937,524,421,134.0255782312925,135.37233560090704,22,22,118,1,103
2938,524,551,134.0255782312925,136.78875283446712,22,20,122,3,27
2939,524,721,134.0255782312925,135.1633560090703,22,18,203,1,197
2940,524,616,134.0255782312925,136.02249433106576,22,17,126,2,92
2941,524,639,134.0255782312925,136.67265306122448,22,21,162,3,115
2942,524,838,134.0255782312925,135.18657596371884,22,20,318,1,314
2943,524,888,134.0255782312925,135.8831746031746,22,15,373,2,364
2944,524,872,134.0255782312925,136.78875283446712,22,18,368,3,348
2945,428,6,134.83827664399092,135.90639455782312,26,49,424,1,422
2946,428,7,134.83827664399092,136.4172335600907,26,47,426,2,421
2947,428,6,134.83827664399092,137.43891156462584,26,50,437,3,422
2948,428,313,134.83827664399092,136.71909297052156,26,25,141,2,115
2949,428,244,134.83827664399092,137.3924716553288,26,24,214,3,184
2950,428,551,134.83827664399092,136.78875283446712,26,20,149,2,123
2951,428,616,134.83827664399092,136.02249433106576,26,17,195,1,188
2952,428,639,134.83827664399092,136.67265306122448,26,21,225,2,211
2953,428,888,134.83827664399092,135.8831746031746,26,15,462,1,460
2954,428,872,134.83827664399092,136.78875283446712,26,18,452,2,444
2955,421,7,135.37233560090704,136.4172335600907,22,47,416,1,414
2956,421,6,135.37233560090704,137.43891156462584,22,50,424,2,415
2957,421,313,135.37233560090704,136.71909297052156,22,25,123,1,108
2958,421,244,135.37233560090704,137.3924716553288,22,24,197,2,177
2959,421,551,135.37233560090704,136.78875283446712,22,20,144,1,130
2960,421,420,135.37233560090704,138.2051700680272,22,20,122,3,1
2961,421,639,135.37233560090704,136.67265306122448,22,21,225,1,218
2962,421,809,135.37233560090704,138.1819501133787,22,16,406,3,388
2963,421,872,135.37233560090704,136.78875283446712,22,18,455,1,451
2964,421,861,135.37233560090704,138.2051700680272,22,16,457,3,440
2965,551,216,136.78875283446712,139.27328798185943,20,26,352,2,335
2966,551,420,136.78875283446712,138.2051700680272,20,20,145,1,131
2967,551,423,136.78875283446712,138.41414965986394,20,19,146,2,128
2968,551,809,136.78875283446712,138.1819501133787,20,16,265,1,258
2969,551,649,136.78875283446712,138.43736961451248,20,17,121,2,98
2970,551,625,136.78875283446712,139.45904761904762,20,13,137,3,74
2971,551,861,136.78875283446712,138.2051700680272,20,16,316,1,310
2972,551,833,136.78875283446712,138.43736961451248,20,15,291,2,282
2973,420,23,138.2051700680272,139.76090702947846,20,41,403,2,397
2974,420,14,138.2051700680272,141.0380045351474,20,43,424,3,406
2975,420,216,138.2051700680272,139.27328798185943,20,26,209,1,204
2976,420,247,138.2051700680272,139.9002267573696,20,26,188,2,173
2977,420,413,138.2051700680272,139.8770068027211,20,17,72,2,7
2978,420,625,138.2051700680272,139.45904761904762,20,13,212,1,205
2979,420,776,138.2051700680272,140.75936507936507,20,15,373,3,356
2980,423,23,138.41414965986394,139.76090702947846,19,41,404,1,400
2981,423,14,138.41414965986394,141.0380045351474,19,43,424,3,409
2982,423,247,138.41414965986394,139.9002267573696,19,26,187,1,176
2983,423,212,138.41414965986394,141.33986394557823,19,22,246,3,211
2984,423,413,138.41414965986394,139.8770068027211,19,17,64,1,10
2985,423,424,138.41414965986394,141.33986394557823,19,15,126,3,1
2986,423,410,138.41414965986394,141.38630385487528,19,15,129,3,13
2987,423,625,138.41414965986394,139.45904761904762,19,13,207,1,202
2988,423,776,138.41414965986394,140.75936507936507,19,15,367,2,353
2989,413,14,139.8770068027211,141.0380045351474,17,43,402,1,399
2990,413,82,139.8770068027211,141.89714285714285,17,42,342,2,331
2991,413,212,139.8770068027211,141.33986394557823,17,22,211,1,201
2992,413,291,139.8770068027211,142.0132426303855,17,23,153,2,122
2993,413,424,139.8770068027211,141.33986394557823,17,15,64,1,11
2994,413,410,139.8770068027211,141.38630385487528,17,15,65,2,3
2995,413,531,139.8770068027211,142.68662131519275,17,20,169,3,118
2996,413,762,139.8770068027211,141.89714285714285,17,15,360,2,349
2997,413,731,139.8770068027211,142.68662131519275,17,14,340,3,318
2998,424,46,141.33986394557823,143.33678004535147,15,43,388,2,378
2999,424,46,141.33986394557823,143.40643990929706,15,42,388,2,378
3000,424,207,141.33986394557823,143.36,15,29,234,2,217
3001,424,207,141.33986394557823,143.40643990929706,15,27,235,2,217
3002,424,531,141.33986394557823,142.68662131519275,15,20,122,1,107
3003,424,480,141.33986394557823,143.75473922902495,15,15,118,2,56
3004,424,731,141.33986394557823,142.68662131519275,15,14,312,1,307
3005,410,46,141.38630385487528,143.33678004535147,15,43,374,2,364
3006,410,46,141.38630385487528,143.40643990929706,15,42,374,2,364
3007,410,207,141.38630385487528,143.36,15,29,220,2,203
3008,410,207,141.38630385487528,143.40643990929706,15,27,221,2,203
3009,410,531,141.38630385487528,142.68662131519275,15,20,133,1,121
3010,410,480,141.38630385487528,143.75473922902495,15,15,124,2,70
3011,410,731,141.38630385487528,142.68662131519275,15,14,326,1,321
3012,531,381,142.68662131519275,145.14793650793652,20,30,184,2,150
3013,531,390,142.68662131519275,145.63555555555556,20,30,190,3,141
3014,531,480,142.68662131519275,143.75473922902495,20,15,69,1,51
3015,531,410,142.68662131519275,144.5906575963719,20,27,146,2,121
3016,480,23,143.75473922902495,144.7764172335601,15,41,459,1,457
3017,480,83,143.75473922902495,146.35537414965987,15,45,412,3,397
3018,480,15,143.75473922902495,146.44825396825397,15,46,479,3,465
3019,480,381,143.75473922902495,145.14793650793652,15,30,116,1,99
3020,480,390,143.75473922902495,145.63555555555556,15,30,121,2,90
3021,480,301,143.75473922902495,146.70367346938775,15,25,219,3,179
3022,480,414,143.75473922902495,145.7748752834467,15,29,109,2,66
3023,480,416,143.75473922902495,146.49469387755101,15,18,134,3,64
3024,480,730,143.75473922902495,145.72843537414965,15,15,264,2,250
3025,410,83,144.5906575963719,146.35537414965987,27,45,336,2,327
3026,410,15,144.5906575963719,146.44825396825397,27,46,403,2,395
3027,410,390,144.5906575963719,145.63555555555556,27,30,49,1,20
3028,410,301,144.5906575963719,146.70367346938775,27,25,142,2,109
3029,410,414,144.5906575963719,145.7748752834467,27,29,51,1,4
3030,410,416,144.5906575963719,146.49469387755101,27,18,82,2,6
3031,410,730,144.5906575963719,145.72843537414965,27,15,324,1,320
3032,414,6,145.7748752834467,148.12009070294786,29,50,420,2,408
3033,414,366,145.7748752834467,148.23619047619047,29,31,116,2,48
3034,414,418,145.7748752834467,148.07365079365078,29,24,99,2,4
3035,414,654,145.7748752834467,147.58603174603175,29,16,252,2,240
3036,414,762,145.7748752834467,148.46839002267575,29,26,367,3,348
3037,414,865,145.7748752834467,147.6092517006803,29,16,458,2,451
3038,414,820,145.7748752834467,148.5380498866213,29,23,423,3,406
3039,416,6,146.49469387755101,148.12009070294786,18,50,416,2,410
3040,416,6,146.49469387755101,149.141768707483,18,50,426,3,410
3041,416,366,146.49469387755101,148.23619047619047,18,31,90,2,50
3042,416,307,146.49469387755101,148.95600907029478,18,31,152,2,109
3043,416,205,146.49469387755101,149.44362811791385,18,27,246,3,211
3044,416,418,146.49469387755101,148.07365079365078,18,24,68,2,2
3045,416,424,146.49469387755101,149.09532879818593,18,22,112,3,8
3046,416,654,146.49469387755101,147.58603174603175,18,16,243,1,238
3047,416,762,146.49469387755101,148.46839002267575,18,26,356,2,346
3048,416,865,146.49469387755101,147.6092517006803,18,16,452,1,449
3049,416,820,146.49469387755101,148.5380498866213,18,23,413,2,404
3050,418,6,148.07365079365078,149.141768707483,24,50,415,1,412
3051,418,6,148.07365079365078,150.16344671201816,24,49,422,2,412
3052,418,205,148.07365079365078,149.44362811791385,24,27,221,1,213
3053,418,218,148.07365079365078,150.465306122449,24,30,225,2,200
3054,418,424,148.07365079365078,149.09532879818593,24,22,44,1,6
3055,418,428,148.07365079365078,150.11700680272108,24,23,89,2,10
3056,418,800,148.07365079365078,150.25632653061226,24,16,393,2,382
3057,418,800,148.07365079365078,150.99936507936508,24,18,402,3,382
3058,424,6,149.09532879818593,150.16344671201816,22,49,421,1,418
3059,424,6,149.09532879818593,151.16190476190476,22,50,427,2,418
3060,424,218,149.09532879818593,150.465306122449,22,30,214,1,206
3061,424,428,149.09532879818593,150.11700680272108,22,23,44,1,4
3062,424,427,149.09532879818593,151.11546485260772,22,19,87,2,3
3063,424,800,149.09532879818593,150.25632653061226,22,16,379,1,376
3064,424,800,149.09532879818593,150.99936507936508,22,18,385,2,376
3065,424,838,149.09532879818593,151.13868480725623,22,15,423,2,414
3066,428,6,150.11700680272108,151.16190476190476,23,50,424,1,422
3067,428,6,150.11700680272108,152.1835827664399,23,50,431,2,422
3068,428,273,150.11700680272108,152.3693424036281,23,36,183,2,155
3069,428,410,150.11700680272108,152.3693424036281,23,25,99,2,18
3070,428,791,150.11700680272108,152.16036281179137,23,18,374,2,363
3071,428,766,150.11700680272108,152.85696145124717,23,23,358,3,338
3072,428,838,150.11700680272108,151.13868480725623,23,15,412,1,410
3073,428,873,150.11700680272108,152.83374149659863,23,20,460,3,445
3074,427,6,151.11546485260772,152.1835827664399,19,50,424,1,421
3075,427,6,151.11546485260772,153.20526077097506,19,50,431,2,421
3076,427,273,151.11546485260772,152.3693424036281,19,36,163,1,154
3077,427,215,151.11546485260772,153.39102040816326,19,40,234,2,212
3078,427,214,151.11546485260772,153.4142403628118,19,38,235,2,213
3079,427,410,151.11546485260772,152.3693424036281,19,25,57,1,17
3080,427,428,151.11546485260772,153.158820861678,19,21,88,2,1
3081,427,791,151.11546485260772,152.16036281179137,19,18,367,1,364
3082,427,766,151.11546485260772,152.85696145124717,19,23,347,2,339
3083,427,718,151.11546485260772,153.87863945578232,19,15,314,3,291
3084,427,873,151.11546485260772,152.83374149659863,19,20,452,2,446
3085,410,6,152.3693424036281,154.2269387755102,25,49,412,2,404
3086,410,6,152.3693424036281,155.24861678004535,25,50,423,3,404
3087,410,215,152.3693424036281,153.39102040816326,25,40,200,1,195
3088,410,214,152.3693424036281,153.4142403628118,25,38,201,1,196
3089,410,206,152.3693424036281,154.43591836734694,25,25,223,2,204
3090,410,419,152.3693424036281,154.15727891156462,25,21,78,2,9
3091,410,429,152.3693424036281,155.17895691609976,25,22,122,3,19
3092,410,718,152.3693424036281,153.87863945578232,25,15,315,2,308
3093,410,644,152.3693424036281,155.0164172335601,25,21,260,3,234
3094,428,6,153.158820861678,154.2269387755102,21,49,424,1,422
3095,428,6,153.158820861678,155.24861678004535,21,50,431,2,422
3096,428,206,153.158820861678,154.43591836734694,21,25,229,1,222
3097,428,370,153.158820861678,156.0148752834467,21,30,136,3,58
3098,428,429,153.158820861678,155.17895691609976,21,22,87,2,1
3099,428,644,153.158820861678,155.0164172335601,21,21,230,2,216
3100,428,656,153.158820861678,155.4575963718821,21,19,249,2,228
3101,419,6,154.15727891156462,155.24861678004535,21,50,416,1,413
3102,419,6,154.15727891156462,156.247074829932,21,50,423,2,413
3103,419,370,154.15727891156462,156.0148752834467,21,30,94,2,49
3104,419,429,154.15727891156462,155.17895691609976,21,22,45,1,10
3105,419,429,154.15727891156462,156.2006349206349,21,22,89,2,10
3106,419,656,154.15727891156462,155.4575963718821,21,19,244,1,237
3107,419,654,154.15727891156462,156.73469387755102,21,19,260,3,235
3108,419,861,154.15727891156462,156.2006349206349,21,21,451,2,442
3109,429,6,155.17895691609976,156.247074829932,22,50,425,1,423
3110,429,6,155.17895691609976,157.26875283446714,22,50,432,2,423
3111,429,335,155.17895691609976,157.1526530612245,22,32,127,2,94
3112,429,205,155.17895691609976,157.59383219954648,22,27,247,2,224
3113,429,654,155.17895691609976,156.73469387755102,22,19,235,2,225
3114,429,817,155.17895691609976,157.75637188208617,22,15,404,3,388
3115,429,861,155.17895691609976,156.2006349206349,22,21,434,1,432
3116,429,891,155.17895691609976,157.75637188208617,22,14,475,3,462
3117,429,6,156.2006349206349,157.26875283446714,22,50,425,1,423
3118,429,6,156.2006349206349,158.29043083900228,22,50,432,2,423
3119,429,205,156.2006349206349,157.59383219954648,22,27,232,1,224
3120,429,218,156.2006349206349,158.59229024943312,22,30,235,2,211
3121,429,447,156.2006349206349,158.75482993197278,22,21,111,3,18
3122,429,817,156.2006349206349,157.75637188208617,22,15,394,2,388
3123,429,660,156.2006349206349,158.75482993197278,22,18,256,3,231
3124,429,891,156.2006349206349,157.75637188208617,22,14,467,2,462
3125,429,6,157.22231292517006,158.29043083900228,23,50,425,1,423
3126,429,6,157.22231292517006,159.31210884353743,23,50,432,2,423
3127,429,218,157.22231292517006,158.59229024943312,23,30,219,1,211
3128,429,218,157.22231292517006,159.59074829931973,23,38,234,2,211
3129,429,447,157.22231292517006,158.75482993197278,23,21,68,2,18
3130,429,660,157.22231292517006,158.75482993197278,23,18,240,2,231
3131,429,663,157.22231292517006,159.4746485260771,23,23,253,2,234
3132,429,854,157.22231292517006,159.42820861678004,23,20,435,2,425
3133,429,838,157.22231292517006,159.49786848072563,23,21,421,2,409
3134,429,6,158.2439909297052,159.31210884353743,22,50,425,1,423
3135,429,5,158.2439909297052,160.33378684807258,22,49,433,2,424
3136,429,218,158.2439909297052,159.59074829931973,22,38,219,1,211
3137,429,218,158.2439909297052,161.19292517006804,22,35,246,3,211
3138,429,425,158.2439909297052,160.264126984127,22,24,87,2,4
3139,429,594,158.2439909297052,161.0536054421769,22,24,205,3,165
3140,429,663,158.2439909297052,159.4746485260771,22,23,240,1,234
3141,429,628,158.2439909297052,161.0768253968254,22,21,233,3,199
3142,429,854,158.2439909297052,159.42820861678004,22,20,428,1,425
3143,429,838,158.2439909297052,159.49786848072563,22,21,413,1,409
3144,429,840,158.2439909297052,161.0768253968254,22,20,429,3,411
3145,447,5,158.75482993197278,160.33378684807258,21,49,447,2,442
3146,447,6,158.75482993197278,161.33224489795919,21,50,455,3,441
3147,447,218,158.75482993197278,161.19292517006804,21,35,252,2,229
3148,447,219,158.75482993197278,161.7037641723356,21,32,261,3,228
3149,447,425,158.75482993197278,160.264126984127,21,24,69,2,22
3150,447,594,158.75482993197278,161.0536054421769,21,24,177,2,147
3151,447,628,158.75482993197278,161.0768253968254,21,21,207,2,181
3152,447,840,158.75482993197278,161.0768253968254,21,20,406,2,393
3153,425,6,160.264126984127,161.33224489795919,24,50,422,1,419
3154,425,6,160.264126984127,162.35392290249433,24,50,429,2,419
3155,425,219,160.264126984127,161.7037641723356,24,32,215,1,206
3156,425,223,160.264126984127,163.2130612244898,24,27,239,3,202
3157,425,547,160.264126984127,161.81986394557825,24,19,139,2,122
3158,425,422,160.264126984127,162.70222222222222,24,21,105,2,3
3159,425,783,160.264126984127,161.81986394557825,24,15,364,2,358
3160,425,768,160.264126984127,162.74866213151927,24,21,359,2,343
3161,425,869,160.264126984127,162.33070294784582,24,15,453,2,444
3162,594,223,161.0536054421769,163.2130612244898,24,27,382,2,371
3163,594,422,161.0536054421769,162.70222222222222,24,21,186,2,172
3164,594,768,161.0536054421769,162.74866213151927,24,21,189,2,174
3165,594,869,161.0536054421769,162.33070294784582,24,15,280,1,275
3166,594,838,161.0536054421769,163.35238095238097,24,16,263,2,244
3167,594,932,161.0536054421769,163.86321995464854,24,16,359,3,338
3168,547,223,161.81986394557825,163.2130612244898,19,27,330,1,324
3169,547,215,161.81986394557825,164.44371882086168,19,37,351,3,332
3170,547,216,161.81986394557825,164.46693877551022,19,36,350,3,331
3171,547,425,161.81986394557825,164.35083900226758,19,24,164,3,122
3172,547,654,161.81986394557825,164.35083900226758,19,18,153,3,107
3173,547,750,161.81986394557825,164.76879818594105,19,26,239,3,203
3174,547,838,161.81986394557825,163.35238095238097,19,16,298,2,291
3175,547,932,161.81986394557825,163.86321995464854,19,16,395,2,385
3176,547,832,161.81986394557825,164.79201814058956,19,22,312,3,285
3177,422,6,162.70222222222222,164.39727891156463,21,49,422,2,416
3178,422,6,162.70222222222222,165.39573696145126,21,49,432,3,416
3179,422,215,162.70222222222222,164.44371882086168,21,37,220,2,207
3180,422,216,162.70222222222222,164.46693877551022,21,36,220,2,206
3181,422,425,162.70222222222222,164.35083900226758,21,24,71,2,3
3182,422,450,162.70222222222222,164.86167800453515,21,21,97,2,28
3183,422,417,162.70222222222222,165.58149659863946,21,27,124,3,5
3184,422,654,162.70222222222222,164.35083900226758,21,18,243,2,232
3185,422,750,162.70222222222222,164.76879818594105,21,26,340,2,328
3186,422,813,162.70222222222222,165.5350566893424,21,22,410,3,391
3187,422,832,162.70222222222222,164.79201814058956,21,22,420,2,410
3188,422,838,162.70222222222222,165.48861678004536,21,20,433,3,416
3189,425,6,164.35083900226758,165.39573696145126,24,49,421,1,419
3190,425,6,164.35083900226758,166.4174149659864,24,50,428,2,419
3191,425,214,164.35083900226758,165.6975963718821,24,39,219,1,211
3192,425,220,164.35083900226758,167.0443537414966,24,38,236,3,205
3193,425,417,164.35083900226758,165.58149659863946,24,27,54,1,8
3194,425,496,164.35083900226758,166.62639455782312,24,24,121,2,71
3195,425,813,164.35083900226758,165.5350566893424,24,22,391,1,388
3196,425,661,164.35083900226758,166.90503401360544,24,16,260,3,236
3197,425,838,164.35083900226758,165.48861678004536,24,20,416,1,413
3198,450,6,164.86167800453515,166.4174149659864,21,50,449,2,444
3199,450,6,164.86167800453515,167.43909297052156,21,50,458,3,444
3200,450,5,164.86167800453515,167.46231292517007,21,48,459,3,445
3201,450,220,164.86167800453515,167.0443537414966,21,38,248,2,230
3202,450,496,164.86167800453515,166.62639455782312,21,24,89,2,46
3203,450,661,164.86167800453515,166.90503401360544,21,16,229,2,211
3204,450,932,164.86167800453515,166.90503401360544,21,16,490,2,482
3205,417,6,165.58149659863946,167.43909297052156,27,50,419,2,411
3206,417,5,165.58149659863946,167.46231292517007,27,48,420,2,412
3207,417,6,165.58149659863946,168.4607709750567,27,50,429,3,411
3208,417,220,165.58149659863946,167.0443537414966,27,38,207,1,197
3209,417,246,165.58149659863946,168.20535147392292,27,34,205,3,171
3210,417,496,165.58149659863946,166.62639455782312,27,24,91,1,79
3211,417,428,165.58149659863946,168.41433106575965,27,24,122,3,11
3212,417,661,165.58149659863946,166.90503401360544,27,16,251,1,244
3213,417,816,165.58149659863946,168.29823129251702,27,17,416,3,399
3214,417,860,165.58149659863946,168.18213151927438,27,17,457,3,443
3215,496,6,166.62639455782312,168.4607709750567,24,50,496,2,490
3216,496,6,166.62639455782312,169.48244897959185,24,50,505,3,490
3217,496,246,166.62639455782312,168.20535147392292,24,34,259,2,250
3218,496,329,166.62639455782312,169.13414965986394,24,30,199,3,167
3219,496,428,166.62639455782312,168.41433106575965,24,24,103,2,68
3220,496,428,166.62639455782312,169.4360090702948,24,21,139,3,68
3221,496,816,166.62639455782312,168.29823129251702,24,17,328,2,320
3222,496,800,166.62639455782312,169.31990929705216,24,16,325,3,304
3223,496,860,166.62639455782312,168.18213151927438,24,17,370,2,364
3224,496,949,166.62639455782312,169.4360090702948,24,13,469,3,453
3225,428,6,168.41433106575965,169.48244897959185,24,50,424,1,422
3226,428,6,168.41433106575965,170.48090702947846,24,49,431,2,422
3227,428,211,168.41433106575965,169.7843083900227,24,38,225,1,217
3228,428,214,168.41433106575965,170.85242630385488,24,37,238,2,214
3229,428,490,168.41433106575965,169.94684807256237,24,21,91,2,62
3230,428,493,168.41433106575965,171.17750566893423,24,20,136,3,65
3231,428,666,168.41433106575965,169.94684807256237,24,15,247,2,238
3232,428,801,168.41433106575965,171.36326530612246,24,17,394,3,373
3233,428,917,168.41433106575965,170.4344671201814,24,13,497,2,489
3234,428,835,168.41433106575965,171.2239455782313,24,15,425,3,407
3235,428,6,169.4360090702948,170.48090702947846,21,49,424,1,422
3236,428,6,169.4360090702948,171.5025850340136,21,50,431,2,422
3237,428,214,169.4360090702948,170.85242630385488,21,37,223,1,214
3238,428,274,169.4360090702948,172.08308390022677,21,36,192,3,154
3239,428,493,169.4360090702948,171.17750566893423,21,20,99,2,65
3240,428,427,169.4360090702948,172.08308390022677,21,25,114,3,1
3241,428,801,169.4360090702948,171.36326530612246,21,17,382,2,373
3242,428,654,169.4360090702948,171.99020408163267,21,14,251,3,226
3243,428,835,169.4360090702948,171.2239455782313,21,15,414,2,407
3244,428,834,169.4360090702948,171.4793650793651,21,16,415,2,406
3245,490,6,169.94684807256237,171.5025850340136,21,50,489,2,484
3246,490,6,169.94684807256237,172.52426303854875,21,50,497,3,484
3247,490,274,169.94684807256237,172.08308390022677,21,36,235,2,216
3248,490,493,169.94684807256237,171.17750566893423,21,20,53,1,3
3249,490,427,169.94684807256237,172.08308390022677,21,25,112,2,63
3250,490,801,169.94684807256237,171.36326530612246,21,17,317,1,311
3251,490,654,169.94684807256237,171.99020408163267,21,14,186,2,164
3252,490,835,169.94684807256237,171.2239455782313,21,15,349,1,345
3253,490,834,169.94684807256237,171.4793650793651,21,16,350,2,344
3254,493,6,171.17750566893423,172.52426303854875,20,50,490,1,487
3255,493,6,171.17750566893423,173.5459410430839,20,50,498,2,487
3256,493,206,171.17750566893423,173.42984126984126,20,35,303,2,287
3257,493,224,171.17750566893423,173.87102040816328,20,33,293,3,269
3258,493,411,171.17750566893423,173.17442176870748,20,29,119,2,82
3259,493,428,171.17750566893423,173.49950113378685,20,20,119,2,65
3260,493,801,171.17750566893423,173.3834013605442,20,17,322,2,308
3261,493,654,171.17750566893423,174.01034013605442,20,15,202,3,161
3262,493,830,171.17750566893423,173.2673015873016,20,15,349,2,337
3263,493,838,171.17750566893423,173.5227210884354,20,16,359,2,345
3264,427,6,172.08308390022677,173.5459410430839,25,50,426,1,421
3265,427,6,172.08308390022677,174.56761904761905,25,50,434,2,421
3266,427,206,172.08308390022677,173.42984126984126,25,35,228,1,221
3267,427,224,172.08308390022677,173.87102040816328,25,33,217,2,203
3268,427,209,172.08308390022677,174.91591836734693,25,36,250,3,218
3269,427,411,172.08308390022677,173.17442176870748,25,29,50,1,16
3270,427,428,172.08308390022677,173.49950113378685,25,20,61,1,1
3271,427,430,172.08308390022677,174.4979591836735,25,20,104,2,3
3272,427,801,172.08308390022677,173.3834013605442,25,17,378,1,374
3273,427,654,172.08308390022677,174.01034013605442,25,15,242,2,227
3274,427,830,172.08308390022677,173.2673015873016,25,15,406,1,403
3275,427,838,172.08308390022677,173.5227210884354,25,16,416,1,411
3276,427,834,172.08308390022677,174.521179138322,25,15,420,2,407
3277,411,6,173.17442176870748,174.56761904761905,29,50,409,1,405
3278,411,6,173.17442176870748,175.56607709750568,29,50,418,2,405
3279,411,209,173.17442176870748,174.91591836734693,29,36,215,2,202
3280,411,273,173.17442176870748,176.14657596371882,29,37,188,3,138
3281,411,430,173.17442176870748,174.4979591836735,29,20,60,1,19
3282,411,425,173.17442176870748,176.10013605442177,29,26,127,3,14
3283,411,801,173.17442176870748,175.4267573696145,29,18,402,2,390
3284,411,784,173.17442176870748,176.05369614512472,29,16,393,3,373
3285,411,834,173.17442176870748,174.521179138322,29,15,427,1,423
3286,411,839,173.17442176870748,175.54285714285714,29,14,440,2,428
3287,428,6,173.49950113378685,174.56761904761905,20,50,424,1,422
3288,428,6,173.49950113378685,175.56607709750568,20,50,431,2,422
3289,428,209,173.49950113378685,174.91591836734693,20,36,227,1,219
3290,428,273,173.49950113378685,176.14657596371882,20,37,192,3,155
3291,428,425,173.49950113378685,176.10013605442177,20,26,112,3,3
3292,428,801,173.49950113378685,175.4267573696145,20,18,382,2,373
3293,428,784,173.49950113378685,176.05369614512472,20,16,373,3,356
3294,428,834,173.49950113378685,174.521179138322,20,15,408,1,406
3295,428,839,173.49950113378685,175.54285714285714,20,14,420,2,411
3296,430,6,174.4979591836735,175.56607709750568,20,50,426,1,424
3297,430,6,174.4979591836735,176.58775510204083,20,50,433,2,424
3298,430,273,174.4979591836735,176.14657596371882,20,37,172,2,157
3299,430,297,174.4979591836735,177.42367346938775,20,29,183,3,133
3300,430,425,174.4979591836735,176.10013605442177,20,26,69,2,5
3301,430,411,174.4979591836735,177.00571428571428,20,26,110,3,19
3302,430,784,174.4979591836735,176.05369614512472,20,16,360,2,354
3303,430,794,174.4979591836735,177.07537414965986,20,16,381,3,364
3304,430,839,174.4979591836735,175.54285714285714,20,14,411,1,409
3305,430,871,174.4979591836735,177.3772335600907,20,18,458,3,441
3306,425,11,176.10013605442177,177.86485260770976,26,41,421,2,414
3307,425,5,176.10013605442177,178.63111111111112,26,48,434,3,420
3308,425,297,176.10013605442177,177.42367346938775,26,29,140,1,128
3309,425,296,176.10013605442177,177.67909297052154,26,34,146,2,129
3310,425,218,176.10013605442177,178.95619047619047,26,40,241,3,207
3311,425,417,176.10013605442177,177.74875283446713,26,19,71,2,8
3312,425,426,176.10013605442177,179.04907029478457,26,25,127,3,1
3313,425,871,176.10013605442177,177.3772335600907,26,18,449,1,446
3314,425,863,176.10013605442177,177.74875283446713,26,14,444,2,438
3315,425,873,176.10013605442177,178.86331065759637,26,16,464,3,448
3316,411,5,177.00571428571428,178.63111111111112,26,48,412,2,406
3317,411,6,177.00571428571428,179.65278911564627,26,49,421,3,405
3318,411,218,177.00571428571428,178.95619047619047,26,40,210,2,193
3319,411,206,177.00571428571428,179.97786848072562,26,32,242,3,205
3320,411,426,177.00571428571428,179.04907029478457,26,25,89,2,15
3321,411,445,177.00571428571428,179.861768707483,26,23,128,3,34
3322,411,645,177.00571428571428,179.09551020408165,26,21,251,2,234
3323,411,621,177.00571428571428,179.55990929705214,26,17,237,3,210
3324,411,873,177.00571428571428,178.86331065759637,26,16,469,2,462
3325,411,872,177.00571428571428,179.88498866213152,26,18,477,3,461
3326,417,6,177.74875283446713,179.65278911564627,19,49,419,2,411
3327,417,218,177.74875283446713,178.95619047619047,19,40,206,1,199
3328,417,206,177.74875283446713,179.97786848072562,19,32,232,2,211
3329,417,426,177.74875283446713,179.04907029478457,19,25,57,1,9
3330,417,445,177.74875283446713,179.861768707483,19,23,95,2,28
3331,417,645,177.74875283446713,179.09551020408165,19,21,235,1,228
3332,417,621,177.74875283446713,179.55990929705214,19,17,218,2,204
3333,417,873,177.74875283446713,178.86331065759637,19,16,459,1,456
3334,417,872,177.74875283446713,179.88498866213152,19,18,464,2,455
3335,426,6,179.04907029478457,181.16208616780045,25,48,430,2,420
3336,426,6,179.04907029478457,181.67292517006803,25,49,435,3,420
3337,426,205,179.04907029478457,181.06920634920635,25,30,238,2,221
3338,426,537,179.04907029478457,181.41750566893424,25,19,151,2,111
3339,426,629,179.04907029478457,181.44072562358278,25,17,228,2,203
3340,426,659,179.04907029478457,181.9283446712018,25,19,264,3,233
3341,426,869,179.04907029478457,181.41750566893424,25,17,455,2,443
3342,426,836,179.04907029478457,181.51038548752834,25,16,423,2,410
3343,445,6,179.861768707483,181.16208616780045,23,48,443,1,439
3344,445,6,179.861768707483,181.67292517006803,23,49,446,2,439
3345,445,6,179.861768707483,182.69460317460317,23,49,456,3,439
3346,445,205,179.861768707483,181.06920634920635,23,30,246,1,240
3347,445,205,179.861768707483,182.41596371882088,23,30,264,3,240
3348,445,537,179.861768707483,181.41750566893424,23,19,114,2,92
3349,445,452,179.861768707483,182.04444444444445,23,24,94,2,7
3350,445,629,179.861768707483,181.44072562358278,23,17,196,2,184
3351,445,659,179.861768707483,181.9283446712018,23,19,232,2,214
3352,445,869,179.861768707483,181.41750566893424,23,17,429,2,424
3353,445,836,179.861768707483,181.51038548752834,23,16,397,2,391
3354,537,214,181.41750566893424,183.1590022675737,19,29,332,2,323
3355,537,374,181.41750566893424,183.53052154195012,19,33,187,2,163
3356,537,412,181.41750566893424,183.39120181405897,19,21,151,2,125
3357,537,412,181.41750566893424,183.9717006802721,19,21,167,3,125
3358,537,798,181.41750566893424,183.32154195011339,19,17,274,2,261
3359,537,631,181.41750566893424,183.60018140589568,19,20,133,2,94
3360,537,855,181.41750566893424,183.43764172335602,19,15,330,2,318
3361,537,865,181.41750566893424,183.57696145124717,19,19,341,2,328
3362,452,6,182.04444444444445,183.71628117913832,24,50,452,2,446
3363,452,6,182.04444444444445,184.73795918367347,24,49,461,3,446
3364,452,214,182.04444444444445,183.1590022675737,24,29,243,1,238
3365,452,374,182.04444444444445,183.53052154195012,24,33,101,1,78
3366,452,218,182.04444444444445,184.78439909297052,24,25,262,3,234
3367,452,412,182.04444444444445,183.39120181405897,24,21,70,1,40
3368,452,412,182.04444444444445,183.9717006802721,24,21,92,2,40
3369,452,508,182.04444444444445,184.97015873015874,24,19,138,3,56
3370,452,798,182.04444444444445,183.32154195011339,24,17,350,1,346
3371,452,631,182.04444444444445,183.60018140589568,24,20,191,2,179
3372,452,649,182.04444444444445,184.69151927437642,24,18,228,3,197
3373,452,855,182.04444444444445,183.43764172335602,24,15,407,1,403
3374,452,865,182.04444444444445,183.57696145124717,24,19,418,2,413
3375,452,831,182.04444444444445,184.9469387755102,24,14,399,3,379
3376,412,6,183.39120181405897,184.73795918367347,21,49,410,1,406
3377,412,6,183.39120181405897,185.7364172335601,21,49,418,2,406
3378,412,218,183.39120181405897,184.78439909297052,21,25,203,1,194
3379,412,214,183.39120181405897,186.03827664399094,21,27,228,3,198
3380,412,508,183.39120181405897,184.97015873015874,21,19,118,2,96
3381,412,491,183.39120181405897,185.96861678004535,21,20,136,3,79
3382,412,649,183.39120181405897,184.69151927437642,21,18,244,1,237
3383,412,806,183.39120181405897,186.1079365079365,21,21,411,3,394
3384,412,831,183.39120181405897,184.9469387755102,21,14,424,2,419
3385,412,897,183.39120181405897,185.96861678004535,21,19,498,3,485
3386,412,6,183.9717006802721,185.7364172335601,21,49,413,2,406
3387,412,214,183.9717006802721,186.03827664399094,21,27,217,2,198
3388,412,491,183.9717006802721,185.96861678004535,21,20,117,2,79
3389,412,450,183.9717006802721,186.85097505668935,21,20,130,3,38
3390,412,806,183.9717006802721,186.1079365079365,21,21,405,2,394
3391,412,897,183.9717006802721,185.96861678004535,21,19,493,2,485
3392,508,214,184.97015873015874,186.03827664399094,19,27,298,1,294
3393,508,218,184.97015873015874,187.03673469387755,19,38,303,2,290
3394,508,221,184.97015873015874,187.66367346938776,19,31,310,3,287
3395,508,450,184.97015873015874,186.85097505668935,19,20,100,2,58
3396,508,806,184.97015873015874,186.1079365079365,19,21,302,1,298
3397,508,756,184.97015873015874,187.1528344671202,19,18,265,2,248
3398,508,917,184.97015873015874,186.7116553287982,19,19,416,2,409
3399,491,6,185.96861678004535,187.26893424036282,20,49,488,1,485
3400,491,6,185.96861678004535,187.7797732426304,20,49,491,2,485
3401,491,6,185.96861678004535,188.80145124716555,20,49,500,3,485
3402,491,218,185.96861678004535,187.03673469387755,20,38,277,1,273
3403,491,221,185.96861678004535,187.66367346938776,20,31,280,2,270
3404,491,205,185.96861678004535,188.5924716553288,20,29,308,3,286
3405,491,427,185.96861678004535,188.29061224489797,20,19,119,2,64
3406,491,756,185.96861678004535,187.1528344671202,20,18,270,1,265
3407,491,630,185.96861678004535,188.0584126984127,20,19,166,2,139
3408,491,937,185.96861678004535,187.98875283446714,20,16,454,2,446
3409,450,6,186.85097505668935,188.80145124716555,20,49,452,2,444
3410,450,6,186.85097505668935,189.8231292517007,20,49,462,3,444
3411,450,205,186.85097505668935,188.5924716553288,20,29,256,2,245
3412,450,427,186.85097505668935,188.29061224489797,20,19,66,1,23
3413,450,589,186.85097505668935,189.10331065759638,20,20,169,2,139
3414,450,630,186.85097505668935,188.0584126984127,20,19,187,1,180
3415,450,619,186.85097505668935,189.10331065759638,20,22,195,2,169
3416,450,937,186.85097505668935,187.98875283446714,20,16,489,1,487
3417,450,849,186.85097505668935,189.28907029478458,20,15,413,2,399
3418,450,887,186.85097505668935,189.7302494331066,20,20,454,3,437
3419,427,6,188.29061224489797,189.8231292517007,19,49,426,2,421
3420,427,5,188.29061224489797,190.84480725623584,19,49,436,3,422
3421,427,235,188.29061224489797,190.05532879818594,19,30,206,2,192
3422,427,455,188.29061224489797,190.21786848072563,19,25,88,2,28
3423,427,730,188.29061224489797,190.03210884353743,19,22,312,2,303
3424,427,887,188.29061224489797,189.7302494331066,19,20,464,1,460
3425,427,897,188.29061224489797,190.9144671201814,19,15,483,3,470
3426,589,216,189.10331065759638,191.37886621315192,20,31,386,2,373
3427,589,455,189.10331065759638,190.21786848072563,20,25,142,1,134
3428,589,490,189.10331065759638,191.47174603174602,20,20,142,2,99
3429,589,803,189.10331065759638,191.49496598639456,20,18,237,2,214
3430,589,812,189.10331065759638,192.07546485260772,20,22,257,3,223
3431,589,897,189.10331065759638,190.9144671201814,20,15,318,2,308
3432,455,6,190.21786848072563,191.84326530612245,25,50,454,2,449
3433,455,6,190.21786848072563,192.8649433106576,25,49,463,3,449
3434,455,216,190.21786848072563,191.37886621315192,25,31,244,1,239
3435,455,317,190.21786848072563,192.28444444444446,25,29,164,2,138
3436,455,490,190.21786848072563,191.47174603174602,25,20,64,1,35
3437,455,432,190.21786848072563,192.14512471655328,25,25,86,2,23
3438,455,429,190.21786848072563,192.81850340136054,25,20,115,3,26
3439,455,803,190.21786848072563,191.49496598639456,25,18,352,1,348
3440,455,812,190.21786848072563,192.07546485260772,25,22,366,2,357
3441,455,649,190.21786848072563,192.84172335600908,25,17,225,3,194
3442,455,828,190.21786848072563,192.12190476190477,25,22,382,2,373
3443,455,827,190.21786848072563,192.84172335600908,25,13,389,3,372
3444,490,6,191.47174603174602,192.8649433106576,20,49,488,1,484
3445,490,6,191.47174603174602,193.88662131519274,20,49,495,2,484
3446,490,252,191.47174603174602,193.35256235827666,20,26,251,2,238
3447,490,333,191.47174603174602,193.8401814058957,20,25,187,2,157
3448,490,429,191.47174603174602,192.81850340136054,20,20,84,1,61
3449,490,560,191.47174603174602,193.79374149659864,20,22,122,2,70
3450,490,649,191.47174603174602,192.84172335600908,20,17,170,1,159
3451,490,679,191.47174603174602,193.81696145124718,20,18,214,2,189
3452,490,827,191.47174603174602,192.84172335600908,20,13,342,1,337
3453,490,832,191.47174603174602,193.60798185941044,20,17,354,2,342
3454,432,6,192.14512471655328,193.88662131519274,25,49,433,2,426
3455,432,252,192.14512471655328,193.35256235827666,25,26,187,1,180
3456,432,333,192.14512471655328,193.8401814058957,25,25,123,2,99
3457,432,220,192.14512471655328,194.86185941043084,25,23,242,3,212
3458,432,560,192.14512471655328,193.79374149659864,25,22,146,2,128
3459,432,679,192.14512471655328,193.81696145124718,25,18,257,2,247
3460,432,631,192.14512471655328,194.88507936507938,25,15,231,3,199
3461,432,832,192.14512471655328,193.60798185941044,25,17,405,1,400
3462,432,846,192.14512471655328,194.86185941043084,25,16,430,3,414
3463,429,6,192.81850340136054,193.88662131519274,20,49,425,1,423
3464,429,6,192.81850340136054,195.39591836734695,20,49,437,3,423
3465,429,4,192.81850340136054,195.5352380952381,20,40,441,3,425
3466,429,333,192.81850340136054,193.8401814058957,20,25,106,1,96
3467,429,220,192.81850340136054,194.86185941043084,20,23,227,2,209
3468,429,368,192.81850340136054,195.76743764172335,20,27,141,3,61
3469,429,411,192.81850340136054,195.21015873015872,20,20,105,2,18
3470,429,413,192.81850340136054,195.76743764172335,20,25,128,3,16
3471,429,631,192.81850340136054,194.88507936507938,20,15,221,2,202
3472,429,846,192.81850340136054,194.86185941043084,20,16,426,2,417
3473,560,220,193.79374149659864,194.86185941043084,22,23,343,1,340
3474,560,368,193.79374149659864,195.76743764172335,22,27,210,2,192
3475,560,411,193.79374149659864,195.21015873015872,22,20,161,1,149
3476,560,413,193.79374149659864,195.76743764172335,22,25,170,2,147
3477,560,631,193.79374149659864,194.88507936507938,22,15,85,1,71
3478,560,648,193.79374149659864,195.81387755102043,22,24,124,2,88
3479,560,846,193.79374149659864,194.86185941043084,22,16,290,1,286
3480,560,934,193.79374149659864,195.81387755102043,22,25,384,2,374
3481,411,16,195.21015873015872,197.11419501133787,20,32,403,2,395
3482,411,16,195.21015873015872,197.6714739229025,20,30,409,2,395
3483,413,16,195.76743764172335,197.11419501133787,25,32,401,1,397
3484,413,16,195.76743764172335,197.6714739229025,25,30,405,2,397
3485,710,274,8.591383219954649,10.24,14,21,442,2,436
3486,710,426,8.591383219954649,10.263219954648527,14,19,293,2,284
3487,710,638,8.591383219954649,10.216780045351474,14,13,100,2,72
3488,638,208,10.216780045351474,12.817414965986394,13,33,444,3,430
3489,638,432,10.216780045351474,12.956734693877552,13,18,237,3,206
3490,638,761,10.216780045351474,12.585215419501134,13,14,160,2,123
3491,761,486,12.585215419501134,14.55891156462585,14,23,288,2,275
3492,761,814,12.585215419501134,13.862312925170068,14,14,76,1,53
3493,761,622,12.585215419501134,14.489251700680272,14,14,161,2,139
3494,814,415,13.862312925170068,16.27718820861678,14,19,412,2,399
3495,622,254,14.489251700680272,16.27718820861678,14,27,376,2,368
3496,622,292,14.489251700680272,17.136326530612244,14,18,349,3,330
3497,622,415,14.489251700680272,16.27718820861678,14,19,221,2,207
3498,622,460,14.489251700680272,17.29886621315193,14,13,202,3,162
3499,773,334,18.18122448979592,20.712199546485262,15,20,452,3,439
3500,773,514,18.18122448979592,20.503219954648525,15,18,278,2,259
3501,773,814,18.18122448979592,20.48,15,15,107,2,41
3502,773,832,18.18122448979592,20.48,15,14,115,2,59
3503,814,355,20.48,22.221496598639455,15,23,465,2,459
3504,814,421,20.48,22.267936507936508,15,18,400,2,393
3505,814,628,20.48,22.19827664399093,15,14,200,2,186
3506,628,295,22.19827664399093,25.007891156462584,14,24,354,3,333
3507,628,417,22.19827664399093,25.007891156462584,14,17,243,3,211
3508,658,216,26.076009070294784,27.445986394557824,14,23,446,1,442
3509,658,308,26.076009070294784,28.95528344671202,14,23,371,3,350
3510,658,416,26.076009070294784,27.260226757369615,14,15,247,1,242
3511,658,514,26.076009070294784,28.81596371882086,14,21,186,3,144
3512,658,636,26.076009070294784,28.81596371882086,14,15,120,3,22
3513,636,318,28.81596371882086,30.812879818594105,15,24,329,2,318
3514,636,295,28.81596371882086,31.7881179138322,15,25,364,3,341
3515,636,475,28.81596371882086,29.83764172335601,15,15,167,1,161
3516,636,411,28.81596371882086,30.65034013605442,15,15,238,2,225
3517,636,414,28.81596371882086,31.648798185941043,15,20,253,3,222
3518,636,625,28.81596371882086,31.71845804988662,15,13,125,3,11
3519,625,213,31.71845804988662,33.99401360544218,13,35,423,2,412
3520,625,208,31.71845804988662,34.69061224489796,13,26,436,3,417
3521,625,427,31.71845804988662,33.99401360544218,13,22,221,2,198
3522,625,646,31.71845804988662,33.69215419501134,13,19,88,2,21
3523,625,771,31.71845804988662,34.644172335600906,13,23,193,3,146
3524,625,853,31.71845804988662,33.668934240362816,13,13,243,2,228
3525,625,826,31.71845804988662,34.644172335600906,13,22,237,3,201
3526,646,337,33.69215419501134,35.131791383219955,19,29,315,1,309
3527,646,499,33.69215419501134,34.71383219954649,19,22,153,1,147
3528,646,499,33.69215419501134,35.735510204081635,19,21,171,2,147
3529,646,538,33.69215419501134,36.664308390022676,19,23,167,3,108
3530,646,687,33.69215419501134,35.71229024943311,19,15,96,2,41
3531,646,630,33.69215419501134,36.5946485260771,19,20,126,3,16
3532,646,868,33.69215419501134,36.64108843537415,19,14,256,3,222
3533,771,499,34.644172335600906,35.735510204081635,23,21,276,1,272
3534,771,538,34.644172335600906,36.664308390022676,23,23,249,2,233
3535,771,687,34.644172335600906,35.71229024943311,23,15,96,1,84
3536,771,630,34.644172335600906,36.5946485260771,23,20,164,2,141
3537,771,868,34.644172335600906,36.64108843537415,23,14,130,2,97
3538,687,213,35.71229024943311,36.73396825396826,15,27,476,1,474
3539,687,327,35.71229024943311,38.080725623582765,15,27,374,2,360
3540,687,438,35.71229024943311,37.755646258503404,15,18,264,2,249
3541,687,435,35.71229024943311,38.521904761904764,15,22,280,3,252
3542,630,327,36.5946485260771,38.080725623582765,20,27,310,1,303
3543,630,217,36.5946485260771,39.05596371882086,20,36,426,2,413
3544,630,215,36.5946485260771,39.497142857142855,20,37,433,3,415
3545,630,438,36.5946485260771,37.755646258503404,20,18,198,1,192
3546,630,435,36.5946485260771,38.521904761904764,20,22,212,2,195
3547,630,687,36.5946485260771,37.755646258503404,20,18,76,1,57
3548,630,637,36.5946485260771,38.846984126984125,20,22,97,2,7
3549,630,865,36.5946485260771,38.800544217687076,20,19,253,2,235
3550,687,217,37.755646258503404,39.05596371882086,18,36,473,1,470
3551,687,215,37.755646258503404,39.497142857142855,18,37,478,2,472
3552,687,332,37.755646258503404,40.12408163265306,18,26,369,2,355
3553,687,429,37.755646258503404,39.7990022675737,18,23,273,2,258
3554,687,637,37.755646258503404,38.846984126984125,18,22,69,1,50
3555,687,718,37.755646258503404,39.9847619047619,18,15,101,2,31
3556,687,865,37.755646258503404,38.800544217687076,18,19,184,1,178
3557,637,332,38.846984126984125,40.12408163265306,22,26,310,1,305
3558,637,278,38.846984126984125,41.633378684807255,22,29,379,3,359
3559,637,478,38.846984126984125,40.79746031746032,22,20,180,2,159
3560,637,545,38.846984126984125,41.56371882086168,22,25,149,3,92
3561,637,718,38.846984126984125,39.9847619047619,22,15,95,1,81
3562,637,753,38.846984126984125,40.84390022675737,22,13,144,2,116
3563,637,626,38.846984126984125,41.56371882086168,22,19,118,3,11
3564,637,844,38.846984126984125,41.56371882086168,22,16,238,3,207
3565,718,278,39.9847619047619,41.633378684807255,15,29,446,2,440
3566,718,545,39.9847619047619,41.56371882086168,15,25,186,2,173
3567,718,429,39.9847619047619,42.840816326530614,15,19,314,3,289
3568,718,626,39.9847619047619,41.56371882086168,15,19,114,2,92
3569,718,682,39.9847619047619,42.306757369614516,15,15,106,2,36
3570,718,844,39.9847619047619,41.56371882086168,15,16,143,2,126
3571,718,876,39.9847619047619,42.283537414965984,15,21,186,2,158
3572,753,301,40.84390022675737,43.444535147392294,13,27,466,3,452
3573,753,429,40.84390022675737,42.840816326530614,13,19,335,2,324
3574,753,512,40.84390022675737,43.769614512471655,13,23,272,3,241
3575,753,682,40.84390022675737,42.306757369614516,13,15,95,1,71
3576,753,876,40.84390022675737,42.283537414965984,13,21,138,1,123
3577,626,301,41.56371882086168,43.444535147392294,19,27,335,2,325
3578,626,429,41.56371882086168,42.840816326530614,19,19,205,1,197
3579,626,512,41.56371882086168,43.769614512471655,19,23,148,2,114
3580,626,415,41.56371882086168,44.489433106575966,19,25,246,3,211
3581,626,661,41.56371882086168,43.86249433106576,19,14,105,2,35
3582,682,301,42.306757369614516,43.444535147392294,15,27,384,1,381
3583,682,292,42.306757369614516,44.55909297052154,15,32,402,2,390
3584,682,512,42.306757369614516,43.769614512471655,15,23,181,1,170
3585,682,415,42.306757369614516,44.489433106575966,15,25,283,2,267
3586,682,661,42.306757369614516,43.86249433106576,15,14,70,2,21
3587,682,750,42.306757369614516,44.76807256235828,15,18,126,2,68
3588,661,218,43.86249433106576,45.97551020408164,14,32,452,2,443
3589,661,364,43.86249433106576,46.602448979591834,14,31,320,3,297
3590,661,547,43.86249433106576,45.60399092970522,14,23,136,2,114
3591,661,743,43.86249433106576,45.627210884353744,14,23,112,2,82
3592,661,851,43.86249433106576,45.627210884353744,14,20,205,2,190
3593,750,364,44.76807256235828,46.602448979591834,18,31,394,2,386
3594,750,449,44.76807256235828,46.9275283446712,18,20,315,2,301
3595,750,687,44.76807256235828,46.90430839002268,18,17,112,2,63
3596,750,624,44.76807256235828,47.18294784580499,18,23,163,2,126
3597,750,823,44.76807256235828,47.206167800453514,18,17,128,2,73
3598,743,449,45.627210884353744,46.9275283446712,23,20,299,1,294
3599,743,438,45.627210884353744,47.925986394557825,23,23,321,2,305
3600,743,687,45.627210884353744,46.90430839002268,23,17,78,1,56
3601,743,624,45.627210884353744,47.18294784580499,23,23,137,2,119
3602,743,823,45.627210884353744,47.206167800453514,23,17,105,2,80
3603,687,219,46.90430839002268,48.29750566893424,17,28,472,1,468
3604,687,438,46.90430839002268,47.925986394557825,17,23,253,1,249
3605,687,423,46.90430839002268,48.92444444444445,17,19,278,2,264
3606,687,621,46.90430839002268,48.92444444444445,17,16,109,2,66
3607,687,633,46.90430839002268,49.22630385487528,17,17,114,2,54
3608,687,927,46.90430839002268,49.20308390022676,17,17,260,2,240
3609,624,219,47.18294784580499,48.29750566893424,23,28,408,1,405
3610,624,293,47.18294784580499,50.062222222222225,23,27,353,3,331
3611,624,423,47.18294784580499,48.92444444444445,23,19,215,2,201
3612,624,499,47.18294784580499,49.96934240362812,23,19,173,3,125
3613,624,621,47.18294784580499,48.92444444444445,23,16,75,2,3
3614,624,633,47.18294784580499,49.22630385487528,23,17,88,2,9
3615,624,927,47.18294784580499,49.20308390022676,23,17,315,2,303
3616,621,293,48.92444444444445,50.062222222222225,16,27,332,1,328
3617,621,220,48.92444444444445,50.549841269841274,16,37,407,2,401
3618,621,227,48.92444444444445,51.7340589569161,16,32,412,3,394
3619,621,499,48.92444444444445,49.96934240362812,16,19,130,1,122
3620,621,436,48.92444444444445,50.80526077097506,16,21,202,2,185
3621,621,814,48.92444444444445,50.874920634920635,16,20,210,2,193
3622,621,682,48.92444444444445,51.66439909297052,16,21,133,3,61
3623,621,866,48.92444444444445,50.944580498866216,16,24,260,2,245
3624,621,821,48.92444444444445,51.61795918367347,16,16,231,3,200
3625,633,220,49.22630385487528,50.549841269841274,17,37,417,1,413
3626,633,227,49.22630385487528,51.7340589569161,17,32,420,3,406
3627,633,436,49.22630385487528,50.80526077097506,17,21,208,2,197
3628,633,437,49.22630385487528,51.98947845804989,17,20,229,3,196
3629,633,814,49.22630385487528,50.874920634920635,17,20,194,2,181
3630,633,682,49.22630385487528,51.66439909297052,17,21,116,2,49
3631,633,866,49.22630385487528,50.944580498866216,17,24,244,2,233
3632,633,821,49.22630385487528,51.61795918367347,17,16,214,2,188
3633,814,437,50.874920634920635,51.98947845804989,20,20,380,1,377
3634,814,440,50.874920634920635,52.98793650793651,20,20,385,2,374
3635,814,647,50.874920634920635,53.011156462585035,20,16,191,2,167
3636,682,230,51.66439909297052,52.98793650793651,21,27,456,1,452
3637,682,230,51.66439909297052,54.00961451247166,21,25,463,2,452
3638,682,227,51.66439909297052,54.31147392290249,21,35,469,3,455
3639,682,440,51.66439909297052,52.98793650793651,21,20,249,1,242
3640,682,443,51.66439909297052,54.00961451247166,21,19,259,2,239
3641,682,647,51.66439909297052,53.011156462585035,21,16,68,1,35
3642,682,646,51.66439909297052,54.03283446712018,21,14,108,2,36
3643,647,227,53.011156462585035,54.31147392290249,16,35,424,1,420
3644,647,213,53.011156462585035,55.77433106575964,16,31,450,3,434
3645,647,429,53.011156462585035,55.031292517006804,16,21,235,2,218
3646,647,646,53.011156462585035,54.03283446712018,16,14,44,1,1
3647,646,213,54.03283446712018,55.77433106575964,14,31,439,2,433
3648,646,211,54.03283446712018,56.21551020408163,14,30,445,2,435
3649,646,491,54.03283446712018,56.029750566893426,14,21,177,2,155
3650,646,647,54.03283446712018,55.05451247165533,14,17,44,1,1
3651,647,211,55.05451247165533,56.21551020408163,17,30,439,1,436
3652,647,429,55.05451247165533,57.05142857142857,17,18,234,2,218
3653,647,620,55.05451247165533,57.05142857142857,17,13,90,2,27
3654,620,245,57.05142857142857,58.07310657596372,13,31,378,1,375
3655,620,241,57.05142857142857,58.212426303854876,13,31,382,1,379
3656,620,209,57.05142857142857,59.512743764172335,13,27,424,2,411
3657,620,429,57.05142857142857,58.096326530612245,13,21,196,1,191
3658,620,412,57.05142857142857,59.025124716553286,13,25,225,2,208
3659,620,423,57.05142857142857,59.55918367346939,13,20,225,3,197
3660,620,803,57.05142857142857,58.096326530612245,13,13,188,1,183
3661,620,726,57.05142857142857,58.816145124716556,13,15,130,2,106
3662,620,615,57.05142857142857,59.60562358276644,13,14,110,3,5
3663,803,423,58.096326530612245,59.55918367346939,13,20,385,1,380
3664,803,615,58.096326530612245,59.60562358276644,13,14,199,2,188
3665,726,266,58.816145124716556,61.045260770975055,15,33,470,2,460
3666,726,410,58.816145124716556,61.11492063492064,15,17,331,2,316
3667,615,266,59.60562358276644,61.045260770975055,14,33,354,1,349
3668,615,216,59.60562358276644,61.99727891156463,14,27,412,2,399
3669,615,410,59.60562358276644,61.11492063492064,14,17,215,2,205
3670,615,418,59.60562358276644,61.881179138322,14,22,220,2,197
3671,615,414,59.60562358276644,62.15981859410431,14,20,229,3,201
3672,615,744,59.60562358276644,61.92761904761905,14,20,163,2,129
3673,615,880,59.60562358276644,61.90439909297052,14,16,283,2,265
3674,744,456,61.92761904761905,64.1102947845805,20,20,303,2,288
3675,744,463,61.92761904761905,64.17995464852608,20,20,297,2,281
3676,744,651,61.92761904761905,63.947755102040816,20,17,127,2,93
3677,744,646,61.92761904761905,64.2031746031746,20,16,139,2,98
3678,651,205,63.947755102040816,65.66603174603175,17,27,452,2,446
3679,651,387,63.947755102040816,66.20009070294785,17,23,281,2,264
3680,651,428,63.947755102040816,65.68925170068027,17,19,235,2,223
3681,651,438,63.947755102040816,66.22331065759637,17,21,234,2,213
3682,651,655,63.947755102040816,65.48027210884354,17,20,66,2,4
3683,651,645,63.947755102040816,66.22331065759637,17,13,98,2,6
3684,651,867,63.947755102040816,65.50349206349206,17,20,226,2,216
3685,646,205,64.2031746031746,65.66603174603175,16,27,445,1,441
3686,646,387,64.2031746031746,66.20009070294785,16,23,273,2,259
3687,646,428,64.2031746031746,65.68925170068027,16,19,227,1,218
3688,646,438,64.2031746031746,66.22331065759637,16,21,225,2,208
3689,646,655,64.2031746031746,65.48027210884354,16,20,56,1,9
3690,646,645,64.2031746031746,66.22331065759637,16,13,87,2,1
3691,646,867,64.2031746031746,65.50349206349206,16,20,228,1,221
3692,655,205,65.48027210884354,67.96480725623583,20,24,463,2,450
3693,655,438,65.48027210884354,67.24498866213152,20,21,230,2,217
3694,655,640,65.48027210884354,68.08090702947845,20,15,113,3,15
3695,645,205,66.22331065759637,67.96480725623583,13,24,446,2,440
3696,645,244,66.22331065759637,69.14902494331066,13,32,420,3,401
3697,645,267,66.22331065759637,69.19546485260771,13,28,399,3,378
3698,645,438,66.22331065759637,67.24498866213152,13,21,212,1,207
3699,645,432,66.22331065759637,68.98648526077098,13,22,244,3,213
3700,645,640,66.22331065759637,68.08090702947845,13,15,80,2,5
3701,645,658,66.22331065759637,68.94004535147393,13,17,118,3,13
3702,640,244,68.08090702947845,69.14902494331066,15,32,399,1,396
3703,640,267,68.08090702947845,69.19546485260771,15,28,376,1,373
3704,640,367,68.08090702947845,71.0530612244898,15,29,302,3,273
3705,640,467,68.08090702947845,69.40444444444445,15,16,182,1,173
3706,640,517,68.08090702947845,70.6118820861678,15,20,164,3,123
3707,640,798,68.08090702947845,69.5437641723356,15,15,170,1,158
3708,640,655,68.08090702947845,71.02984126984127,15,17,128,3,15
3709,640,830,68.08090702947845,69.5437641723356,15,13,200,1,190
3710,658,367,68.94004535147393,71.0530612244898,17,29,305,2,291
3711,658,220,68.94004535147393,71.26204081632653,17,31,449,2,438
3712,658,517,68.94004535147393,70.6118820861678,17,20,158,2,141
3713,658,415,68.94004535147393,71.28526077097506,17,14,263,2,243
3714,658,655,68.94004535147393,71.02984126984127,17,17,90,2,3
3715,658,732,68.94004535147393,71.28526077097506,17,14,125,2,74
3716,798,367,69.5437641723356,71.0530612244898,15,29,436,2,431
3717,798,517,69.5437641723356,70.6118820861678,15,20,285,1,281
3718,798,415,69.5437641723356,71.28526077097506,15,14,390,2,383
3719,798,444,69.5437641723356,72.28371882086168,15,15,373,3,354
3720,798,655,69.5437641723356,71.02984126984127,15,17,157,1,143
3721,798,732,69.5437641723356,71.28526077097506,15,14,100,2,66
3722,655,223,71.02984126984127,72.2140589569161,17,19,435,1,432
3723,655,288,71.02984126984127,73.21251700680273,17,23,379,2,367
3724,655,444,71.02984126984127,72.28371882086168,17,15,218,1,211
3725,655,543,71.02984126984127,73.32861678004535,17,23,149,2,112
3726,655,627,71.02984126984127,73.32861678004535,17,18,103,2,28
3727,732,288,71.28526077097506,73.21251700680273,14,23,452,2,444
3728,732,543,71.28526077097506,73.32861678004535,14,23,208,2,189
3729,732,627,71.28526077097506,73.32861678004535,14,18,137,2,105
3730,627,280,73.32861678004535,75.16299319727891,18,27,356,2,347
3731,627,218,73.32861678004535,75.3255328798186,18,27,418,2,409
3732,627,460,73.32861678004535,74.3502947845805,18,23,173,1,167
3733,627,451,73.32861678004535,75.60417233560091,18,15,201,2,176
3734,627,621,73.32861678004535,75.11655328798186,18,16,77,2,6
3735,621,208,75.11655328798186,76.64907029478458,16,15,418,2,413
3736,621,207,75.11655328798186,77.57786848072563,16,30,427,2,414
3737,621,413,75.11655328798186,77.29922902494332,16,14,228,2,208
3738,657,244,78.78530612244899,79.87664399092971,14,25,416,1,413
3739,657,290,78.78530612244899,80.2249433106576,14,18,372,1,367
3740,654,206,83.73115646258503,84.7760544217687,18,17,450,1,448
3741,654,320,83.73115646258503,85.98349206349206,18,24,348,2,334
3742,654,218,83.73115646258503,86.40145124716554,18,32,451,3,436
3743,654,523,83.73115646258503,85.8441723356009,18,20,160,2,131
3744,654,717,83.73115646258503,85.72807256235828,18,16,107,2,63
3745,717,274,85.72807256235828,87.42312925170069,16,22,449,2,443
3746,717,425,85.72807256235828,86.819410430839,16,18,296,1,292
3747,717,615,85.72807256235828,87.00517006802721,16,14,116,1,102
3748,717,777,85.72807256235828,87.86430839002267,16,14,110,2,60
3749,717,631,85.72807256235828,88.51446712018141,16,17,148,3,86
3750,615,213,87.00517006802721,88.42158730158731,14,29,407,1,402
3751,615,321,87.00517006802721,89.90766439909297,14,18,319,3,294
3752,615,413,87.00517006802721,89.02530612244898,14,15,220,2,202
3753,615,598,87.00517006802721,89.79156462585034,14,22,121,3,17
3754,615,631,87.00517006802721,88.51446712018141,14,17,67,2,16
3755,615,629,87.00517006802721,89.79156462585034,14,22,121,3,14
3756,615,968,87.00517006802721,89.81478458049887,14,14,373,3,353
3757,777,321,87.86430839002267,89.90766439909297,14,18,464,2,456
3758,777,413,87.86430839002267,89.02530612244898,14,15,367,1,364
3759,777,598,87.86430839002267,89.79156462585034,14,22,197,2,179
3760,777,413,87.86430839002267,90.48816326530613,14,23,381,3,364
3761,777,629,87.86430839002267,89.79156462585034,14,22,170,2,148
3762,777,968,87.86430839002267,89.81478458049887,14,14,209,2,191
3763,631,321,88.51446712018141,89.90766439909297,17,18,316,1,310
3764,631,230,88.51446712018141,90.51138321995465,17,36,410,2,401
3765,631,598,88.51446712018141,89.79156462585034,17,22,64,1,33
3766,631,413,88.51446712018141,90.48816326530613,17,23,234,2,218
3767,631,629,88.51446712018141,89.79156462585034,17,22,55,1,2
3768,631,968,88.51446712018141,89.81478458049887,17,14,342,1,337
3769,629,298,89.79156462585034,91.64916099773242,22,30,341,2,331
3770,629,412,89.79156462585034,91.64916099773242,22,24,231,2,217
3771,629,414,89.79156462585034,92.34575963718821,22,26,242,3,215
3772,652,219,94.69097505668934,96.73433106575963,16,26,442,2,433
3773,652,218,94.69097505668934,97.57024943310658,16,28,451,3,434
3774,652,516,94.69097505668934,95.71265306122449,16,21,143,1,136
3775,652,415,94.69097505668934,97.22195011337868,16,22,261,3,237
3776,652,619,94.69097505668934,96.73433106575963,16,15,94,2,33
3777,652,630,94.69097505668934,97.61668934240363,16,21,128,3,22
3778,652,869,94.69097505668934,97.22195011337868,16,13,243,3,217
3779,652,889,94.69097505668934,97.61668934240363,16,15,268,3,237
3780,777,415,95.66621315192744,97.22195011337868,22,22,368,2,362
3781,777,538,95.66621315192744,97.6863492063492,22,23,254,2,239
3782,777,619,95.66621315192744,96.73433106575963,22,15,165,1,158
3783,777,630,95.66621315192744,97.61668934240363,22,21,169,2,147
3784,777,869,95.66621315192744,97.22195011337868,22,13,114,2,92
3785,777,889,95.66621315192744,97.61668934240363,22,15,140,2,112
3786,619,326,96.73433106575963,99.12598639455783,15,32,311,2,293
3787,619,523,96.73433106575963,98.80090702947847,15,19,131,2,96
3788,619,684,96.73433106575963,98.7544671201814,15,16,109,2,65
3789,619,820,96.73433106575963,99.1956462585034,15,15,227,2,201
3790,630,326,97.61668934240363,99.12598639455783,21,32,311,2,304
3791,630,216,97.61668934240363,100.19410430839002,21,39,429,3,414
3792,630,211,97.61668934240363,100.54240362811791,21,41,438,3,419
3793,630,523,97.61668934240363,98.80090702947847,21,19,119,1,107
3794,630,535,97.61668934240363,99.82258503401361,21,23,134,2,95
3795,630,684,97.61668934240363,98.7544671201814,21,16,73,1,54
3796,630,650,97.61668934240363,99.96190476190476,21,25,103,2,20
3797,630,820,97.61668934240363,99.1956462585034,21,15,202,2,190
3798,630,826,97.61668934240363,99.96190476190476,21,21,220,2,196
3799,684,216,98.7544671201814,100.19410430839002,16,39,472,1,468
3800,684,211,98.7544671201814,100.54240362811791,16,41,479,2,473
3801,684,216,98.7544671201814,101.44798185941043,16,36,482,3,468
3802,684,535,98.7544671201814,99.82258503401361,16,23,156,1,149
3803,684,523,98.7544671201814,100.82104308390024,16,18,184,2,161
3804,684,650,98.7544671201814,99.96190476190476,16,25,62,1,34
3805,684,696,98.7544671201814,100.82104308390024,16,17,90,2,12
3806,684,826,98.7544671201814,99.96190476190476,16,21,151,1,142
3807,650,216,99.96190476190476,101.44798185941043,25,36,439,1,434
3808,650,278,99.96190476190476,102.65541950113379,25,29,390,3,372
3809,650,428,99.96190476190476,102.1213605442177,25,21,241,2,222
3810,650,545,99.96190476190476,102.56253968253968,25,23,154,3,105
3811,650,648,99.96190476190476,102.1213605442177,25,22,93,2,2
3812,650,644,99.96190476190476,102.56253968253968,25,19,112,3,6
3813,650,867,99.96190476190476,102.14458049886622,25,23,236,2,217
3814,696,278,100.82104308390024,102.65541950113379,17,29,425,2,418
3815,696,215,100.82104308390024,103.51455782312925,17,28,495,3,481
3816,696,428,100.82104308390024,102.1213605442177,17,21,274,1,268
3817,696,545,100.82104308390024,102.56253968253968,17,23,169,2,151
3818,696,648,100.82104308390024,102.1213605442177,17,22,74,1,48
3819,696,644,100.82104308390024,102.56253968253968,17,19,91,2,52
3820,696,646,100.82104308390024,103.32879818594104,17,16,119,3,50
3821,696,867,100.82104308390024,102.14458049886622,17,23,180,1,171
3822,696,856,100.82104308390024,103.25913832199547,17,20,191,2,160
3823,696,875,100.82104308390024,103.30557823129251,17,20,209,2,179
3824,648,215,102.1213605442177,103.51455782312925,22,28,437,1,433
3825,648,244,102.1213605442177,104.86131519274376,22,27,421,3,404
3826,648,526,102.1213605442177,104.07183673469387,22,19,148,2,122
3827,648,512,102.1213605442177,104.76843537414966,22,22,177,3,136
3828,648,646,102.1213605442177,103.32879818594104,22,16,52,1,2
3829,648,618,102.1213605442177,104.90775510204082,22,15,124,3,30
3830,648,856,102.1213605442177,103.25913832199547,22,20,214,1,208
3831,648,875,102.1213605442177,103.30557823129251,22,20,233,1,227
3832,648,930,102.1213605442177,104.35047619047619,22,13,298,2,282
3833,644,244,102.56253968253968,104.86131519274376,19,27,412,2,400
3834,644,526,102.56253968253968,104.07183673469387,19,19,135,2,118
3835,644,512,102.56253968253968,104.76843537414966,19,22,163,2,132
3836,644,415,102.56253968253968,105.48825396825397,19,24,261,3,229
3837,644,618,102.56253968253968,104.90775510204082,19,15,104,2,26
3838,644,930,102.56253968253968,104.35047619047619,19,13,296,2,286
3839,646,244,103.32879818594104,104.86131519274376,16,27,407,2,402
3840,646,212,103.32879818594104,105.8829931972789,16,33,448,3,434
3841,646,512,103.32879818594104,104.76843537414966,16,22,148,1,134
3842,646,415,103.32879818594104,105.48825396825397,16,24,249,2,231
3843,646,618,103.32879818594104,104.90775510204082,16,15,74,2,28
3844,646,731,103.32879818594104,105.8829931972789,16,16,139,3,85
3845,646,930,103.32879818594104,104.35047619047619,16,13,287,1,284
3846,646,908,103.32879818594104,105.8829931972789,16,13,284,3,262
3847,618,219,104.90775510204082,106.99755102040817,15,37,409,2,399
3848,618,306,104.90775510204082,107.3922902494331,15,34,330,2,312
3849,618,411,104.90775510204082,107.04399092970522,15,24,227,2,207
3850,618,742,104.90775510204082,106.62603174603174,15,15,144,2,124
3851,618,887,104.90775510204082,106.90467120181407,15,15,282,2,269
3852,731,306,105.8829931972789,107.3922902494331,16,34,430,2,425
3853,731,411,105.8829931972789,107.04399092970522,16,24,324,1,320
3854,731,476,105.8829931972789,107.92634920634922,16,19,270,2,255
3855,731,783,105.8829931972789,108.181768707483,16,16,112,2,52
3856,731,887,105.8829931972789,106.90467120181407,16,15,162,1,156
3857,731,860,105.8829931972789,108.15854875283446,16,13,162,2,129
3858,742,476,106.62603174603174,107.92634920634922,15,19,272,1,266
3859,742,456,106.62603174603174,108.92480725623582,15,18,303,2,286
3860,742,783,106.62603174603174,108.181768707483,15,16,79,2,41
3861,742,652,106.62603174603174,108.92480725623582,15,16,134,2,90
3862,742,860,106.62603174603174,108.15854875283446,15,13,135,2,118
3863,742,887,106.62603174603174,108.94802721088436,15,15,176,2,145
3864,783,549,108.181768707483,110.15546485260771,16,22,249,2,234
3865,783,414,108.181768707483,110.96816326530613,16,18,388,3,369
3866,783,649,108.181768707483,110.2251247165533,16,22,160,2,134
3867,783,632,108.181768707483,110.29478458049887,16,17,176,2,151
3868,783,867,108.181768707483,110.2251247165533,16,20,122,2,84
3869,783,935,108.181768707483,110.45732426303856,16,14,181,2,152
3870,652,218,108.92480725623582,109.94648526077098,16,30,436,1,434
3871,652,219,108.92480725623582,111.27002267573697,16,30,445,2,433
3872,652,219,108.92480725623582,111.5718820861678,16,39,448,3,433
3873,652,549,108.92480725623582,110.15546485260771,16,22,116,1,103
3874,652,414,108.92480725623582,110.96816326530613,16,18,254,2,238
3875,652,436,108.92480725623582,111.82730158730159,16,22,250,3,216
3876,652,649,108.92480725623582,110.2251247165533,16,22,56,1,3
3877,652,632,108.92480725623582,110.29478458049887,16,17,62,1,20
3878,652,867,108.92480725623582,110.2251247165533,16,20,222,1,215
3879,652,935,108.92480725623582,110.45732426303856,16,14,291,2,283
3880,649,219,110.2251247165533,111.27002267573697,22,30,432,1,430
3881,649,219,110.2251247165533,111.5718820861678,22,39,434,1,430
3882,649,227,110.2251247165533,112.75609977324264,22,32,436,3,422
3883,649,436,110.2251247165533,111.82730158730159,22,22,224,2,213
3884,649,425,110.2251247165533,112.98829931972789,22,19,254,3,224
3885,649,818,110.2251247165533,111.92018140589569,22,19,184,2,169
3886,649,682,110.2251247165533,112.66321995464853,22,21,110,2,33
3887,649,866,110.2251247165533,111.96662131519274,22,22,230,2,217
3888,649,821,110.2251247165533,112.64,22,17,201,2,172
3889,632,219,110.29478458049887,111.5718820861678,17,39,417,1,413
3890,632,227,110.29478458049887,112.75609977324264,17,32,419,2,405
3891,632,436,110.29478458049887,111.82730158730159,17,22,207,2,196
3892,632,425,110.29478458049887,112.98829931972789,17,19,237,3,207
3893,632,818,110.29478458049887,111.92018140589569,17,19,199,2,186
3894,632,682,110.29478458049887,112.66321995464853,17,21,114,2,50
3895,632,866,110.29478458049887,111.96662131519274,17,22,245,2,234
3896,632,821,110.29478458049887,112.64,17,17,214,2,189
3897,818,425,111.92018140589569,112.98829931972789,19,19,396,1,393
3898,818,496,111.92018140589569,113.7081179138322,19,21,331,2,322
3899,818,501,111.92018140589569,114.52081632653062,19,17,336,3,317
3900,818,646,111.92018140589569,113.49913832199547,19,14,185,2,172
3901,682,218,112.66321995464853,114.19573696145125,21,28,469,2,464
3902,682,221,112.66321995464853,114.42793650793651,21,32,467,2,461
3903,682,216,112.66321995464853,115.4031746031746,21,35,481,3,466
3904,682,496,112.66321995464853,113.7081179138322,21,21,191,1,186
3905,682,501,112.66321995464853,114.52081632653062,21,17,198,2,181
3906,682,442,112.66321995464853,115.37995464852608,21,19,267,3,240
3907,682,686,112.66321995464853,115.0316553287982,21,14,102,2,4
3908,646,216,113.49913832199547,115.4031746031746,14,35,438,2,430
3909,646,501,113.49913832199547,114.52081632653062,14,17,152,1,145
3910,646,442,113.49913832199547,115.37995464852608,14,19,219,2,204
3911,646,686,113.49913832199547,115.0316553287982,14,14,77,2,40
3912,646,683,113.49913832199547,116.05333333333334,14,14,116,3,37
3913,686,214,115.0316553287982,116.74993197278911,14,32,478,2,472
3914,686,216,115.0316553287982,117.95736961451247,14,29,487,3,470
3915,686,493,115.0316553287982,117.0053514739229,14,19,211,2,193
3916,686,441,115.0316553287982,117.77160997732426,14,18,272,3,245
3917,686,683,115.0316553287982,116.05333333333334,14,14,44,1,3
3918,686,684,115.0316553287982,117.07501133786849,14,15,88,2,2
3919,686,887,115.0316553287982,117.07501133786849,14,13,219,2,201
3920,683,216,116.05333333333334,117.95736961451247,14,29,474,2,467
3921,683,300,116.05333333333334,119.02548752834467,14,30,404,3,383
3922,683,441,116.05333333333334,117.77160997732426,14,18,253,2,242
3923,683,684,116.05333333333334,117.07501133786849,14,15,44,1,1
3924,683,887,116.05333333333334,117.07501133786849,14,13,209,1,204
3925,684,300,117.07501133786849,119.02548752834467,15,30,393,2,384
3926,684,217,117.07501133786849,119.53632653061224,15,30,479,2,467
3927,684,423,117.07501133786849,119.16480725623583,15,21,276,2,261
3928,684,410,117.07501133786849,119.4898866213152,15,21,293,2,274
3929,684,651,117.07501133786849,119.09514739229026,15,17,93,2,33
3930,684,618,117.07501133786849,119.86140589569162,15,16,137,3,66
3931,651,209,119.09514739229026,120.55800453514739,17,36,446,1,442
3932,651,269,119.09514739229026,122.02086167800454,17,32,402,3,382
3933,651,413,119.09514739229026,120.6508843537415,17,22,247,2,238
3934,651,470,119.09514739229026,121.95120181405896,17,23,219,3,181
3935,651,788,119.09514739229026,120.95274376417234,17,19,159,2,137
3936,651,713,119.09514739229026,121.95120181405896,17,18,138,3,62
3937,651,853,119.09514739229026,120.79020408163265,17,19,215,2,202
3938,651,869,119.09514739229026,121.95120181405896,17,14,250,3,218
3939,618,269,119.86140589569162,122.02086167800454,16,32,361,2,349
3940,618,221,119.86140589569162,122.57814058956916,16,32,414,3,397
3941,618,470,119.86140589569162,121.95120181405896,16,23,173,2,148
3942,618,788,119.86140589569162,120.95274376417234,16,19,176,1,170
3943,618,713,119.86140589569162,121.95120181405896,16,18,131,2,95
3944,618,869,119.86140589569162,121.95120181405896,16,14,267,2,251
3945,788,470,120.95274376417234,122.90321995464853,19,23,329,2,318
3946,788,505,120.95274376417234,123.87845804988662,19,22,310,3,283
3947,788,744,120.95274376417234,122.94965986394558,19,19,97,2,44
3948,788,808,120.95274376417234,123.8552380952381,19,17,127,3,20
3949,788,841,120.95274376417234,122.90321995464853,19,20,99,2,53
3950,788,824,120.95274376417234,123.83201814058957,19,14,129,3,36
3951,713,218,121.95120181405896,124.203537414966,18,25,504,2,495
3952,713,505,121.95120181405896,123.87845804988662,18,22,224,2,208
3953,713,808,121.95120181405896,123.8552380952381,18,17,125,2,95
3954,713,634,121.95120181405896,124.59827664399093,18,22,139,3,79
3955,713,824,121.95120181405896,123.83201814058957,18,14,137,2,111
3956,744,470,122.94965986394558,124.99301587301588,19,24,288,2,274
3957,744,634,122.94965986394558,124.59827664399093,19,22,131,2,110
3958,744,876,122.94965986394558,124.99301587301588,19,18,159,2,132
3959,808,470,123.8552380952381,124.99301587301588,17,24,342,1,338
3960,808,462,123.8552380952381,126.22367346938776,17,21,361,2,346
3961,808,411,123.8552380952381,126.38621315192744,17,24,412,3,397
3962,808,627,123.8552380952381,126.24689342403629,17,17,208,2,181
3963,808,633,123.8552380952381,126.50231292517007,17,21,209,3,175
3964,808,876,123.8552380952381,124.99301587301588,17,18,84,1,68
3965,808,833,123.8552380952381,126.22367346938776,17,14,105,2,25
3966,808,958,123.8552380952381,126.50231292517007,17,18,188,3,150
3967,634,220,124.59827664399093,126.22367346938776,22,26,420,2,414
3968,634,220,124.59827664399093,127.24535147392291,22,26,429,3,414
3969,634,462,124.59827664399093,126.22367346938776,22,21,186,2,172
3970,634,411,124.59827664399093,126.38621315192744,22,24,236,2,223
3971,634,627,124.59827664399093,126.24689342403629,22,17,71,2,7
3972,634,633,124.59827664399093,126.50231292517007,22,21,82,2,1
3973,634,833,124.59827664399093,126.22367346938776,22,14,211,2,199
3974,634,958,124.59827664399093,126.50231292517007,22,18,334,2,324
3975,627,329,126.24689342403629,128.01160997732427,17,24,308,2,298
3976,627,374,126.24689342403629,129.1958276643991,17,27,283,3,253
3977,627,516,126.24689342403629,128.05804988662132,17,22,136,2,111
3978,627,492,126.24689342403629,129.03328798185942,17,23,181,3,135
3979,627,629,126.24689342403629,127.98839002267574,17,17,75,2,2
3980,627,628,126.24689342403629,128.661768707483,17,24,104,2,1
3981,627,837,126.24689342403629,128.26702947845806,17,14,227,2,210
3982,627,825,126.24689342403629,129.102947845805,17,17,233,3,198
3983,633,329,126.50231292517007,128.01160997732427,21,24,311,2,304
3984,633,374,126.50231292517007,129.1958276643991,21,27,284,3,259
3985,633,516,126.50231292517007,128.05804988662132,21,22,135,2,117
3986,633,492,126.50231292517007,129.03328798185942,21,23,178,3,141
3987,633,629,126.50231292517007,127.98839002267574,21,17,64,1,4
3988,633,628,126.50231292517007,128.661768707483,21,24,93,2,5
3989,633,837,126.50231292517007,128.26702947845806,21,14,218,2,204
3990,633,825,126.50231292517007,129.102947845805,21,17,222,3,192
3991,629,374,127.98839002267574,129.1958276643991,17,27,260,1,255
3992,629,218,127.98839002267574,129.84598639455783,17,28,419,2,411
3993,629,492,127.98839002267574,129.03328798185942,17,23,144,1,137
3994,629,450,127.98839002267574,129.89242630385488,17,22,197,2,179
3995,629,477,127.98839002267574,130.4497052154195,17,22,185,2,152
3996,629,659,127.98839002267574,129.93886621315193,17,21,89,2,30
3997,629,825,127.98839002267574,129.102947845805,17,17,202,1,196
3998,629,859,127.98839002267574,130.03174603174602,17,14,246,2,230
3999,629,957,127.98839002267574,130.56580498866214,17,20,346,3,328
4000,628,218,128.661768707483,129.84598639455783,24,28,413,1,410
4001,628,311,128.661768707483,131.21596371882086,24,28,336,3,317
4002,628,450,128.661768707483,129.89242630385488,24,22,186,1,178
4003,628,477,128.661768707483,130.4497052154195,24,22,169,2,151
4004,628,659,128.661768707483,129.93886621315193,24,21,63,1,31
4005,628,785,128.661768707483,131.12308390022676,24,19,189,2,157
4006,628,859,128.661768707483,130.03174603174602,24,14,238,1,231
4007,628,957,128.661768707483,130.56580498866214,24,20,339,2,329
4008,659,311,129.93886621315193,131.21596371882086,21,28,352,1,348
4009,659,218,129.93886621315193,132.3305215419501,21,28,453,2,441
4010,659,499,129.93886621315193,132.3305215419501,21,18,190,2,160
4011,659,785,129.93886621315193,131.12308390022676,21,19,136,1,126
4012,659,755,129.93886621315193,131.98222222222222,21,18,130,2,96
4013,659,628,129.93886621315193,132.60916099773243,21,25,119,3,31
4014,659,833,129.93886621315193,132.3305215419501,21,15,202,2,174
4015,659,867,129.93886621315193,132.60916099773243,21,19,238,3,208
4016,785,499,131.12308390022676,132.3305215419501,19,18,291,1,286
4017,785,469,131.12308390022676,133.12,19,27,327,2,316
4018,785,524,131.12308390022676,134.0255782312925,19,22,289,3,261
4019,785,628,131.12308390022676,132.60916099773243,19,25,170,1,157
4020,785,623,131.12308390022676,134.04879818594105,19,17,205,3,162
4021,785,833,131.12308390022676,132.3305215419501,19,15,71,1,48
4022,785,867,131.12308390022676,132.60916099773243,19,19,104,1,82
4023,785,820,131.12308390022676,133.3754195011338,19,15,103,2,35
4024,755,469,131.98222222222222,133.12,18,27,290,1,286
4025,755,524,131.98222222222222,134.0255782312925,18,22,247,2,231
4026,755,428,131.98222222222222,134.83827664399092,18,26,349,3,327
4027,755,623,131.98222222222222,134.04879818594105,18,17,159,2,132
4028,755,820,131.98222222222222,133.3754195011338,18,15,88,1,65
4029,628,238,132.60916099773243,134.3506575963719,25,24,397,2,390
4030,628,217,132.60916099773243,135.1633560090703,25,26,425,3,411
4031,628,218,132.60916099773243,135.37233560090704,25,25,427,3,410
4032,628,524,132.60916099773243,134.0255782312925,25,22,121,1,104
4033,628,428,132.60916099773243,134.83827664399092,25,26,222,2,200
4034,628,421,132.60916099773243,135.37233560090704,25,22,239,3,207
4035,628,623,132.60916099773243,134.04879818594105,25,17,62,1,5
4036,628,721,132.60916099773243,135.1633560090703,25,18,144,3,93
4037,628,838,132.60916099773243,135.18657596371884,25,20,238,3,210
4038,623,217,134.04879818594105,135.1633560090703,17,26,409,1,406
4039,623,218,134.04879818594105,135.37233560090704,17,25,409,1,405
4040,623,313,134.04879818594105,136.71909297052156,17,25,331,3,310
4041,623,421,134.04879818594105,135.37233560090704,17,22,210,1,202
4042,623,551,134.04879818594105,136.78875283446712,17,20,138,3,72
4043,623,721,134.04879818594105,135.1633560090703,17,18,109,1,98
4044,623,616,134.04879818594105,136.02249433106576,17,17,85,2,7
4045,623,639,134.04879818594105,136.67265306122448,17,21,114,3,16
4046,623,838,134.04879818594105,135.18657596371884,17,20,221,1,215
4047,623,888,134.04879818594105,135.8831746031746,17,15,277,2,265
4048,623,872,134.04879818594105,136.78875283446712,17,18,276,3,249
4049,721,313,135.1633560090703,136.71909297052156,18,25,413,2,408
4050,721,244,135.1633560090703,137.3924716553288,18,24,487,2,477
4051,721,551,135.1633560090703,136.78875283446712,18,20,184,2,170
4052,721,639,135.1633560090703,136.67265306122448,18,21,105,2,82
4053,721,872,135.1633560090703,136.78875283446712,18,18,166,2,151
4054,616,244,136.02249433106576,137.3924716553288,17,24,377,1,372
4055,616,420,136.02249433106576,138.2051700680272,17,20,217,2,196
4056,616,423,136.02249433106576,138.41414965986394,17,19,219,2,193
4057,616,809,136.02249433106576,138.1819501133787,17,16,214,2,193
4058,616,649,136.02249433106576,138.43736961451248,17,17,109,2,33
4059,616,861,136.02249433106576,138.2051700680272,17,16,262,2,245
4060,616,833,136.02249433106576,138.43736961451248,17,15,241,2,217
4061,639,216,136.67265306122448,139.27328798185943,21,26,438,3,423
4062,639,420,136.67265306122448,138.2051700680272,21,20,229,2,219
4063,639,423,136.67265306122448,138.41414965986394,21,19,229,2,216
4064,639,809,136.67265306122448,138.1819501133787,21,16,182,2,170
4065,639,649,136.67265306122448,138.43736961451248,21,17,77,2,10
4066,639,625,136.67265306122448,139.45904761904762,21,13,121,3,14
4067,639,861,136.67265306122448,138.2051700680272,21,16,232,2,222
4068,639,833,136.67265306122448,138.43736961451248,21,15,208,2,194
4069,809,413,138.1819501133787,139.8770068027211,16,17,403,2,396
4070,809,625,138.1819501133787,139.45904761904762,16,13,192,1,184
4071,809,776,138.1819501133787,140.75936507936507,16,15,116,3,33
4072,649,247,138.43736961451248,139.9002267573696,17,26,407,1,402
4073,649,212,138.43736961451248,141.33986394557823,17,22,455,3,437
4074,649,413,138.43736961451248,139.8770068027211,17,17,244,1,236
4075,649,424,138.43736961451248,141.33986394557823,17,15,257,3,225
4076,649,410,138.43736961451248,141.38630385487528,17,15,271,3,239
4077,649,625,138.43736961451248,139.45904761904762,17,13,50,1,24
4078,649,776,138.43736961451248,140.75936507936507,17,15,162,2,127
4079,625,212,139.45904761904762,141.33986394557823,13,22,421,2,413
4080,625,291,139.45904761904762,142.0132426303855,13,23,352,3,334
4081,625,424,139.45904761904762,141.33986394557823,13,15,217,2,201
4082,625,410,139.45904761904762,141.38630385487528,13,15,230,2,215
4083,625,776,139.45904761904762,140.75936507936507,13,15,161,1,151
4084,625,762,139.45904761904762,141.89714285714285,13,15,173,2,137
4085,776,291,140.75936507936507,142.0132426303855,15,23,488,1,485
4086,776,531,140.75936507936507,142.68662131519275,15,20,259,2,245
4087,776,762,140.75936507936507,141.89714285714285,15,15,51,1,14
4088,776,731,140.75936507936507,142.68662131519275,15,14,94,2,45
4089,762,480,141.89714285714285,143.75473922902495,15,15,293,2,282
4090,762,410,141.89714285714285,144.5906575963719,15,27,371,3,352
4091,731,381,142.68662131519275,145.14793650793652,14,30,366,2,350
4092,731,390,142.68662131519275,145.63555555555556,14,30,364,3,341
4093,731,480,142.68662131519275,143.75473922902495,14,15,255,1,251
4094,731,410,142.68662131519275,144.5906575963719,14,27,331,2,321
4095,730,366,145.72843537414965,148.23619047619047,15,31,380,3,364
4096,730,418,145.72843537414965,148.07365079365078,15,24,328,2,312
4097,730,654,145.72843537414965,147.58603174603175,15,16,110,2,76
4098,730,762,145.72843537414965,148.46839002267575,15,26,122,3,32
4099,730,865,145.72843537414965,147.6092517006803,15,16,157,2,135
4100,730,820,145.72843537414965,148.5380498866213,15,23,151,3,90
4101,654,307,147.58603174603175,148.95600907029478,16,31,352,1,347
4102,654,205,147.58603174603175,149.44362811791385,16,27,456,2,449
4103,654,218,147.58603174603175,150.465306122449,16,30,453,3,436
4104,654,424,147.58603174603175,149.09532879818593,16,22,239,2,230
4105,654,428,147.58603174603175,150.11700680272108,16,23,251,3,226
4106,654,800,147.58603174603175,150.25632653061226,16,16,186,3,146
4107,654,932,147.58603174603175,149.62938775510204,16,13,292,2,278
4108,762,428,148.46839002267575,150.11700680272108,26,23,341,2,334
4109,762,427,148.46839002267575,151.11546485260772,26,19,354,3,335
4110,762,800,148.46839002267575,150.25632653061226,26,16,86,2,38
4111,762,800,148.46839002267575,150.99936507936508,26,18,115,3,38
4112,762,932,148.46839002267575,149.62938775510204,26,13,177,1,170
4113,762,838,148.46839002267575,151.13868480725623,26,15,138,3,76
4114,800,410,150.25632653061226,152.3693424036281,16,25,400,2,390
4115,800,428,150.25632653061226,153.158820861678,16,21,392,3,372
4116,800,791,150.25632653061226,152.16036281179137,16,18,82,2,9
4117,800,766,150.25632653061226,152.85696145124717,16,23,117,3,34
4118,800,932,150.25632653061226,151.67274376417234,16,15,145,1,132
4119,800,873,150.25632653061226,152.83374149659863,16,20,133,3,73
4120,800,410,150.99936507936508,152.3693424036281,18,25,394,1,390
4121,800,428,150.99936507936508,153.158820861678,18,21,383,2,372
4122,800,791,150.99936507936508,152.16036281179137,18,18,51,1,9
4123,800,766,150.99936507936508,152.85696145124717,18,23,87,2,34
4124,800,718,150.99936507936508,153.87863945578232,18,15,149,3,82
4125,800,873,150.99936507936508,152.83374149659863,18,20,108,2,73
4126,800,932,150.99936507936508,153.6928798185941,18,15,176,3,132
4127,791,419,152.16036281179137,154.15727891156462,18,21,382,2,372
4128,791,718,152.16036281179137,153.87863945578232,18,15,104,2,73
4129,791,644,152.16036281179137,155.0164172335601,18,21,192,3,147
4130,791,932,152.16036281179137,153.6928798185941,18,15,156,2,141
4131,791,950,152.16036281179137,154.96997732426306,18,18,200,3,159
4132,766,419,152.85696145124717,154.15727891156462,23,21,351,1,347
4133,766,429,152.85696145124717,155.17895691609976,23,22,352,2,337
4134,766,718,152.85696145124717,153.87863945578232,23,15,65,1,48
4135,766,644,152.85696145124717,155.0164172335601,23,21,153,2,122
4136,766,656,152.85696145124717,155.4575963718821,23,19,157,3,110
4137,766,950,152.85696145124717,154.96997732426306,23,18,205,2,184
4138,718,370,153.87863945578232,156.0148752834467,15,30,360,2,348
4139,718,429,153.87863945578232,155.17895691609976,15,22,294,1,289
4140,718,429,153.87863945578232,156.2006349206349,15,22,306,2,289
4141,718,644,153.87863945578232,155.0164172335601,15,21,89,1,74
4142,718,656,153.87863945578232,155.4575963718821,15,19,92,2,62
4143,718,654,153.87863945578232,156.73469387755102,15,19,139,3,64
4144,718,950,153.87863945578232,154.96997732426306,15,18,237,1,232
4145,718,861,153.87863945578232,156.2006349206349,15,21,174,2,143
4146,718,932,153.87863945578232,156.73469387755102,15,16,247,3,214
4147,644,335,155.0164172335601,157.1526530612245,21,32,322,2,309
4148,644,205,155.0164172335601,157.59383219954648,21,27,453,3,439
4149,644,429,155.0164172335601,156.2006349206349,21,22,221,1,215
4150,644,429,155.0164172335601,157.22231292517006,21,23,235,2,215
4151,644,654,155.0164172335601,156.73469387755102,21,19,75,2,10
4152,644,817,155.0164172335601,157.75637188208617,21,15,209,3,173
4153,644,861,155.0164172335601,156.2006349206349,21,21,223,1,217
4154,644,932,155.0164172335601,156.73469387755102,21,16,297,2,288
4155,644,891,155.0164172335601,157.75637188208617,21,14,274,3,247
4156,656,335,155.4575963718821,157.1526530612245,19,32,329,2,321
4157,656,205,155.4575963718821,157.59383219954648,19,27,460,2,451
4158,656,429,155.4575963718821,157.22231292517006,19,23,239,2,227
4159,656,429,155.4575963718821,158.2439909297052,19,22,257,3,227
4160,656,654,155.4575963718821,156.73469387755102,19,19,55,1,2
4161,656,817,155.4575963718821,157.75637188208617,19,15,189,2,161
4162,656,932,155.4575963718821,156.73469387755102,19,16,281,1,276
4163,656,891,155.4575963718821,157.75637188208617,19,14,255,2,235
4164,654,218,156.73469387755102,158.59229024943312,19,30,443,2,436
4165,654,218,156.73469387755102,159.59074829931973,19,38,453,3,436
4166,654,429,156.73469387755102,158.2439909297052,19,22,234,2,225
4167,654,447,156.73469387755102,158.75482993197278,19,21,225,2,207
4168,654,817,156.73469387755102,157.75637188208617,19,15,169,1,163
4169,654,660,156.73469387755102,158.75482993197278,19,18,87,2,6
4170,654,663,156.73469387755102,159.4746485260771,19,23,118,3,9
4171,654,891,156.73469387755102,157.75637188208617,19,14,241,1,237
4172,654,854,156.73469387755102,159.42820861678004,19,20,231,3,200
4173,654,838,156.73469387755102,159.49786848072563,19,21,219,3,184
4174,817,425,157.75637188208617,160.264126984127,15,24,407,3,392
4175,817,663,157.75637188208617,159.4746485260771,15,23,171,2,154
4176,817,854,157.75637188208617,159.42820861678004,15,20,81,2,37
4177,817,838,157.75637188208617,159.49786848072563,15,21,78,2,21
4178,660,218,158.75482993197278,161.19292517006804,18,35,454,2,442
4179,660,219,158.75482993197278,161.7037641723356,18,32,459,3,441
4180,660,425,158.75482993197278,160.264126984127,18,24,244,2,235
4181,660,594,158.75482993197278,161.0536054421769,18,24,119,2,66
4182,660,628,158.75482993197278,161.0768253968254,18,21,105,2,32
4183,660,840,158.75482993197278,161.0768253968254,18,20,206,2,180
4184,663,218,159.4746485260771,161.19292517006804,23,35,451,2,445
4185,663,219,159.4746485260771,161.7037641723356,23,32,454,2,444
4186,663,594,159.4746485260771,161.0536054421769,23,24,97,2,69
4187,663,547,159.4746485260771,161.81986394557825,23,19,154,2,116
4188,663,628,159.4746485260771,161.0768253968254,23,21,77,2,35
4189,663,783,159.4746485260771,161.81986394557825,23,15,157,2,120
4190,663,840,159.4746485260771,161.0768253968254,23,20,190,2,177
4191,663,869,159.4746485260771,162.33070294784582,23,15,240,3,206
4192,628,223,161.0768253968254,163.2130612244898,21,27,415,2,405
4193,628,422,161.0768253968254,162.70222222222222,21,21,218,2,206
4194,628,768,161.0768253968254,162.74866213151927,21,21,157,2,140
4195,628,869,161.0768253968254,162.33070294784582,21,15,247,1,241
4196,628,838,161.0768253968254,163.35238095238097,21,16,232,2,210
4197,628,932,161.0768253968254,163.86321995464854,21,16,327,3,304
4198,783,425,161.81986394557825,164.35083900226758,15,24,374,3,358
4199,783,654,161.81986394557825,164.35083900226758,15,18,169,3,129
4200,783,750,161.81986394557825,164.76879818594105,15,26,131,3,33
4201,783,838,161.81986394557825,163.35238095238097,15,16,86,2,55
4202,783,932,161.81986394557825,163.86321995464854,15,16,173,2,149
4203,783,832,161.81986394557825,164.79201814058956,15,22,137,3,49
4204,768,425,162.74866213151927,164.35083900226758,21,24,350,2,343
4205,768,450,162.74866213151927,164.86167800453515,21,21,331,2,318
4206,768,417,162.74866213151927,165.58149659863946,21,27,372,3,351
4207,768,654,162.74866213151927,164.35083900226758,21,18,133,2,114
4208,768,750,162.74866213151927,164.76879818594105,21,26,89,2,18
4209,768,813,162.74866213151927,165.5350566893424,21,22,128,3,45
4210,768,932,162.74866213151927,163.86321995464854,21,16,171,1,164
4211,768,832,162.74866213151927,164.79201814058956,21,22,109,2,64
4212,768,838,162.74866213151927,165.48861678004536,21,20,137,3,70
4213,654,214,164.35083900226758,165.6975963718821,18,39,444,1,440
4214,654,220,164.35083900226758,167.0443537414966,18,38,449,3,434
4215,654,417,164.35083900226758,165.58149659863946,18,27,243,1,237
4216,654,496,164.35083900226758,166.62639455782312,18,24,186,2,158
4217,654,813,164.35083900226758,165.5350566893424,18,22,167,1,159
4218,654,661,164.35083900226758,166.90503401360544,18,16,110,3,7
4219,654,838,164.35083900226758,165.48861678004536,18,20,190,1,184
4220,654,932,164.35083900226758,166.90503401360544,18,16,299,3,278
4221,750,496,164.76879818594105,166.62639455782312,26,24,266,2,254
4222,750,661,164.76879818594105,166.90503401360544,26,16,128,2,89
4223,750,932,164.76879818594105,166.90503401360544,26,16,204,2,182
4224,813,496,165.5350566893424,166.62639455782312,22,24,320,1,317
4225,813,428,165.5350566893424,168.41433106575965,22,24,404,3,385
4226,813,661,165.5350566893424,166.90503401360544,22,16,163,1,152
4227,813,816,165.5350566893424,168.29823129251702,22,17,119,3,3
4228,813,932,165.5350566893424,166.90503401360544,22,16,133,1,119
4229,813,860,165.5350566893424,168.18213151927438,22,17,123,3,47
4230,661,246,166.90503401360544,168.20535147392292,16,34,419,1,415
4231,661,329,166.90503401360544,169.13414965986394,16,30,346,2,332
4232,661,211,166.90503401360544,169.7843083900227,16,38,467,3,450
4233,661,428,166.90503401360544,168.41433106575965,16,24,242,2,233
4234,661,428,166.90503401360544,169.4360090702948,16,21,257,3,233
4235,661,816,166.90503401360544,168.29823129251702,16,17,166,1,155
4236,661,800,166.90503401360544,169.31990929705216,16,16,174,2,139
4237,661,860,166.90503401360544,168.18213151927438,16,17,206,1,199
4238,661,949,166.90503401360544,169.4360090702948,16,13,308,3,288
4239,816,428,168.29823129251702,169.4360090702948,17,21,391,1,388
4240,816,490,168.29823129251702,169.94684807256237,17,21,334,2,326
4241,816,493,168.29823129251702,171.17750566893423,17,20,346,3,323
4242,816,800,168.29823129251702,169.31990929705216,17,16,47,1,16
4243,816,666,168.29823129251702,169.94684807256237,17,15,166,2,150
4244,816,949,168.29823129251702,169.4360090702948,17,13,142,1,133
4245,816,917,168.29823129251702,170.4344671201814,17,13,137,2,101
4246,816,835,168.29823129251702,171.2239455782313,17,15,127,3,19
4247,800,493,169.31990929705216,171.17750566893423,16,20,317,2,307
4248,800,427,169.31990929705216,172.08308390022677,16,25,392,3,373
4249,800,801,169.31990929705216,171.36326530612246,16,17,88,2,1
4250,800,654,169.31990929705216,171.99020408163267,16,14,186,3,146
4251,800,917,169.31990929705216,170.4344671201814,16,13,126,1,117
4252,800,835,169.31990929705216,171.2239455782313,16,15,89,2,35
4253,800,834,169.31990929705216,171.4793650793651,16,16,99,2,34
4254,666,274,169.94684807256237,172.08308390022677,15,36,403,2,392
4255,666,493,169.94684807256237,171.17750566893423,15,20,181,1,173
4256,666,427,169.94684807256237,172.08308390022677,15,25,256,2,239
4257,666,801,169.94684807256237,171.36326530612246,15,17,148,1,135
4258,666,654,169.94684807256237,171.99020408163267,15,14,89,2,12
4259,666,835,169.94684807256237,171.2239455782313,15,15,178,1,169
4260,666,834,169.94684807256237,171.4793650793651,15,16,180,2,168
4261,801,411,171.36326530612246,173.17442176870748,17,29,398,2,390
4262,801,428,171.36326530612246,173.49950113378685,17,20,384,2,373
4263,801,654,171.36326530612246,174.01034013605442,17,15,186,3,147
4264,801,830,171.36326530612246,173.2673015873016,17,15,87,2,29
4265,801,838,171.36326530612246,173.5227210884354,17,16,100,2,37
4266,654,206,171.99020408163267,173.42984126984126,14,35,452,1,448
4267,654,224,171.99020408163267,173.87102040816328,14,33,438,2,430
4268,654,209,171.99020408163267,174.91591836734693,14,36,462,3,445
4269,654,411,171.99020408163267,173.17442176870748,14,29,248,1,243
4270,654,428,171.99020408163267,173.49950113378685,14,20,235,2,226
4271,654,430,171.99020408163267,174.4979591836735,14,20,249,3,224
4272,654,801,171.99020408163267,173.3834013605442,14,17,159,1,147
4273,654,830,171.99020408163267,173.2673015873016,14,15,184,1,176
4274,654,838,171.99020408163267,173.5227210884354,14,16,195,2,184
4275,654,834,171.99020408163267,174.521179138322,14,15,210,3,180
4276,801,430,173.3834013605442,174.4979591836735,17,20,374,1,371
4277,801,425,173.3834013605442,176.10013605442177,17,26,394,3,376
4278,801,784,173.3834013605442,176.05369614512472,17,16,116,3,17
4279,801,834,173.3834013605442,174.521179138322,17,15,59,1,33
4280,801,839,173.3834013605442,175.54285714285714,17,14,100,2,38
4281,654,273,174.01034013605442,176.14657596371882,15,37,392,2,381
4282,654,425,174.01034013605442,176.10013605442177,15,26,246,2,229
4283,654,801,174.01034013605442,175.4267573696145,15,18,159,1,147
4284,654,784,174.01034013605442,176.05369614512472,15,16,157,2,130
4285,654,839,174.01034013605442,175.54285714285714,15,14,196,2,185
4286,801,411,175.4267573696145,177.00571428571428,18,26,396,2,390
4287,801,417,175.4267573696145,177.74875283446713,18,19,397,2,384
4288,801,794,175.4267573696145,177.07537414965986,18,16,71,2,7
4289,801,871,175.4267573696145,177.3772335600907,18,18,109,2,70
4290,801,863,175.4267573696145,177.74875283446713,18,14,118,2,62
4291,784,297,176.05369614512472,177.42367346938775,16,29,491,1,487
4292,784,296,176.05369614512472,177.67909297052154,16,34,493,2,488
4293,784,417,176.05369614512472,177.74875283446713,16,19,374,2,367
4294,784,794,176.05369614512472,177.07537414965986,16,16,45,1,10
4295,784,871,176.05369614512472,177.3772335600907,16,18,104,1,87
4296,784,863,176.05369614512472,177.74875283446713,16,14,108,2,79
4297,784,873,176.05369614512472,178.86331065759637,16,16,150,3,89
4298,794,426,177.07537414965986,179.04907029478457,16,25,378,2,368
4299,794,445,177.07537414965986,179.861768707483,16,23,369,3,349
4300,794,645,177.07537414965986,179.09551020408165,16,21,173,2,149
4301,794,621,177.07537414965986,179.55990929705214,16,17,203,2,173
4302,794,873,177.07537414965986,178.86331065759637,16,16,110,2,79
4303,794,872,177.07537414965986,179.88498866213152,16,18,144,3,78
4304,645,205,179.09551020408165,181.06920634920635,21,30,448,2,440
4305,645,537,179.09551020408165,181.41750566893424,21,19,147,2,108
4306,645,452,179.09551020408165,182.04444444444445,21,24,231,3,193
4307,645,629,179.09551020408165,181.44072562358278,21,17,102,2,16
4308,645,659,179.09551020408165,181.9283446712018,21,19,123,3,14
4309,645,869,179.09551020408165,181.41750566893424,21,17,245,2,224
4310,645,836,179.09551020408165,181.51038548752834,21,16,217,2,191
4311,621,205,179.55990929705214,181.06920634920635,17,30,421,2,416
4312,621,205,179.55990929705214,182.41596371882088,17,30,434,3,416
4313,621,537,179.55990929705214,181.41750566893424,17,19,116,2,84
4314,621,452,179.55990929705214,182.04444444444445,17,24,200,2,169
4315,621,629,179.55990929705214,181.44072562358278,17,17,81,2,8
4316,621,659,179.55990929705214,181.9283446712018,17,19,109,2,38
4317,621,869,179.55990929705214,181.41750566893424,17,17,261,2,248
4318,621,836,179.55990929705214,181.51038548752834,17,16,231,2,215
4319,629,214,181.44072562358278,183.1590022675737,17,29,422,2,415
4320,629,374,181.44072562358278,183.53052154195012,17,33,270,2,255
4321,629,412,181.44072562358278,183.39120181405897,17,21,233,2,217
4322,629,412,181.44072562358278,183.9717006802721,17,21,243,3,217
4323,629,798,181.44072562358278,183.32154195011339,17,17,187,2,169
4324,629,631,181.44072562358278,183.60018140589568,17,20,93,2,2
4325,629,855,181.44072562358278,183.43764172335602,17,15,242,2,226
4326,629,865,181.44072562358278,183.57696145124717,17,19,253,2,236
4327,659,214,181.9283446712018,183.1590022675737,19,29,448,1,445
4328,659,374,181.9283446712018,183.53052154195012,19,33,293,2,285
4329,659,218,181.9283446712018,184.78439909297052,19,25,458,3,441
4330,659,412,181.9283446712018,183.39120181405897,19,21,255,1,247
4331,659,412,181.9283446712018,183.9717006802721,19,21,262,2,247
4332,659,798,181.9283446712018,183.32154195011339,19,17,151,1,139
4333,659,631,181.9283446712018,183.60018140589568,19,20,77,2,28
4334,659,649,181.9283446712018,184.69151927437642,19,18,119,3,10
4335,659,855,181.9283446712018,183.43764172335602,19,15,206,2,196
4336,659,865,181.9283446712018,183.57696145124717,19,19,218,2,206
4337,798,508,183.32154195011339,184.97015873015874,17,19,299,2,290
4338,798,491,183.32154195011339,185.96861678004535,17,20,327,3,307
4339,798,649,183.32154195011339,184.69151927437642,17,18,160,1,149
4340,798,806,183.32154195011339,186.1079365079365,17,21,120,3,8
4341,798,831,183.32154195011339,184.9469387755102,17,14,77,2,33
4342,798,897,183.32154195011339,185.96861678004535,17,19,151,3,99
4343,631,218,183.60018140589568,184.78439909297052,20,25,416,1,413
4344,631,214,183.60018140589568,186.03827664399094,20,27,430,2,417
4345,631,508,183.60018140589568,184.97015873015874,20,19,136,1,123
4346,631,491,183.60018140589568,185.96861678004535,20,20,173,2,140
4347,631,649,183.60018140589568,184.69151927437642,20,18,50,1,18
4348,631,806,183.60018140589568,186.1079365079365,20,21,206,3,175
4349,631,831,183.60018140589568,184.9469387755102,20,14,208,1,200
4350,631,897,183.60018140589568,185.96861678004535,20,19,285,2,266
4351,649,214,184.69151927437642,186.03827664399094,18,27,439,1,435
4352,649,218,184.69151927437642,187.03673469387755,18,38,443,2,431
4353,649,221,184.69151927437642,187.66367346938776,18,31,447,3,428
4354,649,491,184.69151927437642,185.96861678004535,18,20,167,1,158
4355,649,450,184.69151927437642,186.85097505668935,18,20,220,2,199
4356,649,806,184.69151927437642,186.1079365079365,18,21,168,1,157
4357,649,756,184.69151927437642,187.1528344671202,18,18,151,2,107
4358,649,897,184.69151927437642,185.96861678004535,18,19,254,1,248
4359,649,917,184.69151927437642,186.7116553287982,18,19,282,2,268
4360,806,427,186.1079365079365,188.29061224489797,21,19,390,2,379
4361,806,756,186.1079365079365,187.1528344671202,21,18,67,1,50
4362,806,630,186.1079365079365,188.0584126984127,21,19,195,2,176
4363,806,937,186.1079365079365,187.98875283446714,21,16,154,2,131
4364,756,427,187.1528344671202,188.29061224489797,18,19,333,1,329
4365,756,589,187.1528344671202,189.10331065759638,18,20,187,2,167
4366,756,619,187.1528344671202,189.10331065759638,18,22,161,2,137
4367,756,730,187.1528344671202,190.03210884353743,18,22,127,3,26
4368,756,849,187.1528344671202,189.28907029478458,18,15,131,2,93
4369,756,887,187.1528344671202,189.7302494331066,18,20,172,3,131
4370,630,235,188.0584126984127,190.05532879818594,19,30,404,2,395
4371,630,589,188.0584126984127,189.10331065759638,19,20,61,1,41
4372,630,455,188.0584126984127,190.21786848072563,19,25,198,2,175
4373,630,619,188.0584126984127,189.10331065759638,19,22,46,1,11
4374,630,730,188.0584126984127,190.03210884353743,19,22,131,2,100
4375,630,849,188.0584126984127,189.28907029478458,19,15,225,1,219
4376,630,887,188.0584126984127,189.7302494331066,19,20,267,2,257
4377,630,897,188.0584126984127,190.9144671201814,19,15,294,3,267
4378,619,216,189.10331065759638,191.37886621315192,22,31,415,2,403
4379,619,455,189.10331065759638,190.21786848072563,22,25,171,1,164
4380,619,490,189.10331065759638,191.47174603174602,22,20,164,2,129
4381,619,803,189.10331065759638,191.49496598639456,22,18,211,2,184
4382,619,812,189.10331065759638,192.07546485260772,22,22,232,3,193
4383,619,897,189.10331065759638,190.9144671201814,22,15,289,2,278
4384,730,317,190.03210884353743,192.28444444444446,22,29,424,2,413
4385,730,490,190.03210884353743,191.47174603174602,22,20,248,1,240
4386,730,432,190.03210884353743,192.14512471655328,22,25,312,2,298
4387,730,429,190.03210884353743,192.81850340136054,22,20,324,3,301
4388,730,803,190.03210884353743,191.49496598639456,22,18,96,1,73
4389,730,812,190.03210884353743,192.07546485260772,22,22,120,2,82
4390,730,649,190.03210884353743,192.84172335600908,22,17,146,3,81
4391,730,828,190.03210884353743,192.12190476190477,22,22,133,2,98
4392,730,827,190.03210884353743,192.84172335600908,22,13,155,3,97
4393,803,333,191.49496598639456,193.8401814058957,18,25,481,2,470
4394,803,429,191.49496598639456,192.81850340136054,18,20,378,1,374
4395,803,560,191.49496598639456,193.79374149659864,18,22,262,2,243
4396,803,649,191.49496598639456,192.84172335600908,18,17,165,1,154
4397,803,679,191.49496598639456,193.81696145124718,18,18,159,2,124
4398,803,827,191.49496598639456,192.84172335600908,18,13,63,1,24
4399,803,832,191.49496598639456,193.60798185941044,18,17,96,2,29
4400,812,333,192.07546485260772,193.8401814058957,22,25,485,2,479
4401,812,560,192.07546485260772,193.79374149659864,22,22,263,2,252
4402,812,679,192.07546485260772,193.81696145124718,22,18,153,2,133
4403,812,631,192.07546485260772,194.88507936507938,22,15,218,3,181
4404,812,832,192.07546485260772,193.60798185941044,22,17,69,2,20
4405,812,846,192.07546485260772,194.86185941043084,22,16,125,3,34
4406,649,220,192.84172335600908,194.86185941043084,17,23,438,2,429
4407,649,368,192.84172335600908,195.76743764172335,17,27,308,3,281
4408,649,411,192.84172335600908,195.21015873015872,17,20,259,2,238
4409,649,413,192.84172335600908,195.76743764172335,17,25,268,3,236
4410,649,631,192.84172335600908,194.88507936507938,17,15,90,2,18
4411,649,648,192.84172335600908,195.81387755102043,17,24,128,3,1
4412,649,846,192.84172335600908,194.86185941043084,17,16,215,2,197
4413,649,934,192.84172335600908,195.81387755102043,17,25,312,3,285
4414,679,220,193.81696145124718,194.86185941043084,18,23,461,1,459
4415,679,368,193.81696145124718,195.76743764172335,18,27,322,2,311
4416,679,411,193.81696145124718,195.21015873015872,18,20,275,1,268
4417,679,413,193.81696145124718,195.76743764172335,18,25,279,2,266
4418,679,631,193.81696145124718,194.88507936507938,18,15,66,1,48
4419,679,648,193.81696145124718,195.81387755102043,18,24,91,2,31
4420,679,846,193.81696145124718,194.86185941043084,18,16,173,1,167
4421,679,934,193.81696145124718,195.81387755102043,18,25,269,2,255
4422,821,334,18.18122448979592,20.712199546485262,15,20,499,3,487
4423,821,514,18.18122448979592,20.503219954648525,15,18,323,2,307
4424,821,814,18.18122448979592,20.48,15,15,99,2,7
4425,821,832,18.18122448979592,20.48,15,14,100,2,11
4426,832,355,20.48,22.221496598639455,14,23,483,2,477
4427,832,421,20.48,22.267936507936508,14,18,418,2,411
4428,832,628,20.48,22.19827664399093,14,14,217,2,204
4429,853,499,33.668934240362816,34.71383219954649,13,22,357,1,354
4430,853,499,33.668934240362816,35.735510204081635,13,21,365,2,354
4431,853,687,33.668934240362816,35.71229024943311,13,15,188,2,166
4432,853,630,33.668934240362816,36.5946485260771,13,20,256,3,223
4433,853,868,33.668934240362816,36.64108843537415,13,14,129,3,15
4434,826,499,34.644172335600906,35.735510204081635,22,21,330,1,327
4435,826,538,34.644172335600906,36.664308390022676,22,23,301,2,288
4436,826,687,34.644172335600906,35.71229024943311,22,15,146,1,139
4437,826,630,34.644172335600906,36.5946485260771,22,20,213,2,196
4438,826,868,34.644172335600906,36.64108843537415,22,14,96,2,42
4439,868,438,36.64108843537415,37.755646258503404,14,18,433,1,430
4440,868,435,36.64108843537415,38.521904761904764,14,22,441,2,433
4441,868,687,36.64108843537415,37.755646258503404,14,18,187,1,181
4442,868,637,36.64108843537415,38.846984126984125,14,22,250,2,231
4443,868,865,36.64108843537415,38.800544217687076,14,19,93,2,3
4444,865,478,38.800544217687076,40.79746031746032,19,20,396,2,387
4445,865,545,38.800544217687076,41.56371882086168,19,25,341,3,320
4446,865,718,38.800544217687076,39.9847619047619,19,15,156,1,147
4447,865,753,38.800544217687076,40.84390022675737,19,13,142,2,112
4448,865,626,38.800544217687076,41.56371882086168,19,19,267,3,239
4449,865,844,38.800544217687076,41.56371882086168,19,16,121,3,21
4450,844,429,41.56371882086168,42.840816326530614,16,19,419,1,415
4451,844,512,41.56371882086168,43.769614512471655,16,23,345,2,332
4452,844,415,41.56371882086168,44.489433106575966,16,25,447,3,429
4453,844,661,41.56371882086168,43.86249433106576,16,14,208,2,183
4454,876,512,42.283537414965984,43.769614512471655,21,23,370,1,364
4455,876,415,42.283537414965984,44.489433106575966,21,25,471,2,461
4456,876,661,42.283537414965984,43.86249433106576,21,14,225,2,215
4457,876,750,42.283537414965984,44.76807256235828,21,18,165,2,126
4458,851,449,45.627210884353744,46.9275283446712,20,20,406,1,402
4459,851,438,45.627210884353744,47.925986394557825,20,23,425,2,413
4460,851,687,45.627210884353744,46.90430839002268,20,17,173,1,164
4461,851,624,45.627210884353744,47.18294784580499,20,23,237,2,227
4462,851,823,45.627210884353744,47.206167800453514,20,17,74,2,28
4463,823,423,47.206167800453514,48.92444444444445,17,19,407,2,400
4464,823,499,47.206167800453514,49.96934240362812,17,19,345,3,324
4465,823,621,47.206167800453514,48.92444444444445,17,16,215,2,202
4466,823,633,47.206167800453514,49.22630385487528,17,17,209,2,190
4467,823,927,47.206167800453514,49.20308390022676,17,17,135,2,104
4468,927,436,49.20308390022676,50.80526077097506,17,21,496,2,491
4469,927,437,49.20308390022676,51.98947845804989,17,20,504,3,490
4470,927,814,49.20308390022676,50.874920634920635,17,20,134,2,113
4471,927,682,49.20308390022676,51.66439909297052,17,21,267,2,245
4472,927,866,49.20308390022676,50.944580498866216,17,24,97,2,61
4473,927,821,49.20308390022676,51.61795918367347,17,16,148,2,106
4474,866,437,50.944580498866216,51.98947845804989,24,20,431,1,429
4475,866,440,50.944580498866216,52.98793650793651,24,20,435,2,426
4476,866,647,50.944580498866216,53.011156462585035,24,16,236,2,219
4477,821,440,51.61795918367347,52.98793650793651,16,20,386,1,381
4478,821,443,51.61795918367347,54.00961451247166,16,19,392,2,378
4479,821,647,51.61795918367347,53.011156462585035,16,16,184,1,174
4480,821,646,51.61795918367347,54.03283446712018,16,14,204,2,175
4481,880,456,61.90439909297052,64.1102947845805,16,20,435,2,424
4482,880,463,61.90439909297052,64.17995464852608,16,20,428,2,417
4483,880,651,61.90439909297052,63.947755102040816,16,17,245,2,229
4484,880,646,61.90439909297052,64.2031746031746,16,16,254,2,234
4485,867,438,65.50349206349206,67.24498866213152,20,21,436,2,429
4486,867,640,65.50349206349206,68.08090702947845,20,15,253,3,227
4487,830,367,69.5437641723356,71.0530612244898,13,29,468,2,463
4488,830,517,69.5437641723356,70.6118820861678,13,20,316,1,313
4489,830,415,69.5437641723356,71.28526077097506,13,14,422,2,415
4490,830,444,69.5437641723356,72.28371882086168,13,15,404,3,386
4491,830,655,69.5437641723356,71.02984126984127,13,17,186,1,175
4492,830,732,69.5437641723356,71.28526077097506,13,14,123,2,98
4493,836,523,83.70793650793651,85.8441723356009,15,20,326,2,313
4494,836,717,83.70793650793651,85.72807256235828,15,16,147,2,119
4495,870,415,95.20181405895691,97.22195011337868,14,22,463,2,455
4496,870,538,95.20181405895691,97.6863492063492,14,23,349,2,332
4497,870,619,95.20181405895691,96.73433106575963,14,15,260,2,251
4498,870,630,95.20181405895691,97.61668934240363,14,21,262,2,240
4499,870,869,95.20181405895691,97.22195011337868,14,13,87,2,1
4500,870,889,95.20181405895691,97.61668934240363,14,15,106,2,19
4501,820,415,95.66621315192744,97.22195011337868,21,22,411,2,405
4502,820,538,95.66621315192744,97.6863492063492,21,23,295,2,282
4503,820,619,95.66621315192744,96.73433106575963,21,15,206,1,201
4504,820,630,95.66621315192744,97.61668934240363,21,21,208,2,190
4505,820,869,95.66621315192744,97.22195011337868,21,13,83,2,49
4506,820,889,95.66621315192744,97.61668934240363,21,15,109,2,69
4507,869,523,97.22195011337868,98.80090702947847,13,19,353,2,346
4508,869,535,97.22195011337868,99.82258503401361,13,23,352,3,334
4509,869,684,97.22195011337868,98.7544671201814,13,16,196,2,185
4510,869,650,97.22195011337868,99.96190476190476,13,25,249,3,219
4511,869,820,97.22195011337868,99.1956462585034,13,15,98,2,49
4512,869,826,97.22195011337868,99.96190476190476,13,21,126,3,43
4513,889,523,97.61668934240363,98.80090702947847,15,19,370,1,366
4514,889,535,97.61668934240363,99.82258503401361,15,23,367,2,354
4515,889,684,97.61668934240363,98.7544671201814,15,16,211,1,205
4516,889,650,97.61668934240363,99.96190476190476,15,25,259,2,239
4517,889,820,97.61668934240363,99.1956462585034,15,15,97,2,69
4518,889,826,97.61668934240363,99.96190476190476,15,21,119,2,63
4519,820,523,99.1956462585034,100.82104308390024,15,18,305,2,297
4520,820,428,99.1956462585034,102.1213605442177,15,21,412,3,392
4521,820,696,99.1956462585034,100.82104308390024,15,17,142,2,124
4522,820,648,99.1956462585034,102.1213605442177,15,22,213,3,172
4523,820,867,99.1956462585034,102.14458049886622,15,23,135,3,47
4524,826,428,99.96190476190476,102.1213605442177,21,21,409,2,398
4525,826,545,99.96190476190476,102.56253968253968,21,23,302,3,281
4526,826,648,99.96190476190476,102.1213605442177,21,22,201,2,178
4527,826,644,99.96190476190476,102.56253968253968,21,19,214,3,182
4528,826,867,99.96190476190476,102.14458049886622,21,23,103,2,41
4529,867,526,102.14458049886622,104.07183673469387,23,19,351,2,341
4530,867,512,102.14458049886622,104.76843537414966,23,22,373,3,355
4531,867,646,102.14458049886622,103.32879818594104,23,16,227,1,221
4532,867,618,102.14458049886622,104.90775510204082,23,15,276,3,249
4533,867,856,102.14458049886622,103.25913832199547,23,20,49,1,11
4534,867,875,102.14458049886622,103.30557823129251,23,20,51,1,8
4535,867,930,102.14458049886622,104.35047619047619,23,13,114,2,63
4536,856,512,103.25913832199547,104.76843537414966,20,22,350,2,344
4537,856,415,103.25913832199547,105.48825396825397,20,24,451,2,441
4538,856,618,103.25913832199547,104.90775510204082,20,15,248,2,238
4539,856,731,103.25913832199547,105.8829931972789,20,16,169,3,125
4540,856,930,103.25913832199547,104.35047619047619,20,13,88,1,74
4541,856,908,103.25913832199547,105.8829931972789,20,13,124,3,52
4542,875,512,103.30557823129251,104.76843537414966,20,22,368,1,363
4543,875,415,103.30557823129251,105.48825396825397,20,24,470,2,460
4544,875,618,103.30557823129251,104.90775510204082,20,15,266,2,257
4545,875,731,103.30557823129251,105.8829931972789,20,16,182,3,144
4546,875,930,103.30557823129251,104.35047619047619,20,13,71,1,55
4547,875,908,103.30557823129251,105.8829931972789,20,13,116,3,33
4548,930,731,104.35047619047619,105.8829931972789,13,16,210,2,199
4549,930,742,104.35047619047619,106.62603174603174,13,15,212,2,188
4550,930,908,104.35047619047619,105.8829931972789,13,13,70,2,22
4551,930,887,104.35047619047619,106.90467120181407,13,15,118,3,43
4552,908,411,105.8829931972789,107.04399092970522,13,24,500,1,497
4553,908,476,105.8829931972789,107.92634920634922,13,19,441,2,432
4554,908,783,105.8829931972789,108.181768707483,13,16,159,2,125
4555,908,887,105.8829931972789,106.90467120181407,13,15,49,1,21
4556,908,860,105.8829931972789,108.15854875283446,13,13,109,2,48
4557,887,476,106.90467120181407,107.92634920634922,15,19,413,1,411
4558,887,456,106.90467120181407,108.92480725623582,15,18,440,2,431
4559,887,783,106.90467120181407,108.181768707483,15,16,118,1,104
4560,887,652,106.90467120181407,108.92480725623582,15,16,251,2,235
4561,887,860,106.90467120181407,108.15854875283446,15,13,60,1,27
4562,860,549,108.15854875283446,110.15546485260771,13,22,323,2,311
4563,860,414,108.15854875283446,110.96816326530613,13,18,462,3,446
4564,860,649,108.15854875283446,110.2251247165533,13,22,229,2,211
4565,860,632,108.15854875283446,110.29478458049887,13,17,246,2,228
4566,860,867,108.15854875283446,110.2251247165533,13,20,89,2,7
4567,860,935,108.15854875283446,110.45732426303856,13,14,124,2,75
4568,887,549,108.94802721088436,110.15546485260771,15,22,342,1,338
4569,887,414,108.94802721088436,110.96816326530613,15,18,481,2,473
4570,887,436,108.94802721088436,111.82730158730159,15,22,468,3,451
4571,887,649,108.94802721088436,110.2251247165533,15,22,244,1,238
4572,887,632,108.94802721088436,110.29478458049887,15,17,262,1,255
4573,887,818,108.94802721088436,111.92018140589569,15,19,145,3,69
4574,887,867,108.94802721088436,110.2251247165533,15,20,59,1,20
4575,887,935,108.94802721088436,110.45732426303856,15,14,81,2,48
4576,867,436,110.2251247165533,111.82730158730159,20,22,436,2,431
4577,867,425,110.2251247165533,112.98829931972789,20,19,458,3,442
4578,867,818,110.2251247165533,111.92018140589569,20,19,88,2,49
4579,867,682,110.2251247165533,112.66321995464853,20,21,213,2,185
4580,867,866,110.2251247165533,111.96662131519274,20,22,75,2,1
4581,867,821,110.2251247165533,112.64,20,17,114,2,46
4582,935,436,110.45732426303856,111.82730158730159,14,22,502,1,499
4583,935,818,110.45732426303856,111.92018140589569,14,19,133,1,117
4584,935,682,110.45732426303856,112.66321995464853,14,21,270,2,253
4585,935,866,110.45732426303856,111.96662131519274,14,22,95,2,69
4586,935,821,110.45732426303856,112.64,14,17,148,2,114
4587,866,425,111.96662131519274,112.98829931972789,22,19,443,1,441
4588,866,496,111.96662131519274,113.7081179138322,22,21,378,2,370
4589,866,501,111.96662131519274,114.52081632653062,22,17,381,3,365
4590,866,646,111.96662131519274,113.49913832199547,22,14,230,2,220
4591,821,496,112.64,113.7081179138322,17,21,328,1,325
4592,821,501,112.64,114.52081632653062,17,17,330,2,320
4593,821,442,112.64,115.37995464852608,17,19,397,3,379
4594,821,686,112.64,115.0316553287982,17,14,170,2,135
4595,887,423,117.07501133786849,119.16480725623583,13,21,473,2,464
4596,887,410,117.07501133786849,119.4898866213152,13,21,488,2,477
4597,887,651,117.07501133786849,119.09514739229026,13,17,252,2,236
4598,887,618,117.07501133786849,119.86140589569162,13,16,295,3,269
4599,853,470,120.79020408163265,121.95120181405896,19,23,386,1,383
4600,853,470,120.79020408163265,122.90321995464853,19,23,394,2,383
4601,853,713,120.79020408163265,121.95120181405896,19,18,149,1,140
4602,853,744,120.79020408163265,122.94965986394558,19,19,143,2,109
4603,853,869,120.79020408163265,121.95120181405896,19,14,52,1,16
4604,853,841,120.79020408163265,122.90321995464853,19,20,92,2,12
4605,869,505,121.95120181405896,123.87845804988662,14,22,373,2,364
4606,869,808,121.95120181405896,123.8552380952381,14,17,102,2,61
4607,869,634,121.95120181405896,124.59827664399093,14,22,261,3,235
4608,869,824,121.95120181405896,123.83201814058957,14,14,93,2,45
4609,841,470,122.90321995464853,124.99301587301588,20,24,382,2,371
4610,841,634,122.90321995464853,124.59827664399093,20,22,219,2,207
4611,841,876,122.90321995464853,124.99301587301588,20,18,97,2,35
4612,824,470,123.83201814058957,124.99301587301588,14,24,358,1,354
4613,824,462,123.83201814058957,126.22367346938776,14,21,376,2,362
4614,824,411,123.83201814058957,126.38621315192744,14,24,427,3,413
4615,824,627,123.83201814058957,126.24689342403629,14,17,223,2,197
4616,824,633,123.83201814058957,126.50231292517007,14,21,223,3,191
4617,824,876,123.83201814058957,124.99301587301588,14,18,72,1,52
4618,824,833,123.83201814058957,126.22367346938776,14,14,103,2,9
4619,824,958,123.83201814058957,126.50231292517007,14,18,177,3,134
4620,876,462,124.99301587301588,126.22367346938776,18,21,417,1,414
4621,876,411,124.99301587301588,126.38621315192744,18,24,469,1,465
4622,876,627,124.99301587301588,126.24689342403629,18,17,255,1,249
4623,876,633,124.99301587301588,126.50231292517007,18,21,252,2,243
4624,876,833,124.99301587301588,126.22367346938776,18,14,68,1,43
4625,876,958,124.99301587301588,126.50231292517007,18,18,105,2,82
4626,833,374,126.22367346938776,129.1958276643991,14,27,477,3,459
4627,833,516,126.22367346938776,128.05804988662132,14,22,327,2,317
4628,833,492,126.22367346938776,129.03328798185942,14,23,362,3,341
4629,833,629,126.22367346938776,127.98839002267574,14,17,218,2,204
4630,833,628,126.22367346938776,128.661768707483,14,24,230,2,205
4631,833,837,126.22367346938776,128.26702947845806,14,14,88,2,4
4632,833,825,126.22367346938776,129.102947845805,14,17,124,3,8
4633,958,516,126.50231292517007,128.05804988662132,18,22,447,2,442
4634,958,492,126.50231292517007,129.03328798185942,18,23,479,3,466
4635,958,629,126.50231292517007,127.98839002267574,18,17,335,1,329
4636,958,628,126.50231292517007,128.661768707483,18,24,343,2,330
4637,958,837,126.50231292517007,128.26702947845806,18,14,143,2,121
4638,958,825,126.50231292517007,129.102947845805,18,17,174,3,133
4639,837,450,128.26702947845806,129.89242630385488,14,22,393,2,387
4640,837,477,128.26702947845806,130.4497052154195,14,22,372,2,360
4641,837,659,128.26702947845806,129.93886621315193,14,21,192,2,178
4642,837,785,128.26702947845806,131.12308390022676,14,19,134,3,52
4643,837,859,128.26702947845806,130.03174603174602,14,14,79,2,22
4644,837,957,128.26702947845806,130.56580498866214,14,20,156,2,120
4645,825,477,129.102947845805,130.4497052154195,17,22,353,1,348
4646,825,785,129.102947845805,131.12308390022676,17,19,96,2,40
4647,825,755,129.102947845805,131.98222222222222,17,18,142,3,70
4648,825,957,129.102947845805,130.56580498866214,17,20,146,1,132
4649,859,499,130.03174603174602,132.3305215419501,14,18,373,2,360
4650,859,785,130.03174603174602,131.12308390022676,14,19,88,1,74
4651,859,755,130.03174603174602,131.98222222222222,14,18,134,2,104
4652,859,628,130.03174603174602,132.60916099773243,14,25,256,3,231
4653,859,833,130.03174603174602,132.3305215419501,14,15,102,2,26
4654,859,867,130.03174603174602,132.60916099773243,14,19,111,3,8
4655,957,499,130.56580498866214,132.3305215419501,20,18,464,2,458
4656,957,469,130.56580498866214,133.12,20,27,500,3,488
4657,957,755,130.56580498866214,131.98222222222222,20,18,211,1,202
4658,957,628,130.56580498866214,132.60916099773243,20,25,341,2,329
4659,957,833,130.56580498866214,132.3305215419501,20,15,145,2,124
4660,957,867,130.56580498866214,132.60916099773243,20,19,126,2,90
4661,957,820,130.56580498866214,133.3754195011338,20,15,183,3,137
4662,833,524,132.3305215419501,134.0255782312925,15,22,318,2,309
4663,833,428,132.3305215419501,134.83827664399092,15,26,419,3,405
4664,833,623,132.3305215419501,134.04879818594105,15,17,223,2,210
4665,833,721,132.3305215419501,135.1633560090703,15,18,166,3,112
4666,833,820,132.3305215419501,133.3754195011338,15,15,47,1,13
4667,833,838,132.3305215419501,135.18657596371884,15,20,123,3,5
4668,867,524,132.60916099773243,134.0255782312925,19,22,348,1,343
4669,867,428,132.60916099773243,134.83827664399092,19,26,449,2,439
4670,867,421,132.60916099773243,135.37233560090704,19,22,462,3,446
4671,867,623,132.60916099773243,134.04879818594105,19,17,252,1,244
4672,867,721,132.60916099773243,135.1633560090703,19,18,183,3,146
4673,867,838,132.60916099773243,135.18657596371884,19,20,115,3,29
4674,820,428,133.3754195011338,134.83827664399092,15,26,397,1,392
4675,820,421,133.3754195011338,135.37233560090704,15,22,408,2,399
4676,820,721,133.3754195011338,135.1633560090703,15,18,125,2,99
4677,820,616,133.3754195011338,136.02249433106576,15,17,234,3,204
4678,820,838,133.3754195011338,135.18657596371884,15,20,80,2,18
4679,820,888,133.3754195011338,135.8831746031746,15,15,128,3,68
4680,838,551,135.18657596371884,136.78875283446712,20,20,295,2,287
4681,838,639,135.18657596371884,136.67265306122448,20,21,209,1,199
4682,838,872,135.18657596371884,136.78875283446712,20,18,77,2,34
4683,888,420,135.8831746031746,138.2051700680272,15,20,479,2,468
4684,888,423,135.8831746031746,138.41414965986394,15,19,478,3,465
4685,888,809,135.8831746031746,138.1819501133787,15,16,127,2,79
4686,888,649,135.8831746031746,138.43736961451248,15,17,263,3,239
4687,888,861,135.8831746031746,138.2051700680272,15,16,104,2,27
4688,888,833,135.8831746031746,138.43736961451248,15,15,123,3,55
4689,872,420,136.78875283446712,138.2051700680272,18,20,456,1,452
4690,872,423,136.78875283446712,138.41414965986394,18,19,454,2,449
4691,872,809,136.78875283446712,138.1819501133787,18,16,87,1,63
4692,872,649,136.78875283446712,138.43736961451248,18,17,234,2,223
4693,872,625,136.78875283446712,139.45904761904762,18,13,272,3,247
4694,872,861,136.78875283446712,138.2051700680272,18,16,62,1,11
4695,872,833,136.78875283446712,138.43736961451248,18,15,81,2,39
4696,861,413,138.2051700680272,139.8770068027211,16,17,454,2,448
4697,861,625,138.2051700680272,139.45904761904762,16,13,242,1,236
4698,861,776,138.2051700680272,140.75936507936507,16,15,139,3,85
4699,833,413,138.43736961451248,139.8770068027211,15,17,425,1,420
4700,833,424,138.43736961451248,141.33986394557823,15,15,428,3,409
4701,833,410,138.43736961451248,141.38630385487528,15,15,442,3,423
4702,833,625,138.43736961451248,139.45904761904762,15,13,213,1,208
4703,833,776,138.43736961451248,140.75936507936507,15,15,115,2,57
4704,865,424,147.6092517006803,149.09532879818593,16,22,446,1,441
4705,865,428,147.6092517006803,150.11700680272108,16,23,450,3,437
4706,865,800,147.6092517006803,150.25632653061226,16,16,131,3,65
4707,865,932,147.6092517006803,149.62938775510204,16,13,110,2,67
4708,820,428,148.5380498866213,150.11700680272108,23,23,398,2,392
4709,820,427,148.5380498866213,151.11546485260772,23,19,408,3,393
4710,820,800,148.5380498866213,150.25632653061226,23,16,77,2,20
4711,820,800,148.5380498866213,150.99936507936508,23,18,108,2,20
4712,820,932,148.5380498866213,149.62938775510204,23,13,121,1,112
4713,820,838,148.5380498866213,151.13868480725623,23,15,113,3,18
4714,932,800,149.62938775510204,150.99936507936508,13,18,145,1,132
4715,932,791,149.62938775510204,152.16036281179137,13,18,178,3,141
4716,932,838,149.62938775510204,151.13868480725623,13,15,114,2,94
4717,838,410,151.13868480725623,152.3693424036281,15,25,431,1,428
4718,838,428,151.13868480725623,153.158820861678,15,21,419,2,410
4719,838,791,151.13868480725623,152.16036281179137,15,18,64,1,47
4720,838,766,151.13868480725623,152.85696145124717,15,23,103,2,72
4721,838,718,151.13868480725623,153.87863945578232,15,15,168,3,120
4722,838,873,151.13868480725623,152.83374149659863,15,20,81,2,35
4723,838,932,151.13868480725623,153.6928798185941,15,15,145,3,94
4724,932,766,151.67274376417234,152.85696145124717,15,23,174,1,166
4725,932,718,151.67274376417234,153.87863945578232,15,15,234,2,214
4726,932,873,151.67274376417234,152.83374149659863,15,20,77,1,59
4727,873,419,152.83374149659863,154.15727891156462,20,21,458,1,454
4728,873,429,152.83374149659863,155.17895691609976,20,22,455,2,444
4729,873,718,152.83374149659863,153.87863945578232,20,15,161,1,155
4730,873,644,152.83374149659863,155.0164172335601,20,21,248,2,229
4731,873,656,152.83374149659863,155.4575963718821,20,19,245,3,217
4732,873,950,152.83374149659863,154.96997732426306,20,18,120,2,77
4733,932,644,153.6928798185941,155.0164172335601,15,21,294,1,288
4734,932,656,153.6928798185941,155.4575963718821,15,19,286,2,276
4735,932,950,153.6928798185941,154.96997732426306,15,18,58,1,18
4736,932,861,153.6928798185941,156.2006349206349,15,21,129,3,71
4737,950,654,154.96997732426306,156.73469387755102,18,19,306,2,296
4738,950,817,154.96997732426306,157.75637188208617,18,15,179,3,133
4739,950,861,154.96997732426306,156.2006349206349,18,21,104,1,89
4740,950,932,154.96997732426306,156.73469387755102,18,16,78,2,18
4741,950,891,154.96997732426306,157.75637188208617,18,14,134,3,59
4742,861,429,156.2006349206349,157.22231292517006,21,23,434,1,432
4743,861,429,156.2006349206349,158.2439909297052,21,22,441,2,432
4744,861,447,156.2006349206349,158.75482993197278,21,21,428,3,414
4745,861,817,156.2006349206349,157.75637188208617,21,15,80,2,44
4746,861,660,156.2006349206349,158.75482993197278,21,18,229,3,201
4747,861,891,156.2006349206349,157.75637188208617,21,14,73,2,30
4748,932,447,156.73469387755102,158.75482993197278,16,21,493,2,485
4749,932,817,156.73469387755102,157.75637188208617,16,15,123,1,115
4750,932,660,156.73469387755102,158.75482993197278,16,18,286,2,272
4751,932,663,156.73469387755102,159.4746485260771,16,23,294,3,269
4752,932,891,156.73469387755102,157.75637188208617,16,14,60,1,41
4753,932,854,156.73469387755102,159.42820861678004,16,20,140,3,78
4754,932,838,156.73469387755102,159.49786848072563,16,21,152,3,94
4755,891,425,157.75637188208617,160.264126984127,14,24,478,3,466
4756,891,663,157.75637188208617,159.4746485260771,14,23,240,2,228
4757,891,854,157.75637188208617,159.42820861678004,14,20,81,2,37
4758,891,838,157.75637188208617,159.49786848072563,14,21,92,2,53
4759,854,594,159.42820861678004,161.0536054421769,20,24,269,2,260
4760,854,547,159.42820861678004,161.81986394557825,20,19,324,2,307
4761,854,628,159.42820861678004,161.0768253968254,20,21,237,2,226
4762,854,783,159.42820861678004,161.81986394557825,20,15,125,2,71
4763,854,840,159.42820861678004,161.0768253968254,20,20,72,2,14
4764,854,869,159.42820861678004,162.33070294784582,20,15,126,3,15
4765,838,594,159.49786848072563,161.0536054421769,21,24,253,2,244
4766,838,547,159.49786848072563,161.81986394557825,21,19,308,2,291
4767,838,628,159.49786848072563,161.0768253968254,21,21,221,2,210
4768,838,783,159.49786848072563,161.81986394557825,21,15,114,2,55
4769,838,840,159.49786848072563,161.0768253968254,21,20,68,2,2
4770,838,869,159.49786848072563,162.33070294784582,21,15,126,3,31
4771,840,422,161.0768253968254,162.70222222222222,20,21,424,2,418
4772,840,768,161.0768253968254,162.74866213151927,20,21,102,2,72
4773,840,869,161.0768253968254,162.33070294784582,20,15,61,1,29
4774,840,838,161.0768253968254,163.35238095238097,20,16,98,2,2
4775,840,932,161.0768253968254,163.86321995464854,20,16,151,3,92
4776,869,425,162.33070294784582,164.35083900226758,15,24,452,2,444
4777,869,450,162.33070294784582,164.86167800453515,15,21,433,3,419
4778,869,654,162.33070294784582,164.35083900226758,15,18,232,2,215
4779,869,750,162.33070294784582,164.76879818594105,15,26,159,2,119
4780,869,838,162.33070294784582,163.35238095238097,15,16,54,1,31
4781,869,932,162.33070294784582,163.86321995464854,15,16,91,2,63
4782,869,832,162.33070294784582,164.79201814058956,15,22,112,2,37
4783,838,450,163.35238095238097,164.86167800453515,16,21,393,2,388
4784,838,417,163.35238095238097,165.58149659863946,16,27,432,2,421
4785,838,750,163.35238095238097,164.76879818594105,16,26,107,1,88
4786,838,813,163.35238095238097,165.5350566893424,16,22,97,2,25
4787,838,832,163.35238095238097,164.79201814058956,16,22,62,1,6
4788,932,496,163.86321995464854,166.62639455782312,16,24,452,3,436
4789,932,813,163.86321995464854,165.5350566893424,16,22,139,2,119
4790,932,838,163.86321995464854,165.48861678004536,16,20,117,2,94
4791,832,496,164.79201814058956,166.62639455782312,22,24,345,2,336
4792,832,661,164.79201814058956,166.90503401360544,22,16,194,2,171
4793,832,932,164.79201814058956,166.90503401360544,22,16,135,2,100
4794,838,496,165.48861678004536,166.62639455782312,20,24,345,1,342
4795,838,428,165.48861678004536,168.41433106575965,20,24,429,3,410
4796,838,661,165.48861678004536,166.90503401360544,20,16,187,1,177
4797,838,816,165.48861678004536,168.29823129251702,20,17,123,3,22
4798,838,932,165.48861678004536,166.90503401360544,20,16,112,1,94
4799,838,860,165.48861678004536,168.18213151927438,20,17,118,3,22
4800,932,816,166.90503401360544,168.29823129251702,16,17,131,1,116
4801,932,800,166.90503401360544,169.31990929705216,16,16,168,2,132
4802,932,860,166.90503401360544,168.18213151927438,16,17,91,1,72
4803,932,949,166.90503401360544,169.4360090702948,16,13,110,3,17
4804,860,428,168.18213151927438,169.4360090702948,17,21,435,1,432
4805,860,490,168.18213151927438,169.94684807256237,17,21,378,2,370
4806,860,800,168.18213151927438,169.31990929705216,17,16,77,1,60
4807,860,666,168.18213151927438,169.94684807256237,17,15,208,2,194
4808,860,949,168.18213151927438,169.4360090702948,17,13,104,1,89
4809,860,917,168.18213151927438,170.4344671201814,17,13,113,2,57
4810,949,493,169.4360090702948,171.17750566893423,13,20,462,2,456
4811,949,801,169.4360090702948,171.36326530612246,13,17,170,2,148
4812,949,654,169.4360090702948,171.99020408163267,13,14,315,3,295
4813,949,835,169.4360090702948,171.2239455782313,13,15,138,2,114
4814,949,834,169.4360090702948,171.4793650793651,13,16,145,2,115
4815,917,427,170.4344671201814,172.08308390022677,13,25,495,2,490
4816,917,654,170.4344671201814,171.99020408163267,13,14,271,2,263
4817,917,801,170.4344671201814,173.3834013605442,13,17,172,3,116
4818,917,834,170.4344671201814,171.4793650793651,13,16,94,1,83
4819,917,830,170.4344671201814,173.2673015873016,13,15,150,3,87
4820,835,411,171.2239455782313,173.17442176870748,15,29,432,2,424
4821,835,428,171.2239455782313,173.49950113378685,15,20,419,2,407
4822,835,801,171.2239455782313,173.3834013605442,15,17,99,2,34
4823,835,654,171.2239455782313,174.01034013605442,15,15,217,3,181
4824,835,830,171.2239455782313,173.2673015873016,15,15,88,2,5
4825,835,838,171.2239455782313,173.5227210884354,15,16,99,2,3
4826,834,411,171.4793650793651,173.17442176870748,16,29,429,2,423
4827,834,428,171.4793650793651,173.49950113378685,16,20,415,2,406
4828,834,801,171.4793650793651,173.3834013605442,16,17,88,2,33
4829,834,654,171.4793650793651,174.01034013605442,16,15,210,3,180
4830,834,830,171.4793650793651,173.2673015873016,16,15,77,2,4
4831,834,838,171.4793650793651,173.5227210884354,16,16,88,2,4
4832,830,430,173.2673015873016,174.4979591836735,15,20,403,1,400
4833,830,425,173.2673015873016,176.10013605442177,15,26,423,3,405
4834,830,801,173.2673015873016,175.4267573696145,15,18,97,2,29
4835,830,784,173.2673015873016,176.05369614512472,15,16,129,3,46
4836,830,834,173.2673015873016,174.521179138322,15,15,54,1,4
4837,830,839,173.2673015873016,175.54285714285714,15,14,98,2,9
4838,838,425,173.5227210884354,176.10013605442177,16,26,428,3,413
4839,838,801,173.5227210884354,175.4267573696145,16,18,90,2,37
4840,838,784,173.5227210884354,176.05369614512472,16,16,122,3,54
4841,838,839,173.5227210884354,175.54285714285714,16,14,87,2,1
4842,834,425,174.521179138322,176.10013605442177,15,26,415,2,409
4843,834,411,174.521179138322,177.00571428571428,15,26,436,2,423
4844,834,784,174.521179138322,176.05369614512472,15,16,83,2,50
4845,834,794,174.521179138322,177.07537414965986,15,16,117,3,40
4846,834,839,174.521179138322,175.54285714285714,15,14,44,1,5
4847,834,871,174.521179138322,177.3772335600907,15,18,128,3,37
4848,839,411,175.54285714285714,177.00571428571428,14,26,433,1,428
4849,839,417,175.54285714285714,177.74875283446713,14,19,433,2,422
4850,839,794,175.54285714285714,177.07537414965986,14,16,80,2,45
4851,839,871,175.54285714285714,177.3772335600907,14,18,85,2,32
4852,839,863,175.54285714285714,177.74875283446713,14,14,98,2,24
4853,871,426,177.3772335600907,179.04907029478457,18,25,451,2,445
4854,871,445,177.3772335600907,179.861768707483,18,23,439,2,426
4855,871,645,177.3772335600907,179.09551020408165,18,21,238,2,226
4856,871,621,177.3772335600907,179.55990929705214,18,17,267,2,250
4857,871,873,177.3772335600907,178.86331065759637,18,16,64,1,2
4858,871,872,177.3772335600907,179.88498866213152,18,18,108,3,1
4859,863,426,177.74875283446713,179.04907029478457,14,25,441,1,437
4860,863,445,177.74875283446713,179.861768707483,14,23,428,2,418
4861,863,645,177.74875283446713,179.09551020408165,14,21,226,1,218
4862,863,621,177.74875283446713,179.55990929705214,14,17,254,2,242
4863,863,873,177.74875283446713,178.86331065759637,14,16,49,1,10
4864,863,872,177.74875283446713,179.88498866213152,14,18,92,2,9
4865,873,537,178.86331065759637,181.41750566893424,16,19,354,3,336
4866,873,629,178.86331065759637,181.44072562358278,16,17,268,3,244
4867,873,872,178.86331065759637,179.88498866213152,16,18,44,1,1
4868,873,869,178.86331065759637,181.41750566893424,16,17,110,3,4
4869,873,836,178.86331065759637,181.51038548752834,16,16,120,3,37
4870,872,537,179.88498866213152,181.41750566893424,18,19,341,2,335
4871,872,452,179.88498866213152,182.04444444444445,18,24,430,2,420
4872,872,629,179.88498866213152,181.44072562358278,18,17,252,2,243
4873,872,659,179.88498866213152,181.9283446712018,18,19,230,2,213
4874,872,869,179.88498866213152,181.41750566893424,18,17,66,2,3
4875,872,836,179.88498866213152,181.51038548752834,18,16,79,2,36
4876,869,374,181.41750566893424,183.53052154195012,17,33,503,2,495
4877,869,412,181.41750566893424,183.39120181405897,17,21,465,2,457
4878,869,412,181.41750566893424,183.9717006802721,17,21,470,3,457
4879,869,798,181.41750566893424,183.32154195011339,17,17,108,2,71
4880,869,631,181.41750566893424,183.60018140589568,17,20,256,2,238
4881,869,855,181.41750566893424,183.43764172335602,17,15,88,2,14
4882,869,865,181.41750566893424,183.57696145124717,17,19,93,2,4
4883,836,374,181.51038548752834,183.53052154195012,16,33,470,2,462
4884,836,412,181.51038548752834,183.39120181405897,16,21,432,2,424
4885,836,412,181.51038548752834,183.9717006802721,16,21,437,2,424
4886,836,798,181.51038548752834,183.32154195011339,16,17,87,2,38
4887,836,631,181.51038548752834,183.60018140589568,16,20,224,2,205
4888,836,855,181.51038548752834,183.43764172335602,16,15,85,2,19
4889,836,865,181.51038548752834,183.57696145124717,16,19,94,2,29
4890,855,508,183.43764172335602,184.97015873015874,15,19,353,2,347
4891,855,491,183.43764172335602,185.96861678004535,15,20,380,3,364
4892,855,649,183.43764172335602,184.69151927437642,15,18,213,1,206
4893,855,806,183.43764172335602,186.1079365079365,15,21,125,3,49
4894,855,831,183.43764172335602,184.9469387755102,15,14,69,2,24
4895,855,897,183.43764172335602,185.96861678004535,15,19,117,3,42
4896,865,508,183.57696145124717,184.97015873015874,19,19,362,1,357
4897,865,491,183.57696145124717,185.96861678004535,19,20,388,2,374
4898,865,649,183.57696145124717,184.69151927437642,19,18,221,1,216
4899,865,806,183.57696145124717,186.1079365079365,19,21,124,3,59
4900,865,831,183.57696145124717,184.9469387755102,19,14,68,1,34
4901,865,897,183.57696145124717,185.96861678004535,19,19,108,2,32
4902,831,491,184.9469387755102,185.96861678004535,14,20,343,1,340
4903,831,450,184.9469387755102,186.85097505668935,14,20,390,2,381
4904,831,806,184.9469387755102,186.1079365079365,14,21,56,1,25
4905,831,756,184.9469387755102,187.1528344671202,14,18,121,2,75
4906,831,897,184.9469387755102,185.96861678004535,14,19,79,1,66
4907,831,917,184.9469387755102,186.7116553287982,14,19,115,2,86
4908,897,427,185.96861678004535,188.29061224489797,19,19,481,2,470
4909,897,756,185.96861678004535,187.1528344671202,19,18,150,1,141
4910,897,630,185.96861678004535,188.0584126984127,19,19,282,2,267
4911,897,937,185.96861678004535,187.98875283446714,19,16,96,2,40
4912,917,427,186.7116553287982,188.29061224489797,19,19,495,2,490
4913,917,589,186.7116553287982,189.10331065759638,19,20,344,2,328
4914,917,630,186.7116553287982,188.0584126984127,19,19,293,1,287
4915,917,619,186.7116553287982,189.10331065759638,19,22,315,2,298
4916,917,937,186.7116553287982,187.98875283446714,19,16,59,1,20
4917,917,849,186.7116553287982,189.28907029478458,19,15,130,3,68
4918,937,589,187.98875283446714,189.10331065759638,16,20,351,1,348
4919,937,455,187.98875283446714,190.21786848072563,16,25,491,2,482
4920,937,619,187.98875283446714,189.10331065759638,16,22,322,1,318
4921,937,730,187.98875283446714,190.03210884353743,16,22,225,2,207
4922,937,849,187.98875283446714,189.28907029478458,16,15,104,1,88
4923,937,887,187.98875283446714,189.7302494331066,16,20,90,2,50
4924,937,897,187.98875283446714,190.9144671201814,16,15,132,3,40
4925,849,490,189.28907029478458,191.47174603174602,15,20,371,2,359
4926,849,432,189.28907029478458,192.14512471655328,15,25,435,3,417
4927,849,803,189.28907029478458,191.49496598639456,15,18,106,2,46
4928,849,812,189.28907029478458,192.07546485260772,15,22,126,3,37
4929,849,897,189.28907029478458,190.9144671201814,15,15,85,2,48
4930,849,828,189.28907029478458,192.12190476190477,15,22,124,3,21
4931,887,490,189.7302494331066,191.47174603174602,20,20,404,2,397
4932,887,432,189.7302494331066,192.14512471655328,20,25,467,2,455
4933,887,803,189.7302494331066,191.49496598639456,20,18,113,2,84
4934,887,812,189.7302494331066,192.07546485260772,20,22,126,2,75
4935,887,897,189.7302494331066,190.9144671201814,20,15,52,1,10
4936,887,828,189.7302494331066,192.12190476190477,20,22,119,2,59
4937,897,432,190.9144671201814,192.14512471655328,15,25,468,1,465
4938,897,429,190.9144671201814,192.81850340136054,15,20,475,2,468
4939,897,560,190.9144671201814,193.79374149659864,15,22,359,3,337
4940,897,812,190.9144671201814,192.07546485260772,15,22,99,1,85
4941,897,649,190.9144671201814,192.84172335600908,15,17,262,2,248
4942,897,679,190.9144671201814,193.81696145124718,15,18,251,3,218
4943,897,828,190.9144671201814,192.12190476190477,15,22,86,1,69
4944,897,827,190.9144671201814,192.84172335600908,15,13,109,2,70
4945,897,832,190.9144671201814,193.60798185941044,15,17,133,3,65
4946,828,333,192.12190476190477,193.8401814058957,22,25,501,2,495
4947,828,560,192.12190476190477,193.79374149659864,22,22,278,2,268
4948,828,679,192.12190476190477,193.81696145124718,22,18,166,2,149
4949,828,631,192.12190476190477,194.88507936507938,22,15,230,3,197
4950,828,832,192.12190476190477,193.60798185941044,22,17,64,1,4
4951,828,846,192.12190476190477,194.86185941043084,22,16,119,3,18
4952,827,368,192.84172335600908,195.76743764172335,13,27,476,3,459
4953,827,411,192.84172335600908,195.21015873015872,13,20,428,2,416
4954,827,413,192.84172335600908,195.76743764172335,13,25,433,3,414
4955,827,631,192.84172335600908,194.88507936507938,13,15,215,2,196
4956,827,648,192.84172335600908,195.81387755102043,13,24,220,3,179
4957,827,846,192.84172335600908,194.86185941043084,13,16,89,2,19
4958,827,934,192.84172335600908,195.81387755102043,13,25,167,3,107
4959,832,368,193.60798185941044,195.76743764172335,17,27,473,2,464
4960,832,411,193.60798185941044,195.21015873015872,17,20,427,2,421
4961,832,413,193.60798185941044,195.76743764172335,17,25,429,2,419
4962,832,631,193.60798185941044,194.88507936507938,17,15,208,1,201
4963,832,648,193.60798185941044,195.81387755102043,17,24,207,2,184
4964,832,846,193.60798185941044,194.86185941043084,17,16,56,1,14
4965,832,934,193.60798185941044,195.81387755102043,17,25,139,2,102
