,f0,f1,t0,t1,dB0,dB1,dist,utime,ufreq
0,66,27,0.4179591836734694,1.9969160997732427,36,33,78,2,39
1,129,20,1.2306575963718822,3.877732426303855,34,34,158,3,109
2,27,20,1.9969160997732427,3.877732426303855,33,34,81,2,7
3,27,20,1.9969160997732427,4.481451247165533,33,34,107,2,7
4,20,62,3.877732426303855,5.061950113378685,34,33,66,1,42
5,20,124,3.877732426303855,6.478367346938776,34,31,153,3,104
6,20,124,4.481451247165533,6.478367346938776,34,31,135,2,104
7,20,5,4.481451247165533,7.198185941043084,34,45,118,3,15
8,20,500,4.481451247165533,6.965986394557823,34,13,492,2,480
9,62,124,5.061950113378685,6.478367346938776,33,31,87,1,62
10,62,5,5.061950113378685,7.198185941043084,33,45,108,2,57
11,62,225,5.061950113378685,7.569705215419502,33,23,196,3,163
12,62,500,5.061950113378685,6.965986394557823,33,13,446,2,438
13,62,486,5.061950113378685,7.592925170068027,33,18,438,3,424
14,124,5,6.478367346938776,8.70748299319728,31,46,153,2,119
15,124,41,6.478367346938776,9.079002267573696,31,40,139,3,83
16,124,225,6.478367346938776,7.569705215419502,31,23,111,1,101
17,124,246,6.478367346938776,8.452063492063493,31,24,149,2,122
18,124,219,6.478367346938776,9.287981859410431,31,23,154,3,95
19,124,486,6.478367346938776,7.592925170068027,31,18,365,1,362
20,124,587,6.478367346938776,8.846802721088435,31,15,474,2,463
21,124,485,6.478367346938776,9.311201814058958,31,17,381,3,361
22,5,41,7.198185941043084,9.079002267573696,45,40,89,2,36
23,5,246,7.198185941043084,8.452063492063493,45,24,247,1,241
24,5,219,7.198185941043084,9.287981859410431,45,23,232,2,214
25,5,252,7.198185941043084,10.170340136054422,45,21,278,3,247
26,5,485,7.198185941043084,9.311201814058958,45,17,489,2,480
27,5,252,8.70748299319728,10.170340136054422,46,21,255,1,247
28,5,485,8.70748299319728,11.00625850340136,46,19,490,2,480
29,41,5,9.079002267573696,10.634739229024943,40,46,76,2,36
30,41,5,9.079002267573696,11.702857142857143,40,46,119,3,36
31,41,252,9.079002267573696,10.170340136054422,40,21,216,1,211
32,41,210,9.079002267573696,11.865396825396825,40,22,207,3,169
33,41,536,9.079002267573696,10.866938775510205,40,17,501,2,495
34,41,485,9.079002267573696,11.00625850340136,40,19,452,2,444
35,5,61,10.634739229024943,13.374693877551021,46,44,131,3,56
36,5,210,10.634739229024943,11.865396825396825,46,22,212,1,205
37,5,219,10.634739229024943,12.329795918367347,46,32,226,2,214
38,5,227,10.634739229024943,13.583673469387755,46,22,256,3,222
39,5,61,11.702857142857143,13.374693877551021,46,44,91,2,56
40,5,227,11.702857142857143,13.583673469387755,46,22,236,2,222
41,5,219,11.702857142857143,14.442811791383221,46,22,244,3,214
42,5,481,11.702857142857143,14.442811791383221,46,18,490,3,476
43,5,61,12.144036281179138,13.374693877551021,46,44,77,1,56
44,5,227,12.144036281179138,13.583673469387755,46,22,230,1,222
45,5,219,12.144036281179138,14.442811791383221,46,22,236,2,214
46,5,481,12.144036281179138,14.442811791383221,46,18,486,2,476
47,61,5,13.374693877551021,15.139410430839003,44,46,94,2,56
48,61,40,13.374693877551021,16.021768707482995,44,38,116,3,21
49,61,219,13.374693877551021,14.442811791383221,44,22,165,1,158
50,61,252,13.374693877551021,15.301950113378686,44,21,208,2,191
51,61,224,13.374693877551021,16.16108843537415,44,21,202,3,163
52,61,481,13.374693877551021,14.442811791383221,44,18,423,1,420
53,61,482,13.374693877551021,16.16108843537415,44,19,438,3,421
54,5,40,14.071292517006803,16.021768707482995,45,38,91,2,35
55,5,252,14.071292517006803,15.301950113378686,45,21,253,1,247
56,5,224,14.071292517006803,16.16108843537415,45,21,237,2,219
57,5,482,14.071292517006803,16.16108843537415,45,19,485,2,477
58,5,224,15.139410430839003,16.16108843537415,46,21,223,1,219
59,5,206,15.139410430839003,17.623945578231293,46,29,228,2,201
60,5,482,15.139410430839003,16.16108843537415,46,19,479,1,477
61,5,447,15.139410430839003,17.670385487528346,46,19,455,3,442
62,40,5,16.021768707482995,17.484625850340137,38,46,72,1,35
63,40,5,16.021768707482995,18.993922902494333,38,46,133,3,35
64,40,206,16.021768707482995,17.623945578231293,38,29,180,2,166
65,40,213,16.021768707482995,18.64562358276644,38,29,207,3,173
66,40,447,16.021768707482995,17.670385487528346,38,19,413,2,407
67,5,37,17.484625850340137,20.01560090702948,46,43,114,3,32
68,5,213,17.484625850340137,18.64562358276644,46,29,214,1,208
69,5,205,17.484625850340137,19.806621315192743,46,37,224,2,200
70,5,205,17.484625850340137,20.29424036281179,46,32,234,3,200
71,5,37,18.993922902494333,20.01560090702948,46,43,54,1,32
72,5,6,18.993922902494333,20.921179138321996,46,49,83,2,1
73,5,205,18.993922902494333,20.29424036281179,46,32,208,1,200
74,5,208,18.993922902494333,21.339138321995467,46,30,227,2,203
75,5,438,18.993922902494333,20.59609977324263,46,21,438,2,433
76,5,485,18.993922902494333,21.08371882086168,46,22,488,2,480
77,37,5,20.01560090702948,21.989297052154196,43,46,91,2,32
78,37,6,20.01560090702948,22.407256235827663,43,46,108,2,31
79,37,208,20.01560090702948,21.339138321995467,43,30,180,1,171
80,37,205,20.01560090702948,22.709115646258503,43,27,204,3,168
81,37,485,20.01560090702948,21.08371882086168,43,22,450,1,448
82,37,453,20.01560090702948,22.175056689342405,43,22,426,2,416
83,6,5,20.921179138321996,21.989297052154196,49,46,46,1,1
84,6,205,20.921179138321996,22.709115646258503,49,27,213,2,199
85,6,226,20.921179138321996,23.057414965986396,49,32,238,2,220
86,6,453,20.921179138321996,22.175056689342405,49,22,450,1,447
87,5,6,21.989297052154196,23.707573696145126,46,46,74,2,1
88,5,6,21.989297052154196,24.357732426303855,46,50,102,2,1
89,5,226,21.989297052154196,23.057414965986396,46,32,226,1,221
90,5,227,21.989297052154196,24.56671201814059,46,28,248,3,222
91,6,227,22.407256235827663,24.56671201814059,46,28,240,2,221
92,6,212,23.707573696145126,25.611609977324264,46,29,222,2,206
93,6,431,23.707573696145126,26.33142857142857,46,22,440,3,425
94,6,8,24.357732426303855,26.772607709750567,50,47,104,2,2
95,6,212,24.357732426303855,25.611609977324264,50,29,213,1,206
96,6,205,24.357732426303855,26.749387755102042,50,32,224,2,199
97,6,205,24.357732426303855,27.16734693877551,50,33,233,3,199
98,6,431,24.357732426303855,26.33142857142857,50,22,433,2,425
99,6,437,24.357732426303855,27.30666666666667,50,20,449,3,431
100,6,8,25.40263038548753,26.772607709750567,47,47,59,1,2
101,6,205,25.40263038548753,26.749387755102042,47,32,207,1,199
102,6,205,25.40263038548753,27.16734693877551,47,33,213,2,199
103,6,205,25.40263038548753,28.328344671201815,47,33,236,3,199
104,6,437,25.40263038548753,27.30666666666667,47,20,439,2,431
105,8,5,26.772607709750567,28.862403628117914,47,46,90,2,3
106,8,6,26.772607709750567,29.257142857142856,47,46,107,2,2
107,8,205,26.772607709750567,28.328344671201815,47,33,208,2,197
108,8,205,26.772607709750567,29.094603174603176,47,28,221,2,197
109,8,449,26.772607709750567,28.444444444444446,47,22,447,2,441
110,6,5,27.77106575963719,28.862403628117914,50,46,47,1,1
111,6,205,27.77106575963719,29.094603174603176,50,28,207,1,199
112,6,258,27.77106575963719,30.60390022675737,50,28,280,3,252
113,5,6,28.862403628117914,30.55746031746032,46,46,73,2,1
114,5,6,28.862403628117914,31.207619047619048,46,49,101,2,1
115,5,258,28.862403628117914,30.60390022675737,46,28,264,2,253
116,5,233,28.862403628117914,31.60235827664399,46,24,257,3,228
117,6,258,29.257142857142856,30.60390022675737,46,28,259,1,252
118,6,233,29.257142857142856,31.60235827664399,46,24,248,2,227
119,6,257,29.257142857142856,32.066757369614514,46,28,279,3,251
120,6,233,30.55746031746032,31.60235827664399,46,24,231,1,227
121,6,257,30.55746031746032,32.066757369614514,46,28,259,2,251
122,6,211,30.55746031746032,33.483174603174604,46,28,241,3,205
123,6,54,31.207619047619048,33.85469387755102,49,38,124,3,48
124,6,211,31.207619047619048,33.483174603174604,49,28,227,2,205
125,6,500,31.207619047619048,33.97079365079365,49,17,508,3,494
126,6,54,32.27573696145125,33.85469387755102,47,38,83,2,48
127,6,211,32.27573696145125,33.483174603174604,47,28,211,1,205
128,6,233,32.27573696145125,35.015691609977324,47,25,256,3,227
129,6,500,32.27573696145125,33.97079365079365,47,17,499,2,494
130,54,5,33.85469387755102,35.71229024943311,38,47,94,2,49
131,54,6,33.85469387755102,36.13024943310658,38,46,109,2,48
132,54,233,33.85469387755102,35.015691609977324,38,25,186,1,179
133,54,233,33.85469387755102,35.87482993197279,38,25,199,2,179
134,54,233,33.85469387755102,36.73396825396826,38,25,218,3,179
135,6,5,34.62095238095238,35.71229024943311,50,47,47,1,1
136,6,233,34.62095238095238,35.87482993197279,50,25,233,1,227
137,6,233,34.62095238095238,36.73396825396826,50,25,245,2,227
138,6,243,34.62095238095238,37.593106575963716,50,25,269,3,237
139,5,6,35.71229024943311,37.40734693877551,47,47,73,2,1
140,5,6,35.71229024943311,38.080725623582765,47,49,102,2,1
141,5,233,35.71229024943311,36.73396825396826,47,25,232,1,228
142,5,243,35.71229024943311,37.593106575963716,47,25,251,2,238
143,6,243,36.13024943310658,37.593106575963716,46,25,245,1,237
144,6,271,36.13024943310658,39.05596371882086,46,27,293,3,265
145,6,271,36.13024943310658,39.07918367346939,46,25,294,3,265
146,6,271,37.40734693877551,39.05596371882086,47,27,274,2,265
147,6,271,37.40734693877551,39.07918367346939,47,25,275,2,265
148,6,8,38.080725623582765,40.47238095238095,49,47,103,2,2
149,6,218,38.080725623582765,40.4259410430839,49,30,235,2,212
150,6,453,38.080725623582765,41.02965986394558,49,22,465,3,447
151,6,8,39.125623582766444,40.47238095238095,48,47,58,1,2
152,6,218,39.125623582766444,40.4259410430839,48,30,219,1,212
153,6,233,39.125623582766444,41.88879818594104,48,25,256,3,227
154,6,453,39.125623582766444,41.02965986394558,48,22,454,2,447
155,6,453,39.125623582766444,41.88879818594104,48,22,463,3,447
156,8,6,40.47238095238095,41.4940589569161,47,50,44,1,2
157,8,5,40.47238095238095,42.5621768707483,47,48,90,2,3
158,8,5,40.47238095238095,43.165895691609975,47,44,116,3,3
159,8,233,40.47238095238095,41.88879818594104,47,25,233,1,225
160,8,212,40.47238095238095,42.72471655328798,47,24,226,2,204
161,8,453,40.47238095238095,41.88879818594104,47,22,449,1,445
162,6,5,41.4940589569161,42.5621768707483,50,48,46,1,1
163,6,5,41.4940589569161,43.165895691609975,50,44,72,2,1
164,6,212,41.4940589569161,42.72471655328798,50,24,213,1,206
165,6,233,41.4940589569161,43.58385487528345,50,25,244,2,227
166,6,224,41.4940589569161,44.46621315192744,50,27,253,3,218
167,6,453,41.4940589569161,43.607074829931975,50,23,456,2,447
168,5,6,42.5621768707483,44.93061224489796,48,50,102,2,1
169,5,233,42.5621768707483,43.58385487528345,48,25,232,1,228
170,5,224,42.5621768707483,44.46621315192744,48,27,234,2,219
171,5,453,42.5621768707483,43.607074829931975,48,23,450,1,448
172,5,493,42.5621768707483,45.302131519274376,48,21,502,3,488
173,5,6,43.165895691609975,44.93061224489796,44,50,76,2,1
174,5,6,43.165895691609975,45.97551020408164,44,47,121,3,1
175,5,224,43.165895691609975,44.46621315192744,44,27,226,1,219
176,5,271,43.165895691609975,45.905850340136055,44,26,291,3,266
177,5,493,43.165895691609975,45.302131519274376,44,21,497,2,488
178,6,9,44.93061224489796,47.879546485260775,50,41,127,3,3
179,6,233,44.93061224489796,46.16126984126984,50,25,233,1,227
180,6,275,44.93061224489796,47.25260770975057,50,22,287,2,269
181,6,454,44.93061224489796,46.18448979591837,50,21,451,1,448
182,6,474,44.93061224489796,47.69378684807256,50,17,483,3,468
183,6,9,45.97551020408164,47.879546485260775,47,41,82,2,3
184,6,65,45.97551020408164,48.808344671201816,47,45,136,3,59
185,6,275,45.97551020408164,47.25260770975057,47,22,275,1,269
186,6,329,45.97551020408164,48.36716553287982,47,24,339,2,323
187,6,474,45.97551020408164,47.69378684807256,47,17,474,2,468
188,6,421,45.97551020408164,48.529705215419504,47,17,429,3,415
189,6,9,46.41668934240363,47.879546485260775,47,41,63,1,3
190,6,65,46.41668934240363,48.808344671201816,47,45,119,2,59
191,6,329,46.41668934240363,48.36716553287982,47,24,334,2,323
192,6,474,46.41668934240363,47.69378684807256,47,17,471,1,468
193,6,421,46.41668934240363,48.529705215419504,47,17,425,2,415
194,9,73,47.879546485260775,49.96934240362812,41,44,110,2,64
195,9,41,47.879546485260775,50.24798185941043,41,42,107,2,32
196,9,220,47.879546485260775,50.0390022675737,41,21,231,2,211
197,9,220,47.879546485260775,50.665941043083905,41,26,243,3,211
198,9,451,47.879546485260775,49.5978231292517,41,17,448,2,442
199,9,451,47.879546485260775,50.45696145124717,41,18,456,3,442
200,65,73,48.808344671201816,49.96934240362812,45,44,51,1,8
201,65,41,48.808344671201816,50.24798185941043,45,42,66,1,24
202,65,6,48.808344671201816,51.78049886621315,45,48,141,3,59
203,65,220,48.808344671201816,50.0390022675737,45,21,164,1,155
204,65,220,48.808344671201816,50.665941043083905,45,26,174,2,155
205,65,207,48.808344671201816,51.316099773242634,45,20,178,3,142
206,65,451,48.808344671201816,50.45696145124717,45,18,392,2,386
207,73,6,49.96934240362812,51.78049886621315,44,48,103,2,67
208,73,6,49.96934240362812,52.848616780045354,44,46,141,3,67
209,73,207,49.96934240362812,51.316099773242634,44,20,146,1,134
210,73,411,49.96934240362812,52.03591836734694,44,19,350,2,338
211,73,508,49.96934240362812,52.17523809523809,44,19,445,2,435
212,41,6,50.24798185941043,51.78049886621315,42,48,75,2,35
213,41,6,50.24798185941043,52.848616780045354,42,46,117,3,35
214,41,207,50.24798185941043,51.316099773242634,42,20,172,1,166
215,41,237,50.24798185941043,53.057596371882084,42,23,230,3,196
216,41,411,50.24798185941043,52.03591836734694,42,19,378,2,370
217,41,508,50.24798185941043,52.17523809523809,42,19,474,2,467
218,6,8,51.78049886621315,54.19537414965986,48,46,104,2,2
219,6,237,51.78049886621315,53.057596371882084,48,23,237,1,231
220,6,218,51.78049886621315,53.75419501133787,48,26,228,2,212
221,6,233,51.78049886621315,54.72943310657597,48,22,260,3,227
222,6,415,51.78049886621315,53.31301587301587,48,21,414,2,409
223,6,450,51.78049886621315,54.72943310657597,48,18,462,3,444
224,6,8,52.848616780045354,54.19537414965986,46,46,58,1,2
225,6,233,52.848616780045354,54.72943310657597,46,22,241,2,227
226,6,233,52.848616780045354,55.58857142857143,46,22,256,3,227
227,6,450,52.848616780045354,54.72943310657597,46,18,451,2,444
228,6,423,52.848616780045354,55.54213151927438,46,21,433,3,417
229,6,233,53.26657596371882,54.72943310657597,46,22,236,1,227
230,6,233,53.26657596371882,55.58857142857143,46,22,248,2,227
231,6,450,53.26657596371882,54.72943310657597,46,18,448,1,444
232,6,423,53.26657596371882,55.54213151927438,46,21,428,2,417
233,8,5,54.19537414965986,56.28517006802721,46,46,90,2,3
234,8,233,54.19537414965986,55.58857142857143,46,22,233,1,225
235,8,206,54.19537414965986,56.633469387755106,46,29,224,2,198
236,8,423,54.19537414965986,55.54213151927438,46,21,419,1,415
237,8,411,54.19537414965986,56.633469387755106,46,20,416,2,403
238,6,5,55.193832199546485,56.28517006802721,49,46,47,1,1
239,6,206,55.193832199546485,56.633469387755106,49,29,209,1,200
240,6,220,55.193832199546485,57.5158276643991,49,27,236,2,214
241,6,411,55.193832199546485,56.633469387755106,49,20,410,1,405
242,5,6,56.28517006802721,57.980226757369614,46,46,73,2,1
243,5,6,56.28517006802721,58.653605442176875,46,48,102,2,1
244,5,220,56.28517006802721,57.5158276643991,46,27,221,1,215
245,5,233,56.28517006802721,59.025124716553286,46,23,257,3,228
246,5,217,56.28517006802721,59.14122448979592,46,25,245,3,212
247,5,493,56.28517006802721,59.025124716553286,46,20,502,3,488
248,6,233,57.980226757369614,59.025124716553286,46,23,231,1,227
249,6,217,57.980226757369614,59.14122448979592,46,25,217,1,211
250,6,233,57.980226757369614,60.74340136054422,46,23,256,3,227
251,6,493,57.980226757369614,59.025124716553286,46,20,489,1,487
252,6,412,57.980226757369614,60.74340136054422,46,20,423,3,406
253,6,233,58.653605442176875,60.74340136054422,48,23,244,2,227
254,6,412,58.653605442176875,60.74340136054422,48,20,416,2,406
255,6,233,59.69850340136055,60.74340136054422,46,23,231,1,227
256,6,259,59.69850340136055,61.85795918367347,46,28,270,2,253
257,6,290,59.69850340136055,62.46167800453515,46,25,308,3,284
258,6,412,59.69850340136055,60.74340136054422,46,20,408,1,406
259,6,453,59.69850340136055,62.46167800453515,46,22,463,3,447
260,6,11,60.13968253968254,63.08861678004535,45,45,127,3,5
261,6,259,60.13968253968254,61.85795918367347,45,28,264,2,253
262,6,290,60.13968253968254,62.46167800453515,45,25,301,2,284
263,6,453,60.13968253968254,62.46167800453515,45,22,458,2,447
264,6,11,62.0669387755102,63.08861678004535,48,45,44,1,5
265,6,5,62.0669387755102,63.135056689342406,48,46,46,1,1
266,6,291,62.0669387755102,63.76199546485261,48,25,294,2,285
267,6,214,62.0669387755102,64.62113378684808,48,29,235,3,208
268,6,431,62.0669387755102,64.57469387755103,48,23,439,3,425
269,11,6,63.08861678004535,64.85333333333334,45,46,76,2,5
270,11,6,63.08861678004535,65.50349206349206,45,49,104,2,5
271,11,214,63.08861678004535,64.62113378684808,45,29,213,2,203
272,11,261,63.08861678004535,65.50349206349206,45,28,271,2,250
273,11,431,63.08861678004535,64.57469387755103,45,23,425,1,420
274,5,6,63.135056689342406,64.85333333333334,46,46,74,2,1
275,5,6,63.135056689342406,65.50349206349206,46,49,102,2,1
276,5,214,63.135056689342406,64.62113378684808,46,29,219,1,209
277,5,261,63.135056689342406,65.50349206349206,46,28,276,2,256
278,5,431,63.135056689342406,64.57469387755103,46,23,430,1,426
279,6,261,64.85333333333334,66.40907029478458,46,24,264,2,255
280,6,289,64.85333333333334,67.63972789115647,46,25,307,3,283
281,6,420,64.85333333333334,67.0592290249433,46,24,425,2,414
282,6,8,65.50349206349206,67.8487074829932,49,45,101,2,2
283,6,289,65.50349206349206,67.63972789115647,49,25,298,2,283
284,6,214,65.50349206349206,68.4756462585034,49,27,244,3,208
285,6,420,65.50349206349206,67.0592290249433,49,24,419,2,414
286,6,8,66.54839002267573,67.8487074829932,46,45,56,1,2
287,6,289,66.54839002267573,67.63972789115647,46,25,287,1,283
288,6,214,66.54839002267573,68.4756462585034,46,27,224,2,208
289,6,233,66.54839002267573,69.31156462585034,46,24,256,3,227
290,6,453,66.54839002267573,69.31156462585034,46,21,463,3,447
291,8,6,67.8487074829932,68.9168253968254,45,49,46,1,2
292,8,5,67.8487074829932,69.9849433106576,45,47,92,2,3
293,8,6,67.8487074829932,70.40290249433107,45,46,110,3,2
294,8,233,67.8487074829932,69.31156462585034,45,24,234,1,225
295,8,453,67.8487074829932,69.31156462585034,45,21,449,1,445
296,6,5,68.9168253968254,69.9849433106576,49,47,46,1,1
297,6,233,68.9168253968254,71.02984126984127,49,23,245,2,227
298,6,218,68.9168253968254,71.19238095238096,49,32,234,2,212
299,5,6,69.9849433106576,71.70321995464853,47,46,74,2,1
300,5,6,69.9849433106576,72.35337868480725,47,49,102,2,1
301,5,233,69.9849433106576,71.02984126984127,47,23,232,1,228
302,5,218,69.9849433106576,71.19238095238096,47,32,219,1,213
303,5,274,69.9849433106576,72.79455782312925,47,29,295,3,269
304,5,452,69.9849433106576,72.58557823129252,47,22,461,3,447
305,6,274,70.40290249433107,72.79455782312925,46,29,287,2,268
306,6,452,70.40290249433107,72.58557823129252,46,22,456,2,446
307,6,274,71.70321995464853,72.79455782312925,46,29,272,1,268
308,6,233,71.70321995464853,73.58403628117914,46,24,241,2,227
309,6,205,71.70321995464853,74.65215419501133,46,34,236,3,199
310,6,73,72.35337868480725,74.95401360544219,49,43,131,3,67
311,6,233,72.35337868480725,73.58403628117914,49,24,233,1,227
312,6,205,72.35337868480725,74.65215419501133,49,34,222,2,199
313,6,245,72.35337868480725,75.18621315192743,49,31,268,3,239
314,6,73,73.83945578231292,74.95401360544219,47,43,82,1,67
315,6,245,73.83945578231292,75.18621315192743,47,31,246,1,239
316,6,205,73.83945578231292,76.23111111111112,47,30,224,2,199
317,6,485,73.83945578231292,75.92925170068027,47,23,487,2,479
318,6,451,73.83945578231292,76.37043083900227,47,24,458,3,445
319,73,6,74.95401360544219,76.83482993197279,43,46,105,2,67
320,73,6,74.95401360544219,77.27600907029479,43,46,120,2,67
321,73,205,74.95401360544219,76.23111111111112,43,30,143,1,132
322,73,226,74.95401360544219,77.90294784580499,43,33,199,3,153
323,73,451,74.95401360544219,76.37043083900227,43,24,383,1,378
324,73,451,74.95401360544219,77.87972789115646,43,21,398,3,378
325,6,226,75.7667120181406,77.90294784580499,49,33,238,2,220
326,6,254,75.7667120181406,78.41378684807256,49,29,273,3,248
327,6,451,75.7667120181406,77.87972789115646,49,21,454,2,445
328,6,226,76.83482993197279,77.90294784580499,46,33,225,1,220
329,6,254,76.83482993197279,78.41378684807256,46,29,257,2,248
330,6,451,76.83482993197279,77.87972789115646,46,21,447,1,445
331,6,254,77.27600907029479,78.41378684807256,46,29,253,1,248
332,6,219,77.27600907029479,80.1320634920635,46,27,246,3,213
333,6,219,78.55310657596372,80.1320634920635,47,27,224,2,213
334,6,233,78.55310657596372,80.45714285714286,47,27,241,2,227
335,6,205,78.55310657596372,81.50204081632653,47,35,236,3,199
336,6,453,78.55310657596372,80.45714285714286,47,21,454,2,447
337,6,8,79.22648526077097,81.61814058956917,49,47,103,2,2
338,6,233,79.22648526077097,80.45714285714286,49,27,233,1,227
339,6,205,79.22648526077097,81.50204081632653,49,35,222,2,199
340,6,453,79.22648526077097,80.45714285714286,49,21,450,1,447
341,6,8,80.27138321995464,81.61814058956917,47,47,58,1,2
342,6,205,80.27138321995464,81.50204081632653,47,35,206,1,199
343,6,206,80.27138321995464,83.05777777777777,47,31,233,3,200
344,6,287,80.27138321995464,83.19709750566894,47,28,308,3,281
345,6,454,80.27138321995464,83.05777777777777,47,23,464,3,448
346,8,6,81.61814058956917,82.63981859410431,47,49,44,1,2
347,8,6,81.61814058956917,84.12589569160998,47,47,108,3,2
348,8,6,81.61814058956917,84.17233560090703,47,45,110,3,2
349,8,206,81.61814058956917,83.05777777777777,47,31,207,1,198
350,8,287,81.61814058956917,83.19709750566894,47,28,287,2,279
351,8,454,81.61814058956917,83.05777777777777,47,23,450,1,446
352,6,233,82.63981859410431,84.72961451247166,49,24,244,2,227
353,6,258,82.63981859410431,85.47265306122449,49,30,280,3,252
354,6,258,84.12589569160998,85.47265306122449,47,30,259,1,252
355,6,257,84.12589569160998,86.91229024943311,47,29,278,3,251
356,6,421,84.12589569160998,86.2853514739229,47,23,425,2,415
357,6,258,84.17233560090703,85.47265306122449,45,30,258,1,252
358,6,257,84.17233560090703,86.91229024943311,45,29,277,3,251
359,6,421,84.17233560090703,86.2853514739229,45,23,425,2,415
360,6,54,86.07637188208616,88.72344671201814,49,40,124,3,48
361,6,233,86.07637188208616,87.30702947845805,49,26,233,1,227
362,6,211,86.07637188208616,88.3287074829932,49,27,227,2,205
363,6,459,86.07637188208616,88.8627664399093,49,18,469,3,453
364,6,54,87.12126984126985,88.72344671201814,47,40,84,2,48
365,6,211,87.12126984126985,88.3287074829932,47,27,211,1,205
366,6,233,87.12126984126985,89.88444444444444,47,26,256,3,227
367,6,459,87.12126984126985,88.8627664399093,47,18,459,2,453
368,6,454,87.12126984126985,89.90766439909297,47,21,464,3,448
369,6,54,87.56244897959184,88.72344671201814,46,40,69,1,48
370,6,233,87.56244897959184,89.88444444444444,46,26,248,2,227
371,6,459,87.56244897959184,88.8627664399093,46,18,456,1,453
372,6,454,87.56244897959184,89.90766439909297,46,21,459,2,448
373,54,5,88.72344671201814,90.5578231292517,40,47,93,2,49
374,54,9,88.72344671201814,91.41696145124716,40,45,124,3,45
375,54,233,88.72344671201814,89.88444444444444,40,26,186,1,179
376,54,339,88.72344671201814,90.74358276643991,40,24,298,2,285
377,54,233,88.72344671201814,91.57950113378685,40,25,217,3,179
378,54,454,88.72344671201814,89.90766439909297,40,21,403,1,400
379,6,5,89.4897052154195,90.5578231292517,50,47,46,1,1
380,6,9,89.4897052154195,91.41696145124716,50,45,83,2,3
381,6,339,89.4897052154195,90.74358276643991,50,24,337,1,333
382,6,233,89.4897052154195,91.57950113378685,50,25,244,2,227
383,6,454,89.4897052154195,92.46185941043085,50,21,466,3,448
384,5,6,90.5578231292517,92.92625850340136,47,49,102,2,1
385,5,233,90.5578231292517,91.57950113378685,47,25,232,1,228
386,5,216,90.5578231292517,92.48507936507937,47,25,227,2,211
387,5,454,90.5578231292517,92.46185941043085,47,21,456,2,449
388,9,6,91.41696145124716,92.92625850340136,45,49,65,2,3
389,9,6,91.41696145124716,93.99437641723357,45,47,111,3,3
390,9,216,91.41696145124716,92.48507936507937,45,25,212,1,207
391,9,271,91.41696145124716,93.90149659863945,45,26,283,2,262
392,9,454,91.41696145124716,92.46185941043085,45,21,447,1,445
393,6,8,92.92625850340136,95.34113378684808,49,47,104,2,2
394,6,244,92.92625850340136,95.06249433106576,49,27,255,2,238
395,6,218,92.92625850340136,95.2714739229025,49,31,235,2,212
396,6,8,93.99437641723357,95.34113378684808,47,47,58,1,2
397,6,244,93.99437641723357,95.06249433106576,47,27,242,1,238
398,6,218,93.99437641723357,95.2714739229025,47,31,219,1,212
399,6,233,93.99437641723357,96.73433106575963,47,25,256,3,227
400,6,233,94.41233560090703,96.73433106575963,47,25,248,2,227
401,8,5,95.34113378684808,97.43092970521542,47,47,90,2,3
402,8,233,95.34113378684808,96.73433106575963,47,25,233,1,225
403,8,236,95.34113378684808,97.5934693877551,47,25,248,2,228
404,6,5,96.3395918367347,97.43092970521542,50,47,47,1,1
405,6,236,96.3395918367347,97.5934693877551,50,25,236,1,230
406,6,243,96.3395918367347,98.42938775510204,50,24,254,2,237
407,6,454,96.3395918367347,98.47582766439909,50,22,457,2,448
408,5,6,97.43092970521542,99.12598639455783,47,47,73,2,1
409,5,6,97.43092970521542,99.79936507936507,47,49,102,2,1
410,5,233,97.43092970521542,100.1708843537415,47,27,257,3,228
411,5,454,97.43092970521542,98.47582766439909,47,22,451,1,449
412,6,233,99.12598639455783,100.1708843537415,47,27,231,1,227
413,6,271,99.12598639455783,100.77460317460317,47,26,274,2,265
414,6,339,99.12598639455783,101.88916099773243,47,25,354,3,333
415,6,453,99.12598639455783,101.88916099773243,47,21,463,3,447
416,6,8,99.79936507936507,102.16780045351474,49,47,102,2,2
417,6,8,99.79936507936507,102.19102040816327,49,47,103,2,2
418,6,339,99.79936507936507,101.88916099773243,49,25,345,2,333
419,6,249,99.79936507936507,102.44643990929706,49,21,268,3,243
420,6,453,99.79936507936507,101.88916099773243,49,21,456,2,447
421,6,436,99.79936507936507,102.44643990929706,49,17,445,3,430
422,6,8,100.84426303854876,102.16780045351474,47,47,57,1,2
423,6,8,100.84426303854876,102.19102040816327,47,47,58,1,2
424,6,339,100.84426303854876,101.88916099773243,47,25,336,1,333
425,6,249,100.84426303854876,102.44643990929706,47,21,253,2,243
426,6,226,100.84426303854876,103.44489795918368,47,14,247,3,220
427,6,453,100.84426303854876,101.88916099773243,47,21,449,1,447
428,6,436,100.84426303854876,102.44643990929706,47,17,436,2,430
429,8,6,102.16780045351474,103.35201814058958,47,45,51,1,2
430,8,226,102.16780045351474,103.44489795918368,47,14,225,1,218
431,8,222,102.16780045351474,104.39691609977325,47,16,235,2,214
432,8,6,102.19102040816327,103.35201814058958,47,45,50,1,2
433,8,42,102.19102040816327,105.16317460317461,47,39,132,3,34
434,8,226,102.19102040816327,103.44489795918368,47,14,225,1,218
435,8,222,102.19102040816327,104.39691609977325,47,16,234,2,214
436,6,42,103.35201814058958,105.16317460317461,45,39,86,2,36
437,6,42,103.35201814058958,105.46503401360545,45,39,98,2,36
438,6,222,103.35201814058958,104.39691609977325,45,16,221,1,216
439,6,220,103.35201814058958,105.81333333333333,45,18,239,2,214
440,42,30,105.16317460317461,106.62603174603174,39,37,64,1,12
441,42,20,105.16317460317461,107.740589569161,39,36,113,3,22
442,42,237,105.16317460317461,107.87990929705215,39,16,227,3,195
443,42,30,105.46503401360545,106.62603174603174,39,37,51,1,12
444,42,20,105.46503401360545,107.740589569161,39,36,100,2,22
445,42,237,105.46503401360545,107.87990929705215,39,16,221,2,195
446,30,20,106.62603174603174,107.740589569161,37,36,49,1,10
447,30,20,106.62603174603174,108.8087074829932,37,37,95,2,10
448,30,237,106.62603174603174,107.87990929705215,37,16,214,1,207
449,30,217,106.62603174603174,108.48362811791384,37,20,203,2,187
450,30,461,106.62603174603174,108.48362811791384,37,14,438,2,431
451,20,30,107.740589569161,110.10902494331066,36,38,102,2,10
452,20,44,107.740589569161,110.57342403628118,36,38,124,3,24
453,20,262,107.740589569161,109.73750566893425,36,17,257,2,242
454,20,219,107.740589569161,110.43410430839002,36,18,230,3,199
455,20,30,108.8087074829932,110.10902494331066,37,38,57,1,10
456,20,44,108.8087074829932,110.57342403628118,37,38,80,2,24
457,20,41,108.8087074829932,111.54866213151928,37,39,120,3,21
458,20,219,108.8087074829932,110.43410430839002,37,18,211,2,199
459,30,41,110.10902494331066,111.54866213151928,38,39,63,1,11
460,30,43,110.10902494331066,112.22204081632653,38,40,92,2,13
461,30,219,110.10902494331066,112.15238095238095,38,20,208,2,189
462,30,218,110.10902494331066,113.01151927437643,38,21,226,3,188
463,30,487,110.10902494331066,112.15238095238095,38,17,465,2,457
464,30,449,110.10902494331066,112.96507936507936,38,19,437,3,419
465,44,43,110.57342403628118,112.22204081632653,38,40,71,2,1
466,44,31,110.57342403628118,113.47591836734694,38,37,126,3,13
467,44,219,110.57342403628118,112.15238095238095,38,20,188,2,175
468,44,218,110.57342403628118,113.01151927437643,38,21,203,2,174
469,44,487,110.57342403628118,112.15238095238095,38,17,448,2,443
470,44,449,110.57342403628118,112.96507936507936,38,19,418,2,405
471,41,31,111.54866213151928,113.47591836734694,39,37,84,2,10
472,41,218,111.54866213151928,113.01151927437643,39,21,188,1,177
473,41,230,111.54866213151928,113.87065759637188,39,20,214,2,189
474,41,449,111.54866213151928,112.96507936507936,39,19,413,1,408
475,41,486,111.54866213151928,113.87065759637188,39,17,456,2,445
476,43,31,112.22204081632653,113.47591836734694,40,37,55,1,12
477,43,28,112.22204081632653,115.17097505668934,40,39,128,3,15
478,43,230,112.22204081632653,113.87065759637188,40,20,200,2,187
479,43,356,112.22204081632653,115.17097505668934,40,19,338,3,313
480,43,486,112.22204081632653,113.87065759637188,40,17,449,2,443
481,43,521,112.22204081632653,114.70657596371882,40,14,490,2,478
482,31,28,113.47591836734694,115.17097505668934,37,39,73,2,3
483,31,27,113.47591836734694,115.26385487528344,37,40,77,2,4
484,31,28,113.47591836734694,116.23909297052154,37,36,119,3,3
485,31,356,113.47591836734694,115.17097505668934,37,19,333,2,325
486,31,355,113.47591836734694,115.82113378684808,37,23,339,2,324
487,31,355,113.47591836734694,116.23909297052154,37,19,345,3,324
488,31,521,113.47591836734694,114.70657596371882,37,14,493,1,490
489,28,72,115.17097505668934,117.77160997732426,39,41,120,3,44
490,28,355,115.17097505668934,116.23909297052154,39,19,330,1,327
491,28,205,115.17097505668934,117.51619047619047,39,35,204,2,177
492,27,72,115.26385487528344,117.77160997732426,40,41,117,3,45
493,27,205,115.26385487528344,117.51619047619047,40,35,203,2,178
494,28,72,116.23909297052154,117.77160997732426,36,41,79,2,44
495,28,6,116.23909297052154,118.63074829931973,36,47,105,2,22
496,28,205,116.23909297052154,117.51619047619047,36,35,185,1,177
497,28,205,116.23909297052154,119.09514739229026,36,30,216,3,177
498,28,455,116.23909297052154,118.67718820861678,36,20,440,2,427
499,72,5,117.77160997732426,119.4898866213152,41,45,100,2,67
500,72,9,117.77160997732426,120.46512471655329,41,44,132,3,63
501,72,205,117.77160997732426,119.09514739229026,41,30,145,1,133
502,72,205,117.77160997732426,119.53632653061224,41,27,153,2,133
503,72,449,117.77160997732426,119.25768707482993,41,22,382,1,377
504,6,9,118.63074829931973,120.46512471655329,47,44,79,2,3
505,6,227,118.63074829931973,120.76698412698413,47,32,239,2,221
506,6,258,118.63074829931973,121.34748299319727,47,28,278,3,252
507,6,430,118.63074829931973,121.13850340136055,47,21,438,3,424
508,5,6,119.4898866213152,122.06730158730159,45,49,111,3,1
509,5,227,119.4898866213152,120.76698412698413,45,32,229,1,222
510,5,258,119.4898866213152,121.34748299319727,45,28,265,2,253
511,5,227,119.4898866213152,122.27628117913832,45,29,252,3,222
512,5,430,119.4898866213152,121.13850340136055,45,21,431,2,425
513,5,465,119.4898866213152,121.69578231292518,45,23,470,2,460
514,5,418,119.4898866213152,122.46204081632654,45,22,432,3,413
515,9,6,120.46512471655329,122.06730158730159,44,49,69,2,3
516,9,6,120.46512471655329,123.1354195011338,44,47,115,3,3
517,9,227,120.46512471655329,122.27628117913832,44,29,232,2,218
518,9,213,120.46512471655329,123.321179138322,44,28,238,3,204
519,9,465,120.46512471655329,121.69578231292518,44,23,459,1,456
520,9,418,120.46512471655329,122.46204081632654,44,22,418,2,409
521,6,8,122.06730158730159,124.4821768707483,49,47,104,2,2
522,6,213,122.06730158730159,123.321179138322,49,28,214,1,207
523,6,205,122.06730158730159,124.34285714285714,49,33,222,2,199
524,6,8,123.1354195011338,124.4821768707483,47,47,58,1,2
525,6,205,123.1354195011338,124.34285714285714,47,33,206,1,199
526,6,205,123.55337868480726,126.13079365079365,47,31,228,3,199
527,8,6,124.4821768707483,126.98993197278912,47,46,108,3,2
528,8,205,124.4821768707483,126.13079365079365,47,31,209,2,197
529,8,205,124.4821768707483,126.59519274376417,47,29,217,2,197
530,8,488,124.4821768707483,127.12925170068027,47,21,493,3,480
531,6,10,125.48063492063493,128.220589569161,50,45,118,3,4
532,6,205,125.48063492063493,126.59519274376417,50,29,205,1,199
533,6,257,125.48063492063493,128.19736961451247,50,27,277,3,251
534,6,258,125.48063492063493,128.33668934240364,50,29,280,3,252
535,6,488,125.48063492063493,127.12925170068027,50,21,487,2,482
536,6,10,126.98993197278912,128.220589569161,46,45,53,1,4
537,6,257,126.98993197278912,128.19736961451247,46,27,256,1,251
538,6,258,126.98993197278912,128.33668934240364,46,29,259,1,252
539,6,257,126.98993197278912,129.77632653061224,46,29,278,3,251
540,10,6,128.220589569161,129.98530612244897,45,48,76,2,4
541,10,6,128.220589569161,130.426485260771,45,46,95,2,4
542,10,257,128.220589569161,129.77632653061224,45,29,256,2,247
543,10,211,128.220589569161,131.19274376417235,45,27,238,3,201
544,6,211,128.94040816326532,131.19274376417235,49,27,227,2,205
545,6,217,128.94040816326532,131.72680272108843,49,27,243,3,211
546,6,432,128.94040816326532,131.91256235827666,49,21,445,3,426
547,6,211,129.98530612244897,131.19274376417235,48,27,211,1,205
548,6,217,129.98530612244897,131.72680272108843,48,27,224,2,211
549,6,339,129.98530612244897,132.74848072562358,48,24,354,3,333
550,6,432,129.98530612244897,131.91256235827666,48,21,434,2,426
551,6,480,129.98530612244897,132.74848072562358,48,21,489,3,474
552,6,217,130.426485260771,131.72680272108843,46,27,218,1,211
553,6,339,130.426485260771,132.74848072562358,46,24,348,2,333
554,6,432,130.426485260771,131.91256235827666,46,21,431,1,426
555,6,480,130.426485260771,132.74848072562358,46,21,484,2,474
556,6,5,131.70358276643992,133.42185941043084,47,47,74,2,1
557,6,339,131.70358276643992,132.74848072562358,47,24,336,1,333
558,6,233,131.70358276643992,133.58439909297053,47,24,241,2,227
559,6,243,131.70358276643992,134.443537414966,47,24,265,3,237
560,6,480,131.70358276643992,132.74848072562358,47,21,476,1,474
561,6,5,132.35374149659864,133.42185941043084,50,47,46,1,1
562,6,233,132.35374149659864,133.58439909297053,50,24,233,1,227
563,6,243,132.35374149659864,134.443537414966,50,24,254,2,237
564,5,6,133.42185941043084,135.14013605442176,47,47,74,2,1
565,5,6,133.42185941043084,135.7902947845805,47,50,102,2,1
566,5,243,133.42185941043084,134.443537414966,47,24,242,1,238
567,5,233,133.42185941043084,136.1618140589569,47,25,257,3,228
568,6,233,135.14013605442176,136.1618140589569,47,25,231,1,227
569,6,271,135.14013605442176,136.7655328798186,47,27,274,2,265
570,6,8,135.7902947845805,138.1819501133787,50,47,103,2,2
571,6,218,135.7902947845805,138.13551020408164,50,32,235,2,212
572,6,218,135.7902947845805,138.57668934240363,50,31,244,3,212
573,6,8,136.83519274376417,138.1819501133787,47,47,58,1,2
574,6,5,136.83519274376417,139.41260770975057,47,46,111,3,1
575,6,218,136.83519274376417,138.13551020408164,47,32,219,1,212
576,6,218,136.83519274376417,138.57668934240363,47,31,225,2,212
577,6,233,136.83519274376417,139.59836734693877,47,26,256,3,227
578,6,425,136.83519274376417,138.87854875283446,47,20,428,2,419
579,6,453,136.83519274376417,139.59836734693877,47,22,463,3,447
580,8,6,138.1819501133787,139.20362811791384,47,50,44,1,2
581,8,5,138.1819501133787,139.41260770975057,47,46,53,1,3
582,8,6,138.1819501133787,140.27174603174603,47,47,90,2,2
583,8,233,138.1819501133787,139.59836734693877,47,26,233,1,225
584,8,235,138.1819501133787,140.45750566893423,47,25,247,2,227
585,8,453,138.1819501133787,139.59836734693877,47,22,449,1,445
586,8,493,138.1819501133787,140.45750566893423,47,22,495,2,485
587,6,235,139.20362811791384,140.45750566893423,50,25,235,1,229
588,6,233,139.20362811791384,142.15256235827664,50,26,260,3,227
589,6,493,139.20362811791384,140.45750566893423,50,22,490,1,487
590,5,6,139.41260770975057,141.99002267573695,46,47,111,3,1
591,5,235,139.41260770975057,140.45750566893423,46,25,234,1,230
592,5,233,139.41260770975057,142.15256235827664,46,26,257,3,228
593,5,493,139.41260770975057,140.45750566893423,46,22,490,1,488
594,6,233,140.27174603174603,142.15256235827664,47,26,241,2,227
595,6,233,140.27174603174603,143.03492063492064,47,25,256,3,227
596,6,7,141.99002267573695,144.28879818594103,47,43,99,2,1
597,6,233,141.99002267573695,143.03492063492064,47,25,231,1,227
598,6,271,141.99002267573695,143.6386394557823,47,27,274,2,265
599,6,216,141.99002267573695,144.91573696145124,47,26,245,3,210
600,6,493,141.99002267573695,143.8708390022676,47,22,494,2,487
601,6,7,142.6401814058957,144.28879818594103,49,43,71,2,1
602,6,216,142.6401814058957,144.91573696145124,49,26,232,2,210
603,6,217,142.6401814058957,145.42657596371882,49,28,243,3,211
604,6,493,142.6401814058957,143.8708390022676,49,22,490,1,487
605,6,493,142.6401814058957,145.24081632653062,49,19,500,3,487
606,6,7,144.14947845804988,146.14639455782313,49,45,86,2,1
607,6,3,144.14947845804988,146.30893424036282,49,44,93,2,3
608,6,217,144.14947845804988,145.42657596371882,49,28,218,1,211
609,6,246,144.14947845804988,146.28571428571428,49,24,257,2,240
610,6,493,144.14947845804988,145.24081632653062,49,19,489,1,487
611,6,411,144.14947845804988,146.28571428571428,49,15,415,2,405
612,7,3,144.28879818594103,146.30893424036282,43,44,87,2,4
613,7,217,144.28879818594103,145.42657596371882,43,28,216,1,210
614,7,246,144.28879818594103,146.28571428571428,43,24,254,2,239
615,7,411,144.28879818594103,146.28571428571428,43,15,413,2,404
616,7,14,146.14639455782313,147.30739229024942,45,41,50,1,7
617,7,2,146.14639455782313,148.30585034013606,45,20,93,2,5
618,7,253,146.14639455782313,147.7021315192744,45,18,255,2,246
619,3,2,146.30893424036282,148.30585034013606,44,20,86,2,1
620,3,253,146.30893424036282,147.7021315192744,44,18,257,1,250
621,225,5,7.569705215419502,8.70748299319728,23,46,225,1,220
622,225,41,7.569705215419502,9.079002267573696,23,40,195,2,184
623,225,219,7.569705215419502,9.287981859410431,23,23,74,2,6
624,225,252,7.569705215419502,10.170340136054422,23,21,115,3,27
625,225,587,7.569705215419502,8.846802721088435,23,15,366,1,362
626,225,485,7.569705215419502,9.311201814058958,23,17,271,2,260
627,246,5,8.452063492063493,10.634739229024943,24,46,259,2,241
628,246,252,8.452063492063493,10.170340136054422,24,21,74,2,6
629,246,536,8.452063492063493,10.866938775510205,24,17,308,2,290
630,246,485,8.452063492063493,11.00625850340136,24,19,263,3,239
631,219,5,9.287981859410431,10.634739229024943,23,46,222,1,214
632,219,5,9.287981859410431,11.702857142857143,23,46,238,2,214
633,219,5,9.287981859410431,12.144036281179138,23,46,247,3,214
634,219,210,9.287981859410431,11.865396825396825,23,22,111,3,9
635,219,536,9.287981859410431,10.866938775510205,23,17,324,2,317
636,219,485,9.287981859410431,11.00625850340136,23,19,276,2,266
637,252,5,10.170340136054422,11.702857142857143,21,46,256,2,247
638,252,5,10.170340136054422,12.144036281179138,21,46,261,2,247
639,252,210,10.170340136054422,11.865396825396825,21,22,84,2,42
640,252,219,10.170340136054422,12.329795918367347,21,32,99,2,33
641,252,586,10.170340136054422,12.329795918367347,21,21,347,2,334
642,252,578,10.170340136054422,13.049614512471656,21,17,349,3,326
643,210,61,11.865396825396825,13.374693877551021,22,44,163,2,149
644,210,5,11.865396825396825,14.071292517006803,22,45,226,2,205
645,210,227,11.865396825396825,13.583673469387755,22,22,76,2,17
646,210,219,11.865396825396825,14.442811791383221,22,22,111,3,9
647,210,578,11.865396825396825,13.049614512471656,22,17,372,1,368
648,210,481,11.865396825396825,14.442811791383221,22,18,293,3,271
649,219,61,12.329795918367347,13.374693877551021,32,44,164,1,158
650,219,5,12.329795918367347,14.071292517006803,32,45,227,2,214
651,219,5,12.329795918367347,15.139410430839003,32,46,246,3,214
652,219,227,12.329795918367347,13.583673469387755,32,22,55,1,8
653,219,252,12.329795918367347,15.301950113378686,32,21,132,3,33
654,219,481,12.329795918367347,14.442811791383221,32,18,277,2,262
655,219,583,12.329795918367347,15.069750566893424,32,17,383,3,364
656,219,713,12.329795918367347,14.814331065759637,32,19,505,2,494
657,227,5,13.583673469387755,15.139410430839003,22,46,232,2,222
658,227,40,13.583673469387755,16.021768707482995,22,38,214,2,187
659,227,252,13.583673469387755,15.301950113378686,22,21,78,2,25
660,227,224,13.583673469387755,16.16108843537415,22,21,111,3,3
661,227,583,13.583673469387755,15.069750566893424,22,17,362,1,356
662,227,482,13.583673469387755,16.16108843537415,22,19,278,3,255
663,227,713,13.583673469387755,14.814331065759637,22,19,489,1,486
664,219,40,14.442811791383221,16.021768707482995,22,38,191,2,179
665,219,224,14.442811791383221,16.16108843537415,22,21,74,2,5
666,219,482,14.442811791383221,16.16108843537415,22,19,273,2,263
667,252,5,15.301950113378686,17.484625850340137,21,46,264,2,247
668,252,206,15.301950113378686,17.623945578231293,21,29,110,2,46
669,252,447,15.301950113378686,17.670385487528346,21,19,220,2,195
670,252,736,15.301950113378686,16.904126984126986,21,16,489,2,484
671,252,734,15.301950113378686,17.322086167800453,21,17,490,2,482
672,224,5,16.16108843537415,17.484625850340137,21,46,226,1,219
673,224,5,16.16108843537415,18.993922902494333,21,46,251,3,219
674,224,206,16.16108843537415,17.623945578231293,21,29,66,1,18
675,224,213,16.16108843537415,18.64562358276644,21,29,108,2,11
676,224,447,16.16108843537415,17.670385487528346,21,19,232,2,223
677,224,581,16.16108843537415,18.854603174603174,21,15,375,3,357
678,224,638,16.16108843537415,18.901043083900227,21,15,430,3,414
679,206,5,17.623945578231293,18.993922902494333,29,46,209,1,201
680,206,37,17.623945578231293,20.01560090702948,29,43,198,2,169
681,206,213,17.623945578231293,18.64562358276644,29,29,45,1,7
682,206,205,17.623945578231293,19.806621315192743,29,37,94,2,1
683,206,205,17.623945578231293,20.29424036281179,29,32,115,3,1
684,206,581,17.623945578231293,18.854603174603174,29,15,379,1,375
685,206,573,17.623945578231293,19.806621315192743,29,23,379,2,367
686,206,438,17.623945578231293,20.59609977324263,29,21,265,3,232
687,206,638,17.623945578231293,18.901043083900227,29,15,435,1,432
688,206,652,17.623945578231293,19.853061224489796,29,25,456,2,446
689,206,616,17.623945578231293,20.54965986394558,29,19,429,3,410
690,213,37,18.64562358276644,20.01560090702948,29,43,186,1,176
691,213,6,18.64562358276644,20.921179138321996,29,49,229,2,207
692,213,205,18.64562358276644,19.806621315192743,29,37,51,1,8
693,213,205,18.64562358276644,20.29424036281179,29,32,71,2,8
694,213,208,18.64562358276644,21.339138321995467,29,30,116,3,5
695,213,573,18.64562358276644,19.806621315192743,29,23,363,1,360
696,213,438,18.64562358276644,20.59609977324263,29,21,240,2,225
697,213,485,18.64562358276644,21.08371882086168,29,22,292,2,272
698,213,652,18.64562358276644,19.853061224489796,29,25,442,1,439
699,213,616,18.64562358276644,20.54965986394558,29,19,411,2,403
700,213,626,18.64562358276644,21.31591836734694,29,20,429,3,413
701,205,6,19.806621315192743,20.921179138321996,37,49,205,1,199
702,205,5,19.806621315192743,21.989297052154196,37,46,221,2,200
703,205,6,19.806621315192743,22.407256235827663,37,46,228,3,199
704,205,208,19.806621315192743,21.339138321995467,37,30,66,2,3
705,205,485,19.806621315192743,21.08371882086168,37,22,285,1,280
706,205,453,19.806621315192743,22.175056689342405,37,22,268,2,248
707,205,626,19.806621315192743,21.31591836734694,37,20,426,2,421
708,205,5,20.29424036281179,21.989297052154196,32,46,213,2,200
709,205,6,20.29424036281179,22.407256235827663,32,46,219,2,199
710,205,208,20.29424036281179,21.339138321995467,32,30,45,1,3
711,205,226,20.29424036281179,23.057414965986396,32,32,121,3,21
712,205,453,20.29424036281179,22.175056689342405,32,22,261,2,248
713,205,571,20.29424036281179,23.034195011337868,32,21,385,3,366
714,205,626,20.29424036281179,21.31591836734694,32,20,423,1,421
715,205,650,20.29424036281179,23.010975056689343,32,20,460,3,445
716,208,6,21.339138321995467,22.407256235827663,30,46,207,1,202
717,208,6,21.339138321995467,23.707573696145126,30,46,226,2,202
718,208,205,21.339138321995467,22.709115646258503,30,27,59,1,3
719,208,226,21.339138321995467,23.057414965986396,30,32,76,2,18
720,208,571,21.339138321995467,23.034195011337868,30,21,370,2,363
721,208,650,21.339138321995467,23.010975056689343,30,20,448,2,442
722,208,618,21.339138321995467,23.56825396825397,30,21,421,2,410
723,205,6,22.709115646258503,24.357732426303855,27,50,211,2,199
724,205,6,22.709115646258503,25.40263038548753,27,47,230,3,199
725,205,227,22.709115646258503,24.56671201814059,27,28,83,2,22
726,205,212,22.709115646258503,25.611609977324264,27,29,125,3,7
727,205,580,22.709115646258503,24.729251700680273,27,21,385,2,375
728,205,511,22.709115646258503,25.26331065759637,27,21,325,3,306
729,205,647,22.709115646258503,24.729251700680273,27,18,450,2,442
730,205,626,22.709115646258503,25.611609977324264,27,18,439,3,421
731,226,6,23.057414965986396,24.357732426303855,32,50,227,1,220
732,226,6,23.057414965986396,25.40263038548753,32,47,242,2,220
733,226,227,23.057414965986396,24.56671201814059,32,28,65,2,1
734,226,212,23.057414965986396,25.611609977324264,32,29,111,3,14
735,226,580,23.057414965986396,24.729251700680273,32,21,361,2,354
736,226,511,23.057414965986396,25.26331065759637,32,21,300,2,285
737,226,647,23.057414965986396,24.729251700680273,32,18,427,2,421
738,226,626,23.057414965986396,25.611609977324264,32,18,415,3,400
739,227,8,24.56671201814059,26.772607709750567,28,47,239,2,219
740,227,212,24.56671201814059,25.611609977324264,28,29,47,1,15
741,227,205,24.56671201814059,26.749387755102042,28,32,97,2,22
742,227,205,24.56671201814059,27.16734693877551,28,33,114,3,22
743,227,431,24.56671201814059,26.33142857142857,28,22,218,2,204
744,227,437,24.56671201814059,27.30666666666667,28,20,241,3,210
745,227,626,24.56671201814059,25.611609977324264,28,18,402,1,399
746,227,652,24.56671201814059,26.70294784580499,28,23,435,2,425
747,227,616,24.56671201814059,27.376326530612246,28,18,407,3,389
748,212,8,25.611609977324264,26.772607709750567,29,47,210,1,204
749,212,6,25.611609977324264,27.77106575963719,29,50,226,2,206
750,212,205,25.611609977324264,26.749387755102042,29,32,49,1,7
751,212,205,25.611609977324264,27.16734693877551,29,33,67,2,7
752,212,205,25.611609977324264,28.328344671201815,29,33,117,3,7
753,212,437,25.611609977324264,27.30666666666667,29,20,237,2,225
754,212,449,25.611609977324264,28.444444444444446,29,22,267,3,237
755,212,652,25.611609977324264,26.70294784580499,29,23,443,1,440
756,212,616,25.611609977324264,27.376326530612246,29,18,411,2,404
757,212,622,25.611609977324264,28.18902494331066,29,19,425,3,410
758,205,6,26.749387755102042,27.77106575963719,32,50,204,1,199
759,205,5,26.749387755102042,28.862403628117914,32,46,220,2,200
760,205,6,26.749387755102042,29.257142857142856,32,46,226,3,199
761,205,449,26.749387755102042,28.444444444444446,32,22,255,2,244
762,205,622,26.749387755102042,28.18902494331066,32,19,422,1,417
763,205,5,27.16734693877551,28.862403628117914,33,46,213,2,200
764,205,6,27.16734693877551,29.257142857142856,33,46,218,2,199
765,205,449,27.16734693877551,28.444444444444446,33,22,250,1,244
766,205,614,27.16734693877551,29.930521541950114,33,22,426,3,409
767,205,622,27.16734693877551,28.18902494331066,33,19,419,1,417
768,205,6,28.328344671201815,30.55746031746032,33,46,221,2,199
769,205,6,28.328344671201815,31.207619047619048,33,49,234,3,199
770,205,258,28.328344671201815,30.60390022675737,33,28,111,2,53
771,205,614,28.328344671201815,29.930521541950114,33,22,415,2,409
772,205,554,28.328344671201815,30.743219954648527,33,23,364,2,349
773,205,6,29.094603174603176,30.55746031746032,28,46,209,1,199
774,205,6,29.094603174603176,31.207619047619048,28,49,219,2,199
775,205,258,29.094603174603176,30.60390022675737,28,28,84,2,53
776,205,233,29.094603174603176,31.60235827664399,28,24,112,3,28
777,205,257,29.094603174603176,32.066757369614514,28,28,138,3,52
778,205,554,29.094603174603176,30.743219954648527,28,23,356,2,349
779,205,555,29.094603174603176,31.60235827664399,28,22,366,3,350
780,258,6,30.60390022675737,32.27573696145125,28,47,262,2,252
781,258,257,30.60390022675737,32.066757369614514,28,28,63,1,1
782,258,211,30.60390022675737,33.483174603174604,28,28,133,3,47
783,258,546,30.60390022675737,32.46149659863946,28,21,299,2,288
784,258,632,30.60390022675737,32.46149659863946,28,19,382,2,374
785,233,54,31.60235827664399,33.85469387755102,24,38,204,2,179
786,233,211,31.60235827664399,33.483174603174604,24,28,84,2,22
787,233,500,31.60235827664399,33.97079365079365,24,17,286,2,267
788,233,689,31.60235827664399,33.97079365079365,24,19,467,2,456
789,257,54,32.066757369614514,33.85469387755102,28,38,217,2,203
790,257,6,32.066757369614514,34.62095238095238,28,50,274,3,251
791,257,211,32.066757369614514,33.483174603174604,28,28,76,1,46
792,257,233,32.066757369614514,35.015691609977324,28,25,129,3,24
793,257,500,32.066757369614514,33.97079365079365,28,17,256,2,243
794,257,555,32.066757369614514,35.015691609977324,28,20,324,3,298
795,257,689,32.066757369614514,33.97079365079365,28,19,440,2,432
796,257,632,32.066757369614514,35.03891156462585,28,19,396,3,375
797,211,6,33.483174603174604,34.62095238095238,28,50,211,1,205
798,211,5,33.483174603174604,35.71229024943311,28,47,227,2,206
799,211,6,33.483174603174604,36.13024943310658,28,46,235,3,205
800,211,233,33.483174603174604,35.015691609977324,28,25,70,2,22
801,211,233,33.483174603174604,35.87482993197279,28,25,105,2,22
802,211,555,33.483174603174604,35.015691609977324,28,20,350,2,344
803,211,580,33.483174603174604,35.87482993197279,28,21,383,2,369
804,211,632,33.483174603174604,35.03891156462585,28,19,426,2,421
805,211,685,33.483174603174604,35.87482993197279,28,17,485,2,474
806,233,6,35.015691609977324,36.13024943310658,25,46,232,1,227
807,233,6,35.015691609977324,37.40734693877551,25,47,249,2,227
808,233,243,35.015691609977324,37.593106575963716,25,25,111,3,10
809,233,580,35.015691609977324,36.73396825396826,25,22,355,2,347
810,233,579,35.015691609977324,37.593106575963716,25,22,363,3,346
811,233,632,35.015691609977324,36.75718820861678,25,19,406,2,399
812,233,650,35.015691609977324,37.593106575963716,25,17,432,3,417
813,233,6,35.87482993197279,37.40734693877551,25,47,236,2,227
814,233,6,35.87482993197279,38.080725623582765,25,49,246,2,227
815,233,243,35.87482993197279,37.593106575963716,25,25,75,2,10
816,233,579,35.87482993197279,37.593106575963716,25,22,354,2,346
817,233,579,35.87482993197279,38.45224489795918,25,22,363,3,346
818,233,650,35.87482993197279,37.593106575963716,25,17,424,2,417
819,233,626,35.87482993197279,38.45224489795918,25,18,408,3,393
820,233,6,36.73396825396826,38.080725623582765,25,49,234,1,227
821,233,6,36.73396825396826,39.125623582766444,25,48,249,2,227
822,233,271,36.73396825396826,39.05596371882086,25,27,107,2,38
823,233,271,36.73396825396826,39.07918367346939,25,25,108,2,38
824,233,579,36.73396825396826,38.45224489795918,25,22,354,2,346
825,233,579,36.73396825396826,39.31138321995465,25,21,363,3,346
826,233,626,36.73396825396826,38.45224489795918,25,18,400,2,393
827,233,632,36.73396825396826,39.31138321995465,25,18,414,3,399
828,243,6,37.593106575963716,39.125623582766444,25,48,246,2,237
829,243,8,37.593106575963716,40.47238095238095,25,47,266,3,235
830,243,271,37.593106575963716,39.05596371882086,25,27,69,1,28
831,243,271,37.593106575963716,39.07918367346939,25,25,70,1,28
832,243,218,37.593106575963716,40.4259410430839,25,30,125,3,25
833,243,579,37.593106575963716,39.31138321995465,25,21,344,2,336
834,243,632,37.593106575963716,39.31138321995465,25,18,396,2,389
835,243,632,37.593106575963716,40.170521541950116,25,18,405,3,389
836,271,8,39.05596371882086,40.47238095238095,27,47,270,1,263
837,271,6,39.05596371882086,41.4940589569161,27,50,285,2,265
838,271,218,39.05596371882086,40.4259410430839,27,30,79,1,53
839,271,233,39.05596371882086,41.88879818594104,27,25,128,3,38
840,271,453,39.05596371882086,41.02965986394558,27,22,201,2,182
841,271,453,39.05596371882086,41.88879818594104,27,22,219,3,182
842,271,632,39.05596371882086,40.170521541950116,27,18,364,1,361
843,271,632,39.05596371882086,41.88879818594104,27,19,381,3,361
844,271,8,39.07918367346939,40.47238095238095,25,47,270,1,263
845,271,6,39.07918367346939,41.4940589569161,25,50,285,2,265
846,271,218,39.07918367346939,40.4259410430839,25,30,79,1,53
847,271,233,39.07918367346939,41.88879818594104,25,25,127,3,38
848,271,453,39.07918367346939,41.02965986394558,25,22,200,2,182
849,271,453,39.07918367346939,41.88879818594104,25,22,219,3,182
850,271,632,39.07918367346939,40.170521541950116,25,18,364,1,361
851,271,632,39.07918367346939,41.88879818594104,25,19,381,3,361
852,218,6,40.4259410430839,41.4940589569161,30,50,217,1,212
853,218,5,40.4259410430839,42.5621768707483,30,48,232,2,213
854,218,5,40.4259410430839,43.165895691609975,30,44,244,3,213
855,218,233,40.4259410430839,41.88879818594104,30,25,65,1,15
856,218,212,40.4259410430839,42.72471655328798,30,24,99,2,6
857,218,453,40.4259410430839,41.88879818594104,30,22,243,1,235
858,218,554,40.4259410430839,42.74793650793651,30,22,351,2,336
859,218,632,40.4259410430839,41.88879818594104,30,19,419,1,414
860,218,666,40.4259410430839,42.74793650793651,30,18,459,2,448
861,233,5,41.88879818594104,43.165895691609975,25,44,235,1,228
862,233,224,41.88879818594104,44.46621315192744,25,27,111,3,9
863,233,453,41.88879818594104,43.607074829931975,25,23,232,2,220
864,233,579,41.88879818594104,44.44299319727891,25,21,363,3,346
865,233,647,41.88879818594104,43.58385487528345,25,19,420,2,414
866,233,688,41.88879818594104,44.67519274376417,25,18,471,3,455
867,212,6,42.72471655328798,44.93061224489796,24,50,227,2,206
868,212,224,42.72471655328798,44.46621315192744,24,27,76,2,12
869,212,579,42.72471655328798,44.44299319727891,24,21,374,2,367
870,212,493,42.72471655328798,45.302131519274376,24,21,302,3,281
871,212,688,42.72471655328798,44.67519274376417,24,18,483,2,476
872,212,681,42.72471655328798,45.302131519274376,24,17,482,3,469
873,233,6,43.58385487528345,44.93061224489796,25,50,234,1,227
874,233,6,43.58385487528345,45.97551020408164,25,47,249,2,227
875,233,6,43.58385487528345,46.41668934240363,25,47,258,3,227
876,233,271,43.58385487528345,45.905850340136055,25,26,107,2,38
877,233,493,43.58385487528345,45.302131519274376,25,21,270,2,260
878,233,454,43.58385487528345,46.18448979591837,25,21,248,3,221
879,233,688,43.58385487528345,44.67519274376417,25,18,457,1,455
880,233,681,43.58385487528345,45.302131519274376,25,17,454,2,448
881,233,647,43.58385487528345,46.16126984126984,25,19,429,3,414
882,224,6,44.46621315192744,45.97551020408164,27,47,227,2,218
883,224,6,44.46621315192744,46.41668934240363,27,47,234,2,218
884,224,271,44.46621315192744,45.905850340136055,27,26,78,1,47
885,224,233,44.46621315192744,46.16126984126984,27,25,74,2,9
886,224,275,44.46621315192744,47.25260770975057,27,22,130,3,51
887,224,454,44.46621315192744,46.18448979591837,27,21,242,2,230
888,224,647,44.46621315192744,46.16126984126984,27,19,429,2,423
889,271,9,45.905850340136055,47.879546485260775,26,41,275,2,262
890,271,65,45.905850340136055,48.808344671201816,26,45,241,3,206
891,271,275,45.905850340136055,47.25260770975057,26,22,58,1,4
892,271,329,45.905850340136055,48.36716553287982,26,24,121,2,58
893,271,474,45.905850340136055,47.69378684807256,26,17,217,2,203
894,271,421,45.905850340136055,48.529705215419504,26,17,188,3,150
895,233,9,46.16126984126984,47.879546485260775,25,41,236,2,224
896,233,65,46.16126984126984,48.808344671201816,25,45,203,3,168
897,233,275,46.16126984126984,47.25260770975057,25,22,63,1,42
898,233,329,46.16126984126984,48.36716553287982,25,24,135,2,96
899,233,474,46.16126984126984,47.69378684807256,25,17,250,2,241
900,233,421,46.16126984126984,48.529705215419504,25,17,214,2,188
901,233,719,46.16126984126984,49.11020408163265,25,19,502,3,486
902,275,65,47.25260770975057,48.808344671201816,22,45,220,2,210
903,275,73,47.25260770975057,49.96934240362812,22,44,233,3,202
904,275,329,47.25260770975057,48.36716553287982,22,24,72,1,54
905,275,220,47.25260770975057,50.0390022675737,22,21,132,3,55
906,275,421,47.25260770975057,48.529705215419504,22,17,156,1,146
907,275,451,47.25260770975057,49.5978231292517,22,17,203,2,176
908,275,762,47.25260770975057,49.0637641723356,22,15,493,2,487
909,275,719,47.25260770975057,49.11020408163265,22,19,451,2,444
910,329,73,48.36716553287982,49.96934240362812,24,44,265,2,256
911,329,41,48.36716553287982,50.24798185941043,24,42,299,2,288
912,329,220,48.36716553287982,50.0390022675737,24,21,131,2,109
913,329,220,48.36716553287982,50.665941043083905,24,26,147,2,109
914,329,207,48.36716553287982,51.316099773242634,24,20,176,3,122
915,329,451,48.36716553287982,49.5978231292517,24,17,133,1,122
916,329,451,48.36716553287982,50.45696145124717,24,18,152,2,122
917,329,820,48.36716553287982,49.78358276643991,24,19,495,1,491
918,220,6,50.0390022675737,51.78049886621315,21,48,227,2,214
919,220,6,50.0390022675737,52.848616780045354,21,46,246,3,214
920,220,207,50.0390022675737,51.316099773242634,21,20,57,1,13
921,220,411,50.0390022675737,52.03591836734694,21,19,209,2,191
922,220,508,50.0390022675737,52.17523809523809,21,19,302,2,288
923,220,618,50.0390022675737,52.15201814058957,21,19,408,2,398
924,220,6,50.665941043083905,51.78049886621315,26,48,219,1,214
925,220,6,50.665941043083905,52.848616780045354,26,46,234,2,214
926,220,6,50.665941043083905,53.26657596371882,26,46,242,3,214
927,220,237,50.665941043083905,53.057596371882084,26,23,104,2,17
928,220,411,50.665941043083905,52.03591836734694,26,19,200,1,191
929,220,508,50.665941043083905,52.17523809523809,26,19,295,2,288
930,220,415,50.665941043083905,53.31301587301587,26,21,226,3,195
931,220,618,50.665941043083905,52.15201814058957,26,19,403,1,398
932,207,6,51.316099773242634,52.848616780045354,20,46,212,2,201
933,207,6,51.316099773242634,53.26657596371882,20,46,218,2,201
934,207,8,51.316099773242634,54.19537414965986,20,46,234,3,199
935,207,237,51.316099773242634,53.057596371882084,20,23,81,2,30
936,207,218,51.316099773242634,53.75419501133787,20,26,106,2,11
937,207,415,51.316099773242634,53.31301587301587,20,21,225,2,208
938,207,621,51.316099773242634,53.661315192743764,20,18,426,2,414
939,207,703,51.316099773242634,54.17215419501134,20,18,511,3,496
940,237,8,53.057596371882084,54.19537414965986,23,46,234,1,229
941,237,6,53.057596371882084,55.193832199546485,23,49,249,2,231
942,237,233,53.057596371882084,54.72943310657597,23,22,72,2,4
943,237,233,53.057596371882084,55.58857142857143,23,22,109,3,4
944,237,450,53.057596371882084,54.72943310657597,23,18,225,2,213
945,237,423,53.057596371882084,55.54213151927438,23,21,215,2,186
946,237,703,53.057596371882084,54.17215419501134,23,18,468,1,466
947,237,650,53.057596371882084,55.58857142857143,23,18,427,3,413
948,218,6,53.75419501133787,55.193832199546485,26,49,221,1,212
949,218,5,53.75419501133787,56.28517006802721,26,46,239,3,213
950,218,233,53.75419501133787,55.58857142857143,26,22,80,2,15
951,218,206,53.75419501133787,56.633469387755106,26,29,125,3,12
952,218,423,53.75419501133787,55.54213151927438,26,21,219,2,205
953,218,411,53.75419501133787,56.633469387755106,26,20,229,3,193
954,218,650,53.75419501133787,55.58857142857143,26,18,439,2,432
955,218,647,53.75419501133787,56.447709750566894,26,17,444,3,429
956,233,5,54.72943310657597,56.28517006802721,22,46,238,2,228
957,233,206,54.72943310657597,56.633469387755106,22,29,86,2,27
958,233,220,54.72943310657597,57.5158276643991,22,27,121,3,13
959,233,411,54.72943310657597,56.633469387755106,22,20,196,2,178
960,233,579,54.72943310657597,57.30684807256236,22,18,363,3,346
961,233,647,54.72943310657597,56.447709750566894,22,17,421,2,414
962,233,632,54.72943310657597,57.30684807256236,22,16,414,3,399
963,233,6,55.58857142857143,57.980226757369614,22,46,249,2,227
964,233,206,55.58857142857143,56.633469387755106,22,29,52,1,27
965,233,220,55.58857142857143,57.5158276643991,22,27,84,2,13
966,233,411,55.58857142857143,56.633469387755106,22,20,184,1,178
967,233,579,55.58857142857143,57.30684807256236,22,18,354,2,346
968,233,632,55.58857142857143,57.30684807256236,22,16,406,2,399
969,206,6,56.633469387755106,57.980226757369614,29,46,208,1,200
970,206,6,56.633469387755106,58.653605442176875,29,48,218,2,200
971,206,233,56.633469387755106,59.025124716553286,29,23,106,2,27
972,206,217,56.633469387755106,59.14122448979592,29,25,109,3,11
973,206,493,56.633469387755106,59.025124716553286,29,20,305,2,287
974,206,658,56.633469387755106,59.025124716553286,29,19,464,2,452
975,220,6,57.5158276643991,58.653605442176875,27,48,220,1,214
976,220,6,57.5158276643991,59.69850340136055,27,46,234,2,214
977,220,6,57.5158276643991,60.13968253968254,27,45,242,3,214
978,220,233,57.5158276643991,59.025124716553286,27,23,66,2,13
979,220,217,57.5158276643991,59.14122448979592,27,25,70,2,3
980,220,493,57.5158276643991,59.025124716553286,27,20,281,2,273
981,220,578,57.5158276643991,59.88426303854875,27,18,372,2,358
982,220,658,57.5158276643991,59.025124716553286,27,19,443,2,438
983,220,632,57.5158276643991,59.88426303854875,27,16,424,2,412
984,233,6,59.025124716553286,60.13968253968254,23,45,232,1,227
985,233,259,59.025124716553286,61.85795918367347,23,28,125,3,26
986,233,412,59.025124716553286,60.74340136054422,23,20,194,2,179
987,233,550,59.025124716553286,61.85795918367347,23,23,340,3,317
988,217,6,59.14122448979592,62.0669387755102,25,48,246,3,211
989,217,233,59.14122448979592,60.74340136054422,25,23,71,2,16
990,217,259,59.14122448979592,61.85795918367347,25,28,124,3,42
991,217,412,59.14122448979592,60.74340136054422,25,20,207,2,195
992,217,550,59.14122448979592,61.85795918367347,25,23,353,3,333
993,233,6,60.74340136054422,62.0669387755102,23,48,234,1,227
994,233,11,60.74340136054422,63.08861678004535,23,45,244,2,222
995,233,5,60.74340136054422,63.135056689342406,23,46,250,2,228
996,233,259,60.74340136054422,61.85795918367347,23,28,55,1,26
997,233,290,60.74340136054422,62.46167800453515,23,25,93,2,57
998,233,550,60.74340136054422,61.85795918367347,23,23,321,1,317
999,233,453,60.74340136054422,62.46167800453515,23,22,232,2,220
1000,233,673,60.74340136054422,62.80997732426304,23,23,449,2,440
1001,259,11,61.85795918367347,63.08861678004535,28,45,254,1,248
1002,259,5,61.85795918367347,63.135056689342406,28,46,260,1,254
1003,259,291,61.85795918367347,63.76199546485261,28,25,88,2,32
1004,259,214,61.85795918367347,64.62113378684808,28,29,127,3,45
1005,259,598,61.85795918367347,64.08707482993198,28,22,352,2,339
1006,259,431,61.85795918367347,64.57469387755103,28,23,208,3,172
1007,259,622,61.85795918367347,64.45859410430839,28,20,380,3,363
1008,290,6,62.46167800453515,64.85333333333334,25,46,302,2,284
1009,290,291,62.46167800453515,63.76199546485261,25,25,56,1,1
1010,290,214,62.46167800453515,64.62113378684808,25,29,120,2,76
1011,290,598,62.46167800453515,64.08707482993198,25,22,316,2,308
1012,290,431,62.46167800453515,64.57469387755103,25,23,168,2,141
1013,290,770,62.46167800453515,64.08707482993198,25,20,485,2,480
1014,290,622,62.46167800453515,64.45859410430839,25,20,343,2,332
1015,291,6,63.76199546485261,64.85333333333334,25,46,289,1,285
1016,291,6,63.76199546485261,65.50349206349206,25,49,295,2,285
1017,291,6,63.76199546485261,66.54839002267573,25,46,309,3,285
1018,291,261,63.76199546485261,65.50349206349206,25,28,81,2,30
1019,291,261,63.76199546485261,66.40907029478458,25,24,118,3,30
1020,291,584,63.76199546485261,65.57315192743765,25,21,303,2,293
1021,291,616,63.76199546485261,65.57315192743765,25,19,334,2,325
1022,291,676,63.76199546485261,66.71092970521542,25,18,405,3,385
1023,214,6,64.62113378684808,66.54839002267573,29,46,224,2,208
1024,214,261,64.62113378684808,66.40907029478458,29,24,90,2,47
1025,214,420,64.62113378684808,67.0592290249433,29,24,231,2,206
1026,214,676,64.62113378684808,66.71092970521542,29,18,471,2,462
1027,261,6,65.50349206349206,66.54839002267573,28,46,259,1,255
1028,261,8,65.50349206349206,67.8487074829932,28,45,272,2,253
1029,261,289,65.50349206349206,67.63972789115647,28,25,96,2,28
1030,261,214,65.50349206349206,68.4756462585034,28,27,136,3,47
1031,261,420,65.50349206349206,67.0592290249433,28,24,173,2,159
1032,261,579,65.50349206349206,67.8487074829932,28,25,334,2,318
1033,261,676,65.50349206349206,66.71092970521542,28,18,418,1,415
1034,261,653,65.50349206349206,67.89514739229026,28,22,405,2,392
1035,261,8,66.40907029478458,67.8487074829932,24,45,260,1,253
1036,261,6,66.40907029478458,68.9168253968254,24,49,277,3,255
1037,261,289,66.40907029478458,67.63972789115647,24,25,60,1,28
1038,261,214,66.40907029478458,68.4756462585034,24,27,101,2,47
1039,261,233,66.40907029478458,69.31156462585034,24,24,128,3,28
1040,261,579,66.40907029478458,67.8487074829932,24,25,324,1,318
1041,261,578,66.40907029478458,68.77750566893424,24,21,333,2,317
1042,261,453,66.40907029478458,69.31156462585034,24,21,229,3,192
1043,261,653,66.40907029478458,67.89514739229026,24,22,397,1,392
1044,261,661,66.40907029478458,68.77750566893424,24,22,413,2,400
1045,289,6,67.63972789115647,68.9168253968254,25,49,288,1,283
1046,289,5,67.63972789115647,69.9849433106576,25,47,301,2,284
1047,289,6,67.63972789115647,70.40290249433107,25,46,307,3,283
1048,289,233,67.63972789115647,69.31156462585034,25,24,91,2,56
1049,289,578,67.63972789115647,68.77750566893424,25,21,293,1,289
1050,289,453,67.63972789115647,69.31156462585034,25,21,179,2,164
1051,289,661,67.63972789115647,68.77750566893424,25,22,375,1,372
1052,289,782,67.63972789115647,69.70630385487529,25,23,501,2,493
1053,214,5,68.4756462585034,69.9849433106576,27,47,219,2,209
1054,214,6,68.4756462585034,70.40290249433107,27,46,224,2,208
1055,214,233,68.4756462585034,71.02984126984127,27,23,112,3,19
1056,214,218,68.4756462585034,71.19238095238096,27,32,117,3,4
1057,214,579,68.4756462585034,71.00662131519275,27,24,381,3,365
1058,214,583,68.4756462585034,71.21560090702948,27,26,387,3,369
1059,214,650,68.4756462585034,71.00662131519275,27,21,449,3,436
1060,214,619,68.4756462585034,71.21560090702948,27,22,422,3,405
1061,233,6,69.31156462585034,70.40290249433107,24,46,232,1,227
1062,233,6,69.31156462585034,71.70321995464853,24,46,249,2,227
1063,233,218,69.31156462585034,71.19238095238096,24,32,82,2,15
1064,233,579,69.31156462585034,71.00662131519275,24,24,354,2,346
1065,233,583,69.31156462585034,71.21560090702948,24,26,359,2,350
1066,233,650,69.31156462585034,71.00662131519275,24,21,423,2,417
1067,233,619,69.31156462585034,71.21560090702948,24,22,395,2,386
1068,233,6,71.02984126984127,72.35337868480725,23,49,234,1,227
1069,233,6,71.02984126984127,73.83945578231292,23,47,257,3,227
1070,233,274,71.02984126984127,72.79455782312925,23,29,86,2,41
1071,233,452,71.02984126984127,72.58557823129252,23,22,229,2,219
1072,233,580,71.02984126984127,73.58403628117914,23,20,364,3,347
1073,233,632,71.02984126984127,73.60725623582766,23,17,414,3,399
1074,218,6,71.19238095238096,72.35337868480725,32,49,218,1,212
1075,218,6,71.19238095238096,73.83945578231292,32,47,241,3,212
1076,218,274,71.19238095238096,72.79455782312925,32,29,89,2,56
1077,218,233,71.19238095238096,73.58403628117914,32,24,104,2,15
1078,218,452,71.19238095238096,72.58557823129252,32,22,242,1,234
1079,218,580,71.19238095238096,73.58403628117914,32,20,376,2,362
1080,218,632,71.19238095238096,73.60725623582766,32,17,427,2,414
1081,274,6,72.79455782312925,73.83945578231292,29,47,272,1,268
1082,274,73,72.79455782312925,74.95401360544219,29,43,221,2,201
1083,274,6,72.79455782312925,75.7667120181406,29,49,297,3,268
1084,274,205,72.79455782312925,74.65215419501133,29,34,106,2,69
1085,274,245,72.79455782312925,75.18621315192743,29,31,107,2,29
1086,274,573,72.79455782312925,74.65215419501133,29,22,310,2,299
1087,274,652,72.79455782312925,74.6985941043084,29,24,387,2,378
1088,274,616,72.79455782312925,75.39519274376417,29,18,360,3,342
1089,233,73,73.58403628117914,74.95401360544219,24,43,171,1,160
1090,233,6,73.58403628117914,75.7667120181406,24,49,246,2,227
1091,233,205,73.58403628117914,74.65215419501133,24,34,54,1,28
1092,233,245,73.58403628117914,75.18621315192743,24,31,70,2,12
1093,233,205,73.58403628117914,76.23111111111112,24,30,117,3,28
1094,233,573,73.58403628117914,74.65215419501133,24,22,343,1,340
1095,233,485,73.58403628117914,75.92925170068027,24,23,271,2,252
1096,233,451,73.58403628117914,76.37043083900227,24,24,249,3,218
1097,233,652,73.58403628117914,74.6985941043084,24,24,422,1,419
1098,233,616,73.58403628117914,75.39519274376417,24,18,391,2,383
1099,233,667,73.58403628117914,76.16145124716553,24,20,448,3,434
1100,205,6,74.65215419501133,75.7667120181406,34,49,205,1,199
1101,205,6,74.65215419501133,76.83482993197279,34,46,220,2,199
1102,205,6,74.65215419501133,77.27600907029479,34,46,229,3,199
1103,205,485,74.65215419501133,75.92925170068027,34,23,285,1,280
1104,205,451,74.65215419501133,76.37043083900227,34,24,257,2,246
1105,205,667,74.65215419501133,76.16145124716553,34,20,467,2,462
1106,245,6,75.18621315192743,76.83482993197279,31,46,249,2,239
1107,245,6,75.18621315192743,77.27600907029479,31,46,255,2,239
1108,245,205,75.18621315192743,76.23111111111112,31,30,60,1,40
1109,245,226,75.18621315192743,77.90294784580499,31,33,119,3,19
1110,245,451,75.18621315192743,76.37043083900227,31,24,212,1,206
1111,245,451,75.18621315192743,77.87972789115646,31,21,236,3,206
1112,245,654,75.18621315192743,77.85650793650794,31,20,425,3,409
1113,205,6,76.23111111111112,77.27600907029479,30,46,204,1,199
1114,205,6,76.23111111111112,78.55310657596372,30,47,223,2,199
1115,205,226,76.23111111111112,77.90294784580499,30,33,75,2,21
1116,205,254,76.23111111111112,78.41378684807256,30,29,106,2,49
1117,205,451,76.23111111111112,77.87972789115646,30,21,256,2,246
1118,205,581,76.23111111111112,78.41378684807256,30,22,388,2,376
1119,205,654,76.23111111111112,77.85650793650794,30,20,454,2,449
1120,205,619,76.23111111111112,78.43700680272109,30,19,425,2,414
1121,226,6,77.90294784580499,79.22648526077097,33,49,227,1,220
1122,226,6,77.90294784580499,80.27138321995464,33,47,242,2,220
1123,226,219,77.90294784580499,80.1320634920635,33,27,96,2,7
1124,226,233,77.90294784580499,80.45714285714286,33,27,110,3,7
1125,226,546,77.90294784580499,79.5980045351474,33,22,328,2,320
1126,226,453,77.90294784580499,80.45714285714286,33,21,252,3,227
1127,226,666,77.90294784580499,79.5980045351474,33,18,446,2,440
1128,226,632,77.90294784580499,80.45714285714286,33,19,421,3,406
1129,254,6,78.41378684807256,80.27138321995464,29,47,261,2,248
1130,254,219,78.41378684807256,80.1320634920635,29,27,82,2,35
1131,254,233,78.41378684807256,80.45714285714286,29,27,90,2,21
1132,254,546,78.41378684807256,79.5980045351474,29,22,296,1,292
1133,254,453,78.41378684807256,80.45714285714286,29,21,218,2,199
1134,254,557,78.41378684807256,81.33950113378685,29,21,328,3,303
1135,254,666,78.41378684807256,79.5980045351474,29,18,415,1,412
1136,254,632,78.41378684807256,80.45714285714286,29,19,388,2,378
1137,219,8,80.1320634920635,81.61814058956917,27,47,220,1,211
1138,219,6,80.1320634920635,82.63981859410431,27,49,239,3,213
1139,219,205,80.1320634920635,81.50204081632653,27,35,61,1,14
1140,219,206,80.1320634920635,83.05777777777777,27,31,127,3,13
1141,219,557,80.1320634920635,81.33950113378685,27,21,342,1,338
1142,219,454,80.1320634920635,83.05777777777777,27,23,267,3,235
1143,219,655,80.1320634920635,81.52526077097505,27,24,440,1,436
1144,219,632,80.1320634920635,83.03455782312925,27,19,432,3,413
1145,233,8,80.45714285714286,81.61814058956917,27,47,230,1,225
1146,233,6,80.45714285714286,82.63981859410431,27,49,246,2,227
1147,233,205,80.45714285714286,81.50204081632653,27,35,53,1,28
1148,233,206,80.45714285714286,83.05777777777777,27,31,115,3,27
1149,233,287,80.45714285714286,83.19709750566894,27,28,130,3,54
1150,233,454,80.45714285714286,83.05777777777777,27,23,248,3,221
1151,233,655,80.45714285714286,81.52526077097505,27,24,424,1,422
1152,233,632,80.45714285714286,83.03455782312925,27,19,414,3,399
1153,205,6,81.50204081632653,82.63981859410431,35,49,205,1,199
1154,205,6,81.50204081632653,84.12589569160998,35,47,229,3,199
1155,205,6,81.50204081632653,84.17233560090703,35,45,230,3,199
1156,205,206,81.50204081632653,83.05777777777777,35,31,67,2,1
1157,205,287,81.50204081632653,83.19709750566894,35,28,110,2,82
1158,205,454,81.50204081632653,83.05777777777777,35,23,258,2,249
1159,205,580,81.50204081632653,83.8704761904762,35,22,389,2,375
1160,205,632,81.50204081632653,83.03455782312925,35,19,432,2,427
1161,205,647,81.50204081632653,83.8704761904762,35,18,454,2,442
1162,206,6,83.05777777777777,84.12589569160998,31,47,205,1,200
1163,206,6,83.05777777777777,84.17233560090703,31,45,206,1,200
1164,206,233,83.05777777777777,84.72961451247166,31,24,77,2,27
1165,206,258,83.05777777777777,85.47265306122449,31,30,116,2,52
1166,206,571,83.05777777777777,84.75283446712018,31,21,372,2,365
1167,206,580,83.05777777777777,85.58875283446712,31,21,390,3,374
1168,206,669,83.05777777777777,85.72807256235828,31,23,477,3,463
1169,287,6,83.19709750566894,86.07637188208616,28,49,307,3,281
1170,287,233,83.19709750566894,84.72961451247166,28,24,85,2,54
1171,287,258,83.19709750566894,85.47265306122449,28,30,102,2,29
1172,287,571,83.19709750566894,84.75283446712018,28,21,292,2,284
1173,287,580,83.19709750566894,85.58875283446712,28,21,311,2,293
1174,287,739,83.19709750566894,84.24199546485261,28,21,454,1,452
1175,287,669,83.19709750566894,85.72807256235828,28,23,397,3,382
1176,233,6,84.72961451247166,86.07637188208616,24,49,234,1,227
1177,233,6,84.72961451247166,87.12126984126985,24,47,249,2,227
1178,233,6,84.72961451247166,87.56244897959184,24,46,258,3,227
1179,233,257,84.72961451247166,86.91229024943311,24,29,97,2,24
1180,233,421,84.72961451247166,86.2853514739229,24,23,200,2,188
1181,233,554,84.72961451247166,87.30702947845805,24,20,340,3,321
1182,233,649,84.72961451247166,86.44789115646259,24,19,423,2,416
1183,233,632,84.72961451247166,87.30702947845805,24,18,414,3,399
1184,258,6,85.47265306122449,87.12126984126985,30,47,262,2,252
1185,258,6,85.47265306122449,87.56244897959184,30,46,268,2,252
1186,258,257,85.47265306122449,86.91229024943311,30,29,62,1,1
1187,258,233,85.47265306122449,87.30702947845805,30,26,83,2,25
1188,258,211,85.47265306122449,88.3287074829932,30,27,132,3,47
1189,258,554,85.47265306122449,87.30702947845805,30,20,306,2,296
1190,258,632,85.47265306122449,87.30702947845805,30,18,382,2,374
1191,257,54,86.91229024943311,88.72344671201814,29,40,217,2,203
1192,257,6,86.91229024943311,89.4897052154195,29,50,274,3,251
1193,257,211,86.91229024943311,88.3287074829932,29,27,76,1,46
1194,257,233,86.91229024943311,89.88444444444444,29,26,130,3,24
1195,257,459,86.91229024943311,88.8627664399093,29,18,219,2,202
1196,257,658,86.91229024943311,88.65378684807257,29,13,408,2,401
1197,257,625,86.91229024943311,89.88444444444444,29,20,390,3,368
1198,233,54,87.30702947845805,88.72344671201814,26,40,189,1,179
1199,233,6,87.30702947845805,89.4897052154195,26,50,246,2,227
1200,233,211,87.30702947845805,88.3287074829932,26,27,49,1,22
1201,233,459,87.30702947845805,88.8627664399093,26,18,236,2,226
1202,233,454,87.30702947845805,89.90766439909297,26,21,248,3,221
1203,233,658,87.30702947845805,88.65378684807257,26,13,429,1,425
1204,233,625,87.30702947845805,89.88444444444444,26,20,407,3,392
1205,211,6,88.3287074829932,89.4897052154195,27,50,211,1,205
1206,211,5,88.3287074829932,90.5578231292517,27,47,227,2,206
1207,211,233,88.3287074829932,89.88444444444444,27,26,71,2,22
1208,211,339,88.3287074829932,90.74358276643991,27,24,165,2,128
1209,211,454,88.3287074829932,89.90766439909297,27,21,252,2,243
1210,211,579,88.3287074829932,90.74358276643991,27,22,382,2,368
1211,211,625,88.3287074829932,89.88444444444444,27,20,419,2,414
1212,211,666,88.3287074829932,90.74358276643991,27,20,467,2,455
1213,233,9,89.88444444444444,91.41696145124716,26,45,234,2,224
1214,233,216,89.88444444444444,92.48507936507937,26,25,113,3,17
1215,233,579,89.88444444444444,91.60272108843537,26,22,354,2,346
1216,233,454,89.88444444444444,92.46185941043085,26,21,247,3,221
1217,233,647,89.88444444444444,91.60272108843537,26,18,421,2,414
1218,233,626,89.88444444444444,92.46185941043085,26,18,408,3,393
1219,339,6,90.74358276643991,92.92625850340136,24,49,346,2,333
1220,339,216,90.74358276643991,92.48507936507937,24,25,144,2,123
1221,339,454,90.74358276643991,92.46185941043085,24,21,137,2,115
1222,339,626,90.74358276643991,92.46185941043085,24,18,296,2,287
1223,339,632,90.74358276643991,93.3209977324263,24,18,313,3,293
1224,339,832,90.74358276643991,93.3209977324263,24,14,505,3,493
1225,233,6,91.57950113378685,92.92625850340136,25,49,234,1,227
1226,233,6,91.57950113378685,93.99437641723357,25,47,250,2,227
1227,233,6,91.57950113378685,94.41233560090703,25,47,258,3,227
1228,233,271,91.57950113378685,93.90149659863945,25,26,107,2,38
1229,233,580,91.57950113378685,94.15691609977324,25,21,364,3,347
1230,233,632,91.57950113378685,93.3209977324263,25,18,406,2,399
1231,216,6,92.48507936507937,93.99437641723357,25,47,220,2,210
1232,216,6,92.48507936507937,94.41233560090703,25,47,226,2,210
1233,216,8,92.48507936507937,95.34113378684808,25,47,242,3,208
1234,216,271,92.48507936507937,93.90149659863945,25,26,82,1,55
1235,216,244,92.48507936507937,95.06249433106576,25,27,114,3,28
1236,216,218,92.48507936507937,95.2714739229025,25,31,120,3,2
1237,216,580,92.48507936507937,94.15691609977324,25,21,371,2,364
1238,216,579,92.48507936507937,95.01605442176871,25,22,379,3,363
1239,216,647,92.48507936507937,95.01605442176871,25,18,445,3,431
1240,271,8,93.90149659863945,95.34113378684808,26,47,270,1,263
1241,271,6,93.90149659863945,96.3395918367347,26,50,285,2,265
1242,271,244,93.90149659863945,95.06249433106576,26,27,57,1,27
1243,271,218,93.90149659863945,95.2714739229025,26,31,79,1,53
1244,271,233,93.90149659863945,96.73433106575963,26,25,128,3,38
1245,271,579,93.90149659863945,95.01605442176871,26,22,312,1,308
1246,271,555,93.90149659863945,95.87519274376417,26,21,296,2,284
1247,271,579,93.90149659863945,96.73433106575963,26,21,331,3,308
1248,271,647,93.90149659863945,95.01605442176871,26,18,379,1,376
1249,271,632,93.90149659863945,95.8984126984127,26,17,371,2,361
1250,271,626,93.90149659863945,96.73433106575963,26,18,375,3,355
1251,244,6,95.06249433106576,96.3395918367347,27,50,244,1,238
1252,244,5,95.06249433106576,97.43092970521542,27,47,260,2,239
1253,244,233,95.06249433106576,96.73433106575963,27,25,73,2,11
1254,244,236,95.06249433106576,97.5934693877551,27,25,109,3,8
1255,244,579,95.06249433106576,96.73433106575963,27,21,343,2,335
1256,244,580,95.06249433106576,97.5934693877551,27,24,353,3,336
1257,244,626,95.06249433106576,96.73433106575963,27,18,389,2,382
1258,244,666,95.06249433106576,97.5934693877551,27,19,436,3,422
1259,218,6,95.2714739229025,96.3395918367347,31,50,217,1,212
1260,218,5,95.2714739229025,97.43092970521542,31,47,232,2,213
1261,218,233,95.2714739229025,96.73433106575963,31,25,65,1,15
1262,218,236,95.2714739229025,97.5934693877551,31,25,102,2,18
1263,218,579,95.2714739229025,96.73433106575963,31,21,366,1,361
1264,218,580,95.2714739229025,97.5934693877551,31,24,376,2,362
1265,218,626,95.2714739229025,96.73433106575963,31,18,413,1,408
1266,218,666,95.2714739229025,97.5934693877551,31,19,459,2,448
1267,233,6,96.73433106575963,99.12598639455783,25,47,249,2,227
1268,233,243,96.73433106575963,98.42938775510204,25,24,74,2,10
1269,233,454,96.73433106575963,98.47582766439909,25,22,233,2,221
1270,233,650,96.73433106575963,98.45260770975057,25,18,424,2,417
1271,233,688,96.73433106575963,99.52072562358276,25,17,471,3,455
1272,236,6,97.5934693877551,99.12598639455783,25,47,239,2,230
1273,236,6,97.5934693877551,99.79936507936507,25,49,249,2,230
1274,236,233,97.5934693877551,100.1708843537415,25,27,111,3,3
1275,236,578,97.5934693877551,100.1708843537415,25,21,360,3,342
1276,236,688,97.5934693877551,99.52072562358276,25,17,460,2,452
1277,243,6,98.42938775510204,99.79936507936507,24,49,244,1,237
1278,243,6,98.42938775510204,100.84426303854876,24,47,259,2,237
1279,243,233,98.42938775510204,100.1708843537415,24,27,76,2,10
1280,243,271,98.42938775510204,100.77460317460317,24,26,105,2,28
1281,243,578,98.42938775510204,100.1708843537415,24,21,343,2,335
1282,243,554,98.42938775510204,101.03002267573696,24,23,331,3,311
1283,243,688,98.42938775510204,99.52072562358276,24,17,447,1,445
1284,243,632,98.42938775510204,101.03002267573696,24,18,405,3,389
1285,233,8,100.1708843537415,102.16780045351474,27,47,241,2,225
1286,233,8,100.1708843537415,102.19102040816327,27,47,241,2,225
1287,233,339,100.1708843537415,101.88916099773243,27,25,129,2,106
1288,233,249,100.1708843537415,102.44643990929706,27,21,99,2,16
1289,233,453,100.1708843537415,101.88916099773243,27,21,232,2,220
1290,233,436,100.1708843537415,102.44643990929706,27,17,225,2,203
1291,233,632,100.1708843537415,101.88916099773243,27,19,406,2,399
1292,233,617,100.1708843537415,102.28390022675737,27,14,395,2,384
1293,271,8,100.77460317460317,102.16780045351474,26,47,270,1,263
1294,271,8,100.77460317460317,102.19102040816327,26,47,270,1,263
1295,271,6,100.77460317460317,103.35201814058958,26,45,287,3,265
1296,271,339,100.77460317460317,101.88916099773243,26,25,83,1,68
1297,271,249,100.77460317460317,102.44643990929706,26,21,75,2,22
1298,271,226,100.77460317460317,103.44489795918368,26,14,123,3,45
1299,271,453,100.77460317460317,101.88916099773243,26,21,188,1,182
1300,271,436,100.77460317460317,102.44643990929706,26,17,180,2,165
1301,271,632,100.77460317460317,101.88916099773243,26,19,364,1,361
1302,271,617,100.77460317460317,102.28390022675737,26,14,352,2,346
1303,271,619,100.77460317460317,103.44489795918368,26,12,367,3,348
1304,339,6,101.88916099773243,103.35201814058958,25,45,339,1,333
1305,339,226,101.88916099773243,103.44489795918368,25,14,131,2,113
1306,339,222,101.88916099773243,104.39691609977325,25,16,159,3,117
1307,339,590,101.88916099773243,103.86285714285715,25,12,265,2,251
1308,339,619,101.88916099773243,103.44489795918368,25,12,288,2,280
1309,249,42,102.44643990929706,105.16317460317461,21,39,238,3,207
1310,249,222,102.44643990929706,104.39691609977325,21,16,88,2,27
1311,249,590,102.44643990929706,103.86285714285715,21,12,346,1,341
1312,226,42,103.44489795918368,105.16317460317461,14,39,198,2,184
1313,226,42,103.44489795918368,105.46503401360545,14,39,204,2,184
1314,226,220,103.44489795918368,105.81333333333333,14,18,102,2,6
1315,226,562,103.44489795918368,105.83655328798186,14,14,351,2,336
1316,222,42,104.39691609977325,105.46503401360545,16,39,186,1,180
1317,222,30,104.39691609977325,106.62603174603174,16,37,215,2,192
1318,222,220,104.39691609977325,105.81333333333333,16,18,61,1,2
1319,222,562,104.39691609977325,105.83655328798186,16,14,346,1,340
1320,220,20,105.81333333333333,107.740589569161,18,36,217,2,200
1321,220,237,105.81333333333333,107.87990929705215,18,16,91,2,17
1322,220,217,105.81333333333333,108.48362811791384,18,20,115,3,3
1323,220,461,105.81333333333333,108.48362811791384,18,14,267,3,241
1324,237,30,107.87990929705215,110.10902494331066,16,38,228,2,207
1325,237,44,107.87990929705215,110.57342403628118,16,38,225,3,193
1326,237,262,107.87990929705215,109.73750566893425,16,17,84,2,25
1327,237,219,107.87990929705215,110.43410430839002,16,18,111,3,18
1328,237,582,107.87990929705215,110.78240362811792,16,16,367,3,345
1329,217,30,108.48362811791384,110.10902494331066,20,38,200,2,187
1330,217,44,108.48362811791384,110.57342403628118,20,38,195,2,173
1331,217,262,108.48362811791384,109.73750566893425,20,17,70,1,45
1332,217,219,108.48362811791384,110.43410430839002,20,18,84,2,2
1333,217,582,108.48362811791384,110.78240362811792,20,16,378,2,365
1334,262,41,109.73750566893425,111.54866213151928,17,39,234,2,221
1335,262,43,109.73750566893425,112.22204081632653,17,40,244,2,219
1336,262,219,109.73750566893425,112.15238095238095,17,20,113,2,43
1337,262,582,109.73750566893425,110.78240362811792,17,16,323,1,320
1338,262,487,109.73750566893425,112.15238095238095,17,17,248,2,225
1339,219,41,110.43410430839002,111.54866213151928,18,39,184,1,178
1340,219,43,110.43410430839002,112.22204081632653,18,40,192,2,176
1341,219,218,110.43410430839002,113.01151927437643,18,21,111,3,1
1342,219,487,110.43410430839002,112.15238095238095,18,17,278,2,268
1343,219,449,110.43410430839002,112.96507936507936,18,19,255,3,230
1344,219,31,112.15238095238095,113.47591836734694,20,37,196,1,188
1345,219,230,112.15238095238095,113.87065759637188,20,20,75,2,11
1346,219,486,112.15238095238095,113.87065759637188,20,17,277,2,267
1347,219,521,112.15238095238095,114.70657596371882,20,14,321,3,302
1348,219,626,112.15238095238095,114.10285714285715,20,12,416,2,407
1349,218,28,113.01151927437643,115.17097505668934,21,39,212,2,190
1350,218,27,113.01151927437643,115.26385487528344,21,40,214,2,191
1351,218,356,113.01151927437643,115.17097505668934,21,19,166,2,138
1352,218,355,113.01151927437643,115.82113378684808,21,23,183,3,137
1353,218,521,113.01151927437643,114.70657596371882,21,14,312,2,303
1354,218,598,113.01151927437643,115.37995464852608,21,18,393,2,380
1355,218,626,113.01151927437643,114.10285714285715,21,12,411,1,408
1356,218,624,113.01151927437643,115.70503401360544,21,12,422,3,406
1357,230,28,113.87065759637188,115.17097505668934,20,39,210,1,202
1358,230,27,113.87065759637188,115.26385487528344,20,40,212,1,203
1359,230,28,113.87065759637188,116.23909297052154,20,36,226,2,202
1360,230,356,113.87065759637188,115.17097505668934,20,19,138,1,126
1361,230,355,113.87065759637188,115.82113378684808,20,23,151,2,125
1362,230,355,113.87065759637188,116.23909297052154,20,19,161,2,125
1363,230,598,113.87065759637188,115.37995464852608,20,18,374,2,368
1364,230,624,113.87065759637188,115.70503401360544,20,12,402,2,394
1365,356,28,115.17097505668934,116.23909297052154,19,36,331,1,328
1366,356,72,115.17097505668934,117.77160997732426,19,41,305,3,284
1367,356,355,115.17097505668934,116.23909297052154,19,19,46,1,1
1368,356,205,115.17097505668934,117.51619047619047,19,35,182,2,151
1369,356,611,115.17097505668934,117.56263038548754,19,22,275,2,255
1370,356,652,115.17097505668934,117.56263038548754,19,25,313,2,296
1371,355,72,115.82113378684808,117.77160997732426,23,41,295,2,283
1372,355,6,115.82113378684808,118.63074829931973,23,47,369,3,349
1373,355,205,115.82113378684808,117.51619047619047,23,35,167,2,150
1374,355,611,115.82113378684808,117.56263038548754,23,22,267,2,256
1375,355,455,115.82113378684808,118.67718820861678,23,20,159,3,100
1376,355,652,115.82113378684808,117.56263038548754,23,25,306,2,297
1377,355,616,115.82113378684808,118.25922902494331,23,18,281,2,261
1378,355,72,116.23909297052154,117.77160997732426,19,41,291,2,283
1379,355,6,116.23909297052154,118.63074829931973,19,47,364,2,349
1380,355,205,116.23909297052154,117.51619047619047,19,35,160,1,150
1381,355,205,116.23909297052154,119.09514739229026,19,30,194,3,150
1382,355,611,116.23909297052154,117.56263038548754,19,22,262,1,256
1383,355,455,116.23909297052154,118.67718820861678,19,20,145,2,100
1384,355,652,116.23909297052154,117.56263038548754,19,25,302,1,297
1385,355,616,116.23909297052154,118.25922902494331,19,18,275,2,261
1386,205,6,117.51619047619047,118.63074829931973,35,47,205,1,199
1387,205,5,117.51619047619047,119.4898866213152,35,45,217,2,200
1388,205,9,117.51619047619047,120.46512471655329,35,44,234,3,196
1389,205,455,117.51619047619047,118.67718820861678,35,20,255,1,250
1390,205,449,117.51619047619047,119.25768707482993,35,22,255,2,244
1391,205,615,117.51619047619047,120.02394557823129,35,13,424,3,410
1392,205,649,117.51619047619047,120.27936507936508,35,19,460,3,444
1393,205,9,119.09514739229026,120.46512471655329,30,44,205,1,196
1394,205,6,119.09514739229026,122.06730158730159,30,49,237,3,199
1395,205,227,119.09514739229026,120.76698412698413,30,32,75,2,22
1396,205,258,119.09514739229026,121.34748299319727,30,28,111,2,53
1397,205,430,119.09514739229026,121.13850340136055,30,21,242,2,225
1398,205,465,119.09514739229026,121.69578231292518,30,23,283,3,260
1399,205,649,119.09514739229026,120.27936507936508,30,19,447,1,444
1400,205,618,119.09514739229026,121.2778231292517,30,20,424,2,413
1401,205,6,119.53632653061224,122.06730158730159,27,49,227,3,199
1402,205,227,119.53632653061224,120.76698412698413,27,32,57,1,22
1403,205,258,119.53632653061224,121.34748299319727,27,28,94,2,53
1404,205,227,119.53632653061224,122.27628117913832,27,29,120,3,22
1405,205,430,119.53632653061224,121.13850340136055,27,21,235,2,225
1406,205,465,119.53632653061224,121.69578231292518,27,23,276,2,260
1407,205,418,119.53632653061224,122.46204081632654,27,22,247,3,213
1408,205,618,119.53632653061224,121.2778231292517,27,20,420,2,413
1409,205,622,119.53632653061224,122.46204081632654,27,18,436,3,417
1410,227,6,120.76698412698413,122.06730158730159,32,49,228,1,221
1411,227,6,120.76698412698413,123.1354195011338,32,47,243,2,221
1412,227,6,120.76698412698413,123.55337868480726,32,47,251,3,221
1413,227,213,120.76698412698413,123.321179138322,32,28,111,3,14
1414,227,418,120.76698412698413,122.46204081632654,32,22,204,2,191
1415,227,554,120.76698412698413,123.321179138322,32,21,345,3,327
1416,227,622,120.76698412698413,122.46204081632654,32,18,402,2,395
1417,258,6,121.34748299319727,123.1354195011338,28,47,264,2,252
1418,258,6,121.34748299319727,123.55337868480726,28,47,269,2,252
1419,258,213,121.34748299319727,123.321179138322,28,28,96,2,45
1420,258,418,121.34748299319727,122.46204081632654,28,22,167,1,160
1421,258,554,121.34748299319727,123.321179138322,28,21,308,2,296
1422,258,622,121.34748299319727,122.46204081632654,28,18,367,1,364
1423,258,690,121.34748299319727,124.0409977324263,28,19,447,3,432
1424,227,6,122.27628117913832,123.55337868480726,29,47,228,1,221
1425,227,8,122.27628117913832,124.4821768707483,29,47,239,2,219
1426,227,213,122.27628117913832,123.321179138322,29,28,47,1,14
1427,227,205,122.27628117913832,124.34285714285714,29,33,92,2,22
1428,227,554,122.27628117913832,123.321179138322,29,21,330,1,327
1429,227,573,122.27628117913832,124.36607709750567,29,21,358,2,346
1430,227,690,122.27628117913832,124.0409977324263,29,19,469,2,463
1431,227,655,122.27628117913832,124.36607709750567,29,24,437,2,428
1432,213,8,123.321179138322,124.4821768707483,28,47,211,1,205
1433,213,6,123.321179138322,125.48063492063493,28,50,227,2,207
1434,213,205,123.321179138322,124.34285714285714,28,33,45,1,8
1435,213,205,123.321179138322,126.13079365079365,28,31,121,3,8
1436,213,573,123.321179138322,124.36607709750567,28,21,363,1,360
1437,213,579,123.321179138322,125.87537414965986,28,22,382,3,366
1438,213,655,123.321179138322,124.36607709750567,28,24,444,1,442
1439,213,626,123.321179138322,125.89859410430839,28,18,428,3,413
1440,205,6,124.34285714285714,125.48063492063493,33,50,205,1,199
1441,205,6,124.34285714285714,126.98993197278912,33,46,229,3,199
1442,205,579,124.34285714285714,125.87537414965986,33,22,380,2,374
1443,205,488,124.34285714285714,127.12925170068027,33,21,307,3,283
1444,205,626,124.34285714285714,125.89859410430839,33,18,426,2,421
1445,205,10,126.13079365079365,128.220589569161,31,45,215,2,195
1446,205,6,126.13079365079365,128.94040816326532,31,49,233,3,199
1447,205,257,126.13079365079365,128.19736961451247,31,27,103,2,52
1448,205,258,126.13079365079365,128.33668934240364,31,29,109,2,53
1449,205,579,126.13079365079365,127.5936507936508,31,21,379,1,374
1450,205,555,126.13079365079365,128.45278911564625,31,23,364,2,350
1451,205,626,126.13079365079365,127.5936507936508,31,18,426,1,421
1452,205,10,126.59519274376417,128.220589569161,29,45,207,2,195
1453,205,6,126.59519274376417,128.94040816326532,29,49,223,2,199
1454,205,257,126.59519274376417,128.19736961451247,29,27,86,2,52
1455,205,258,126.59519274376417,128.33668934240364,29,29,92,2,53
1456,205,555,126.59519274376417,128.45278911564625,29,23,359,2,350
1457,257,6,128.19736961451247,129.98530612244897,27,48,263,2,251
1458,257,6,128.19736961451247,130.426485260771,27,46,269,2,251
1459,257,554,128.19736961451247,130.1710657596372,27,23,309,2,297
1460,257,546,128.19736961451247,131.03020408163266,27,22,314,3,289
1461,257,632,128.19736961451247,130.1710657596372,27,20,385,2,375
1462,257,666,128.19736961451247,131.03020408163266,27,18,427,3,409
1463,258,6,128.33668934240364,129.98530612244897,29,48,262,2,252
1464,258,6,128.33668934240364,130.426485260771,29,46,268,2,252
1465,258,257,128.33668934240364,129.77632653061224,29,29,62,1,1
1466,258,211,128.33668934240364,131.19274376417235,29,27,132,3,47
1467,258,554,128.33668934240364,130.1710657596372,29,23,306,2,296
1468,258,546,128.33668934240364,131.03020408163266,29,22,310,3,288
1469,258,632,128.33668934240364,130.1710657596372,29,20,382,2,374
1470,258,666,128.33668934240364,131.03020408163266,29,18,424,3,408
1471,257,6,129.77632653061224,131.70358276643992,29,47,264,2,251
1472,257,6,129.77632653061224,132.35374149659864,29,50,274,3,251
1473,257,211,129.77632653061224,131.19274376417235,29,27,76,1,46
1474,257,217,129.77632653061224,131.72680272108843,29,27,93,2,40
1475,257,339,129.77632653061224,132.74848072562358,29,24,152,3,82
1476,257,546,129.77632653061224,131.03020408163266,29,22,294,1,289
1477,257,432,129.77632653061224,131.91256235827666,29,21,198,2,175
1478,257,480,129.77632653061224,132.74848072562358,29,21,257,3,223
1479,257,666,129.77632653061224,131.03020408163266,29,18,413,1,409
1480,257,642,129.77632653061224,131.86612244897958,29,18,395,2,385
1481,257,697,129.77632653061224,132.74848072562358,29,19,458,3,440
1482,211,6,131.19274376417235,132.35374149659864,27,50,211,1,205
1483,211,5,131.19274376417235,133.42185941043084,27,47,227,2,206
1484,211,339,131.19274376417235,132.74848072562358,27,24,144,2,128
1485,211,233,131.19274376417235,133.58439909297053,27,24,105,2,22
1486,211,480,131.19274376417235,132.74848072562358,27,21,277,2,269
1487,211,555,131.19274376417235,133.60761904761904,27,22,359,2,344
1488,211,697,131.19274376417235,132.74848072562358,27,19,491,2,486
1489,211,647,131.19274376417235,133.58439909297053,27,18,448,2,436
1490,217,5,131.72680272108843,133.42185941043084,27,47,224,2,212
1491,217,339,131.72680272108843,132.74848072562358,27,24,130,1,122
1492,217,233,131.72680272108843,133.58439909297053,27,24,82,2,16
1493,217,243,131.72680272108843,134.443537414966,27,24,120,3,26
1494,217,480,131.72680272108843,132.74848072562358,27,21,267,1,263
1495,217,555,131.72680272108843,133.60761904761904,27,22,348,2,338
1496,217,546,131.72680272108843,134.46675736961453,27,22,350,3,329
1497,217,697,131.72680272108843,132.74848072562358,27,19,482,1,480
1498,217,647,131.72680272108843,133.58439909297053,27,18,437,2,430
1499,217,649,131.72680272108843,134.443537414966,27,18,448,3,432
1500,339,6,132.74848072562358,135.14013605442176,24,47,349,2,333
1501,339,243,132.74848072562358,134.443537414966,24,24,121,2,96
1502,339,546,132.74848072562358,134.46675736961453,24,22,220,2,207
1503,339,649,132.74848072562358,134.443537414966,24,18,318,2,310
1504,339,832,132.74848072562358,134.443537414966,24,13,498,2,493
1505,339,833,132.74848072562358,135.32589569161,24,14,506,3,494
1506,233,6,133.58439909297053,135.14013605442176,24,47,237,2,227
1507,233,6,133.58439909297053,135.7902947845805,24,50,246,2,227
1508,233,546,133.58439909297053,136.1618140589569,24,22,332,3,313
1509,233,647,133.58439909297053,136.1618140589569,24,19,429,3,414
1510,243,6,134.443537414966,135.7902947845805,24,50,244,1,237
1511,243,6,134.443537414966,136.83519274376417,24,47,258,2,237
1512,243,233,134.443537414966,136.1618140589569,24,25,75,2,10
1513,243,271,134.443537414966,136.7655328798186,24,27,104,2,28
1514,243,546,134.443537414966,136.1618140589569,24,22,312,2,303
1515,243,580,134.443537414966,137.0209523809524,24,21,355,3,337
1516,243,647,134.443537414966,136.1618140589569,24,19,411,2,404
1517,243,649,134.443537414966,137.0209523809524,24,18,421,3,406
1518,233,8,136.1618140589569,138.1819501133787,25,47,241,2,225
1519,233,218,136.1618140589569,138.13551020408164,25,32,86,2,15
1520,233,218,136.1618140589569,138.57668934240363,25,31,105,2,15
1521,233,546,136.1618140589569,137.88009070294785,25,23,322,2,313
1522,233,425,136.1618140589569,138.87854875283446,25,20,225,3,192
1523,233,632,136.1618140589569,137.88009070294785,25,17,406,2,399
1524,233,639,136.1618140589569,138.7392290249433,25,18,421,3,406
1525,271,8,136.7655328798186,138.1819501133787,27,47,270,1,263
1526,271,6,136.7655328798186,139.20362811791384,27,50,285,2,265
1527,271,5,136.7655328798186,139.41260770975057,27,46,289,3,266
1528,271,218,136.7655328798186,138.13551020408164,27,32,79,1,53
1529,271,218,136.7655328798186,138.57668934240363,27,31,94,2,53
1530,271,233,136.7655328798186,139.59836734693877,27,26,128,3,38
1531,271,546,136.7655328798186,137.88009070294785,27,23,279,1,275
1532,271,425,136.7655328798186,138.87854875283446,27,20,179,2,154
1533,271,453,136.7655328798186,139.59836734693877,27,22,219,3,182
1534,271,632,136.7655328798186,137.88009070294785,27,17,364,1,361
1535,271,639,136.7655328798186,138.7392290249433,27,18,378,2,368
1536,271,666,136.7655328798186,139.59836734693877,27,19,413,3,395
1537,218,6,138.13551020408164,139.20362811791384,32,50,217,1,212
1538,218,5,138.13551020408164,139.41260770975057,32,46,220,1,213
1539,218,6,138.13551020408164,140.27174603174603,32,47,231,2,212
1540,218,233,138.13551020408164,139.59836734693877,32,26,65,1,15
1541,218,235,138.13551020408164,140.45750566893423,32,25,101,2,17
1542,218,453,138.13551020408164,139.59836734693877,32,22,243,1,235
1543,218,493,138.13551020408164,140.45750566893423,32,22,293,2,275
1544,218,666,138.13551020408164,139.59836734693877,32,19,452,1,448
1545,218,666,138.13551020408164,140.45750566893423,32,18,459,2,448
1546,218,6,138.57668934240363,140.27174603174603,31,47,224,2,212
1547,218,233,138.57668934240363,139.59836734693877,31,26,46,1,15
1548,218,235,138.57668934240363,140.45750566893423,31,25,83,2,17
1549,218,453,138.57668934240363,139.59836734693877,31,22,239,1,235
1550,218,493,138.57668934240363,140.45750566893423,31,22,287,2,275
1551,218,546,138.57668934240363,141.31664399092972,31,22,349,3,328
1552,218,666,138.57668934240363,139.59836734693877,31,19,450,1,448
1553,218,666,138.57668934240363,140.45750566893423,31,18,455,2,448
1554,233,6,139.59836734693877,141.99002267573695,26,47,249,2,227
1555,233,546,139.59836734693877,141.31664399092972,26,22,322,2,313
1556,233,697,139.59836734693877,142.17578231292518,26,18,477,3,464
1557,233,688,139.59836734693877,142.38476190476192,26,19,471,3,455
1558,235,6,140.45750566893423,141.99002267573695,25,47,238,2,229
1559,235,6,140.45750566893423,142.6401814058957,25,49,248,2,229
1560,235,233,140.45750566893423,142.15256235827664,25,26,73,2,2
1561,235,233,140.45750566893423,143.03492063492064,25,25,111,3,2
1562,235,555,140.45750566893423,143.03492063492064,25,21,339,3,320
1563,235,697,140.45750566893423,142.17578231292518,25,18,468,2,462
1564,235,688,140.45750566893423,142.38476190476192,25,19,461,2,453
1565,233,6,142.15256235827664,144.14947845804988,26,49,243,2,227
1566,233,7,142.15256235827664,144.28879818594103,26,43,244,2,226
1567,233,271,142.15256235827664,143.6386394557823,26,27,74,1,38
1568,233,216,142.15256235827664,144.91573696145124,26,26,120,3,17
1569,233,493,142.15256235827664,143.8708390022676,26,22,270,2,260
1570,233,632,142.15256235827664,143.8940589569161,26,19,406,2,399
1571,233,6,143.03492063492064,144.14947845804988,25,49,232,1,227
1572,233,7,143.03492063492064,144.28879818594103,25,43,232,1,226
1573,233,216,143.03492063492064,144.91573696145124,25,26,83,2,17
1574,233,217,143.03492063492064,145.42657596371882,25,28,104,2,16
1575,233,493,143.03492063492064,145.24081632653062,25,19,277,2,260
1576,233,574,143.03492063492064,145.28725623582767,25,15,355,2,341
1577,233,657,143.03492063492064,145.24081632653062,25,16,435,2,424
1578,233,629,143.03492063492064,145.28725623582767,25,16,408,2,396
1579,271,7,143.6386394557823,146.14639455782313,27,45,285,3,264
1580,271,3,143.6386394557823,146.30893424036282,27,44,292,3,268
1581,271,216,143.6386394557823,144.91573696145124,27,26,78,1,55
1582,271,217,143.6386394557823,145.42657596371882,27,28,94,2,54
1583,271,246,143.6386394557823,146.28571428571428,27,24,117,3,25
1584,271,493,143.6386394557823,145.24081632653062,27,19,232,2,222
1585,271,574,143.6386394557823,145.28725623582767,27,15,311,2,303
1586,271,411,143.6386394557823,146.28571428571428,27,15,181,3,140
1587,271,657,143.6386394557823,145.24081632653062,27,16,392,2,386
1588,271,629,143.6386394557823,145.28725623582767,27,16,365,2,358
1589,216,7,144.91573696145124,146.14639455782313,26,45,216,1,209
1590,216,3,144.91573696145124,146.30893424036282,26,44,221,1,213
1591,216,14,144.91573696145124,147.30739229024942,26,41,227,2,202
1592,216,246,144.91573696145124,146.28571428571428,26,24,66,1,30
1593,216,253,144.91573696145124,147.7021315192744,26,18,126,3,37
1594,216,411,144.91573696145124,146.28571428571428,26,15,204,1,195
1595,217,14,145.42657596371882,147.30739229024942,28,41,219,2,203
1596,217,2,145.42657596371882,148.30585034013606,28,20,248,3,215
1597,217,253,145.42657596371882,147.7021315192744,28,18,104,2,36
1598,246,14,146.28571428571428,147.30739229024942,24,41,236,1,232
1599,246,2,146.28571428571428,148.30585034013606,24,20,259,2,244
1600,246,253,146.28571428571428,147.7021315192744,24,18,61,1,7
1601,500,5,6.965986394557823,8.70748299319728,13,46,501,2,495
1602,500,41,6.965986394557823,9.079002267573696,13,40,468,2,459
1603,500,246,6.965986394557823,8.452063492063493,13,24,262,1,254
1604,500,219,6.965986394557823,9.287981859410431,13,23,298,2,281
1605,500,587,6.965986394557823,8.846802721088435,13,15,119,2,87
1606,500,485,6.965986394557823,9.311201814058958,13,17,102,2,15
1607,500,771,6.965986394557823,8.614603174603175,13,19,280,2,271
1608,500,893,6.965986394557823,8.6378231292517,13,20,400,2,393
1609,486,5,7.592925170068027,8.70748299319728,18,46,483,1,481
1610,486,41,7.592925170068027,9.079002267573696,18,40,450,1,445
1611,486,219,7.592925170068027,9.287981859410431,18,23,277,2,267
1612,486,252,7.592925170068027,10.170340136054422,18,21,259,3,234
1613,486,587,7.592925170068027,8.846802721088435,18,15,115,1,101
1614,486,485,7.592925170068027,9.311201814058958,18,17,74,2,1
1615,486,771,7.592925170068027,8.614603174603175,18,19,288,1,285
1616,486,893,7.592925170068027,8.6378231292517,18,20,409,1,407
1617,486,834,7.592925170068027,10.54185941043084,18,18,370,3,348
1618,587,252,8.846802721088435,10.170340136054422,15,21,340,1,335
1619,587,536,8.846802721088435,10.866938775510205,15,17,101,2,51
1620,587,485,8.846802721088435,11.00625850340136,15,19,138,2,102
1621,587,784,8.846802721088435,10.866938775510205,15,17,215,2,197
1622,587,759,8.846802721088435,11.331337868480725,15,15,203,2,172
1623,587,834,8.846802721088435,10.54185941043084,15,18,258,2,247
1624,587,839,8.846802721088435,11.261678004535147,15,13,273,2,252
1625,485,5,9.311201814058958,10.634739229024943,17,46,483,1,480
1626,485,5,9.311201814058958,11.702857142857143,17,46,491,2,480
1627,485,5,9.311201814058958,12.144036281179138,17,46,495,3,480
1628,485,210,9.311201814058958,11.865396825396825,17,22,296,3,275
1629,485,536,9.311201814058958,10.866938775510205,17,17,84,2,51
1630,485,784,9.311201814058958,10.866938775510205,17,17,306,2,299
1631,485,759,9.311201814058958,11.331337868480725,17,15,287,2,274
1632,485,834,9.311201814058958,10.54185941043084,17,18,353,1,349
1633,485,839,9.311201814058958,11.261678004535147,17,13,364,2,354
1634,536,61,10.866938775510205,13.374693877551021,17,44,487,3,475
1635,536,219,10.866938775510205,12.329795918367347,17,32,323,1,317
1636,536,227,10.866938775510205,13.583673469387755,17,22,330,3,309
1637,536,586,10.866938775510205,12.329795918367347,17,21,80,1,50
1638,536,578,10.866938775510205,13.049614512471656,17,17,103,2,42
1639,536,768,10.866938775510205,12.353015873015874,17,20,241,1,232
1640,536,935,10.866938775510205,12.701315192743765,17,15,407,2,399
1641,485,5,11.00625850340136,12.144036281179138,19,46,482,1,480
1642,485,61,11.00625850340136,13.374693877551021,19,44,436,2,424
1643,485,219,11.00625850340136,12.329795918367347,19,32,272,1,266
1644,485,227,11.00625850340136,13.583673469387755,19,22,281,3,258
1645,485,586,11.00625850340136,12.329795918367347,19,21,116,1,101
1646,485,578,11.00625850340136,13.049614512471656,19,17,128,2,93
1647,485,768,11.00625850340136,12.353015873015874,19,20,289,1,283
1648,485,791,11.00625850340136,13.908752834467121,19,19,331,3,306
1649,485,935,11.00625850340136,12.701315192743765,19,15,456,2,450
1650,485,901,11.00625850340136,13.862312925170068,19,17,434,3,416
1651,586,227,12.329795918367347,13.583673469387755,21,22,363,1,359
1652,586,219,12.329795918367347,14.442811791383221,21,22,378,2,367
1653,586,252,12.329795918367347,15.301950113378686,21,21,358,3,334
1654,586,481,12.329795918367347,14.442811791383221,21,18,139,2,105
1655,586,583,12.329795918367347,15.069750566893424,21,17,118,3,3
1656,586,791,12.329795918367347,13.908752834467121,21,19,216,2,205
1657,586,713,12.329795918367347,14.814331065759637,21,19,166,2,127
1658,586,901,12.329795918367347,13.862312925170068,21,17,322,2,315
1659,586,859,12.329795918367347,14.814331065759637,21,19,293,2,273
1660,578,219,13.049614512471656,14.442811791383221,17,22,364,1,359
1661,578,252,13.049614512471656,15.301950113378686,17,21,340,2,326
1662,578,481,13.049614512471656,14.442811791383221,17,18,114,1,97
1663,578,583,13.049614512471656,15.069750566893424,17,17,87,2,5
1664,578,713,13.049614512471656,14.814331065759637,17,19,155,2,135
1665,578,814,13.049614512471656,15.464489795918368,17,17,258,2,236
1666,578,859,13.049614512471656,14.814331065759637,17,19,291,2,281
1667,578,966,13.049614512471656,15.487709750566895,17,19,402,2,388
1668,481,40,14.442811791383221,16.021768707482995,18,38,446,2,441
1669,481,224,14.442811791383221,16.16108843537415,18,21,267,2,257
1670,481,482,14.442811791383221,16.16108843537415,18,19,74,2,1
1671,481,814,14.442811791383221,15.464489795918368,18,17,336,1,333
1672,481,736,14.442811791383221,16.904126984126986,18,16,276,2,255
1673,481,734,14.442811791383221,17.322086167800453,18,17,282,3,253
1674,481,966,14.442811791383221,15.487709750566895,18,19,487,1,485
1675,481,902,14.442811791383221,16.973786848072564,18,20,435,3,421
1676,481,888,14.442811791383221,17.29886621315193,18,15,425,3,407
1677,583,224,15.069750566893424,16.16108843537415,17,21,362,1,359
1678,583,206,15.069750566893424,17.623945578231293,17,29,393,3,377
1679,583,482,15.069750566893424,16.16108843537415,17,19,111,1,101
1680,583,447,15.069750566893424,17.670385487528346,17,19,176,3,136
1681,583,736,15.069750566893424,16.904126984126986,17,16,172,2,153
1682,583,734,15.069750566893424,17.322086167800453,17,17,179,2,151
1683,583,902,15.069750566893424,16.973786848072564,17,20,329,2,319
1684,583,888,15.069750566893424,17.29886621315193,17,15,320,2,305
1685,482,5,16.16108843537415,17.484625850340137,19,46,480,1,477
1686,482,5,16.16108843537415,18.993922902494333,19,46,492,3,477
1687,482,206,16.16108843537415,17.623945578231293,19,29,283,1,276
1688,482,213,16.16108843537415,18.64562358276644,19,29,289,2,269
1689,482,447,16.16108843537415,17.670385487528346,19,19,74,2,35
1690,482,581,16.16108843537415,18.854603174603174,19,15,153,3,99
1691,482,734,16.16108843537415,17.322086167800453,19,17,257,1,252
1692,482,638,16.16108843537415,18.901043083900227,19,15,196,3,156
1693,482,888,16.16108843537415,17.29886621315193,19,15,409,1,406
1694,482,954,16.16108843537415,18.901043083900227,19,16,487,3,472
1695,447,5,17.670385487528346,18.993922902494333,19,46,446,1,442
1696,447,37,17.670385487528346,20.01560090702948,19,43,422,2,410
1697,447,205,17.670385487528346,19.806621315192743,19,37,259,2,242
1698,447,205,17.670385487528346,20.29424036281179,19,32,267,3,242
1699,447,581,17.670385487528346,18.854603174603174,19,15,143,1,134
1700,447,573,17.670385487528346,19.806621315192743,19,23,156,2,126
1701,447,438,17.670385487528346,20.59609977324263,19,21,126,3,9
1702,447,638,17.670385487528346,18.901043083900227,19,15,198,1,191
1703,447,652,17.670385487528346,19.853061224489796,19,25,226,2,205
1704,447,616,17.670385487528346,20.54965986394558,19,19,210,3,169
1705,581,205,18.854603174603174,20.29424036281179,15,32,381,1,376
1706,581,208,18.854603174603174,21.339138321995467,15,30,388,2,373
1707,581,438,18.854603174603174,20.59609977324263,15,21,161,2,143
1708,581,485,18.854603174603174,21.08371882086168,15,22,136,2,96
1709,581,616,18.854603174603174,20.54965986394558,15,19,81,2,35
1710,581,626,18.854603174603174,21.31591836734694,15,20,115,2,45
1711,581,833,18.854603174603174,21.292698412698414,15,13,273,2,252
1712,573,208,19.806621315192743,21.339138321995467,23,30,371,2,365
1713,573,205,19.806621315192743,22.709115646258503,23,27,389,3,368
1714,573,485,19.806621315192743,21.08371882086168,23,22,104,1,88
1715,573,453,19.806621315192743,22.175056689342405,23,22,157,2,120
1716,573,626,19.806621315192743,21.31591836734694,23,20,84,2,53
1717,573,833,19.806621315192743,21.292698412698414,23,13,268,1,260
1718,573,827,19.806621315192743,22.569795918367348,23,15,280,3,254
1719,438,5,20.59609977324263,21.989297052154196,21,46,437,1,433
1720,438,6,20.59609977324263,22.407256235827663,21,46,439,2,432
1721,438,205,20.59609977324263,22.709115646258503,21,27,250,2,233
1722,438,226,20.59609977324263,23.057414965986396,21,32,237,2,212
1723,438,453,20.59609977324263,22.175056689342405,21,22,70,2,15
1724,438,571,20.59609977324263,23.034195011337868,21,21,169,2,133
1725,438,650,20.59609977324263,23.010975056689343,21,20,236,2,212
1726,438,618,20.59609977324263,23.56825396825397,21,21,221,3,180
1727,438,827,20.59609977324263,22.569795918367348,21,15,398,2,389
1728,485,6,21.08371882086168,22.407256235827663,22,46,482,1,479
1729,485,6,21.08371882086168,23.707573696145126,22,46,492,3,479
1730,485,205,21.08371882086168,22.709115646258503,22,27,289,2,280
1731,485,226,21.08371882086168,23.057414965986396,22,32,273,2,259
1732,485,453,21.08371882086168,22.175056689342405,22,22,57,1,32
1733,485,571,21.08371882086168,23.034195011337868,22,21,120,2,86
1734,485,650,21.08371882086168,23.010975056689343,22,20,185,2,165
1735,485,618,21.08371882086168,23.56825396825397,22,21,171,2,133
1736,485,827,21.08371882086168,22.569795918367348,22,15,348,1,342
1737,485,832,21.08371882086168,23.870113378684806,22,13,367,3,347
1738,453,6,22.175056689342405,23.707573696145126,22,46,452,2,447
1739,453,6,22.175056689342405,24.357732426303855,22,50,457,2,447
1740,453,227,22.175056689342405,24.56671201814059,22,28,248,2,226
1741,453,580,22.175056689342405,24.729251700680273,22,21,168,3,127
1742,453,618,22.175056689342405,23.56825396825397,22,21,176,1,165
1743,453,647,22.175056689342405,24.729251700680273,22,18,223,3,194
1744,453,832,22.175056689342405,23.870113378684806,22,13,386,2,379
1745,453,826,22.175056689342405,24.49705215419501,22,16,386,2,373
1746,571,227,23.034195011337868,24.56671201814059,21,28,350,2,344
1747,571,212,23.034195011337868,25.611609977324264,21,29,376,3,359
1748,571,580,23.034195011337868,24.729251700680273,21,21,74,2,9
1749,571,511,23.034195011337868,25.26331065759637,21,21,113,2,60
1750,571,647,23.034195011337868,24.729251700680273,21,18,105,2,76
1751,571,626,23.034195011337868,25.611609977324264,21,18,124,3,55
1752,571,826,23.034195011337868,24.49705215419501,21,16,263,1,255
1753,571,918,23.034195011337868,25.58839002267574,21,13,364,3,347
1754,580,205,24.729251700680273,26.749387755102042,21,32,385,2,375
1755,580,205,24.729251700680273,27.16734693877551,21,33,389,2,375
1756,580,431,24.729251700680273,26.33142857142857,21,22,164,2,149
1757,580,437,24.729251700680273,27.30666666666667,21,20,181,3,143
1758,580,652,24.729251700680273,26.70294784580499,21,23,111,2,72
1759,580,616,24.729251700680273,27.376326530612246,21,18,120,3,36
1760,580,908,24.729251700680273,26.33142857142857,21,17,335,2,328
1761,580,832,24.729251700680273,27.30666666666667,21,12,275,3,252
1762,511,205,25.26331065759637,26.749387755102042,21,32,313,1,306
1763,511,205,25.26331065759637,27.16734693877551,21,33,317,2,306
1764,511,431,25.26331065759637,26.33142857142857,21,22,92,1,80
1765,511,437,25.26331065759637,27.30666666666667,21,20,115,2,74
1766,511,652,25.26331065759637,26.70294784580499,21,23,154,1,141
1767,511,616,25.26331065759637,27.376326530612246,21,18,139,2,105
1768,511,622,25.26331065759637,28.18902494331066,21,19,168,3,111
1769,511,908,25.26331065759637,26.33142857142857,21,17,400,1,397
1770,511,832,25.26331065759637,27.30666666666667,21,12,333,2,321
1771,511,832,25.26331065759637,28.16580498866213,21,14,344,3,321
1772,431,6,26.33142857142857,27.77106575963719,22,50,429,1,425
1773,431,5,26.33142857142857,28.862403628117914,22,46,440,3,426
1774,431,6,26.33142857142857,29.257142857142856,22,46,443,3,425
1775,431,205,26.33142857142857,28.328344671201815,22,33,242,2,226
1776,431,205,26.33142857142857,29.094603174603176,22,28,255,3,226
1777,431,449,26.33142857142857,28.444444444444446,22,22,93,2,18
1778,431,616,26.33142857142857,27.376326530612246,22,18,190,1,185
1779,431,622,26.33142857142857,28.18902494331066,22,19,207,2,191
1780,431,832,26.33142857142857,28.16580498866213,22,14,409,2,401
1781,437,5,27.30666666666667,28.862403628117914,20,46,437,2,432
1782,437,6,27.30666666666667,29.257142857142856,20,46,439,2,431
1783,437,205,27.30666666666667,28.328344671201815,20,33,236,1,232
1784,437,205,27.30666666666667,29.094603174603176,20,28,244,2,232
1785,437,449,27.30666666666667,28.444444444444446,20,22,50,1,12
1786,437,614,27.30666666666667,29.930521541950114,20,22,210,3,177
1787,437,777,27.30666666666667,29.396462585034016,20,21,352,2,340
1788,437,830,27.30666666666667,29.396462585034016,20,21,403,2,393
1789,449,6,28.444444444444446,30.55746031746032,22,46,452,2,443
1790,449,6,28.444444444444446,31.207619047619048,22,49,459,3,443
1791,449,258,28.444444444444446,30.60390022675737,22,28,212,2,191
1792,449,614,28.444444444444446,29.930521541950114,22,22,177,1,165
1793,449,554,28.444444444444446,30.743219954648527,22,23,144,2,105
1794,449,729,28.444444444444446,30.83609977324263,22,22,298,2,280
1795,449,716,28.444444444444446,31.32371882086168,22,19,294,3,267
1796,449,824,28.444444444444446,30.83609977324263,22,18,389,2,375
1797,449,848,28.444444444444446,31.32371882086168,22,17,418,3,399
1798,614,233,29.930521541950114,31.60235827664399,22,24,388,2,381
1799,614,257,29.930521541950114,32.066757369614514,22,28,369,2,357
1800,614,555,29.930521541950114,31.60235827664399,22,22,93,2,59
1801,614,546,29.930521541950114,32.46149659863946,22,21,128,3,68
1802,614,716,29.930521541950114,31.32371882086168,22,19,118,1,102
1803,614,632,29.930521541950114,32.46149659863946,22,19,110,3,18
1804,614,848,29.930521541950114,31.32371882086168,22,17,242,1,234
1805,614,832,29.930521541950114,32.43827664399093,22,16,243,3,218
1806,554,257,30.743219954648527,32.066757369614514,23,28,302,1,297
1807,554,211,30.743219954648527,33.483174603174604,23,28,363,3,343
1808,554,546,30.743219954648527,32.46149659863946,23,21,74,2,8
1809,554,632,30.743219954648527,32.46149659863946,23,19,108,2,78
1810,554,832,30.743219954648527,32.43827664399093,23,16,287,2,278
1811,555,211,31.60235827664399,33.483174603174604,22,28,353,2,344
1812,555,500,31.60235827664399,33.97079365079365,22,17,116,2,55
1813,555,689,31.60235827664399,33.97079365079365,22,19,168,2,134
1814,546,54,32.46149659863946,33.85469387755102,21,38,496,1,492
1815,546,211,32.46149659863946,33.483174603174604,21,28,338,1,335
1816,546,233,32.46149659863946,35.015691609977324,21,25,332,3,313
1817,546,500,32.46149659863946,33.97079365079365,21,17,80,2,46
1818,546,555,32.46149659863946,35.015691609977324,21,20,110,3,9
1819,546,689,32.46149659863946,33.97079365079365,21,19,157,2,143
1820,546,632,32.46149659863946,35.03891156462585,21,19,140,3,86
1821,546,832,32.46149659863946,35.015691609977324,21,15,306,3,286
1822,500,5,33.97079365079365,35.71229024943311,17,47,501,2,495
1823,500,6,33.97079365079365,36.13024943310658,17,46,503,2,494
1824,500,233,33.97079365079365,35.015691609977324,17,25,271,1,267
1825,500,233,33.97079365079365,35.87482993197279,17,25,279,2,267
1826,500,233,33.97079365079365,36.73396825396826,17,25,292,3,267
1827,500,555,33.97079365079365,35.015691609977324,17,20,71,1,55
1828,500,580,33.97079365079365,35.87482993197279,17,21,115,2,80
1829,500,580,33.97079365079365,36.73396825396826,17,22,143,3,80
1830,500,632,33.97079365079365,35.03891156462585,17,19,140,1,132
1831,500,685,33.97079365079365,35.87482993197279,17,17,202,2,185
1832,500,632,33.97079365079365,36.75718820861678,17,19,178,3,132
1833,500,832,33.97079365079365,35.015691609977324,17,15,335,1,332
1834,500,832,33.97079365079365,35.87482993197279,17,15,342,2,332
1835,500,832,33.97079365079365,36.73396825396826,17,12,353,3,332
1836,555,233,35.015691609977324,36.73396825396826,20,25,330,2,322
1837,555,243,35.015691609977324,37.593106575963716,20,25,331,3,312
1838,555,580,35.015691609977324,36.73396825396826,20,22,78,2,25
1839,555,579,35.015691609977324,37.593106575963716,20,22,114,3,24
1840,555,632,35.015691609977324,36.75718820861678,20,19,107,2,77
1841,555,650,35.015691609977324,37.593106575963716,20,17,146,3,95
1842,555,832,35.015691609977324,36.73396825396826,20,12,287,2,277
1843,580,243,35.87482993197279,37.593106575963716,21,25,345,2,337
1844,580,579,35.87482993197279,37.593106575963716,21,22,74,2,1
1845,580,579,35.87482993197279,38.45224489795918,21,22,111,3,1
1846,580,650,35.87482993197279,37.593106575963716,21,17,102,2,70
1847,580,626,35.87482993197279,38.45224489795918,21,18,120,3,46
1848,580,271,36.73396825396826,39.05596371882086,22,27,325,2,309
1849,580,271,36.73396825396826,39.07918367346939,22,25,325,2,309
1850,580,579,36.73396825396826,38.45224489795918,22,22,74,2,1
1851,580,579,36.73396825396826,39.31138321995465,22,21,111,3,1
1852,580,626,36.73396825396826,38.45224489795918,22,18,87,2,46
1853,580,632,36.73396825396826,39.31138321995465,22,18,123,3,52
1854,580,832,36.73396825396826,39.31138321995465,22,13,275,3,252
1855,579,271,37.593106575963716,39.05596371882086,22,27,314,1,308
1856,579,271,37.593106575963716,39.07918367346939,22,25,315,1,308
1857,579,218,37.593106575963716,40.4259410430839,22,30,381,3,361
1858,579,632,37.593106575963716,39.31138321995465,22,18,91,2,53
1859,579,632,37.593106575963716,40.170521541950116,22,18,123,3,53
1860,579,832,37.593106575963716,39.31138321995465,22,13,264,2,253
1861,579,832,37.593106575963716,40.170521541950116,22,13,276,3,253
1862,579,218,38.45224489795918,40.4259410430839,22,30,371,2,361
1863,579,453,38.45224489795918,41.02965986394558,22,22,168,3,126
1864,579,632,38.45224489795918,40.170521541950116,22,18,91,2,53
1865,579,832,38.45224489795918,40.170521541950116,22,13,264,2,253
1866,579,218,39.31138321995465,40.4259410430839,21,30,364,1,361
1867,579,233,39.31138321995465,41.88879818594104,21,25,363,3,346
1868,579,453,39.31138321995465,41.02965986394558,21,22,146,2,126
1869,579,453,39.31138321995465,41.88879818594104,21,22,168,3,126
1870,579,632,39.31138321995465,41.88879818594104,21,19,123,3,53
1871,579,835,39.31138321995465,41.86557823129252,21,12,279,3,256
1872,453,5,41.02965986394558,42.5621768707483,22,48,453,2,448
1873,453,5,41.02965986394558,43.165895691609975,22,44,457,2,448
1874,453,212,41.02965986394558,42.72471655328798,22,24,252,2,241
1875,453,233,41.02965986394558,43.58385487528345,22,25,246,3,220
1876,453,554,41.02965986394558,42.74793650793651,22,22,125,2,101
1877,453,666,41.02965986394558,42.74793650793651,22,18,225,2,213
1878,453,647,41.02965986394558,43.58385487528345,22,19,223,3,194
1879,453,832,41.02965986394558,42.74793650793651,22,13,386,2,379
1880,453,832,41.02965986394558,43.607074829931975,22,13,395,3,379
1881,453,5,41.88879818594104,43.165895691609975,22,44,451,1,448
1882,453,233,41.88879818594104,43.58385487528345,22,25,232,2,220
1883,453,224,41.88879818594104,44.46621315192744,22,27,254,3,229
1884,453,579,41.88879818594104,44.44299319727891,22,21,167,3,126
1885,453,647,41.88879818594104,43.58385487528345,22,19,207,2,194
1886,453,688,41.88879818594104,44.67519274376417,22,18,264,3,235
1887,453,832,41.88879818594104,43.607074829931975,22,13,386,2,379
1888,453,832,41.88879818594104,44.44299319727891,22,13,395,3,379
1889,554,224,42.74793650793651,44.46621315192744,22,27,338,2,330
1890,554,579,42.74793650793651,44.44299319727891,22,21,77,2,25
1891,554,493,42.74793650793651,45.302131519274376,22,21,126,3,61
1892,554,688,42.74793650793651,44.67519274376417,22,18,158,2,134
1893,554,681,42.74793650793651,45.302131519274376,22,17,168,3,127
1894,554,832,42.74793650793651,44.44299319727891,22,13,287,2,278
1895,554,835,42.74793650793651,45.302131519274376,22,13,302,3,281
1896,453,6,43.607074829931975,44.93061224489796,23,50,451,1,447
1897,453,6,43.607074829931975,45.97551020408164,23,47,458,2,447
1898,453,6,43.607074829931975,46.41668934240363,23,47,463,3,447
1899,453,271,43.607074829931975,45.905850340136055,23,26,207,2,182
1900,453,233,43.607074829931975,46.16126984126984,23,25,246,3,220
1901,453,493,43.607074829931975,45.302131519274376,23,21,83,2,40
1902,453,454,43.607074829931975,46.18448979591837,23,21,111,3,1
1903,453,688,43.607074829931975,44.67519274376417,23,18,239,1,235
1904,453,681,43.607074829931975,45.302131519274376,23,17,239,2,228
1905,453,647,43.607074829931975,46.16126984126984,23,19,223,3,194
1906,453,835,43.607074829931975,45.302131519274376,23,13,389,2,382
1907,453,832,43.607074829931975,46.16126984126984,23,17,395,3,379
1908,579,271,44.44299319727891,45.905850340136055,21,26,314,1,308
1909,579,233,44.44299319727891,46.16126984126984,21,25,354,2,346
1910,579,275,44.44299319727891,47.25260770975057,21,22,327,3,304
1911,579,454,44.44299319727891,46.18448979591837,21,21,146,2,125
1912,579,647,44.44299319727891,46.16126984126984,21,19,100,2,68
1913,579,832,44.44299319727891,46.16126984126984,21,17,264,2,253
1914,493,6,45.302131519274376,46.41668934240363,21,47,489,1,487
1915,493,9,45.302131519274376,47.879546485260775,21,41,497,3,484
1916,493,275,45.302131519274376,47.25260770975057,21,22,234,2,218
1917,493,474,45.302131519274376,47.69378684807256,21,17,105,2,19
1918,454,9,46.18448979591837,47.879546485260775,21,41,451,2,445
1919,454,65,46.18448979591837,48.808344671201816,21,45,405,3,389
1920,454,275,46.18448979591837,47.25260770975057,21,22,185,1,179
1921,454,329,46.18448979591837,48.36716553287982,21,24,156,2,125
1922,454,474,46.18448979591837,47.69378684807256,21,17,68,2,20
1923,454,421,46.18448979591837,48.529705215419504,21,17,106,2,33
1924,454,762,46.18448979591837,49.0637641723356,21,15,332,3,308
1925,454,719,46.18448979591837,49.11020408163265,21,19,293,3,265
1926,454,827,46.18448979591837,49.0637641723356,21,16,393,3,373
1927,474,65,47.69378684807256,48.808344671201816,17,45,412,1,409
1928,474,73,47.69378684807256,49.96934240362812,17,44,413,2,401
1929,474,41,47.69378684807256,50.24798185941043,17,42,447,3,433
1930,474,220,47.69378684807256,50.0390022675737,17,21,273,2,254
1931,474,220,47.69378684807256,50.665941043083905,17,26,284,3,254
1932,474,451,47.69378684807256,49.5978231292517,17,17,85,2,23
1933,474,451,47.69378684807256,50.45696145124717,17,18,121,3,23
1934,474,762,47.69378684807256,49.0637641723356,17,15,294,1,288
1935,474,719,47.69378684807256,49.11020408163265,17,19,252,1,245
1936,474,827,47.69378684807256,49.0637641723356,17,16,358,1,353
1937,474,820,47.69378684807256,49.78358276643991,17,19,358,2,346
1938,421,73,48.529705215419504,49.96934240362812,17,44,353,1,348
1939,421,41,48.529705215419504,50.24798185941043,17,42,387,2,380
1940,421,220,48.529705215419504,50.0390022675737,17,21,211,2,201
1941,421,220,48.529705215419504,50.665941043083905,17,26,221,2,201
1942,421,207,48.529705215419504,51.316099773242634,17,20,245,3,214
1943,421,451,48.529705215419504,49.5978231292517,17,17,55,1,30
1944,421,451,48.529705215419504,50.45696145124717,17,18,88,2,30
1945,421,820,48.529705215419504,49.78358276643991,17,19,403,1,399
1946,451,6,49.5978231292517,51.78049886621315,17,48,455,2,445
1947,451,220,49.5978231292517,50.665941043083905,17,26,236,1,231
1948,451,207,49.5978231292517,51.316099773242634,17,20,255,2,244
1949,451,411,49.5978231292517,52.03591836734694,17,19,112,2,40
1950,451,508,49.5978231292517,52.17523809523809,17,19,125,3,57
1951,451,721,49.5978231292517,51.66439909297052,17,17,284,2,270
1952,451,618,49.5978231292517,52.15201814058957,17,19,200,3,167
1953,451,880,49.5978231292517,51.68761904761905,17,18,438,2,429
1954,451,6,50.45696145124717,51.78049886621315,18,48,449,1,445
1955,451,6,50.45696145124717,52.848616780045354,18,46,457,2,445
1956,451,6,50.45696145124717,53.26657596371882,18,46,461,3,445
1957,451,237,50.45696145124717,53.057596371882084,18,23,242,3,214
1958,451,411,50.45696145124717,52.03591836734694,18,19,79,2,40
1959,451,508,50.45696145124717,52.17523809523809,18,19,93,2,57
1960,451,415,50.45696145124717,53.31301587301587,18,21,128,3,36
1961,451,721,50.45696145124717,51.66439909297052,18,17,275,1,270
1962,451,618,50.45696145124717,52.15201814058957,18,19,182,2,167
1963,451,880,50.45696145124717,51.68761904761905,18,18,432,1,429
1964,451,923,50.45696145124717,53.10403628117914,18,16,486,3,472
1965,411,6,52.03591836734694,53.26657596371882,19,46,408,1,405
1966,411,8,52.03591836734694,54.19537414965986,19,46,414,2,403
1967,411,237,52.03591836734694,53.057596371882084,19,23,179,1,174
1968,411,218,52.03591836734694,53.75419501133787,19,26,207,2,193
1969,411,233,52.03591836734694,54.72943310657597,19,22,212,3,178
1970,411,415,52.03591836734694,53.31301587301587,19,21,55,1,4
1971,411,450,52.03591836734694,54.72943310657597,19,18,122,3,39
1972,411,621,52.03591836734694,53.661315192743764,19,18,221,2,210
1973,411,703,52.03591836734694,54.17215419501134,19,18,306,2,292
1974,411,855,52.03591836734694,54.14893424036281,19,15,453,2,444
1975,508,218,52.17523809523809,53.75419501133787,19,26,298,2,290
1976,508,233,52.17523809523809,54.72943310657597,19,22,296,3,275
1977,508,415,52.17523809523809,53.31301587301587,19,21,105,1,93
1978,508,450,52.17523809523809,54.72943310657597,19,18,124,3,58
1979,508,621,52.17523809523809,53.661315192743764,19,18,130,1,113
1980,508,703,52.17523809523809,54.17215419501134,19,18,213,2,195
1981,508,855,52.17523809523809,54.14893424036281,19,15,357,2,347
1982,415,6,53.31301587301587,55.193832199546485,21,49,417,2,409
1983,415,5,53.31301587301587,56.28517006802721,21,46,430,3,410
1984,415,233,53.31301587301587,54.72943310657597,21,22,192,1,182
1985,415,233,53.31301587301587,55.58857142857143,21,22,207,2,182
1986,415,450,53.31301587301587,54.72943310657597,21,18,70,1,35
1987,415,423,53.31301587301587,55.54213151927438,21,21,96,2,8
1988,415,650,53.31301587301587,55.58857142857143,21,18,255,2,235
1989,415,876,53.31301587301587,55.58857142857143,21,12,471,2,461
1990,450,5,54.72943310657597,56.28517006802721,18,46,450,2,445
1991,450,206,54.72943310657597,56.633469387755106,18,29,257,2,244
1992,450,220,54.72943310657597,57.5158276643991,18,27,259,3,230
1993,450,411,54.72943310657597,56.633469387755106,18,20,91,2,39
1994,450,579,54.72943310657597,57.30684807256236,18,18,170,3,129
1995,450,647,54.72943310657597,56.447709750566894,18,17,210,2,197
1996,450,632,54.72943310657597,57.30684807256236,18,16,213,3,182
1997,450,820,54.72943310657597,56.401269841269844,18,16,377,2,370
1998,423,6,55.54213151927438,57.980226757369614,21,46,430,2,417
1999,423,206,55.54213151927438,56.633469387755106,21,29,222,1,217
2000,423,220,55.54213151927438,57.5158276643991,21,27,220,2,203
2001,423,411,55.54213151927438,56.633469387755106,21,20,49,1,12
2002,423,579,55.54213151927438,57.30684807256236,21,18,174,2,156
2003,423,632,55.54213151927438,57.30684807256236,21,16,222,2,209
2004,411,6,56.633469387755106,57.980226757369614,20,46,409,1,405
2005,411,6,56.633469387755106,58.653605442176875,20,48,414,2,405
2006,411,233,56.633469387755106,59.025124716553286,20,23,206,2,178
2007,411,217,56.633469387755106,59.14122448979592,20,25,222,3,194
2008,411,493,56.633469387755106,59.025124716553286,20,20,132,2,82
2009,411,658,56.633469387755106,59.025124716553286,20,19,268,2,247
2010,411,876,56.633469387755106,59.00190476190476,20,17,476,2,465
2011,579,233,57.30684807256236,59.025124716553286,18,23,354,2,346
2012,579,217,57.30684807256236,59.14122448979592,18,25,371,2,362
2013,579,493,57.30684807256236,59.025124716553286,18,20,113,2,86
2014,579,578,57.30684807256236,59.88426303854875,18,18,111,3,1
2015,579,658,57.30684807256236,59.025124716553286,18,19,108,2,79
2016,579,632,57.30684807256236,59.88426303854875,18,16,123,3,53
2017,579,876,57.30684807256236,59.00190476190476,18,17,306,2,297
2018,493,6,59.025124716553286,60.13968253968254,20,45,489,1,487
2019,493,233,59.025124716553286,60.74340136054422,20,23,270,2,260
2020,493,259,59.025124716553286,61.85795918367347,20,28,264,3,234
2021,493,412,59.025124716553286,60.74340136054422,20,20,110,2,81
2022,493,550,59.025124716553286,61.85795918367347,20,23,135,3,57
2023,493,770,59.025124716553286,60.74340136054422,20,15,287,2,277
2024,493,777,59.025124716553286,61.85795918367347,20,17,309,3,284
2025,493,824,59.025124716553286,61.9740589569161,20,18,355,3,331
2026,578,259,59.88426303854875,61.85795918367347,18,28,330,2,319
2027,578,290,59.88426303854875,62.46167800453515,18,25,309,3,288
2028,578,550,59.88426303854875,61.85795918367347,18,23,89,2,28
2029,578,453,59.88426303854875,62.46167800453515,18,22,167,3,125
2030,578,777,59.88426303854875,61.85795918367347,18,17,216,2,199
2031,578,673,59.88426303854875,62.80997732426304,18,23,158,3,95
2032,578,824,59.88426303854875,61.9740589569161,18,18,262,2,246
2033,578,906,59.88426303854875,62.80997732426304,18,20,351,3,328
2034,412,6,60.74340136054422,62.0669387755102,20,48,410,1,406
2035,412,11,60.74340136054422,63.08861678004535,20,45,414,2,401
2036,412,5,60.74340136054422,63.135056689342406,20,46,420,2,407
2037,412,259,60.74340136054422,61.85795918367347,20,28,160,1,153
2038,412,290,60.74340136054422,62.46167800453515,20,25,143,2,122
2039,412,550,60.74340136054422,61.85795918367347,20,23,146,1,138
2040,412,453,60.74340136054422,62.46167800453515,20,22,85,2,41
2041,412,777,60.74340136054422,61.85795918367347,20,17,368,1,365
2042,412,673,60.74340136054422,62.80997732426304,20,23,276,2,261
2043,412,824,60.74340136054422,61.9740589569161,20,18,415,1,412
2044,412,906,60.74340136054422,62.80997732426304,20,20,502,2,494
2045,550,291,61.85795918367347,63.76199546485261,23,25,272,2,259
2046,550,214,61.85795918367347,64.62113378684808,23,29,356,3,336
2047,550,598,61.85795918367347,64.08707482993198,23,22,107,2,48
2048,550,431,61.85795918367347,64.57469387755103,23,23,167,3,119
2049,550,770,61.85795918367347,64.08707482993198,23,20,240,2,220
2050,550,622,61.85795918367347,64.45859410430839,23,20,133,3,72
2051,550,943,61.85795918367347,64.01741496598639,23,19,404,2,393
2052,550,864,61.85795918367347,64.1102947845805,23,13,329,2,314
2053,453,6,62.46167800453515,64.85333333333334,22,46,459,2,447
2054,453,291,62.46167800453515,63.76199546485261,22,25,171,1,162
2055,453,214,62.46167800453515,64.62113378684808,22,29,256,2,239
2056,453,598,62.46167800453515,64.08707482993198,22,22,161,2,145
2057,453,431,62.46167800453515,64.57469387755103,22,23,94,2,22
2058,453,770,62.46167800453515,64.08707482993198,22,20,325,2,317
2059,453,622,62.46167800453515,64.45859410430839,22,20,190,2,169
2060,453,943,62.46167800453515,64.01741496598639,22,19,495,2,490
2061,453,864,62.46167800453515,64.1102947845805,22,13,417,2,411
2062,453,934,62.46167800453515,65.22485260770975,22,15,496,3,481
2063,598,261,64.08707482993198,65.50349206349206,22,28,342,1,337
2064,598,261,64.08707482993198,66.40907029478458,22,24,352,2,337
2065,598,584,64.08707482993198,65.57315192743765,22,21,66,1,14
2066,598,420,64.08707482993198,67.0592290249433,22,24,219,3,178
2067,598,616,64.08707482993198,65.57315192743765,22,19,66,1,18
2068,598,676,64.08707482993198,66.71092970521542,22,18,137,3,78
2069,598,934,64.08707482993198,65.22485260770975,22,15,340,1,336
2070,598,927,64.08707482993198,66.71092970521542,22,17,348,3,329
2071,431,6,64.57469387755103,66.54839002267573,23,46,433,2,425
2072,431,261,64.57469387755103,66.40907029478458,23,24,187,2,170
2073,431,420,64.57469387755103,67.0592290249433,23,24,108,2,11
2074,431,676,64.57469387755103,66.71092970521542,23,18,262,2,245
2075,431,927,64.57469387755103,66.71092970521542,23,17,504,2,496
2076,431,905,64.57469387755103,67.33786848072563,23,16,489,3,474
2077,584,289,65.57315192743765,67.63972789115647,21,25,308,2,295
2078,584,214,65.57315192743765,68.4756462585034,21,27,391,3,370
2079,584,420,65.57315192743765,67.0592290249433,21,24,176,1,164
2080,584,579,65.57315192743765,67.8487074829932,21,25,98,2,5
2081,584,676,65.57315192743765,66.71092970521542,21,18,104,1,92
2082,584,653,65.57315192743765,67.89514739229026,21,22,121,2,69
2083,584,927,65.57315192743765,66.71092970521542,21,17,346,1,343
2084,584,905,65.57315192743765,67.33786848072563,21,16,330,2,321
2085,420,6,67.0592290249433,68.9168253968254,24,49,422,2,414
2086,420,5,67.0592290249433,69.9849433106576,24,47,434,3,415
2087,420,214,67.0592290249433,68.4756462585034,24,27,215,1,206
2088,420,233,67.0592290249433,69.31156462585034,24,24,211,2,187
2089,420,578,67.0592290249433,68.77750566893424,24,21,174,2,158
2090,420,453,67.0592290249433,69.31156462585034,24,21,102,2,33
2091,420,661,67.0592290249433,68.77750566893424,24,22,252,2,241
2092,420,782,67.0592290249433,69.70630385487529,24,23,380,3,362
2093,420,839,67.0592290249433,68.77750566893424,24,21,425,2,419
2094,420,826,67.0592290249433,69.47410430839003,24,21,419,2,406
2095,579,233,67.8487074829932,69.31156462585034,25,24,352,1,346
2096,579,453,67.8487074829932,69.31156462585034,25,21,141,1,126
2097,579,782,67.8487074829932,69.70630385487529,25,23,218,2,203
2098,579,826,67.8487074829932,69.47410430839003,25,21,257,2,247
2099,579,861,67.8487074829932,70.33324263038548,25,19,302,2,282
2100,578,233,68.77750566893424,71.02984126984127,21,23,358,2,345
2101,578,218,68.77750566893424,71.19238095238096,21,32,375,2,360
2102,578,579,68.77750566893424,71.00662131519275,21,24,96,2,1
2103,578,583,68.77750566893424,71.21560090702948,21,26,105,2,5
2104,578,650,68.77750566893424,71.00662131519275,21,21,120,2,72
2105,578,619,68.77750566893424,71.21560090702948,21,22,113,2,41
2106,578,861,68.77750566893424,70.33324263038548,21,19,291,2,283
2107,453,6,69.31156462585034,70.40290249433107,21,46,449,1,447
2108,453,6,69.31156462585034,71.70321995464853,21,46,459,2,447
2109,453,233,69.31156462585034,71.02984126984127,21,23,232,2,220
2110,453,218,69.31156462585034,71.19238095238096,21,32,249,2,235
2111,453,579,69.31156462585034,71.00662131519275,21,24,146,2,126
2112,453,583,69.31156462585034,71.21560090702948,21,26,154,2,130
2113,453,650,69.31156462585034,71.00662131519275,21,21,210,2,197
2114,453,619,69.31156462585034,71.21560090702948,21,22,185,2,166
2115,453,861,69.31156462585034,70.33324263038548,21,19,410,1,408
2116,453,940,69.31156462585034,72.26049886621315,21,23,503,3,487
2117,579,274,71.00662131519275,72.79455782312925,24,29,315,2,305
2118,579,233,71.00662131519275,73.58403628117914,24,24,363,3,346
2119,579,452,71.00662131519275,72.58557823129252,24,22,144,2,127
2120,579,580,71.00662131519275,73.58403628117914,24,20,111,3,1
2121,579,799,71.00662131519275,72.95709750566894,24,20,235,2,220
2122,579,632,71.00662131519275,73.60725623582766,24,17,124,3,53
2123,579,940,71.00662131519275,72.26049886621315,24,23,365,1,361
2124,579,832,71.00662131519275,73.58403628117914,24,14,276,3,253
2125,583,274,71.21560090702948,72.79455782312925,26,29,316,2,309
2126,583,233,71.21560090702948,73.58403628117914,26,24,365,2,350
2127,583,452,71.21560090702948,72.58557823129252,26,22,144,1,131
2128,583,580,71.21560090702948,73.58403628117914,26,20,102,2,3
2129,583,799,71.21560090702948,72.95709750566894,26,20,229,2,216
2130,583,632,71.21560090702948,73.60725623582766,26,17,114,2,49
2131,583,940,71.21560090702948,72.26049886621315,26,23,360,1,357
2132,583,832,71.21560090702948,73.58403628117914,26,14,269,2,249
2133,452,6,72.58557823129252,73.83945578231292,22,47,449,1,446
2134,452,73,72.58557823129252,74.95401360544219,22,43,392,2,379
2135,452,205,72.58557823129252,74.65215419501133,22,34,263,2,247
2136,452,245,72.58557823129252,75.18621315192743,22,31,235,3,207
2137,452,573,72.58557823129252,74.65215419501133,22,22,150,2,121
2138,452,632,72.58557823129252,73.60725623582766,22,17,185,1,180
2139,452,652,72.58557823129252,74.6985941043084,22,24,220,2,200
2140,452,616,72.58557823129252,75.39519274376417,22,18,204,3,164
2141,580,205,73.58403628117914,74.65215419501133,20,34,378,1,375
2142,580,245,73.58403628117914,75.18621315192743,20,31,342,2,335
2143,580,205,73.58403628117914,76.23111111111112,20,30,392,3,375
2144,580,573,73.58403628117914,74.65215419501133,20,22,47,1,7
2145,580,485,73.58403628117914,75.92925170068027,20,23,139,2,95
2146,580,451,73.58403628117914,76.37043083900227,20,24,176,3,129
2147,580,652,73.58403628117914,74.6985941043084,20,24,87,1,72
2148,580,616,73.58403628117914,75.39519274376417,20,18,86,2,36
2149,580,667,73.58403628117914,76.16145124716553,20,20,141,3,87
2150,580,832,73.58403628117914,76.16145124716553,20,12,275,3,252
2151,573,205,74.65215419501133,76.23111111111112,22,30,374,2,368
2152,573,485,74.65215419501133,75.92925170068027,22,23,104,1,88
2153,573,451,74.65215419501133,76.37043083900227,22,24,143,2,122
2154,573,667,74.65215419501133,76.16145124716553,22,20,114,2,94
2155,573,832,74.65215419501133,76.16145124716553,22,12,267,2,259
2156,485,6,75.92925170068027,77.27600907029479,23,46,482,1,479
2157,485,6,75.92925170068027,78.55310657596372,23,47,492,3,479
2158,485,226,75.92925170068027,77.90294784580499,23,33,273,2,259
2159,485,254,75.92925170068027,78.41378684807256,23,29,255,2,231
2160,485,451,75.92925170068027,77.87972789115646,23,21,91,2,34
2161,485,581,75.92925170068027,78.41378684807256,23,22,144,2,96
2162,485,654,75.92925170068027,77.85650793650794,23,20,188,2,169
2163,485,619,75.92925170068027,78.43700680272109,23,19,172,3,134
2164,485,835,75.92925170068027,77.85650793650794,23,13,360,2,350
2165,485,832,75.92925170068027,78.73886621315192,23,14,367,3,347
2166,451,6,76.37043083900227,78.55310657596372,24,47,455,2,445
2167,451,6,76.37043083900227,79.22648526077097,24,49,462,3,445
2168,451,226,76.37043083900227,77.90294784580499,24,33,234,2,225
2169,451,254,76.37043083900227,78.41378684807256,24,29,216,2,197
2170,451,581,76.37043083900227,78.41378684807256,24,22,157,2,130
2171,451,654,76.37043083900227,77.85650793650794,24,20,213,1,203
2172,451,619,76.37043083900227,78.43700680272109,24,19,190,2,168
2173,451,835,76.37043083900227,77.85650793650794,24,13,389,1,384
2174,451,832,76.37043083900227,78.73886621315192,24,14,394,2,381
2175,451,6,77.87972789115646,79.22648526077097,21,49,449,1,445
2176,451,6,77.87972789115646,80.27138321995464,21,47,457,2,445
2177,451,219,77.87972789115646,80.1320634920635,21,27,251,2,232
2178,451,233,77.87972789115646,80.45714285714286,21,27,245,3,218
2179,451,546,77.87972789115646,79.5980045351474,21,22,120,2,95
2180,451,453,77.87972789115646,80.45714285714286,21,21,111,3,2
2181,451,666,77.87972789115646,79.5980045351474,21,18,227,2,215
2182,451,632,77.87972789115646,80.45714285714286,21,19,212,3,181
2183,451,853,77.87972789115646,79.36580498866213,21,16,407,1,402
2184,581,219,78.41378684807256,80.1320634920635,22,27,369,2,362
2185,581,233,78.41378684807256,80.45714285714286,22,27,359,2,348
2186,581,546,78.41378684807256,79.5980045351474,22,22,62,1,35
2187,581,453,78.41378684807256,80.45714285714286,22,21,155,2,128
2188,581,557,78.41378684807256,81.33950113378685,22,21,128,3,24
2189,581,666,78.41378684807256,79.5980045351474,22,18,99,1,85
2190,581,632,78.41378684807256,80.45714285714286,22,19,102,2,51
2191,581,827,78.41378684807256,81.13052154195012,22,13,272,3,246
2192,581,827,78.41378684807256,81.17696145124717,22,18,273,3,246
2193,546,205,79.5980045351474,81.50204081632653,22,35,351,2,341
2194,546,557,79.5980045351474,81.33950113378685,22,21,76,2,11
2195,546,655,79.5980045351474,81.52526077097505,22,24,137,2,109
2196,546,827,79.5980045351474,81.13052154195012,22,13,289,2,281
2197,546,827,79.5980045351474,81.17696145124717,22,18,289,2,281
2198,453,8,80.45714285714286,81.61814058956917,21,47,448,1,445
2199,453,6,80.45714285714286,82.63981859410431,21,49,457,2,447
2200,453,205,80.45714285714286,81.50204081632653,21,35,252,1,248
2201,453,206,80.45714285714286,83.05777777777777,21,31,271,3,247
2202,453,287,80.45714285714286,83.19709750566894,21,28,204,3,166
2203,453,454,80.45714285714286,83.05777777777777,21,23,112,3,1
2204,453,655,80.45714285714286,81.52526077097505,21,24,207,1,202
2205,453,632,80.45714285714286,83.03455782312925,21,19,211,3,179
2206,557,206,81.33950113378685,83.05777777777777,21,31,359,2,351
2207,557,287,81.33950113378685,83.19709750566894,21,28,282,2,270
2208,557,454,81.33950113378685,83.05777777777777,21,23,127,2,103
2209,557,580,81.33950113378685,83.8704761904762,21,22,111,3,23
2210,557,632,81.33950113378685,83.03455782312925,21,19,105,2,75
2211,557,647,81.33950113378685,83.8704761904762,21,18,141,3,90
2212,557,739,81.33950113378685,84.24199546485261,21,21,221,3,182
2213,557,829,81.33950113378685,84.24199546485261,21,20,299,3,272
2214,454,6,83.05777777777777,84.12589569160998,23,47,450,1,448
2215,454,6,83.05777777777777,84.17233560090703,23,45,451,1,448
2216,454,233,83.05777777777777,84.72961451247166,23,24,232,2,221
2217,454,258,83.05777777777777,85.47265306122449,23,30,222,2,196
2218,454,571,83.05777777777777,84.75283446712018,23,21,138,2,117
2219,454,580,83.05777777777777,85.58875283446712,23,21,167,3,126
2220,454,739,83.05777777777777,84.24199546485261,23,21,290,1,285
2221,454,669,83.05777777777777,85.72807256235828,23,23,244,3,215
2222,454,829,83.05777777777777,84.24199546485261,23,20,378,1,375
2223,454,831,83.05777777777777,85.68163265306123,23,18,394,3,377
2224,580,258,83.8704761904762,85.47265306122449,22,30,329,2,322
2225,580,421,83.8704761904762,86.2853514739229,22,23,190,2,159
2226,580,669,83.8704761904762,85.72807256235828,22,23,120,2,89
2227,580,649,83.8704761904762,86.44789115646259,22,19,131,3,69
2228,580,831,83.8704761904762,85.68163265306123,22,18,263,2,251
2229,580,847,83.8704761904762,86.21569160997733,22,18,285,2,267
2230,571,257,84.75283446712018,86.91229024943311,21,29,327,2,314
2231,571,233,84.75283446712018,87.30702947845805,21,26,355,3,338
2232,571,421,84.75283446712018,86.2853514739229,21,23,164,2,150
2233,571,554,84.75283446712018,87.30702947845805,21,20,111,3,17
2234,571,649,84.75283446712018,86.44789115646259,21,19,107,2,78
2235,571,632,84.75283446712018,87.30702947845805,21,18,126,3,61
2236,571,847,84.75283446712018,86.21569160997733,21,18,283,1,276
2237,571,944,84.75283446712018,87.33024943310657,21,12,389,3,373
2238,580,257,85.58875283446712,86.91229024943311,21,29,328,1,323
2239,580,233,85.58875283446712,87.30702947845805,21,26,355,2,347
2240,580,211,85.58875283446712,88.3287074829932,21,27,387,3,369
2241,580,554,85.58875283446712,87.30702947845805,21,20,78,2,26
2242,580,632,85.58875283446712,87.30702947845805,21,18,90,2,52
2243,580,944,85.58875283446712,87.33024943310657,21,12,372,2,364
2244,421,6,86.2853514739229,87.56244897959184,23,46,419,1,415
2245,421,54,86.2853514739229,88.72344671201814,23,40,382,2,367
2246,421,233,86.2853514739229,87.30702947845805,23,26,193,1,188
2247,421,211,86.2853514739229,88.3287074829932,23,27,228,2,210
2248,421,554,86.2853514739229,87.30702947845805,23,20,140,1,133
2249,421,459,86.2853514739229,88.8627664399093,23,18,117,3,38
2250,421,632,86.2853514739229,87.30702947845805,23,18,216,1,211
2251,421,658,86.2853514739229,88.65378684807257,23,13,258,2,237
2252,554,211,87.30702947845805,88.3287074829932,20,27,346,1,343
2253,554,233,87.30702947845805,89.88444444444444,20,26,340,3,321
2254,554,459,87.30702947845805,88.8627664399093,20,18,116,2,95
2255,554,454,87.30702947845805,89.90766439909297,20,21,150,3,100
2256,554,658,87.30702947845805,88.65378684807257,20,13,119,1,104
2257,554,625,87.30702947845805,89.88444444444444,20,20,132,3,71
2258,554,932,87.30702947845805,89.88444444444444,20,13,394,3,378
2259,459,5,88.8627664399093,90.5578231292517,18,47,460,2,454
2260,459,9,88.8627664399093,91.41696145124716,18,45,463,3,450
2261,459,233,88.8627664399093,89.88444444444444,18,26,230,1,226
2262,459,339,88.8627664399093,90.74358276643991,18,24,145,2,120
2263,459,233,88.8627664399093,91.57950113378685,18,25,254,3,226
2264,459,454,88.8627664399093,89.90766439909297,18,21,45,1,5
2265,459,579,88.8627664399093,90.74358276643991,18,22,145,2,120
2266,459,579,88.8627664399093,91.60272108843537,18,22,168,3,120
2267,459,625,88.8627664399093,89.88444444444444,18,20,172,1,166
2268,459,666,88.8627664399093,90.74358276643991,18,20,222,2,207
2269,459,647,88.8627664399093,91.60272108843537,18,18,222,3,188
2270,459,932,88.8627664399093,89.88444444444444,18,13,475,1,473
2271,459,898,88.8627664399093,90.72036281179139,18,13,446,2,439
2272,459,832,88.8627664399093,91.60272108843537,18,13,391,3,373
2273,454,9,89.90766439909297,91.41696145124716,21,45,450,2,445
2274,454,233,89.90766439909297,91.57950113378685,21,25,232,2,221
2275,454,216,89.90766439909297,92.48507936507937,21,25,263,3,238
2276,454,579,89.90766439909297,91.60272108843537,21,22,145,2,125
2277,454,647,89.90766439909297,91.60272108843537,21,18,206,2,193
2278,454,626,89.90766439909297,92.46185941043085,21,18,204,3,172
2279,454,832,89.90766439909297,91.60272108843537,21,13,385,2,378
2280,454,841,89.90766439909297,92.43863945578231,21,13,402,3,387
2281,579,216,90.74358276643991,92.48507936507937,22,25,371,2,363
2282,579,454,90.74358276643991,92.46185941043085,22,21,145,2,125
2283,579,626,90.74358276643991,92.46185941043085,22,18,88,2,47
2284,579,632,90.74358276643991,93.3209977324263,22,18,123,3,53
2285,579,841,90.74358276643991,92.43863945578231,22,13,272,2,262
2286,579,832,90.74358276643991,93.3209977324263,22,14,276,3,253
2287,579,271,91.60272108843537,93.90149659863945,22,26,324,2,308
2288,579,580,91.60272108843537,94.15691609977324,22,21,110,3,1
2289,579,632,91.60272108843537,93.3209977324263,22,18,91,2,53
2290,579,832,91.60272108843537,93.3209977324263,22,14,264,2,253
2291,579,832,91.60272108843537,94.18013605442177,22,12,276,3,253
2292,454,6,92.46185941043085,93.99437641723357,21,47,453,2,448
2293,454,6,92.46185941043085,94.41233560090703,21,47,456,2,448
2294,454,8,92.46185941043085,95.34113378684808,21,47,463,3,446
2295,454,271,92.46185941043085,93.90149659863945,21,26,193,1,183
2296,454,244,92.46185941043085,95.06249433106576,21,27,238,3,210
2297,454,218,92.46185941043085,95.2714739229025,21,31,265,3,236
2298,454,580,92.46185941043085,94.15691609977324,21,21,146,2,126
2299,454,579,92.46185941043085,95.01605442176871,21,22,167,3,125
2300,454,647,92.46185941043085,95.01605442176871,21,18,222,3,193
2301,454,832,92.46185941043085,94.18013605442177,21,12,385,2,378
2302,580,218,94.15691609977324,95.2714739229025,21,31,365,1,362
2303,580,233,94.15691609977324,96.73433106575963,21,25,364,3,347
2304,580,555,94.15691609977324,95.87519274376417,21,21,78,2,25
2305,580,579,94.15691609977324,96.73433106575963,21,21,111,3,1
2306,580,632,94.15691609977324,95.8984126984127,21,17,91,2,52
2307,580,626,94.15691609977324,96.73433106575963,21,18,120,3,46
2308,580,832,94.15691609977324,95.87519274376417,21,13,263,2,252
2309,580,835,94.15691609977324,96.73433106575963,21,13,278,3,255
2310,579,233,95.01605442176871,96.73433106575963,22,25,354,2,346
2311,579,236,95.01605442176871,97.5934693877551,22,25,361,3,343
2312,579,580,95.01605442176871,97.5934693877551,22,24,111,3,1
2313,579,626,95.01605442176871,96.73433106575963,22,18,88,2,47
2314,579,666,95.01605442176871,97.5934693877551,22,19,141,3,87
2315,579,835,95.01605442176871,96.73433106575963,22,13,266,2,256
2316,579,910,95.01605442176871,97.5934693877551,22,13,349,3,331
2317,555,236,95.87519274376417,97.5934693877551,21,25,327,2,319
2318,555,243,95.87519274376417,98.42938775510204,21,24,331,3,312
2319,555,580,95.87519274376417,97.5934693877551,21,24,78,2,25
2320,555,454,95.87519274376417,98.47582766439909,21,22,151,3,101
2321,555,666,95.87519274376417,97.5934693877551,21,19,133,2,111
2322,555,650,95.87519274376417,98.45260770975057,21,18,146,3,95
2323,555,910,95.87519274376417,97.5934693877551,21,13,363,2,355
2324,555,832,95.87519274376417,98.45260770975057,21,13,298,3,277
2325,579,243,96.73433106575963,98.42938775510204,21,24,344,2,336
2326,579,454,96.73433106575963,98.47582766439909,21,22,146,2,125
2327,579,650,96.73433106575963,98.45260770975057,21,18,103,2,71
2328,579,688,96.73433106575963,99.52072562358276,21,17,162,3,109
2329,579,832,96.73433106575963,98.45260770975057,21,13,264,2,253
2330,580,233,97.5934693877551,100.1708843537415,24,27,364,3,347
2331,580,578,97.5934693877551,100.1708843537415,24,21,111,3,2
2332,580,688,97.5934693877551,99.52072562358276,24,17,136,2,108
2333,580,832,97.5934693877551,100.1708843537415,24,13,275,3,252
2334,454,6,98.47582766439909,99.79936507936507,22,49,452,1,448
2335,454,6,98.47582766439909,100.84426303854876,22,47,459,2,448
2336,454,233,98.47582766439909,100.1708843537415,22,27,233,2,221
2337,454,271,98.47582766439909,100.77460317460317,22,26,208,2,183
2338,454,578,98.47582766439909,100.1708843537415,22,21,144,2,124
2339,454,554,98.47582766439909,101.03002267573696,22,23,149,3,100
2340,454,688,98.47582766439909,99.52072562358276,22,17,238,1,234
2341,454,632,98.47582766439909,101.03002267573696,22,18,209,3,178
2342,454,832,98.47582766439909,100.1708843537415,22,13,385,2,378
2343,454,833,98.47582766439909,101.03002267573696,22,13,395,3,379
2344,578,339,100.1708843537415,101.88916099773243,21,25,250,2,239
2345,578,249,100.1708843537415,102.44643990929706,21,21,343,2,329
2346,578,453,100.1708843537415,101.88916099773243,21,21,145,2,125
2347,578,436,100.1708843537415,102.44643990929706,21,17,173,2,142
2348,578,632,100.1708843537415,101.88916099773243,21,19,92,2,54
2349,578,617,100.1708843537415,102.28390022675737,21,14,99,2,39
2350,578,832,100.1708843537415,101.86594104308391,21,14,264,2,254
2351,554,249,101.03002267573696,102.44643990929706,23,21,311,1,305
2352,554,226,101.03002267573696,103.44489795918368,23,14,344,2,328
2353,554,436,101.03002267573696,102.44643990929706,23,17,133,1,118
2354,554,590,101.03002267573696,103.86285714285715,23,12,127,3,36
2355,554,617,101.03002267573696,102.28390022675737,23,14,83,1,63
2356,554,619,101.03002267573696,103.44489795918368,23,12,123,2,65
2357,453,6,101.88916099773243,103.35201814058958,21,45,451,1,447
2358,453,226,101.88916099773243,103.44489795918368,21,14,237,2,227
2359,453,222,101.88916099773243,104.39691609977325,21,16,255,3,231
2360,453,590,101.88916099773243,103.86285714285715,21,12,161,2,137
2361,453,619,101.88916099773243,103.44489795918368,21,12,179,2,166
2362,436,42,102.44643990929706,105.16317460317461,17,39,411,3,394
2363,436,222,102.44643990929706,104.39691609977325,17,16,230,2,214
2364,436,590,102.44643990929706,103.86285714285715,17,12,166,1,154
2365,590,220,103.86285714285715,105.81333333333333,12,18,379,2,370
2366,590,562,103.86285714285715,105.83655328798186,12,14,89,2,28
2367,562,237,105.83655328798186,107.87990929705215,14,16,337,2,325
2368,562,217,105.83655328798186,108.48362811791384,14,20,363,3,345
2369,562,461,105.83655328798186,108.48362811791384,14,14,152,3,101
2370,461,30,108.48362811791384,110.10902494331066,14,38,437,2,431
2371,461,44,108.48362811791384,110.57342403628118,14,38,427,2,417
2372,461,262,108.48362811791384,109.73750566893425,14,17,206,1,199
2373,461,219,108.48362811791384,110.43410430839002,14,18,256,2,242
2374,461,582,108.48362811791384,110.78240362811792,14,16,156,2,121
2375,582,219,110.78240362811792,112.15238095238095,16,20,368,1,363
2376,582,218,110.78240362811792,113.01151927437643,16,21,376,2,364
2377,582,487,110.78240362811792,112.15238095238095,16,17,112,1,95
2378,582,449,110.78240362811792,112.96507936507936,16,19,163,2,133
2379,487,31,112.15238095238095,113.47591836734694,17,37,460,1,456
2380,487,230,112.15238095238095,113.87065759637188,17,20,267,2,257
2381,487,486,112.15238095238095,113.87065759637188,17,17,74,2,1
2382,487,521,112.15238095238095,114.70657596371882,17,14,115,3,34
2383,487,626,112.15238095238095,114.10285714285715,17,12,162,2,139
2384,449,28,112.96507936507936,115.17097505668934,19,39,432,2,421
2385,449,27,112.96507936507936,115.26385487528344,19,40,433,2,422
2386,449,356,112.96507936507936,115.17097505668934,19,19,133,2,93
2387,449,355,112.96507936507936,115.82113378684808,19,23,155,3,94
2388,449,521,112.96507936507936,114.70657596371882,19,14,104,2,72
2389,449,598,112.96507936507936,115.37995464852608,19,18,182,2,149
2390,449,626,112.96507936507936,114.10285714285715,19,12,184,1,177
2391,449,624,112.96507936507936,115.70503401360544,19,12,211,3,175
2392,486,28,113.87065759637188,115.17097505668934,17,39,461,1,458
2393,486,27,113.87065759637188,115.26385487528344,17,40,463,1,459
2394,486,28,113.87065759637188,116.23909297052154,17,36,469,2,458
2395,486,356,113.87065759637188,115.17097505668934,17,19,142,1,130
2396,486,355,113.87065759637188,115.82113378684808,17,23,156,2,131
2397,486,355,113.87065759637188,116.23909297052154,17,19,166,2,131
2398,486,598,113.87065759637188,115.37995464852608,17,18,129,2,112
2399,486,624,113.87065759637188,115.70503401360544,17,12,159,2,138
2400,521,28,114.70657596371882,116.23909297052154,14,36,497,2,493
2401,521,355,114.70657596371882,115.82113378684808,14,23,173,1,166
2402,521,355,114.70657596371882,116.23909297052154,14,19,179,2,166
2403,521,205,114.70657596371882,117.51619047619047,14,35,338,3,316
2404,521,611,114.70657596371882,117.56263038548754,14,22,152,3,90
2405,521,652,114.70657596371882,117.56263038548754,14,25,180,3,131
2406,598,205,115.37995464852608,117.51619047619047,18,35,404,2,393
2407,598,611,115.37995464852608,117.56263038548754,18,22,95,2,13
2408,598,652,115.37995464852608,117.56263038548754,18,25,108,2,54
2409,598,616,115.37995464852608,118.25922902494331,18,18,125,3,18
2410,611,205,117.56263038548754,119.09514739229026,22,30,411,2,406
2411,611,205,117.56263038548754,119.53632653061224,22,27,415,2,406
2412,611,455,117.56263038548754,118.67718820861678,22,20,163,1,156
2413,611,449,117.56263038548754,119.25768707482993,22,22,178,2,162
2414,611,615,117.56263038548754,120.02394557823129,22,13,106,2,4
2415,611,649,117.56263038548754,120.27936507936508,22,19,123,3,38
2416,455,9,118.67718820861678,120.46512471655329,20,44,453,2,446
2417,455,227,118.67718820861678,120.76698412698413,20,32,245,2,228
2418,455,258,118.67718820861678,121.34748299319727,20,28,228,3,197
2419,455,430,118.67718820861678,121.13850340136055,20,21,109,2,25
2420,455,615,118.67718820861678,120.02394557823129,20,13,170,1,160
2421,455,649,118.67718820861678,120.27936507936508,20,19,206,2,194
2422,455,618,118.67718820861678,121.2778231292517,20,20,198,3,163
2423,455,824,118.67718820861678,121.55646258503401,20,19,389,3,369
2424,449,9,119.25768707482993,120.46512471655329,22,44,443,1,440
2425,449,6,119.25768707482993,122.06730158730159,22,49,459,3,443
2426,449,227,119.25768707482993,120.76698412698413,22,32,231,2,222
2427,449,258,119.25768707482993,121.34748299319727,22,28,211,2,191
2428,449,430,119.25768707482993,121.13850340136055,22,21,83,2,19
2429,449,465,119.25768707482993,121.69578231292518,22,23,106,2,16
2430,449,649,119.25768707482993,120.27936507936508,22,19,205,1,200
2431,449,618,119.25768707482993,121.2778231292517,22,20,190,2,169
2432,449,824,119.25768707482993,121.55646258503401,22,19,388,2,375
2433,430,6,121.13850340136055,123.1354195011338,21,47,433,2,424
2434,430,6,121.13850340136055,123.55337868480726,21,47,437,2,424
2435,430,227,121.13850340136055,122.27628117913832,21,29,209,1,203
2436,430,213,121.13850340136055,123.321179138322,21,28,236,2,217
2437,430,418,121.13850340136055,122.46204081632654,21,22,58,1,12
2438,430,554,121.13850340136055,123.321179138322,21,21,156,2,124
2439,430,622,121.13850340136055,122.46204081632654,21,18,200,1,192
2440,430,690,121.13850340136055,124.0409977324263,21,19,288,3,260
2441,430,836,121.13850340136055,122.46204081632654,21,13,410,1,406
2442,430,825,121.13850340136055,124.0409977324263,21,17,414,3,395
2443,465,6,121.69578231292518,123.1354195011338,23,47,463,1,459
2444,465,6,121.69578231292518,123.55337868480726,23,47,466,2,459
2445,465,8,121.69578231292518,124.4821768707483,23,47,472,3,457
2446,465,213,121.69578231292518,123.321179138322,23,28,262,2,252
2447,465,205,121.69578231292518,124.34285714285714,23,33,284,3,260
2448,465,554,121.69578231292518,123.321179138322,23,21,113,2,89
2449,465,573,121.69578231292518,124.36607709750567,23,21,158,3,108
2450,465,690,121.69578231292518,124.0409977324263,23,19,247,2,225
2451,465,655,121.69578231292518,124.36607709750567,23,24,222,3,190
2452,465,825,121.69578231292518,124.0409977324263,23,17,374,2,360
2453,418,6,122.46204081632654,123.55337868480726,22,47,415,1,412
2454,418,8,122.46204081632654,124.4821768707483,22,47,419,2,410
2455,418,205,122.46204081632654,124.34285714285714,22,33,228,2,213
2456,418,573,122.46204081632654,124.36607709750567,22,21,175,2,155
2457,418,690,122.46204081632654,124.0409977324263,22,19,280,2,272
2458,418,655,122.46204081632654,124.36607709750567,22,24,251,2,237
2459,418,825,122.46204081632654,124.0409977324263,22,17,413,2,407
2460,418,835,122.46204081632654,125.0162358276644,22,14,431,3,417
2461,554,205,123.321179138322,124.34285714285714,21,33,352,1,349
2462,554,205,123.321179138322,126.13079365079365,21,31,369,3,349
2463,554,573,123.321179138322,124.36607709750567,21,21,49,1,19
2464,554,579,123.321179138322,125.87537414965986,21,22,113,3,25
2465,554,655,123.321179138322,124.36607709750567,21,24,111,1,101
2466,554,626,123.321179138322,125.89859410430839,21,18,132,3,72
2467,554,835,123.321179138322,125.0162358276644,21,14,290,2,281
2468,554,833,123.321179138322,125.87537414965986,21,14,300,3,279
2469,573,205,124.36607709750567,126.13079365079365,21,31,376,2,368
2470,573,205,124.36607709750567,126.59519274376417,21,29,380,2,368
2471,573,579,124.36607709750567,125.87537414965986,21,22,65,2,6
2472,573,488,124.36607709750567,127.12925170068027,21,21,146,3,85
2473,573,626,124.36607709750567,125.89859410430839,21,18,85,2,53
2474,573,793,124.36607709750567,127.10603174603175,21,20,250,3,220
2475,573,833,124.36607709750567,125.87537414965986,21,14,268,2,260
2476,573,864,124.36607709750567,127.10603174603175,21,17,314,3,291
2477,579,257,125.87537414965986,128.19736961451247,22,27,337,2,322
2478,579,258,125.87537414965986,128.33668934240364,22,29,338,2,321
2479,579,488,125.87537414965986,127.12925170068027,22,21,106,1,91
2480,579,555,125.87537414965986,128.45278911564625,22,23,114,3,24
2481,579,793,125.87537414965986,127.10603174603175,22,20,220,1,214
2482,579,626,125.87537414965986,127.5936507936508,22,18,88,2,47
2483,579,729,125.87537414965986,128.54566893424035,22,21,189,3,150
2484,579,864,125.87537414965986,127.10603174603175,22,17,290,1,285
2485,579,826,125.87537414965986,127.96517006802722,22,15,263,2,247
2486,488,10,127.12925170068027,128.220589569161,21,45,480,1,478
2487,488,6,127.12925170068027,128.94040816326532,21,49,488,2,482
2488,488,6,127.12925170068027,129.98530612244897,21,48,497,3,482
2489,488,257,127.12925170068027,128.19736961451247,21,27,236,1,231
2490,488,258,127.12925170068027,128.33668934240364,21,29,236,1,230
2491,488,257,127.12925170068027,129.77632653061224,21,29,258,3,231
2492,488,555,127.12925170068027,128.45278911564625,21,23,88,1,67
2493,488,729,127.12925170068027,128.54566893424035,21,21,249,1,241
2494,488,923,127.12925170068027,129.03328798185942,21,17,443,2,435
2495,488,832,127.12925170068027,129.3119274376417,21,13,357,2,344
2496,579,257,127.5936507936508,129.77632653061224,21,29,335,2,322
2497,579,554,127.5936507936508,130.1710657596372,21,23,114,3,25
2498,579,632,127.5936507936508,130.1710657596372,21,20,123,3,53
2499,579,923,127.5936507936508,129.03328798185942,21,17,350,1,344
2500,579,832,127.5936507936508,129.3119274376417,21,13,264,2,253
2501,555,257,128.45278911564625,129.77632653061224,23,29,303,1,298
2502,555,211,128.45278911564625,131.19274376417235,23,27,364,3,344
2503,555,554,128.45278911564625,130.1710657596372,23,23,74,2,1
2504,555,546,128.45278911564625,131.03020408163266,23,22,111,3,9
2505,555,632,128.45278911564625,130.1710657596372,23,20,107,2,77
2506,555,666,128.45278911564625,131.03020408163266,23,18,157,3,111
2507,555,832,128.45278911564625,131.00698412698412,23,12,298,3,277
2508,555,831,128.45278911564625,131.4249433106576,23,13,304,3,276
2509,554,211,130.1710657596372,131.19274376417235,23,27,346,1,343
2510,554,217,130.1710657596372,131.72680272108843,23,27,344,2,337
2511,554,339,130.1710657596372,132.74848072562358,23,24,242,3,215
2512,554,432,130.1710657596372,131.91256235827666,23,21,143,2,122
2513,554,480,130.1710657596372,132.74848072562358,23,21,133,3,74
2514,554,642,130.1710657596372,131.86612244897958,23,18,114,2,88
2515,554,697,130.1710657596372,132.74848072562358,23,19,181,3,143
2516,554,831,130.1710657596372,131.4249433106576,23,13,282,1,277
2517,554,835,130.1710657596372,132.72526077097507,23,14,302,3,281
2518,546,339,131.03020408163266,132.74848072562358,22,24,220,2,207
2519,546,233,131.03020408163266,133.58439909297053,22,24,332,3,313
2520,546,480,131.03020408163266,132.74848072562358,22,21,99,2,66
2521,546,555,131.03020408163266,133.60761904761904,22,22,111,3,9
2522,546,697,131.03020408163266,132.74848072562358,22,19,168,2,151
2523,546,647,131.03020408163266,133.58439909297053,22,18,149,3,101
2524,546,835,131.03020408163266,132.72526077097507,22,14,298,2,289
2525,546,832,131.03020408163266,133.58439909297053,22,13,306,3,286
2526,432,5,131.91256235827666,133.42185941043084,21,47,432,2,427
2527,432,233,131.91256235827666,133.58439909297053,21,24,212,2,199
2528,432,243,131.91256235827666,134.443537414966,21,24,218,3,189
2529,432,555,131.91256235827666,133.60761904761904,21,22,143,2,123
2530,432,546,131.91256235827666,134.46675736961453,21,22,158,3,114
2531,432,647,131.91256235827666,133.58439909297053,21,18,227,2,215
2532,432,649,131.91256235827666,134.443537414966,21,18,243,3,217
2533,432,832,131.91256235827666,133.58439909297053,21,13,406,2,400
2534,432,832,131.91256235827666,134.443537414966,21,13,415,3,400
2535,480,6,132.74848072562358,135.14013605442176,21,47,485,2,474
2536,480,243,132.74848072562358,134.443537414966,21,24,248,2,237
2537,480,546,132.74848072562358,134.46675736961453,21,22,99,2,66
2538,480,649,132.74848072562358,134.443537414966,21,18,184,2,169
2539,480,832,132.74848072562358,134.443537414966,21,13,359,2,352
2540,480,833,132.74848072562358,135.32589569161,21,14,370,3,353
2541,555,233,133.60761904761904,136.1618140589569,22,25,340,3,322
2542,555,546,133.60761904761904,136.1618140589569,22,22,110,3,9
2543,555,647,133.60761904761904,136.1618140589569,22,19,143,3,92
2544,555,833,133.60761904761904,135.32589569161,22,14,288,2,278
2545,546,233,134.46675736961453,136.1618140589569,22,25,321,2,313
2546,546,271,134.46675736961453,136.7655328798186,22,27,292,2,275
2547,546,580,134.46675736961453,137.0209523809524,22,21,115,3,34
2548,546,647,134.46675736961453,136.1618140589569,22,19,125,2,101
2549,546,649,134.46675736961453,137.0209523809524,22,18,151,3,103
2550,546,832,134.46675736961453,137.0209523809524,22,14,306,3,286
2551,546,832,134.46675736961453,137.43891156462584,22,12,313,3,286
2552,546,218,136.1618140589569,138.13551020408164,22,32,339,2,328
2553,546,218,136.1618140589569,138.57668934240363,22,31,344,2,328
2554,546,425,136.1618140589569,138.87854875283446,22,20,168,3,121
2555,546,632,136.1618140589569,137.88009070294785,22,17,113,2,86
2556,546,639,136.1618140589569,138.7392290249433,22,18,145,3,93
2557,546,832,136.1618140589569,137.43891156462584,22,12,291,1,286
2558,546,835,136.1618140589569,138.7392290249433,22,13,310,3,289
2559,580,218,137.0209523809524,138.13551020408164,21,32,365,1,362
2560,580,218,137.0209523809524,138.57668934240363,21,31,368,2,362
2561,580,233,137.0209523809524,139.59836734693877,21,26,364,3,347
2562,580,425,137.0209523809524,138.87854875283446,21,20,174,2,155
2563,580,453,137.0209523809524,139.59836734693877,21,22,169,3,127
2564,580,639,137.0209523809524,138.7392290249433,21,18,95,2,59
2565,580,666,137.0209523809524,139.59836734693877,21,19,140,3,86
2566,580,835,137.0209523809524,138.7392290249433,21,13,266,2,255
2567,580,835,137.0209523809524,139.57514739229026,21,12,278,3,255
2568,546,233,137.88009070294785,139.59836734693877,23,26,322,2,313
2569,546,235,137.88009070294785,140.45750566893423,23,25,330,3,311
2570,546,453,137.88009070294785,139.59836734693877,23,22,119,2,93
2571,546,493,137.88009070294785,140.45750566893423,23,22,123,3,53
2572,546,666,137.88009070294785,139.59836734693877,23,19,141,2,120
2573,546,666,137.88009070294785,140.45750566893423,23,18,163,3,120
2574,546,835,137.88009070294785,139.57514739229026,23,12,298,2,289
2575,546,948,137.88009070294785,140.43428571428572,23,12,417,3,402
2576,425,6,138.87854875283446,140.27174603174603,20,47,423,1,419
2577,425,235,138.87854875283446,140.45750566893423,20,25,202,2,190
2578,425,493,138.87854875283446,140.45750566893423,20,22,96,2,68
2579,425,546,138.87854875283446,141.31664399092972,20,22,160,2,121
2580,425,666,138.87854875283446,140.45750566893423,20,18,250,2,241
2581,425,840,138.87854875283446,141.29342403628118,20,13,428,2,415
2582,453,6,139.59836734693877,141.99002267573695,22,47,459,2,447
2583,453,233,139.59836734693877,142.15256235827664,22,26,246,3,220
2584,453,546,139.59836734693877,141.31664399092972,22,22,119,2,93
2585,453,697,139.59836734693877,142.17578231292518,22,18,268,3,244
2586,453,688,139.59836734693877,142.38476190476192,22,19,264,3,235
2587,453,840,139.59836734693877,141.29342403628118,22,13,394,2,387
2588,493,6,140.45750566893423,141.99002267573695,22,47,491,2,487
2589,493,6,140.45750566893423,142.6401814058957,22,49,496,2,487
2590,493,233,140.45750566893423,142.15256235827664,22,26,270,2,260
2591,493,233,140.45750566893423,143.03492063492064,22,25,283,3,260
2592,493,555,140.45750566893423,143.03492063492064,22,21,127,3,62
2593,493,697,140.45750566893423,142.17578231292518,22,18,217,2,204
2594,493,688,140.45750566893423,142.38476190476192,22,19,212,2,195
2595,493,835,140.45750566893423,143.0117006802721,22,12,359,3,342
2596,546,233,141.31664399092972,143.03492063492064,22,25,322,2,313
2597,546,271,141.31664399092972,143.6386394557823,22,27,293,2,275
2598,546,555,141.31664399092972,143.03492063492064,22,21,75,2,9
2599,546,493,141.31664399092972,143.8708390022676,22,22,122,3,53
2600,546,688,141.31664399092972,142.38476190476192,22,19,149,1,142
2601,546,632,141.31664399092972,143.8940589569161,22,19,140,3,86
2602,546,835,141.31664399092972,143.0117006802721,22,12,298,2,289
2603,546,910,141.31664399092972,143.8708390022676,22,12,380,3,364
2604,555,216,143.03492063492064,144.91573696145124,21,26,349,2,339
2605,555,217,143.03492063492064,145.42657596371882,21,28,353,2,338
2606,555,493,143.03492063492064,145.24081632653062,21,19,113,2,62
2607,555,574,143.03492063492064,145.28725623582767,21,15,99,2,19
2608,555,657,143.03492063492064,145.24081632653062,21,16,139,2,102
2609,555,629,143.03492063492064,145.28725623582767,21,16,122,2,74
2610,493,7,143.8708390022676,146.14639455782313,22,45,496,2,486
2611,493,3,143.8708390022676,146.30893424036282,22,44,501,2,490
2612,493,216,143.8708390022676,144.91573696145124,22,26,281,1,277
2613,493,217,143.8708390022676,145.42657596371882,22,28,284,2,276
2614,493,246,143.8708390022676,146.28571428571428,22,24,268,2,247
2615,493,574,143.8708390022676,145.28725623582767,22,15,101,1,81
2616,493,411,143.8708390022676,146.28571428571428,22,15,132,2,82
2617,493,657,143.8708390022676,145.24081632653062,22,16,174,1,164
2618,493,629,143.8708390022676,145.28725623582767,22,16,149,1,136
2619,493,3,145.24081632653062,146.30893424036282,19,44,492,1,490
2620,493,14,145.24081632653062,147.30739229024942,19,41,487,2,479
2621,493,246,145.24081632653062,146.28571428571428,19,24,251,1,247
2622,493,253,145.24081632653062,147.7021315192744,19,18,262,2,240
2623,493,411,145.24081632653062,146.28571428571428,19,15,94,1,82
2624,574,253,145.28725623582767,147.7021315192744,15,18,337,2,321
2625,411,14,146.28571428571428,147.30739229024942,15,41,399,1,397
2626,411,2,146.28571428571428,148.30585034013606,15,20,418,2,409
2627,411,253,146.28571428571428,147.7021315192744,15,18,169,1,158
2628,688,246,6.965986394557823,8.452063492063493,12,24,447,1,442
2629,688,219,6.965986394557823,9.287981859410431,12,23,480,2,469
2630,688,587,6.965986394557823,8.846802721088435,12,15,129,2,101
2631,688,485,6.965986394557823,9.311201814058958,12,17,227,2,203
2632,688,771,6.965986394557823,8.614603174603175,12,19,109,2,83
2633,688,893,6.965986394557823,8.6378231292517,12,20,217,2,205
2634,649,219,7.964444444444444,9.287981859410431,18,23,434,1,430
2635,649,252,7.964444444444444,10.170340136054422,18,21,408,2,397
2636,649,485,7.964444444444444,9.311201814058958,18,17,174,1,164
2637,649,536,7.964444444444444,10.866938775510205,18,17,169,3,113
2638,649,784,7.964444444444444,10.866938775510205,18,17,184,3,135
2639,649,834,7.964444444444444,10.54185941043084,18,18,216,3,185
2640,771,536,8.614603174603175,10.866938775510205,19,17,254,2,235
2641,771,485,8.614603174603175,11.00625850340136,19,19,304,2,286
2642,771,784,8.614603174603175,10.866938775510205,19,17,98,2,13
2643,771,759,8.614603174603175,11.331337868480725,19,15,118,3,12
2644,771,834,8.614603174603175,10.54185941043084,19,18,104,2,63
2645,771,839,8.614603174603175,11.261678004535147,19,13,133,3,68
2646,784,586,10.866938775510205,12.329795918367347,17,21,208,1,198
2647,784,578,10.866938775510205,13.049614512471656,17,17,226,2,206
2648,784,768,10.866938775510205,12.353015873015874,17,20,66,1,16
2649,784,935,10.866938775510205,12.701315192743765,17,15,170,2,151
2650,759,578,11.331337868480725,13.049614512471656,15,17,196,2,181
2651,759,768,11.331337868480725,12.353015873015874,15,20,45,1,9
2652,759,791,11.331337868480725,13.908752834467121,15,19,116,3,32
2653,759,935,11.331337868480725,12.701315192743765,15,15,186,1,176
2654,759,901,11.331337868480725,13.862312925170068,15,17,179,3,142
2655,768,481,12.353015873015874,14.442811791383221,20,18,301,2,287
2656,768,583,12.353015873015874,15.069750566893424,20,17,219,3,185
2657,768,791,12.353015873015874,13.908752834467121,20,19,71,2,23
2658,768,713,12.353015873015874,14.814331065759637,20,19,119,2,55
2659,768,901,12.353015873015874,13.862312925170068,20,17,148,2,133
2660,768,859,12.353015873015874,14.814331065759637,20,19,140,2,91
2661,791,583,13.908752834467121,15.069750566893424,19,17,214,1,208
2662,791,482,13.908752834467121,16.16108843537415,19,19,324,2,309
2663,791,814,13.908752834467121,15.464489795918368,19,17,71,2,23
2664,791,966,13.908752834467121,15.487709750566895,19,19,188,2,175
2665,713,224,14.814331065759637,16.16108843537415,19,21,492,1,489
2666,713,482,14.814331065759637,16.16108843537415,19,19,238,1,231
2667,713,447,14.814331065759637,17.670385487528346,19,19,293,3,266
2668,713,736,14.814331065759637,16.904126984126986,19,16,93,2,23
2669,713,734,14.814331065759637,17.322086167800453,19,17,110,3,21
2670,713,902,14.814331065759637,16.973786848072564,19,20,211,2,189
2671,713,888,14.814331065759637,17.29886621315193,19,15,205,2,175
2672,814,447,15.464489795918368,17.670385487528346,17,19,379,2,367
2673,814,736,15.464489795918368,16.904126984126986,17,16,100,1,78
2674,814,734,15.464489795918368,17.322086167800453,17,17,113,2,80
2675,814,902,15.464489795918368,16.973786848072564,17,20,109,2,88
2676,814,888,15.464489795918368,17.29886621315193,17,15,108,2,74
2677,736,581,16.904126984126986,18.854603174603174,16,15,176,2,155
2678,736,573,16.904126984126986,19.806621315192743,16,23,205,3,163
2679,736,638,16.904126984126986,18.901043083900227,16,15,130,2,98
2680,736,652,16.904126984126986,19.853061224489796,16,25,152,3,84
2681,736,954,16.904126984126986,18.901043083900227,16,16,234,2,218
2682,734,581,17.322086167800453,18.854603174603174,17,15,167,2,153
2683,734,573,17.322086167800453,19.806621315192743,17,23,193,2,161
2684,734,638,17.322086167800453,18.901043083900227,17,15,118,2,96
2685,734,652,17.322086167800453,19.853061224489796,17,25,136,3,82
2686,734,954,17.322086167800453,18.901043083900227,17,16,230,2,220
2687,638,205,18.901043083900227,20.29424036281179,15,32,437,1,433
2688,638,208,18.901043083900227,21.339138321995467,15,30,443,2,430
2689,638,438,18.901043083900227,20.59609977324263,15,21,213,2,200
2690,638,485,18.901043083900227,21.08371882086168,15,22,180,2,153
2691,638,616,18.901043083900227,20.54965986394558,15,19,74,2,22
2692,638,626,18.901043083900227,21.31591836734694,15,20,105,2,12
2693,638,833,18.901043083900227,21.292698412698414,15,13,221,2,195
2694,652,208,19.853061224489796,21.339138321995467,25,30,449,1,444
2695,652,205,19.853061224489796,22.709115646258503,25,27,464,3,447
2696,652,485,19.853061224489796,21.08371882086168,25,22,175,1,167
2697,652,453,19.853061224489796,22.175056689342405,25,22,223,2,199
2698,652,626,19.853061224489796,21.31591836734694,25,20,68,1,26
2699,652,833,19.853061224489796,21.292698412698414,25,13,191,1,181
2700,652,827,19.853061224489796,22.569795918367348,25,15,211,3,175
2701,616,205,20.54965986394558,22.709115646258503,19,27,421,2,411
2702,616,226,20.54965986394558,23.057414965986396,19,32,405,3,390
2703,616,453,20.54965986394558,22.175056689342405,19,22,177,2,163
2704,616,571,20.54965986394558,23.034195011337868,19,21,116,2,45
2705,616,650,20.54965986394558,23.010975056689343,19,20,111,2,34
2706,616,827,20.54965986394558,22.569795918367348,19,15,228,2,211
2707,626,205,21.31591836734694,22.709115646258503,20,27,425,1,421
2708,626,226,21.31591836734694,23.057414965986396,20,32,407,2,400
2709,626,571,21.31591836734694,23.034195011337868,20,21,92,2,55
2710,626,650,21.31591836734694,23.010975056689343,20,20,77,2,24
2711,626,618,21.31591836734694,23.56825396825397,20,21,97,2,8
2712,626,827,21.31591836734694,22.569795918367348,20,15,208,1,201
2713,626,832,21.31591836734694,23.870113378684806,20,13,234,3,206
2714,650,227,23.010975056689343,24.56671201814059,20,28,428,2,423
2715,650,212,23.010975056689343,25.611609977324264,20,29,452,3,438
2716,650,580,23.010975056689343,24.729251700680273,20,21,102,2,70
2717,650,511,23.010975056689343,25.26331065759637,20,21,169,2,139
2718,650,647,23.010975056689343,24.729251700680273,20,18,74,2,3
2719,650,626,23.010975056689343,25.611609977324264,20,18,115,3,24
2720,650,826,23.010975056689343,24.49705215419501,20,16,187,1,176
2721,650,918,23.010975056689343,25.58839002267574,20,13,290,3,268
2722,618,212,23.56825396825397,25.611609977324264,21,29,415,2,406
2723,618,580,23.56825396825397,24.729251700680273,21,21,63,1,38
2724,618,511,23.56825396825397,25.26331065759637,21,21,130,2,107
2725,618,431,23.56825396825397,26.33142857142857,21,22,222,3,187
2726,618,647,23.56825396825397,24.729251700680273,21,18,58,1,29
2727,618,626,23.56825396825397,25.611609977324264,21,18,88,2,8
2728,618,918,23.56825396825397,25.58839002267574,21,13,312,2,300
2729,618,908,23.56825396825397,26.33142857142857,21,17,313,3,290
2730,647,205,24.729251700680273,26.749387755102042,18,32,450,2,442
2731,647,205,24.729251700680273,27.16734693877551,18,33,454,2,442
2732,647,431,24.729251700680273,26.33142857142857,18,22,227,2,216
2733,647,437,24.729251700680273,27.30666666666667,18,20,238,3,210
2734,647,652,24.729251700680273,26.70294784580499,18,23,85,2,5
2735,647,616,24.729251700680273,27.376326530612246,18,18,118,3,31
2736,647,908,24.729251700680273,26.33142857142857,18,17,270,2,261
2737,647,832,24.729251700680273,27.30666666666667,18,12,216,3,185
2738,626,205,25.611609977324264,26.749387755102042,18,32,424,1,421
2739,626,205,25.611609977324264,27.16734693877551,18,33,426,2,421
2740,626,205,25.611609977324264,28.328344671201815,18,33,437,3,421
2741,626,437,25.611609977324264,27.30666666666667,18,20,203,2,189
2742,626,449,25.611609977324264,28.444444444444446,18,22,215,3,177
2743,626,652,25.611609977324264,26.70294784580499,18,23,54,1,26
2744,626,616,25.611609977324264,27.376326530612246,18,18,77,2,10
2745,626,622,25.611609977324264,28.18902494331066,18,19,111,3,4
2746,626,832,25.611609977324264,27.30666666666667,18,12,219,2,206
2747,626,832,25.611609977324264,28.16580498866213,18,14,234,3,206
2748,652,205,26.70294784580499,28.328344671201815,23,33,452,2,447
2749,652,205,26.70294784580499,29.094603174603176,23,28,459,2,447
2750,652,449,26.70294784580499,28.444444444444446,23,22,216,2,203
2751,652,622,26.70294784580499,28.18902494331066,23,19,71,1,30
2752,652,777,26.70294784580499,29.396462585034016,23,21,171,3,125
2753,652,832,26.70294784580499,28.16580498866213,23,14,191,1,180
2754,652,830,26.70294784580499,29.396462585034016,23,21,212,3,178
2755,616,205,27.376326530612246,29.094603174603176,18,28,418,2,411
2756,616,449,27.376326530612246,28.444444444444446,18,22,173,1,167
2757,616,614,27.376326530612246,29.930521541950114,18,22,110,3,2
2758,616,777,27.376326530612246,29.396462585034016,18,21,183,2,161
2759,616,830,27.376326530612246,29.396462585034016,18,21,231,2,214
2760,622,258,28.18902494331066,30.60390022675737,19,28,379,2,364
2761,622,614,28.18902494331066,29.930521541950114,19,22,75,2,8
2762,622,554,28.18902494331066,30.743219954648527,19,23,129,3,68
2763,622,777,28.18902494331066,29.396462585034016,19,21,163,1,155
2764,622,729,28.18902494331066,30.83609977324263,19,22,156,3,107
2765,622,830,28.18902494331066,29.396462585034016,19,21,214,1,208
2766,622,824,28.18902494331066,30.83609977324263,19,18,232,3,202
2767,777,554,29.396462585034016,30.743219954648527,21,23,230,1,223
2768,777,555,29.396462585034016,31.60235827664399,21,22,241,2,222
2769,777,729,29.396462585034016,30.83609977324263,21,22,78,1,48
2770,777,716,29.396462585034016,31.32371882086168,21,19,103,2,61
2771,777,824,29.396462585034016,30.83609977324263,21,18,78,1,47
2772,777,848,29.396462585034016,31.32371882086168,21,17,109,2,71
2773,729,257,30.83609977324263,32.066757369614514,22,28,475,1,472
2774,729,546,30.83609977324263,32.46149659863946,22,21,196,2,183
2775,729,632,30.83609977324263,32.46149659863946,22,19,120,2,97
2776,729,832,30.83609977324263,32.43827664399093,22,16,124,2,103
2777,716,546,31.32371882086168,32.46149659863946,19,21,177,1,170
2778,716,500,31.32371882086168,33.97079365079365,19,17,244,3,216
2779,716,632,31.32371882086168,32.46149659863946,19,19,97,1,84
2780,716,689,31.32371882086168,33.97079365079365,19,19,117,3,27
2781,716,832,31.32371882086168,32.43827664399093,19,16,126,1,116
2782,632,211,32.46149659863946,33.483174603174604,19,28,423,1,421
2783,632,233,32.46149659863946,35.015691609977324,19,25,414,3,399
2784,632,500,32.46149659863946,33.97079365079365,19,17,147,2,132
2785,632,555,32.46149659863946,35.015691609977324,19,20,134,3,77
2786,632,689,32.46149659863946,33.97079365079365,19,19,86,2,57
2787,632,832,32.46149659863946,35.015691609977324,19,15,228,3,200
2788,689,233,33.97079365079365,35.015691609977324,19,25,458,1,456
2789,689,233,33.97079365079365,35.87482993197279,19,25,463,2,456
2790,689,233,33.97079365079365,36.73396825396826,19,25,471,3,456
2791,689,555,33.97079365079365,35.015691609977324,19,20,141,1,134
2792,689,580,33.97079365079365,35.87482993197279,19,21,136,2,109
2793,689,580,33.97079365079365,36.73396825396826,19,22,161,3,109
2794,689,632,33.97079365079365,35.03891156462585,19,19,73,1,57
2795,689,685,33.97079365079365,35.87482993197279,19,17,82,2,4
2796,689,632,33.97079365079365,36.75718820861678,19,19,133,3,57
2797,689,832,33.97079365079365,35.015691609977324,19,15,150,1,143
2798,689,832,33.97079365079365,35.87482993197279,19,15,165,2,143
2799,689,832,33.97079365079365,36.73396825396826,19,12,186,3,143
2800,632,233,35.03891156462585,36.73396825396826,19,25,406,2,399
2801,632,243,35.03891156462585,37.593106575963716,19,25,404,3,389
2802,632,580,35.03891156462585,36.73396825396826,19,22,90,2,52
2803,632,579,35.03891156462585,37.593106575963716,19,22,122,3,53
2804,632,650,35.03891156462585,37.593106575963716,19,17,111,3,18
2805,632,832,35.03891156462585,36.73396825396826,19,12,213,2,200
2806,685,243,35.87482993197279,37.593106575963716,17,25,448,2,442
2807,685,579,35.87482993197279,37.593106575963716,17,22,129,2,106
2808,685,579,35.87482993197279,38.45224489795918,17,22,153,3,106
2809,685,650,35.87482993197279,37.593106575963716,17,17,82,2,35
2810,685,626,35.87482993197279,38.45224489795918,17,18,126,3,59
2811,632,271,36.75718820861678,39.05596371882086,19,27,374,2,361
2812,632,271,36.75718820861678,39.07918367346939,19,25,375,2,361
2813,632,579,36.75718820861678,38.45224489795918,19,22,90,2,53
2814,632,579,36.75718820861678,39.31138321995465,19,21,122,3,53
2815,632,626,36.75718820861678,38.45224489795918,19,18,73,2,6
2816,632,832,36.75718820861678,39.31138321995465,19,13,228,3,200
2817,650,271,37.593106575963716,39.05596371882086,17,27,384,1,379
2818,650,271,37.593106575963716,39.07918367346939,17,25,384,1,379
2819,650,218,37.593106575963716,40.4259410430839,17,30,449,3,432
2820,650,579,37.593106575963716,39.31138321995465,17,21,103,2,71
2821,650,632,37.593106575963716,39.31138321995465,17,18,76,2,18
2822,650,632,37.593106575963716,40.170521541950116,17,18,112,3,18
2823,650,832,37.593106575963716,39.31138321995465,17,13,196,2,182
2824,650,832,37.593106575963716,40.170521541950116,17,13,213,3,182
2825,626,218,38.45224489795918,40.4259410430839,18,30,417,2,408
2826,626,453,38.45224489795918,41.02965986394558,18,22,206,3,173
2827,626,632,38.45224489795918,40.170521541950116,18,18,74,2,6
2828,626,832,38.45224489795918,40.170521541950116,18,13,219,2,206
2829,632,218,39.31138321995465,40.4259410430839,18,30,417,1,414
2830,632,233,39.31138321995465,41.88879818594104,18,25,414,3,399
2831,632,453,39.31138321995465,41.02965986394558,18,22,194,2,179
2832,632,453,39.31138321995465,41.88879818594104,18,22,211,3,179
2833,632,835,39.31138321995465,41.86557823129252,18,12,231,3,203
2834,632,233,40.170521541950116,41.88879818594104,18,25,406,2,399
2835,632,212,40.170521541950116,42.72471655328798,18,24,434,3,420
2836,632,453,40.170521541950116,41.88879818594104,18,22,194,2,179
2837,632,554,40.170521541950116,42.74793650793651,18,22,136,3,78
2838,632,666,40.170521541950116,42.74793650793651,18,18,116,3,34
2839,632,835,40.170521541950116,41.86557823129252,18,12,216,2,203
2840,632,832,40.170521541950116,42.74793650793651,18,13,229,3,200
2841,632,233,41.88879818594104,43.58385487528345,19,25,406,2,399
2842,632,224,41.88879818594104,44.46621315192744,19,27,423,3,408
2843,632,453,41.88879818594104,43.607074829931975,19,23,194,2,179
2844,632,579,41.88879818594104,44.44299319727891,19,21,122,3,53
2845,632,647,41.88879818594104,43.58385487528345,19,19,75,2,15
2846,632,688,41.88879818594104,44.67519274376417,19,18,132,3,56
2847,632,832,41.88879818594104,43.607074829931975,19,13,213,2,200
2848,632,832,41.88879818594104,44.44299319727891,19,13,228,3,200
2849,666,224,42.74793650793651,44.46621315192744,18,27,448,2,442
2850,666,579,42.74793650793651,44.44299319727891,18,21,114,2,87
2851,666,493,42.74793650793651,45.302131519274376,18,21,205,3,173
2852,666,688,42.74793650793651,44.67519274376417,18,18,86,2,22
2853,666,681,42.74793650793651,45.302131519274376,18,17,111,3,15
2854,666,832,42.74793650793651,44.44299319727891,18,13,181,2,166
2855,666,835,42.74793650793651,45.302131519274376,18,13,202,3,169
2856,647,271,43.58385487528345,45.905850340136055,19,26,389,2,376
2857,647,233,43.58385487528345,46.16126984126984,19,25,429,3,414
2858,647,493,43.58385487528345,45.302131519274376,19,21,171,2,154
2859,647,454,43.58385487528345,46.18448979591837,19,21,223,3,193
2860,647,688,43.58385487528345,44.67519274376417,19,18,62,1,41
2861,647,681,43.58385487528345,45.302131519274376,19,17,81,2,34
2862,647,835,43.58385487528345,45.302131519274376,19,13,202,2,188
2863,647,832,43.58385487528345,46.16126984126984,19,17,216,3,185
2864,688,271,44.67519274376417,45.905850340136055,18,26,420,1,417
2865,688,233,44.67519274376417,46.16126984126984,18,25,459,1,455
2866,688,275,44.67519274376417,47.25260770975057,18,22,428,3,413
2867,688,454,44.67519274376417,46.18448979591837,18,21,243,2,234
2868,688,647,44.67519274376417,46.16126984126984,18,19,76,1,41
2869,688,832,44.67519274376417,46.16126984126984,18,17,158,1,144
2870,681,275,45.302131519274376,47.25260770975057,17,22,415,2,406
2871,681,474,45.302131519274376,47.69378684807256,17,17,231,2,207
2872,647,275,46.16126984126984,47.25260770975057,19,22,375,1,372
2873,647,329,46.16126984126984,48.36716553287982,19,24,332,2,318
2874,647,474,46.16126984126984,47.69378684807256,19,17,185,2,173
2875,647,421,46.16126984126984,48.529705215419504,19,17,248,2,226
2876,647,762,46.16126984126984,49.0637641723356,19,15,170,3,115
2877,647,719,46.16126984126984,49.11020408163265,19,19,146,3,72
2878,647,827,46.16126984126984,49.0637641723356,19,16,219,3,180
2879,762,451,49.0637641723356,50.45696145124717,15,18,317,1,311
2880,762,411,49.0637641723356,52.03591836734694,15,19,374,3,351
2881,762,721,49.0637641723356,51.66439909297052,15,17,119,3,41
2882,762,880,49.0637641723356,51.68761904761905,15,18,163,3,118
2883,719,220,49.11020408163265,50.665941043083905,19,26,503,2,499
2884,719,451,49.11020408163265,50.45696145124717,19,18,274,1,268
2885,719,411,49.11020408163265,52.03591836734694,19,19,333,3,308
2886,719,721,49.11020408163265,51.66439909297052,19,17,110,3,2
2887,719,880,49.11020408163265,51.68761904761905,19,18,196,3,161
2888,721,237,51.66439909297052,53.057596371882084,17,23,488,1,484
2889,721,415,51.66439909297052,53.31301587301587,17,21,314,2,306
2890,721,621,51.66439909297052,53.661315192743764,17,18,132,2,100
2891,721,703,51.66439909297052,54.17215419501134,17,18,109,3,18
2892,721,966,51.66439909297052,53.080816326530616,17,17,252,1,245
2893,721,923,51.66439909297052,53.10403628117914,17,16,211,1,202
2894,721,855,51.66439909297052,54.14893424036281,17,15,171,2,134
2895,618,218,52.15201814058957,53.75419501133787,19,26,406,2,400
2896,618,233,52.15201814058957,54.72943310657597,19,22,401,3,385
2897,618,415,52.15201814058957,53.31301587301587,19,21,209,1,203
2898,618,450,52.15201814058957,54.72943310657597,19,18,201,3,168
2899,618,621,52.15201814058957,53.661315192743764,19,18,65,2,3
2900,618,703,52.15201814058957,54.17215419501134,19,18,122,2,85
2901,618,855,52.15201814058957,54.14893424036281,19,15,252,2,237
2902,621,233,53.661315192743764,54.72943310657597,18,22,391,1,388
2903,621,233,53.661315192743764,55.58857142857143,18,22,397,2,388
2904,621,206,53.661315192743764,56.633469387755106,18,29,434,3,415
2905,621,450,53.661315192743764,54.72943310657597,18,18,177,1,171
2906,621,423,53.661315192743764,55.54213151927438,18,21,214,2,198
2907,621,411,53.661315192743764,56.633469387755106,18,20,246,3,210
2908,621,650,53.661315192743764,55.58857142857143,18,18,88,2,29
2909,621,647,53.661315192743764,56.447709750566894,18,17,123,3,26
2910,621,876,53.661315192743764,55.58857142857143,18,12,268,2,255
2911,621,820,53.661315192743764,56.401269841269844,18,16,231,3,199
2912,703,233,54.17215419501134,55.58857142857143,18,22,474,1,470
2913,703,206,54.17215419501134,56.633469387755106,18,29,508,2,497
2914,703,423,54.17215419501134,55.54213151927438,18,21,286,1,280
2915,703,411,54.17215419501134,56.633469387755106,18,20,311,2,292
2916,703,650,54.17215419501134,55.58857142857143,18,18,81,1,53
2917,703,647,54.17215419501134,56.447709750566894,18,17,113,2,56
2918,703,876,54.17215419501134,55.58857142857143,18,12,183,1,173
2919,703,820,54.17215419501134,56.401269841269844,18,16,151,2,117
2920,650,206,55.58857142857143,56.633469387755106,18,29,446,1,444
2921,650,220,55.58857142857143,57.5158276643991,18,27,438,2,430
2922,650,411,55.58857142857143,56.633469387755106,18,20,243,1,239
2923,650,579,55.58857142857143,57.30684807256236,18,18,103,2,71
2924,650,632,55.58857142857143,57.30684807256236,18,16,76,2,18
2925,647,220,56.447709750566894,57.5158276643991,17,27,429,1,427
2926,647,233,56.447709750566894,59.025124716553286,17,23,429,3,414
2927,647,217,56.447709750566894,59.14122448979592,17,25,445,3,430
2928,647,493,56.447709750566894,59.025124716553286,17,20,190,3,154
2929,647,658,56.447709750566894,59.025124716553286,17,19,112,3,11
2930,647,876,56.447709750566894,59.00190476190476,17,17,254,3,229
2931,632,233,57.30684807256236,59.025124716553286,16,23,406,2,399
2932,632,217,57.30684807256236,59.14122448979592,16,25,422,2,415
2933,632,493,57.30684807256236,59.025124716553286,16,20,157,2,139
2934,632,578,57.30684807256236,59.88426303854875,16,18,123,3,54
2935,632,658,57.30684807256236,59.025124716553286,16,19,78,2,26
2936,632,876,57.30684807256236,59.00190476190476,16,17,255,2,244
2937,658,233,59.025124716553286,60.74340136054422,19,23,431,2,425
2938,658,259,59.025124716553286,61.85795918367347,19,28,417,3,399
2939,658,412,59.025124716553286,60.74340136054422,19,20,257,2,246
2940,658,550,59.025124716553286,61.85795918367347,19,23,163,3,108
2941,658,770,59.025124716553286,60.74340136054422,19,15,134,2,112
2942,658,777,59.025124716553286,61.85795918367347,19,17,170,3,119
2943,658,824,59.025124716553286,61.9740589569161,19,18,209,3,166
2944,632,259,59.88426303854875,61.85795918367347,16,28,383,2,373
2945,632,290,59.88426303854875,62.46167800453515,16,25,360,3,342
2946,632,550,59.88426303854875,61.85795918367347,16,23,118,2,82
2947,632,453,59.88426303854875,62.46167800453515,16,22,211,3,179
2948,632,777,59.88426303854875,61.85795918367347,16,17,168,2,145
2949,632,673,59.88426303854875,62.80997732426304,16,23,133,3,41
2950,632,824,59.88426303854875,61.9740589569161,16,18,212,2,192
2951,632,906,59.88426303854875,62.80997732426304,16,20,302,3,274
2952,770,290,60.74340136054422,62.46167800453515,15,25,486,2,480
2953,770,550,60.74340136054422,61.85795918367347,15,23,225,1,220
2954,770,453,60.74340136054422,62.46167800453515,15,22,326,2,317
2955,770,777,60.74340136054422,61.85795918367347,15,17,49,1,7
2956,770,673,60.74340136054422,62.80997732426304,15,23,132,2,97
2957,770,824,60.74340136054422,61.9740589569161,15,18,76,1,54
2958,770,906,60.74340136054422,62.80997732426304,15,20,163,2,136
2959,777,291,61.85795918367347,63.76199546485261,17,25,493,2,486
2960,777,598,61.85795918367347,64.08707482993198,17,22,203,2,179
2961,777,431,61.85795918367347,64.57469387755103,17,23,365,3,346
2962,777,770,61.85795918367347,64.08707482993198,17,20,96,2,7
2963,777,622,61.85795918367347,64.45859410430839,17,20,191,3,155
2964,777,943,61.85795918367347,64.01741496598639,17,19,190,2,166
2965,777,864,61.85795918367347,64.1102947845805,17,13,130,2,87
2966,673,214,62.80997732426304,64.62113378684808,23,29,466,2,459
2967,673,261,62.80997732426304,65.50349206349206,23,28,428,3,412
2968,673,598,62.80997732426304,64.08707482993198,23,22,93,1,75
2969,673,431,62.80997732426304,64.57469387755103,23,23,254,2,242
2970,673,584,62.80997732426304,65.57315192743765,23,21,149,3,89
2971,673,770,62.80997732426304,64.08707482993198,23,20,112,1,97
2972,673,622,62.80997732426304,64.45859410430839,23,20,87,2,51
2973,673,616,62.80997732426304,65.57315192743765,23,19,132,3,57
2974,673,943,62.80997732426304,64.01741496598639,23,19,275,1,270
2975,673,864,62.80997732426304,64.1102947845805,23,13,199,1,191
2976,673,934,62.80997732426304,65.22485260770975,23,15,281,2,261
2977,770,584,64.08707482993198,65.57315192743765,20,21,197,1,186
2978,770,420,64.08707482993198,67.0592290249433,20,24,373,3,350
2979,770,616,64.08707482993198,65.57315192743765,20,19,167,1,154
2980,770,676,64.08707482993198,66.71092970521542,20,18,147,3,94
2981,770,934,64.08707482993198,65.22485260770975,20,15,171,1,164
2982,770,927,64.08707482993198,66.71092970521542,20,17,193,3,157
2983,622,261,64.45859410430839,65.50349206349206,20,28,364,1,361
2984,622,261,64.45859410430839,66.40907029478458,20,24,371,2,361
2985,622,584,64.45859410430839,65.57315192743765,20,21,61,1,38
2986,622,420,64.45859410430839,67.0592290249433,20,24,231,3,202
2987,622,616,64.45859410430839,65.57315192743765,20,19,48,1,6
2988,622,676,64.45859410430839,66.71092970521542,20,18,111,2,54
2989,622,927,64.45859410430839,66.71092970521542,20,17,320,2,305
2990,622,905,64.45859410430839,67.33786848072563,20,16,309,3,283
2991,616,289,65.57315192743765,67.63972789115647,19,25,339,2,327
2992,616,214,65.57315192743765,68.4756462585034,19,27,421,3,402
2993,616,420,65.57315192743765,67.0592290249433,19,24,206,1,196
2994,616,579,65.57315192743765,67.8487074829932,19,25,105,2,37
2995,616,676,65.57315192743765,66.71092970521542,19,18,77,1,60
2996,616,653,65.57315192743765,67.89514739229026,19,22,107,2,37
2997,616,927,65.57315192743765,66.71092970521542,19,17,315,1,311
2998,616,905,65.57315192743765,67.33786848072563,19,16,299,2,289
2999,676,214,66.71092970521542,68.4756462585034,18,27,468,2,462
3000,676,233,66.71092970521542,69.31156462585034,18,24,457,3,443
3001,676,579,66.71092970521542,67.8487074829932,18,25,109,1,97
3002,676,578,66.71092970521542,68.77750566893424,18,21,132,2,98
3003,676,453,66.71092970521542,69.31156462585034,18,21,250,3,223
3004,676,653,66.71092970521542,67.89514739229026,18,22,56,1,23
3005,676,661,66.71092970521542,68.77750566893424,18,22,90,2,15
3006,676,839,66.71092970521542,68.77750566893424,18,21,186,2,163
3007,676,826,66.71092970521542,69.47410430839003,18,21,191,3,150
3008,653,233,67.89514739229026,69.31156462585034,22,24,424,1,420
3009,653,453,67.89514739229026,69.31156462585034,22,21,209,1,200
3010,653,782,67.89514739229026,69.70630385487529,22,23,151,2,129
3011,653,826,67.89514739229026,69.47410430839003,22,21,186,2,173
3012,653,861,67.89514739229026,70.33324263038548,22,19,233,2,208
3013,661,233,68.77750566893424,71.02984126984127,22,23,439,2,428
3014,661,218,68.77750566893424,71.19238095238096,22,32,455,2,443
3015,661,579,68.77750566893424,71.00662131519275,22,24,126,2,82
3016,661,583,68.77750566893424,71.21560090702948,22,26,131,2,78
3017,661,650,68.77750566893424,71.00662131519275,22,21,97,2,11
3018,661,619,68.77750566893424,71.21560090702948,22,22,113,2,42
3019,661,861,68.77750566893424,70.33324263038548,22,19,211,2,200
3020,782,579,69.70630385487529,71.00662131519275,23,24,211,1,203
3021,782,583,69.70630385487529,71.21560090702948,23,26,209,2,199
3022,782,452,69.70630385487529,72.58557823129252,23,22,353,3,330
3023,782,650,69.70630385487529,71.00662131519275,23,21,143,1,132
3024,782,619,69.70630385487529,71.21560090702948,23,22,175,2,163
3025,782,940,69.70630385487529,72.26049886621315,23,23,193,3,158
3026,650,274,71.00662131519275,72.79455782312925,21,29,384,2,376
3027,650,233,71.00662131519275,73.58403628117914,21,24,432,3,417
3028,650,452,71.00662131519275,72.58557823129252,21,22,209,2,198
3029,650,580,71.00662131519275,73.58403628117914,21,20,131,3,70
3030,650,799,71.00662131519275,72.95709750566894,21,20,171,2,149
3031,650,632,71.00662131519275,73.60725623582766,21,17,113,3,18
3032,650,940,71.00662131519275,72.26049886621315,21,23,295,1,290
3033,650,832,71.00662131519275,73.58403628117914,21,14,213,3,182
3034,619,274,71.21560090702948,72.79455782312925,22,29,352,2,345
3035,619,233,71.21560090702948,73.58403628117914,22,24,399,2,386
3036,619,452,71.21560090702948,72.58557823129252,22,22,177,1,167
3037,619,580,71.21560090702948,73.58403628117914,22,20,109,2,39
3038,619,799,71.21560090702948,72.95709750566894,22,20,195,2,180
3039,619,632,71.21560090702948,73.60725623582766,22,17,104,2,13
3040,619,940,71.21560090702948,72.26049886621315,22,23,324,1,321
3041,619,832,71.21560090702948,73.58403628117914,22,14,236,2,213
3042,799,573,72.95709750566894,74.65215419501133,20,22,237,2,226
3043,799,485,72.95709750566894,75.92925170068027,20,23,339,3,314
3044,799,652,72.95709750566894,74.6985941043084,20,24,165,2,147
3045,799,616,72.95709750566894,75.39519274376417,20,18,211,2,183
3046,632,205,73.60725623582766,74.65215419501133,17,34,429,1,427
3047,632,245,73.60725623582766,75.18621315192743,17,31,393,2,387
3048,632,205,73.60725623582766,76.23111111111112,17,30,442,3,427
3049,632,573,73.60725623582766,74.65215419501133,17,22,74,1,59
3050,632,485,73.60725623582766,75.92925170068027,17,23,178,2,147
3051,632,451,73.60725623582766,76.37043083900227,17,24,217,3,181
3052,632,652,73.60725623582766,74.6985941043084,17,24,51,1,20
3053,632,616,73.60725623582766,75.39519274376417,17,18,79,2,16
3054,632,667,73.60725623582766,76.16145124716553,17,20,115,3,35
3055,632,832,73.60725623582766,76.16145124716553,17,12,228,3,200
3056,652,205,74.6985941043084,76.23111111111112,24,30,452,2,447
3057,652,485,74.6985941043084,75.92925170068027,24,23,175,1,167
3058,652,451,74.6985941043084,76.37043083900227,24,24,214,2,201
3059,652,667,74.6985941043084,76.16145124716553,24,20,65,1,15
3060,652,832,74.6985941043084,76.16145124716553,24,12,191,1,180
3061,616,226,75.39519274376417,77.90294784580499,18,33,405,3,390
3062,616,451,75.39519274376417,77.87972789115646,18,21,197,2,165
3063,616,654,75.39519274376417,77.85650793650794,18,20,113,2,38
3064,616,835,75.39519274376417,77.85650793650794,18,13,243,2,219
3065,667,226,76.16145124716553,77.90294784580499,20,33,447,2,441
3066,667,254,76.16145124716553,78.41378684807256,20,29,424,2,413
3067,667,451,76.16145124716553,77.87972789115646,20,21,228,2,216
3068,667,581,76.16145124716553,78.41378684807256,20,22,130,2,86
3069,667,654,76.16145124716553,77.85650793650794,20,20,74,2,13
3070,667,619,76.16145124716553,78.43700680272109,20,19,109,2,48
3071,667,835,76.16145124716553,77.85650793650794,20,13,183,2,168
3072,667,832,76.16145124716553,78.73886621315192,20,14,199,3,165
3073,654,219,77.85650793650794,80.1320634920635,20,27,446,2,435
3074,654,233,77.85650793650794,80.45714285714286,20,27,436,3,421
3075,654,546,77.85650793650794,79.5980045351474,20,22,131,2,108
3076,654,453,77.85650793650794,80.45714285714286,20,21,230,3,201
3077,654,666,77.85650793650794,79.5980045351474,20,18,76,2,12
3078,654,632,77.85650793650794,80.45714285714286,20,19,114,3,22
3079,654,853,77.85650793650794,79.36580498866213,20,16,209,2,199
3080,619,219,78.43700680272109,80.1320634920635,19,27,407,2,400
3081,619,233,78.43700680272109,80.45714285714286,19,27,396,2,386
3082,619,546,78.43700680272109,79.5980045351474,19,22,88,1,73
3083,619,453,78.43700680272109,80.45714285714286,19,21,187,2,166
3084,619,557,78.43700680272109,81.33950113378685,19,21,140,3,62
3085,619,666,78.43700680272109,79.5980045351474,19,18,69,1,47
3086,619,632,78.43700680272109,80.45714285714286,19,19,88,2,13
3087,619,827,78.43700680272109,81.13052154195012,19,13,238,3,208
3088,619,827,78.43700680272109,81.17696145124717,19,18,239,3,208
3089,666,205,79.5980045351474,81.50204081632653,18,35,468,2,461
3090,666,557,79.5980045351474,81.33950113378685,18,21,132,2,109
3091,666,655,79.5980045351474,81.52526077097505,18,24,84,2,11
3092,666,827,79.5980045351474,81.13052154195012,18,13,174,2,161
3093,666,827,79.5980045351474,81.17696145124717,18,18,175,2,161
3094,632,205,80.45714285714286,81.50204081632653,19,35,429,1,427
3095,632,206,80.45714285714286,83.05777777777777,19,31,440,3,426
3096,632,287,80.45714285714286,83.19709750566894,19,28,365,3,345
3097,632,454,80.45714285714286,83.05777777777777,19,23,210,3,178
3098,632,655,80.45714285714286,81.52526077097505,19,24,51,1,23
3099,655,206,81.52526077097505,83.05777777777777,24,31,454,2,449
3100,655,287,81.52526077097505,83.19709750566894,24,28,375,2,368
3101,655,454,81.52526077097505,83.05777777777777,24,23,212,2,201
3102,655,580,81.52526077097505,83.8704761904762,24,22,126,2,75
3103,655,632,81.52526077097505,83.03455782312925,24,19,69,2,23
3104,655,647,81.52526077097505,83.8704761904762,24,18,101,2,8
3105,655,739,81.52526077097505,84.24199546485261,24,21,144,3,84
3106,655,829,81.52526077097505,84.24199546485261,24,20,210,3,174
3107,632,233,83.03455782312925,84.72961451247166,19,24,406,2,399
3108,632,258,83.03455782312925,85.47265306122449,19,30,388,2,374
3109,632,571,83.03455782312925,84.75283446712018,19,21,96,2,61
3110,632,580,83.03455782312925,85.58875283446712,19,21,122,3,52
3111,632,739,83.03455782312925,84.24199546485261,19,21,119,1,107
3112,632,669,83.03455782312925,85.72807256235828,19,23,122,3,37
3113,632,829,83.03455782312925,84.24199546485261,19,20,204,1,197
3114,632,831,83.03455782312925,85.68163265306123,19,18,229,3,199
3115,647,258,83.8704761904762,85.47265306122449,18,30,395,2,389
3116,647,580,83.8704761904762,85.58875283446712,18,21,100,2,67
3117,647,421,83.8704761904762,86.2853514739229,18,23,249,2,226
3118,647,669,83.8704761904762,85.72807256235828,18,23,83,2,22
3119,647,649,83.8704761904762,86.44789115646259,18,19,111,3,2
3120,647,831,83.8704761904762,85.68163265306123,18,18,200,2,184
3121,647,847,83.8704761904762,86.21569160997733,18,18,224,2,200
3122,739,258,84.24199546485261,85.47265306122449,21,30,484,1,481
3123,739,257,84.24199546485261,86.91229024943311,21,29,496,3,482
3124,739,580,84.24199546485261,85.58875283446712,21,21,169,1,159
3125,739,421,84.24199546485261,86.2853514739229,21,23,330,2,318
3126,739,669,84.24199546485261,85.72807256235828,21,23,95,1,70
3127,739,649,84.24199546485261,86.44789115646259,21,19,131,2,90
3128,739,831,84.24199546485261,85.68163265306123,21,18,111,1,92
3129,739,847,84.24199546485261,86.21569160997733,21,18,137,2,108
3130,669,257,85.72807256235828,86.91229024943311,23,29,415,1,412
3131,669,233,85.72807256235828,87.30702947845805,23,26,441,2,436
3132,669,211,85.72807256235828,88.3287074829932,23,27,471,3,458
3133,669,554,85.72807256235828,87.30702947845805,23,20,134,2,115
3134,669,632,85.72807256235828,87.30702947845805,23,18,77,2,37
3135,669,658,85.72807256235828,88.65378684807257,23,13,126,3,11
3136,669,944,85.72807256235828,87.33024943310657,23,12,284,2,275
3137,649,211,86.44789115646259,88.3287074829932,19,27,445,2,438
3138,649,459,86.44789115646259,88.8627664399093,19,18,217,2,190
3139,649,658,86.44789115646259,88.65378684807257,19,13,95,2,9
3140,632,211,87.30702947845805,88.3287074829932,18,27,423,1,421
3141,632,233,87.30702947845805,89.88444444444444,18,26,414,3,399
3142,632,459,87.30702947845805,88.8627664399093,18,18,186,2,173
3143,632,454,87.30702947845805,89.90766439909297,18,21,210,3,178
3144,632,658,87.30702947845805,88.65378684807257,18,13,64,1,26
3145,632,625,87.30702947845805,89.88444444444444,18,20,111,3,7
3146,632,932,87.30702947845805,89.88444444444444,18,13,320,3,300
3147,658,233,88.65378684807257,89.88444444444444,13,26,428,1,425
3148,658,339,88.65378684807257,90.74358276643991,13,24,331,2,319
3149,658,233,88.65378684807257,91.57950113378685,13,25,443,3,425
3150,658,454,88.65378684807257,89.90766439909297,13,21,211,1,204
3151,658,579,88.65378684807257,90.74358276643991,13,22,120,2,79
3152,658,579,88.65378684807257,91.60272108843537,13,22,150,3,79
3153,658,625,88.65378684807257,89.88444444444444,13,20,62,1,33
3154,658,666,88.65378684807257,90.74358276643991,13,20,90,2,8
3155,658,647,88.65378684807257,91.60272108843537,13,18,127,3,11
3156,658,932,88.65378684807257,89.88444444444444,13,13,279,1,274
3157,658,898,88.65378684807257,90.72036281179139,13,13,256,2,240
3158,658,832,88.65378684807257,91.60272108843537,13,13,215,3,174
3159,625,233,89.88444444444444,91.57950113378685,20,25,399,2,392
3160,625,216,89.88444444444444,92.48507936507937,20,25,424,3,409
3161,625,579,89.88444444444444,91.60272108843537,20,22,87,2,46
3162,625,454,89.88444444444444,92.46185941043085,20,21,204,3,171
3163,625,647,89.88444444444444,91.60272108843537,20,18,77,2,22
3164,625,626,89.88444444444444,92.46185941043085,20,18,111,3,1
3165,625,832,89.88444444444444,91.60272108843537,20,13,220,2,207
3166,625,841,89.88444444444444,92.43863945578231,20,13,242,3,216
3167,666,216,90.74358276643991,92.48507936507937,20,25,456,2,450
3168,666,454,90.74358276643991,92.46185941043085,20,21,225,2,212
3169,666,626,90.74358276643991,92.46185941043085,20,18,84,2,40
3170,666,632,90.74358276643991,93.3209977324263,20,18,116,3,34
3171,666,841,90.74358276643991,92.43863945578231,20,13,190,2,175
3172,666,832,90.74358276643991,93.3209977324263,20,14,200,3,166
3173,647,271,91.60272108843537,93.90149659863945,18,26,389,2,376
3174,647,580,91.60272108843537,94.15691609977324,18,21,129,3,67
3175,647,632,91.60272108843537,93.3209977324263,18,18,76,2,15
3176,647,832,91.60272108843537,93.3209977324263,18,14,199,2,185
3177,647,832,91.60272108843537,94.18013605442177,18,12,216,3,185
3178,626,271,92.46185941043085,93.90149659863945,18,26,360,1,355
3179,626,244,92.46185941043085,95.06249433106576,18,27,398,3,382
3180,626,218,92.46185941043085,95.2714739229025,18,31,426,3,408
3181,626,580,92.46185941043085,94.15691609977324,18,21,86,2,46
3182,626,579,92.46185941043085,95.01605442176871,18,22,120,3,47
3183,626,647,92.46185941043085,95.01605442176871,18,18,112,3,21
3184,626,832,92.46185941043085,94.18013605442177,18,12,219,2,206
3185,632,244,93.3209977324263,95.06249433106576,18,27,395,2,388
3186,632,218,93.3209977324263,95.2714739229025,18,31,422,2,414
3187,632,579,93.3209977324263,95.01605442176871,18,22,90,2,53
3188,632,555,93.3209977324263,95.87519274376417,18,21,134,3,77
3189,632,647,93.3209977324263,95.01605442176871,18,18,75,2,15
3190,632,832,93.3209977324263,95.87519274376417,18,13,228,3,200
3191,647,233,95.01605442176871,96.73433106575963,18,25,421,2,414
3192,647,236,95.01605442176871,97.5934693877551,18,25,426,3,411
3193,647,579,95.01605442176871,96.73433106575963,18,21,100,2,68
3194,647,580,95.01605442176871,97.5934693877551,18,24,130,3,67
3195,647,626,95.01605442176871,96.73433106575963,18,18,77,2,21
3196,647,666,95.01605442176871,97.5934693877551,18,19,113,3,19
3197,647,835,95.01605442176871,96.73433106575963,18,13,202,2,188
3198,647,910,95.01605442176871,97.5934693877551,18,13,285,3,263
3199,632,236,95.8984126984127,97.5934693877551,17,25,403,2,396
3200,632,243,95.8984126984127,98.42938775510204,17,24,404,3,389
3201,632,580,95.8984126984127,97.5934693877551,17,24,90,2,52
3202,632,454,95.8984126984127,98.47582766439909,17,22,210,3,178
3203,632,666,95.8984126984127,97.5934693877551,17,19,81,2,34
3204,632,650,95.8984126984127,98.45260770975057,17,18,111,3,18
3205,632,910,95.8984126984127,97.5934693877551,17,13,287,2,278
3206,632,832,95.8984126984127,98.45260770975057,17,13,228,3,200
3207,626,243,96.73433106575963,98.42938775510204,18,24,390,2,383
3208,626,454,96.73433106575963,98.47582766439909,18,22,188,2,172
3209,626,650,96.73433106575963,98.45260770975057,18,18,78,2,24
3210,626,688,96.73433106575963,99.52072562358276,18,17,135,3,62
3211,626,832,96.73433106575963,98.45260770975057,18,13,219,2,206
3212,666,233,97.5934693877551,100.1708843537415,19,27,447,3,433
3213,666,578,97.5934693877551,100.1708843537415,19,21,142,3,88
3214,666,688,97.5934693877551,99.52072562358276,19,17,86,2,22
3215,666,832,97.5934693877551,100.1708843537415,19,13,200,3,166
3216,650,233,98.45260770975057,100.1708843537415,18,27,424,2,417
3217,650,271,98.45260770975057,100.77460317460317,18,26,392,2,379
3218,650,578,98.45260770975057,100.1708843537415,18,21,103,2,72
3219,650,554,98.45260770975057,101.03002267573696,18,23,147,3,96
3220,650,688,98.45260770975057,99.52072562358276,18,17,60,1,38
3221,650,632,98.45260770975057,101.03002267573696,18,18,112,3,18
3222,650,832,98.45260770975057,100.1708843537415,18,13,196,2,182
3223,650,833,98.45260770975057,101.03002267573696,18,13,214,3,183
3224,688,271,99.52072562358276,100.77460317460317,17,26,420,1,417
3225,688,339,99.52072562358276,101.88916099773243,17,25,364,2,349
3226,688,249,99.52072562358276,102.44643990929706,17,21,457,3,439
3227,688,554,99.52072562358276,101.03002267573696,17,23,149,2,134
3228,688,453,99.52072562358276,101.88916099773243,17,21,256,2,235
3229,688,436,99.52072562358276,102.44643990929706,17,17,282,3,252
3230,688,632,99.52072562358276,101.03002267573696,17,18,86,2,56
3231,688,632,99.52072562358276,101.88916099773243,17,19,116,2,56
3232,688,617,99.52072562358276,102.28390022675737,17,14,139,3,71
3233,688,833,99.52072562358276,101.03002267573696,17,13,159,2,145
3234,688,832,99.52072562358276,101.86594104308391,17,14,176,2,144
3235,632,249,101.03002267573696,102.44643990929706,18,21,388,1,383
3236,632,226,101.03002267573696,103.44489795918368,18,14,419,2,406
3237,632,436,101.03002267573696,102.44643990929706,18,17,205,1,196
3238,632,590,101.03002267573696,103.86285714285715,18,12,129,3,42
3239,632,617,101.03002267573696,102.28390022675737,18,14,56,1,15
3240,632,619,101.03002267573696,103.44489795918368,18,12,105,2,13
3241,632,226,101.88916099773243,103.44489795918368,19,14,411,2,406
3242,632,222,101.88916099773243,104.39691609977325,19,16,424,3,410
3243,632,590,101.88916099773243,103.86285714285715,19,12,95,2,42
3244,632,619,101.88916099773243,103.44489795918368,19,12,68,2,13
3245,617,226,102.28390022675737,103.44489795918368,14,14,394,1,391
3246,617,222,102.28390022675737,104.39691609977325,14,16,405,2,395
3247,617,590,102.28390022675737,103.86285714285715,14,12,73,2,27
3248,617,619,102.28390022675737,103.44489795918368,14,12,50,1,2
3249,619,220,103.44489795918368,105.81333333333333,12,18,412,2,399
3250,619,562,103.44489795918368,105.83655328798186,12,14,118,2,57
3251,626,356,114.10285714285715,115.17097505668934,12,19,274,1,270
3252,626,355,114.10285714285715,115.82113378684808,12,23,281,2,271
3253,626,355,114.10285714285715,116.23909297052154,12,19,286,2,271
3254,626,598,114.10285714285715,115.37995464852608,12,18,62,1,28
3255,626,624,114.10285714285715,115.70503401360544,12,12,69,2,2
3256,624,205,115.70503401360544,117.51619047619047,12,35,426,2,419
3257,624,611,115.70503401360544,117.56263038548754,12,22,81,2,13
3258,624,455,115.70503401360544,118.67718820861678,12,20,212,3,169
3259,624,652,115.70503401360544,117.56263038548754,12,25,85,2,28
3260,624,616,115.70503401360544,118.25922902494331,12,18,110,3,8
3261,652,205,117.56263038548754,119.09514739229026,25,30,452,2,447
3262,652,205,117.56263038548754,119.53632653061224,25,27,455,2,447
3263,652,455,117.56263038548754,118.67718820861678,25,20,203,1,197
3264,652,449,117.56263038548754,119.25768707482993,25,22,216,2,203
3265,652,615,117.56263038548754,120.02394557823129,25,13,112,2,37
3266,652,649,117.56263038548754,120.27936507936508,25,19,117,3,3
3267,616,205,118.25922902494331,119.53632653061224,18,27,415,1,411
3268,616,227,118.25922902494331,120.76698412698413,18,32,404,3,389
3269,616,430,118.25922902494331,121.13850340136055,18,21,224,3,186
3270,616,615,118.25922902494331,120.02394557823129,18,13,76,2,1
3271,616,649,118.25922902494331,120.27936507936508,18,19,93,2,33
3272,615,258,120.02394557823129,121.34748299319727,13,28,362,1,357
3273,615,227,120.02394557823129,122.27628117913832,13,29,400,2,388
3274,615,430,120.02394557823129,121.13850340136055,13,21,191,1,185
3275,615,465,120.02394557823129,121.69578231292518,13,23,166,2,150
3276,615,418,120.02394557823129,122.46204081632654,13,22,223,2,197
3277,615,618,120.02394557823129,121.2778231292517,13,20,54,1,3
3278,615,622,120.02394557823129,122.46204081632654,13,18,105,2,7
3279,615,824,120.02394557823129,121.55646258503401,13,19,219,2,209
3280,615,836,120.02394557823129,122.46204081632654,13,13,245,2,221
3281,649,258,120.27936507936508,121.34748299319727,19,28,394,1,391
3282,649,227,120.27936507936508,122.27628117913832,19,29,431,2,422
3283,649,465,120.27936507936508,121.69578231292518,19,23,194,1,184
3284,649,418,120.27936507936508,122.46204081632654,19,22,249,2,231
3285,649,622,120.27936507936508,122.46204081632654,19,18,98,2,27
3286,649,824,120.27936507936508,121.55646258503401,19,19,183,1,175
3287,649,836,120.27936507936508,122.46204081632654,19,13,209,2,187
3288,618,213,121.2778231292517,123.321179138322,20,28,414,2,405
3289,618,418,121.2778231292517,122.46204081632654,20,22,206,1,200
3290,618,554,121.2778231292517,123.321179138322,20,21,109,2,64
3291,618,622,121.2778231292517,122.46204081632654,20,18,51,1,4
3292,618,690,121.2778231292517,124.0409977324263,20,19,139,3,72
3293,618,836,121.2778231292517,122.46204081632654,20,13,224,1,218
3294,618,825,121.2778231292517,124.0409977324263,20,17,239,3,207
3295,622,205,122.46204081632654,124.34285714285714,18,33,425,2,417
3296,622,573,122.46204081632654,124.36607709750567,18,21,96,2,49
3297,622,690,122.46204081632654,124.0409977324263,18,19,96,2,68
3298,622,655,122.46204081632654,124.36607709750567,18,24,88,2,33
3299,622,825,122.46204081632654,124.0409977324263,18,17,214,2,203
3300,622,835,122.46204081632654,125.0162358276644,18,14,240,3,213
3301,690,205,124.0409977324263,126.13079365079365,19,31,493,2,485
3302,690,205,124.0409977324263,126.59519274376417,19,29,497,3,485
3303,690,579,124.0409977324263,125.87537414965986,19,22,136,2,111
3304,690,626,124.0409977324263,125.89859410430839,19,18,102,2,64
3305,690,833,124.0409977324263,125.87537414965986,19,14,163,2,143
3306,655,205,124.36607709750567,126.13079365079365,24,31,456,2,450
3307,655,205,124.36607709750567,126.59519274376417,24,29,460,2,450
3308,655,579,124.36607709750567,125.87537414965986,24,22,100,2,76
3309,655,488,124.36607709750567,127.12925170068027,24,21,205,3,167
3310,655,626,124.36607709750567,125.89859410430839,24,18,72,2,29
3311,655,793,124.36607709750567,127.10603174603175,24,20,182,3,138
3312,655,833,124.36607709750567,125.87537414965986,24,14,189,2,178
3313,655,864,124.36607709750567,127.10603174603175,24,17,240,3,209
3314,626,257,125.89859410430839,128.19736961451247,18,27,382,2,369
3315,626,258,125.89859410430839,128.33668934240364,18,29,383,2,368
3316,626,488,125.89859410430839,127.12925170068027,18,21,148,1,138
3317,626,579,125.89859410430839,127.5936507936508,18,21,87,2,47
3318,626,555,125.89859410430839,128.45278911564625,18,23,131,3,71
3319,626,793,125.89859410430839,127.10603174603175,18,20,175,1,167
3320,626,729,125.89859410430839,128.54566893424035,18,21,154,3,103
3321,626,864,125.89859410430839,127.10603174603175,18,17,244,1,238
3322,626,826,125.89859410430839,127.96517006802722,18,15,219,2,200
3323,793,555,127.10603174603175,128.45278911564625,20,23,245,1,238
3324,793,729,127.10603174603175,128.54566893424035,20,21,89,1,64
3325,793,923,127.10603174603175,129.03328798185942,20,17,154,2,130
3326,793,832,127.10603174603175,129.3119274376417,20,13,103,2,39
3327,626,257,127.5936507936508,129.77632653061224,18,29,381,2,369
3328,626,554,127.5936507936508,130.1710657596372,18,23,132,3,72
3329,626,632,127.5936507936508,130.1710657596372,18,20,111,3,6
3330,626,923,127.5936507936508,129.03328798185942,18,17,303,1,297
3331,626,832,127.5936507936508,129.3119274376417,18,13,219,2,206
3332,729,257,128.54566893424035,129.77632653061224,21,29,475,1,472
3333,729,554,128.54566893424035,130.1710657596372,21,23,188,2,175
3334,729,546,128.54566893424035,131.03020408163266,21,22,212,2,183
3335,729,632,128.54566893424035,130.1710657596372,21,20,120,2,97
3336,729,666,128.54566893424035,131.03020408163266,21,18,124,2,63
3337,729,832,128.54566893424035,131.00698412698412,21,12,148,2,103
3338,729,831,128.54566893424035,131.4249433106576,21,13,161,3,102
3339,632,211,130.1710657596372,131.19274376417235,20,27,423,1,421
3340,632,217,130.1710657596372,131.72680272108843,20,27,420,2,415
3341,632,339,130.1710657596372,132.74848072562358,20,24,313,3,293
3342,632,432,130.1710657596372,131.91256235827666,20,21,214,2,200
3343,632,480,130.1710657596372,132.74848072562358,20,21,188,3,152
3344,632,642,130.1710657596372,131.86612244897958,20,18,74,2,10
3345,632,697,130.1710657596372,132.74848072562358,20,19,129,3,65
3346,632,831,130.1710657596372,131.4249433106576,20,13,206,1,199
3347,632,835,130.1710657596372,132.72526077097507,20,14,231,3,203
3348,666,339,131.03020408163266,132.74848072562358,18,24,335,2,327
3349,666,233,131.03020408163266,133.58439909297053,18,24,447,3,433
3350,666,480,131.03020408163266,132.74848072562358,18,21,200,2,186
3351,666,555,131.03020408163266,133.60761904761904,18,22,157,3,111
3352,666,697,131.03020408163266,132.74848072562358,18,19,80,2,31
3353,666,647,131.03020408163266,133.58439909297053,18,18,112,3,19
3354,666,835,131.03020408163266,132.72526077097507,18,14,184,2,169
3355,666,832,131.03020408163266,133.58439909297053,18,13,199,3,166
3356,642,233,131.86612244897958,133.58439909297053,18,24,416,2,409
3357,642,243,131.86612244897958,134.443537414966,18,24,414,3,399
3358,642,555,131.86612244897958,133.60761904761904,18,22,115,2,87
3359,642,546,131.86612244897958,134.46675736961453,18,22,148,3,96
3360,642,647,131.86612244897958,133.58439909297053,18,18,74,2,5
3361,642,649,131.86612244897958,134.443537414966,18,18,111,3,7
3362,642,832,131.86612244897958,133.58439909297053,18,13,204,2,190
3363,642,832,131.86612244897958,134.443537414966,18,13,220,3,190
3364,697,243,132.74848072562358,134.443537414966,19,24,460,2,454
3365,697,546,132.74848072562358,134.46675736961453,19,22,168,2,151
3366,697,649,132.74848072562358,134.443537414966,19,18,87,2,48
3367,697,832,132.74848072562358,134.443537414966,19,13,153,2,135
3368,697,833,132.74848072562358,135.32589569161,19,14,176,3,136
3369,647,233,133.58439909297053,136.1618140589569,18,25,429,3,414
3370,647,546,133.58439909297053,136.1618140589569,18,22,150,3,101
3371,647,833,133.58439909297053,135.32589569161,18,14,201,2,186
3372,649,233,134.443537414966,136.1618140589569,18,25,423,2,416
3373,649,271,134.443537414966,136.7655328798186,18,27,391,2,378
3374,649,546,134.443537414966,136.1618140589569,18,22,127,2,103
3375,649,580,134.443537414966,137.0209523809524,18,21,131,3,69
3376,649,647,134.443537414966,136.1618140589569,18,19,74,2,2
3377,649,832,134.443537414966,137.0209523809524,18,14,214,3,183
3378,647,218,136.1618140589569,138.13551020408164,19,32,437,2,429
3379,647,218,136.1618140589569,138.57668934240363,19,31,441,2,429
3380,647,546,136.1618140589569,137.88009070294785,19,23,125,2,101
3381,647,425,136.1618140589569,138.87854875283446,19,20,251,3,222
3382,647,632,136.1618140589569,137.88009070294785,19,17,76,2,15
3383,647,639,136.1618140589569,138.7392290249433,19,18,111,3,8
3384,647,832,136.1618140589569,137.43891156462584,19,12,193,1,185
3385,647,835,136.1618140589569,138.7392290249433,19,13,218,3,188
3386,649,218,137.0209523809524,138.13551020408164,18,32,434,1,431
3387,649,218,137.0209523809524,138.57668934240363,18,31,436,2,431
3388,649,233,137.0209523809524,139.59836734693877,18,26,431,3,416
3389,649,425,137.0209523809524,138.87854875283446,18,20,238,2,224
3390,649,453,137.0209523809524,139.59836734693877,18,22,225,3,196
3391,649,639,137.0209523809524,138.7392290249433,18,18,75,2,10
3392,649,666,137.0209523809524,139.59836734693877,18,19,112,3,17
3393,649,835,137.0209523809524,138.7392290249433,18,13,200,2,186
3394,649,835,137.0209523809524,139.57514739229026,18,12,216,3,186
3395,632,233,137.88009070294785,139.59836734693877,17,26,406,2,399
3396,632,235,137.88009070294785,140.45750566893423,17,25,412,3,397
3397,632,453,137.88009070294785,139.59836734693877,17,22,194,2,179
3398,632,493,137.88009070294785,140.45750566893423,17,22,178,3,139
3399,632,666,137.88009070294785,139.59836734693877,17,19,81,2,34
3400,632,666,137.88009070294785,140.45750566893423,17,18,116,3,34
3401,632,835,137.88009070294785,139.57514739229026,17,12,216,2,203
3402,632,948,137.88009070294785,140.43428571428572,17,12,335,3,316
3403,639,235,138.7392290249433,140.45750566893423,18,25,411,2,404
3404,639,493,138.7392290249433,140.45750566893423,18,22,164,2,146
3405,639,546,138.7392290249433,141.31664399092972,18,22,145,3,93
3406,639,666,138.7392290249433,140.45750566893423,18,18,79,2,27
3407,639,948,138.7392290249433,140.43428571428572,18,12,318,2,309
3408,639,840,138.7392290249433,141.29342403628118,18,13,229,3,201
3409,666,233,139.59836734693877,142.15256235827664,19,26,447,3,433
3410,666,546,139.59836734693877,141.31664399092972,19,22,141,2,120
3411,666,697,139.59836734693877,142.17578231292518,19,18,115,3,31
3412,666,688,139.59836734693877,142.38476190476192,19,19,122,3,22
3413,666,840,139.59836734693877,141.29342403628118,19,13,189,2,174
3414,666,233,140.45750566893423,142.15256235827664,18,26,439,2,433
3415,666,233,140.45750566893423,143.03492063492064,18,25,447,3,433
3416,666,555,140.45750566893423,143.03492063492064,18,21,157,3,111
3417,666,697,140.45750566893423,142.17578231292518,18,18,80,2,31
3418,666,688,140.45750566893423,142.38476190476192,18,19,86,2,22
3419,666,835,140.45750566893423,143.0117006802721,18,12,202,3,169
3420,697,271,142.17578231292518,143.6386394557823,18,27,431,1,426
3421,697,216,142.17578231292518,144.91573696145124,18,26,495,3,481
3422,697,493,142.17578231292518,143.8708390022676,18,22,217,2,204
3423,697,632,142.17578231292518,143.8940589569161,18,19,98,2,65
3424,697,910,142.17578231292518,143.8708390022676,18,12,225,2,213
3425,688,271,142.38476190476192,143.6386394557823,19,27,420,1,417
3426,688,216,142.38476190476192,144.91573696145124,19,26,484,3,472
3427,688,493,142.38476190476192,143.8708390022676,19,22,205,1,195
3428,688,493,142.38476190476192,145.24081632653062,19,19,231,3,195
3429,688,574,142.38476190476192,145.28725623582767,19,15,169,3,114
3430,688,632,142.38476190476192,143.8940589569161,19,19,86,2,56
3431,688,657,142.38476190476192,145.24081632653062,19,16,127,3,31
3432,688,629,142.38476190476192,145.28725623582767,19,16,138,3,59
3433,688,910,142.38476190476192,143.8708390022676,19,12,231,1,222
3434,632,216,143.8940589569161,144.91573696145124,19,26,418,1,416
3435,632,217,143.8940589569161,145.42657596371882,19,28,420,2,415
3436,632,246,143.8940589569161,146.28571428571428,19,24,400,2,386
3437,632,493,143.8940589569161,145.24081632653062,19,19,151,1,139
3438,632,574,143.8940589569161,145.28725623582767,19,15,83,1,58
3439,632,411,143.8940589569161,146.28571428571428,19,15,244,2,221
3440,632,657,143.8940589569161,145.24081632653062,19,16,63,1,25
3441,632,629,143.8940589569161,145.28725623582767,19,16,60,1,3
3442,657,246,145.24081632653062,146.28571428571428,16,24,413,1,411
3443,657,253,145.24081632653062,147.7021315192744,16,18,418,2,404
3444,657,411,145.24081632653062,146.28571428571428,16,15,250,1,246
3445,629,253,145.28725623582767,147.7021315192744,16,18,390,2,376
3446,836,485,7.9412244897959186,9.311201814058958,18,17,356,1,351
3447,836,536,7.9412244897959186,10.866938775510205,18,17,325,3,300
3448,836,784,7.9412244897959186,10.866938775510205,18,17,136,3,52
3449,836,834,7.9412244897959186,10.54185941043084,18,18,112,3,2
3450,893,536,8.6378231292517,10.866938775510205,20,17,370,2,357
3451,893,485,8.6378231292517,11.00625850340136,20,19,421,2,408
3452,893,784,8.6378231292517,10.866938775510205,20,17,145,2,109
3453,893,759,8.6378231292517,11.331337868480725,20,15,177,3,134
3454,893,834,8.6378231292517,10.54185941043084,20,18,101,2,59
3455,893,839,8.6378231292517,11.261678004535147,20,13,125,3,54
3456,834,586,10.54185941043084,12.329795918367347,18,21,260,2,248
3457,834,578,10.54185941043084,13.049614512471656,18,17,278,3,256
3458,834,768,10.54185941043084,12.353015873015874,18,20,102,2,66
3459,834,935,10.54185941043084,12.701315192743765,18,15,137,2,101
3460,839,586,11.261678004535147,12.329795918367347,13,21,257,1,253
3461,839,578,11.261678004535147,13.049614512471656,13,17,272,2,261
3462,839,768,11.261678004535147,12.353015873015874,13,20,85,1,71
3463,839,791,11.261678004535147,13.908752834467121,13,19,124,3,48
3464,839,935,11.261678004535147,12.701315192743765,13,15,114,1,96
3465,839,901,11.261678004535147,13.862312925170068,13,17,128,3,62
3466,935,481,12.701315192743765,14.442811791383221,15,18,460,2,454
3467,935,583,12.701315192743765,15.069750566893424,15,17,366,2,352
3468,935,791,12.701315192743765,13.908752834467121,15,19,153,1,144
3469,935,713,12.701315192743765,14.814331065759637,15,19,240,2,222
3470,935,814,12.701315192743765,15.464489795918368,15,17,170,3,121
3471,935,901,12.701315192743765,13.862312925170068,15,17,60,1,34
3472,935,859,12.701315192743765,14.814331065759637,15,19,119,2,76
3473,935,966,12.701315192743765,15.487709750566895,15,19,124,3,31
3474,901,583,13.862312925170068,15.069750566893424,17,17,322,1,318
3475,901,482,13.862312925170068,16.16108843537415,17,19,431,2,419
3476,901,814,13.862312925170068,15.464489795918368,17,17,111,2,87
3477,901,966,13.862312925170068,15.487709750566895,17,19,96,2,65
3478,859,482,14.814331065759637,16.16108843537415,19,19,381,1,377
3479,859,447,14.814331065759637,17.670385487528346,19,19,430,3,412
3480,859,736,14.814331065759637,16.904126984126986,19,16,152,2,123
3481,859,734,14.814331065759637,17.322086167800453,19,17,165,3,125
3482,859,902,14.814331065759637,16.973786848072564,19,20,102,2,43
3483,859,888,14.814331065759637,17.29886621315193,19,15,111,2,29
3484,966,736,15.487709750566895,16.904126984126986,19,16,238,1,230
3485,966,734,15.487709750566895,17.322086167800453,19,17,245,2,232
3486,966,902,15.487709750566895,16.973786848072564,19,20,91,1,64
3487,966,888,15.487709750566895,17.29886621315193,19,15,110,2,78
3488,902,581,16.973786848072564,18.854603174603174,20,15,331,2,321
3489,902,573,16.973786848072564,19.806621315192743,20,23,351,3,329
3490,902,638,16.973786848072564,18.901043083900227,20,15,277,2,264
3491,902,652,16.973786848072564,19.853061224489796,20,25,279,3,250
3492,902,954,16.973786848072564,18.901043083900227,20,16,98,2,52
3493,888,581,17.29886621315193,18.854603174603174,15,15,314,2,307
3494,888,573,17.29886621315193,19.806621315192743,15,23,333,3,315
3495,888,638,17.29886621315193,18.901043083900227,15,15,259,2,250
3496,888,652,17.29886621315193,19.853061224489796,15,25,260,3,236
3497,888,954,17.29886621315193,18.901043083900227,15,16,95,2,66
3498,954,485,18.901043083900227,21.08371882086168,16,22,478,2,469
3499,954,616,18.901043083900227,20.54965986394558,16,19,345,2,338
3500,954,626,18.901043083900227,21.31591836734694,16,20,344,2,328
3501,954,833,18.901043083900227,21.292698412698414,16,13,159,2,121
3502,833,571,21.292698412698414,23.034195011337868,13,21,273,2,262
3503,833,650,21.292698412698414,23.010975056689343,13,20,197,2,183
3504,833,618,21.292698412698414,23.56825396825397,13,21,236,2,215
3505,833,827,21.292698412698414,22.569795918367348,13,15,55,1,6
3506,833,832,21.292698412698414,23.870113378684806,13,13,111,3,1
3507,827,580,22.569795918367348,24.729251700680273,15,21,264,2,247
3508,827,511,22.569795918367348,25.26331065759637,15,21,337,3,316
3509,827,647,22.569795918367348,24.729251700680273,15,18,203,2,180
3510,827,832,22.569795918367348,23.870113378684806,15,13,56,1,5
3511,827,826,22.569795918367348,24.49705215419501,15,16,83,2,1
3512,832,511,23.870113378684806,25.26331065759637,13,21,327,1,321
3513,832,431,23.870113378684806,26.33142857142857,13,22,415,2,401
3514,832,626,23.870113378684806,25.611609977324264,13,18,219,2,206
3515,832,652,23.870113378684806,26.70294784580499,13,23,217,3,180
3516,832,918,23.870113378684806,25.58839002267574,13,13,113,2,86
3517,832,908,23.870113378684806,26.33142857142857,13,17,130,2,76
3518,826,431,24.49705215419501,26.33142857142857,16,22,403,2,395
3519,826,437,24.49705215419501,27.30666666666667,16,20,407,3,389
3520,826,626,24.49705215419501,25.611609977324264,16,18,206,1,200
3521,826,652,24.49705215419501,26.70294784580499,16,23,198,2,174
3522,826,616,24.49705215419501,27.376326530612246,16,18,244,3,210
3523,826,918,24.49705215419501,25.58839002267574,16,13,103,1,92
3524,826,908,24.49705215419501,26.33142857142857,16,17,114,2,82
3525,826,832,24.49705215419501,27.30666666666667,16,12,121,3,6
3526,918,437,25.58839002267574,27.30666666666667,13,20,487,2,481
3527,918,449,25.58839002267574,28.444444444444446,13,22,485,3,469
3528,918,652,25.58839002267574,26.70294784580499,13,23,270,1,266
3529,918,616,25.58839002267574,27.376326530612246,13,18,312,2,302
3530,918,622,25.58839002267574,28.18902494331066,13,19,316,3,296
3531,918,832,25.58839002267574,27.30666666666667,13,12,113,2,86
3532,918,832,25.58839002267574,28.16580498866213,13,14,140,3,86
3533,908,449,26.33142857142857,28.444444444444446,17,22,468,2,459
3534,908,616,26.33142857142857,27.376326530612246,17,18,295,1,292
3535,908,622,26.33142857142857,28.18902494331066,17,19,297,2,286
3536,908,832,26.33142857142857,28.16580498866213,17,14,110,2,76
3537,832,449,27.30666666666667,28.444444444444446,12,22,386,1,383
3538,832,614,27.30666666666667,29.930521541950114,12,22,246,3,218
3539,832,777,27.30666666666667,29.396462585034016,12,21,105,2,55
3540,832,830,27.30666666666667,29.396462585034016,12,21,90,2,2
3541,832,614,28.16580498866213,29.930521541950114,14,22,231,2,218
3542,832,554,28.16580498866213,30.743219954648527,14,23,299,3,278
3543,832,777,28.16580498866213,29.396462585034016,14,21,76,1,55
3544,832,729,28.16580498866213,30.83609977324263,14,22,154,3,103
3545,832,830,28.16580498866213,29.396462585034016,14,21,53,1,2
3546,832,824,28.16580498866213,30.83609977324263,14,18,115,3,8
3547,830,554,29.396462585034016,30.743219954648527,21,23,282,1,276
3548,830,555,29.396462585034016,31.60235827664399,21,22,291,2,275
3549,830,729,29.396462585034016,30.83609977324263,21,22,119,1,101
3550,830,716,29.396462585034016,31.32371882086168,21,19,141,2,114
3551,830,824,29.396462585034016,30.83609977324263,21,18,62,1,6
3552,830,848,29.396462585034016,31.32371882086168,21,17,85,2,18
3553,824,546,30.83609977324263,32.46149659863946,18,21,287,2,278
3554,824,632,30.83609977324263,32.46149659863946,18,19,204,2,192
3555,824,832,30.83609977324263,32.43827664399093,18,16,69,2,8
3556,848,546,31.32371882086168,32.46149659863946,17,21,306,1,302
3557,848,500,31.32371882086168,33.97079365079365,17,17,366,3,348
3558,848,632,31.32371882086168,32.46149659863946,17,19,221,1,216
3559,848,689,31.32371882086168,33.97079365079365,17,19,196,3,159
3560,848,832,31.32371882086168,32.43827664399093,17,16,51,1,16
3561,832,500,32.43827664399093,33.97079365079365,16,17,338,2,332
3562,832,555,32.43827664399093,35.015691609977324,16,20,298,3,277
3563,832,689,32.43827664399093,33.97079365079365,16,19,157,2,143
3564,832,632,32.43827664399093,35.03891156462585,16,19,229,3,200
3565,832,580,35.015691609977324,36.73396825396826,15,22,263,2,252
3566,832,579,35.015691609977324,37.593106575963716,15,22,276,3,253
3567,832,632,35.015691609977324,36.75718820861678,15,19,214,2,200
3568,832,650,35.015691609977324,37.593106575963716,15,17,213,3,182
3569,832,579,35.87482993197279,37.593106575963716,15,22,264,2,253
3570,832,579,35.87482993197279,38.45224489795918,15,22,276,3,253
3571,832,650,35.87482993197279,37.593106575963716,15,17,196,2,182
3572,832,626,35.87482993197279,38.45224489795918,15,18,234,3,206
3573,832,579,36.73396825396826,38.45224489795918,12,22,264,2,253
3574,832,579,36.73396825396826,39.31138321995465,12,21,276,3,253
3575,832,626,36.73396825396826,38.45224489795918,12,18,219,2,206
3576,832,632,36.73396825396826,39.31138321995465,12,18,229,3,200
3577,832,453,39.31138321995465,41.02965986394558,13,22,386,2,379
3578,832,453,39.31138321995465,41.88879818594104,13,22,395,3,379
3579,832,632,39.31138321995465,41.88879818594104,13,19,229,3,200
3580,832,835,39.31138321995465,41.86557823129252,13,12,110,3,3
3581,832,453,40.170521541950116,41.88879818594104,13,22,386,2,379
3582,832,554,40.170521541950116,42.74793650793651,13,22,299,3,278
3583,832,632,40.170521541950116,41.88879818594104,13,19,213,2,200
3584,832,666,40.170521541950116,42.74793650793651,13,18,200,3,166
3585,832,835,40.170521541950116,41.86557823129252,13,12,73,2,3
3586,835,453,41.86557823129252,43.607074829931975,12,23,389,2,382
3587,835,579,41.86557823129252,44.44299319727891,12,21,279,3,256
3588,835,647,41.86557823129252,43.58385487528345,12,19,202,2,188
3589,835,688,41.86557823129252,44.67519274376417,12,18,190,3,147
3590,835,832,41.86557823129252,43.607074829931975,12,13,75,2,3
3591,835,832,41.86557823129252,44.44299319727891,12,13,111,3,3
3592,832,579,42.74793650793651,44.44299319727891,13,21,263,2,253
3593,832,493,42.74793650793651,45.302131519274376,13,21,356,3,339
3594,832,688,42.74793650793651,44.67519274376417,13,18,166,2,144
3595,832,681,42.74793650793651,45.302131519274376,13,17,187,3,151
3596,832,835,42.74793650793651,45.302131519274376,13,13,110,3,3
3597,832,493,43.607074829931975,45.302131519274376,13,21,347,2,339
3598,832,454,43.607074829931975,46.18448979591837,13,21,394,3,378
3599,832,688,43.607074829931975,44.67519274376417,13,18,151,1,144
3600,832,681,43.607074829931975,45.302131519274376,13,17,168,2,151
3601,832,647,43.607074829931975,46.16126984126984,13,19,215,3,185
3602,832,835,43.607074829931975,45.302131519274376,13,13,73,2,3
3603,832,454,44.44299319727891,46.18448979591837,13,21,385,2,378
3604,832,647,44.44299319727891,46.16126984126984,13,19,199,2,185
3605,835,474,45.302131519274376,47.69378684807256,13,17,375,2,361
3606,832,474,46.16126984126984,47.69378684807256,17,17,364,2,358
3607,832,421,46.16126984126984,48.529705215419504,17,17,423,2,411
3608,832,762,46.16126984126984,49.0637641723356,17,15,143,3,70
3609,832,719,46.16126984126984,49.11020408163265,17,19,170,3,113
3610,832,827,46.16126984126984,49.0637641723356,17,16,125,3,5
3611,827,451,49.0637641723356,50.45696145124717,16,18,381,1,376
3612,827,411,49.0637641723356,52.03591836734694,16,19,435,3,416
3613,827,721,49.0637641723356,51.66439909297052,16,17,154,3,106
3614,827,880,49.0637641723356,51.68761904761905,16,18,125,3,53
3615,820,411,49.78358276643991,52.03591836734694,19,19,420,2,409
3616,820,508,49.78358276643991,52.17523809523809,19,19,329,2,312
3617,820,721,49.78358276643991,51.66439909297052,19,17,128,2,99
3618,820,618,49.78358276643991,52.15201814058957,19,19,226,2,202
3619,820,880,49.78358276643991,51.68761904761905,19,18,102,2,60
3620,880,415,51.68761904761905,53.31301587301587,18,21,470,2,465
3621,880,621,51.68761904761905,53.661315192743764,18,18,273,2,259
3622,880,703,51.68761904761905,54.17215419501134,18,18,207,2,177
3623,880,966,51.68761904761905,53.080816326530616,18,17,105,1,86
3624,880,923,51.68761904761905,53.10403628117914,18,16,75,1,43
3625,880,855,51.68761904761905,54.14893424036281,18,15,109,2,25
3626,966,703,53.080816326530616,54.17215419501134,17,18,267,1,263
3627,966,650,53.080816326530616,55.58857142857143,17,18,334,3,316
3628,966,855,53.080816326530616,54.14893424036281,17,15,120,1,111
3629,966,876,53.080816326530616,55.58857142857143,17,12,141,3,90
3630,923,450,53.10403628117914,54.72943310657597,16,18,478,2,473
3631,923,703,53.10403628117914,54.17215419501134,16,18,225,1,220
3632,923,650,53.10403628117914,55.58857142857143,16,18,293,2,273
3633,923,855,53.10403628117914,54.14893424036281,16,15,82,1,68
3634,923,876,53.10403628117914,55.58857142857143,16,12,117,2,47
3635,855,423,54.14893424036281,55.54213151927438,15,21,436,1,432
3636,855,411,54.14893424036281,56.633469387755106,15,20,457,2,444
3637,855,650,54.14893424036281,55.58857142857143,15,18,214,1,205
3638,855,647,54.14893424036281,56.447709750566894,15,17,230,2,208
3639,855,876,54.14893424036281,55.58857142857143,15,12,65,1,21
3640,855,820,54.14893424036281,56.401269841269844,15,16,103,2,35
3641,876,411,55.58857142857143,56.633469387755106,12,20,467,1,465
3642,876,579,55.58857142857143,57.30684807256236,12,18,306,2,297
3643,876,632,55.58857142857143,57.30684807256236,12,16,255,2,244
3644,820,493,56.401269841269844,59.025124716553286,16,20,346,3,327
3645,820,658,56.401269841269844,59.025124716553286,16,19,198,3,162
3646,820,876,56.401269841269844,59.00190476190476,16,17,125,3,56
3647,876,412,59.00190476190476,60.74340136054422,17,20,470,2,464
3648,876,550,59.00190476190476,61.85795918367347,17,23,348,3,326
3649,876,770,59.00190476190476,60.74340136054422,17,15,130,2,106
3650,876,777,59.00190476190476,61.85795918367347,17,17,158,3,99
3651,876,824,59.00190476190476,61.9740589569161,17,18,138,3,52
3652,824,598,61.9740589569161,64.08707482993198,18,22,244,2,226
3653,824,431,61.9740589569161,64.57469387755103,18,23,409,3,393
3654,824,770,61.9740589569161,64.08707482993198,18,20,106,2,54
3655,824,622,61.9740589569161,64.45859410430839,18,20,229,2,202
3656,824,943,61.9740589569161,64.01741496598639,18,19,148,2,119
3657,824,864,61.9740589569161,64.1102947845805,18,13,100,2,40
3658,906,598,62.80997732426304,64.08707482993198,20,22,313,1,308
3659,906,431,62.80997732426304,64.57469387755103,20,23,481,2,475
3660,906,584,62.80997732426304,65.57315192743765,20,21,343,3,322
3661,906,770,62.80997732426304,64.08707482993198,20,20,147,1,136
3662,906,622,62.80997732426304,64.45859410430839,20,20,293,2,284
3663,906,616,62.80997732426304,65.57315192743765,20,19,313,3,290
3664,906,943,62.80997732426304,64.01741496598639,20,19,64,1,37
3665,906,864,62.80997732426304,64.1102947845805,20,13,70,1,42
3666,906,934,62.80997732426304,65.22485260770975,20,15,108,2,28
3667,943,584,64.01741496598639,65.57315192743765,19,21,365,2,359
3668,943,616,64.01741496598639,65.57315192743765,19,19,334,2,327
3669,943,676,64.01741496598639,66.71092970521542,19,18,291,3,267
3670,943,934,64.01741496598639,65.22485260770975,19,15,53,1,9
3671,943,927,64.01741496598639,66.71092970521542,19,17,117,3,16
3672,864,584,64.1102947845805,65.57315192743765,13,21,287,1,280
3673,864,420,64.1102947845805,67.0592290249433,13,24,462,3,444
3674,864,616,64.1102947845805,65.57315192743765,13,19,256,1,248
3675,864,676,64.1102947845805,66.71092970521542,13,18,219,3,188
3676,864,934,64.1102947845805,65.22485260770975,13,15,85,1,70
3677,864,927,64.1102947845805,66.71092970521542,13,17,129,3,63
3678,934,579,65.22485260770975,67.8487074829932,15,25,373,3,355
3679,934,676,65.22485260770975,66.71092970521542,15,18,266,1,258
3680,934,653,65.22485260770975,67.89514739229026,15,22,304,3,281
3681,934,927,65.22485260770975,66.71092970521542,15,17,64,1,7
3682,934,905,65.22485260770975,67.33786848072563,15,16,96,2,29
3683,927,579,66.71092970521542,67.8487074829932,17,25,351,1,348
3684,927,578,66.71092970521542,68.77750566893424,17,21,360,2,349
3685,927,453,66.71092970521542,69.31156462585034,17,21,487,3,474
3686,927,653,66.71092970521542,67.89514739229026,17,22,279,1,274
3687,927,661,66.71092970521542,68.77750566893424,17,22,280,2,266
3688,927,839,66.71092970521542,68.77750566893424,17,21,125,2,88
3689,927,826,66.71092970521542,69.47410430839003,17,21,156,3,101
3690,905,578,67.33786848072563,68.77750566893424,16,21,333,1,327
3691,905,453,67.33786848072563,69.31156462585034,16,21,460,2,452
3692,905,661,67.33786848072563,68.77750566893424,16,22,252,1,244
3693,905,782,67.33786848072563,69.70630385487529,16,23,160,2,123
3694,905,839,67.33786848072563,68.77750566893424,16,21,91,1,66
3695,905,826,67.33786848072563,69.47410430839003,16,21,121,2,79
3696,839,579,68.77750566893424,71.00662131519275,21,24,277,2,260
3697,839,583,68.77750566893424,71.21560090702948,21,26,277,2,256
3698,839,650,68.77750566893424,71.00662131519275,21,21,212,2,189
3699,839,619,68.77750566893424,71.21560090702948,21,22,244,2,220
3700,839,861,68.77750566893424,70.33324263038548,21,19,71,2,22
3701,826,579,69.47410430839003,71.00662131519275,21,24,256,2,247
3702,826,583,69.47410430839003,71.21560090702948,21,26,254,2,243
3703,826,650,69.47410430839003,71.00662131519275,21,21,188,2,176
3704,826,619,69.47410430839003,71.21560090702948,21,22,220,2,207
3705,826,940,69.47410430839003,72.26049886621315,21,23,166,3,114
3706,861,452,70.33324263038548,72.58557823129252,19,22,420,2,409
3707,861,799,70.33324263038548,72.95709750566894,19,20,129,3,62
3708,861,940,70.33324263038548,72.26049886621315,19,23,115,2,79
3709,940,580,72.26049886621315,73.58403628117914,23,20,364,1,360
3710,940,573,72.26049886621315,74.65215419501133,23,22,381,2,367
3711,940,632,72.26049886621315,73.60725623582766,23,17,313,1,308
3712,940,652,72.26049886621315,74.6985941043084,23,24,307,2,288
3713,940,832,72.26049886621315,73.58403628117914,23,14,122,1,108
3714,832,573,73.58403628117914,74.65215419501133,14,22,263,1,259
3715,832,485,73.58403628117914,75.92925170068027,14,23,361,2,347
3716,832,451,73.58403628117914,76.37043083900227,14,24,399,3,381
3717,832,652,73.58403628117914,74.6985941043084,14,24,186,1,180
3718,832,616,73.58403628117914,75.39519274376417,14,18,230,2,216
3719,832,667,73.58403628117914,76.16145124716553,14,20,199,3,165
3720,832,451,76.16145124716553,77.87972789115646,12,21,388,2,381
3721,832,581,76.16145124716553,78.41378684807256,12,22,269,2,251
3722,832,654,76.16145124716553,77.85650793650794,12,20,192,2,178
3723,832,619,76.16145124716553,78.43700680272109,12,19,234,2,213
3724,832,835,76.16145124716553,77.85650793650794,12,13,73,2,3
3725,835,546,77.85650793650794,79.5980045351474,13,22,299,2,289
3726,835,453,77.85650793650794,80.45714285714286,13,21,398,3,382
3727,835,666,77.85650793650794,79.5980045351474,13,18,185,2,169
3728,835,632,77.85650793650794,80.45714285714286,13,19,232,3,203
3729,835,853,77.85650793650794,79.36580498866213,13,16,67,2,18
3730,832,453,78.73886621315192,80.45714285714286,14,21,386,2,379
3731,832,557,78.73886621315192,81.33950113378685,14,21,297,3,275
3732,832,632,78.73886621315192,80.45714285714286,14,19,213,2,200
3733,832,655,78.73886621315192,81.52526077097505,14,24,214,3,177
3734,832,827,78.73886621315192,81.13052154195012,14,13,103,2,5
3735,832,827,78.73886621315192,81.17696145124717,14,18,105,2,5
3736,853,453,79.36580498866213,80.45714285714286,16,21,403,1,400
3737,853,557,79.36580498866213,81.33950113378685,16,21,308,2,296
3738,853,632,79.36580498866213,80.45714285714286,16,19,226,1,221
3739,853,655,79.36580498866213,81.52526077097505,16,24,219,2,198
3740,853,827,79.36580498866213,81.13052154195012,16,13,80,2,26
3741,853,827,79.36580498866213,81.17696145124717,16,18,82,2,26
3742,827,454,81.13052154195012,83.05777777777777,13,23,382,2,373
3743,827,580,81.13052154195012,83.8704761904762,13,22,274,3,247
3744,827,632,81.13052154195012,83.03455782312925,13,19,212,2,195
3745,827,647,81.13052154195012,83.8704761904762,13,18,215,3,180
3746,827,454,81.17696145124717,83.05777777777777,18,23,382,2,373
3747,827,580,81.17696145124717,83.8704761904762,18,22,273,3,247
3748,827,632,81.17696145124717,83.03455782312925,18,19,211,2,195
3749,827,647,81.17696145124717,83.8704761904762,18,18,214,3,180
3750,829,580,84.24199546485261,85.58875283446712,20,21,256,1,249
3751,829,421,84.24199546485261,86.2853514739229,20,23,417,2,408
3752,829,669,84.24199546485261,85.72807256235828,20,23,172,1,160
3753,829,649,84.24199546485261,86.44789115646259,20,19,204,2,180
3754,829,831,84.24199546485261,85.68163265306123,20,18,62,1,2
3755,829,847,84.24199546485261,86.21569160997733,20,18,87,2,18
3756,831,554,85.68163265306123,87.30702947845805,18,20,286,2,277
3757,831,632,85.68163265306123,87.30702947845805,18,18,211,2,199
3758,831,658,85.68163265306123,88.65378684807257,18,13,215,3,173
3759,831,944,85.68163265306123,87.33024943310657,18,12,133,2,113
3760,847,554,86.21569160997733,87.30702947845805,18,20,297,1,293
3761,847,459,86.21569160997733,88.8627664399093,18,18,404,3,388
3762,847,632,86.21569160997733,87.30702947845805,18,18,220,1,215
3763,847,658,86.21569160997733,88.65378684807257,18,13,216,2,189
3764,847,944,86.21569160997733,87.33024943310657,18,12,108,1,97
3765,944,459,87.33024943310657,88.8627664399093,12,18,489,2,485
3766,944,454,87.33024943310657,89.90766439909297,12,21,502,3,490
3767,944,658,87.33024943310657,88.65378684807257,12,13,292,1,286
3768,944,625,87.33024943310657,89.88444444444444,12,20,337,3,319
3769,944,932,87.33024943310657,89.88444444444444,12,13,111,3,12
3770,932,579,89.88444444444444,91.60272108843537,13,22,361,2,353
3771,932,454,89.88444444444444,92.46185941043085,13,21,491,3,478
3772,932,647,89.88444444444444,91.60272108843537,13,18,294,2,285
3773,932,626,89.88444444444444,92.46185941043085,13,18,326,3,306
3774,932,832,89.88444444444444,91.60272108843537,13,13,124,2,100
3775,932,841,89.88444444444444,92.43863945578231,13,13,143,3,91
3776,898,454,90.72036281179139,92.46185941043085,13,21,450,2,444
3777,898,626,90.72036281179139,92.46185941043085,13,18,282,2,272
3778,898,632,90.72036281179139,93.3209977324263,13,18,289,3,266
3779,898,841,90.72036281179139,92.43863945578231,13,13,93,2,57
3780,898,832,90.72036281179139,93.3209977324263,13,14,130,3,66
3781,832,580,91.60272108843537,94.15691609977324,13,21,275,3,252
3782,832,632,91.60272108843537,93.3209977324263,13,18,213,2,200
3783,841,580,92.43863945578231,94.15691609977324,13,21,271,2,261
3784,841,579,92.43863945578231,95.01605442176871,13,22,285,3,262
3785,841,647,92.43863945578231,95.01605442176871,13,18,224,3,194
3786,841,832,92.43863945578231,94.18013605442177,13,12,76,2,9
3787,832,579,93.3209977324263,95.01605442176871,14,22,263,2,253
3788,832,555,93.3209977324263,95.87519274376417,14,21,298,3,277
3789,832,647,93.3209977324263,95.01605442176871,14,18,199,2,185
3790,832,632,93.3209977324263,95.8984126984127,14,17,229,3,200
3791,832,555,94.18013605442177,95.87519274376417,12,21,286,2,277
3792,832,579,94.18013605442177,96.73433106575963,12,21,276,3,253
3793,832,632,94.18013605442177,95.8984126984127,12,17,213,2,200
3794,832,626,94.18013605442177,96.73433106575963,12,18,234,3,206
3795,832,835,94.18013605442177,96.73433106575963,12,13,110,3,3
3796,832,580,95.87519274376417,97.5934693877551,13,24,263,2,252
3797,832,454,95.87519274376417,98.47582766439909,13,22,394,3,378
3798,832,666,95.87519274376417,97.5934693877551,13,19,182,2,166
3799,832,650,95.87519274376417,98.45260770975057,13,18,213,3,182
3800,832,910,95.87519274376417,97.5934693877551,13,13,108,2,78
3801,835,454,96.73433106575963,98.47582766439909,13,22,388,2,381
3802,835,650,96.73433106575963,98.45260770975057,13,18,199,2,185
3803,835,688,96.73433106575963,99.52072562358276,13,17,190,3,147
3804,835,832,96.73433106575963,98.45260770975057,13,13,74,2,3
3805,910,578,97.5934693877551,100.1708843537415,13,21,350,3,332
3806,910,688,97.5934693877551,99.52072562358276,13,17,237,2,222
3807,910,832,97.5934693877551,100.1708843537415,13,13,136,3,78
3808,832,578,98.45260770975057,100.1708843537415,13,21,265,2,254
3809,832,554,98.45260770975057,101.03002267573696,13,23,299,3,278
3810,832,688,98.45260770975057,99.52072562358276,13,17,151,1,144
3811,832,632,98.45260770975057,101.03002267573696,13,18,229,3,200
3812,832,833,98.45260770975057,101.03002267573696,13,13,111,3,1
3813,832,339,100.1708843537415,101.88916099773243,13,25,499,2,493
3814,832,453,100.1708843537415,101.88916099773243,13,21,386,2,379
3815,832,436,100.1708843537415,102.44643990929706,13,17,408,2,396
3816,832,632,100.1708843537415,101.88916099773243,13,19,213,2,200
3817,832,617,100.1708843537415,102.28390022675737,13,14,233,2,215
3818,833,436,101.03002267573696,102.44643990929706,13,17,402,1,397
3819,833,590,101.03002267573696,103.86285714285715,13,12,272,3,243
3820,833,617,101.03002267573696,102.28390022675737,13,14,223,1,216
3821,833,619,101.03002267573696,103.44489795918368,13,12,238,2,214
3822,832,590,101.86594104308391,103.86285714285715,14,12,257,2,242
3823,832,619,101.86594104308391,103.44489795918368,14,12,224,2,213
3824,824,554,121.55646258503401,123.321179138322,19,21,280,2,270
3825,824,573,121.55646258503401,124.36607709750567,19,21,279,3,251
3826,824,690,121.55646258503401,124.0409977324263,19,19,171,2,134
3827,824,655,121.55646258503401,124.36607709750567,19,24,208,3,169
3828,824,825,121.55646258503401,124.0409977324263,19,17,107,2,1
3829,836,573,122.46204081632654,124.36607709750567,13,21,275,2,263
3830,836,690,122.46204081632654,124.0409977324263,13,19,161,2,146
3831,836,655,122.46204081632654,124.36607709750567,13,24,199,2,181
3832,836,825,122.46204081632654,124.0409977324263,13,17,69,2,11
3833,836,835,122.46204081632654,125.0162358276644,13,14,110,3,1
3834,825,579,124.0409977324263,125.87537414965986,17,22,258,2,246
3835,825,626,124.0409977324263,125.89859410430839,17,18,214,2,199
3836,825,833,124.0409977324263,125.87537414965986,17,14,79,2,8
3837,835,488,125.0162358276644,127.12925170068027,14,21,359,2,347
3838,835,579,125.0162358276644,127.5936507936508,14,21,279,3,256
3839,835,793,125.0162358276644,127.10603174603175,14,20,99,2,42
3840,835,626,125.0162358276644,127.5936507936508,14,18,237,3,209
3841,835,864,125.0162358276644,127.10603174603175,14,17,95,2,29
3842,835,826,125.0162358276644,127.96517006802722,14,15,127,3,9
3843,833,488,125.87537414965986,127.12925170068027,14,21,349,1,345
3844,833,579,125.87537414965986,127.5936507936508,14,21,265,2,254
3845,833,555,125.87537414965986,128.45278911564625,14,23,299,3,278
3846,833,793,125.87537414965986,127.10603174603175,14,20,66,1,40
3847,833,626,125.87537414965986,127.5936507936508,14,18,220,2,207
3848,833,729,125.87537414965986,128.54566893424035,14,21,155,3,104
3849,833,864,125.87537414965986,127.10603174603175,14,17,61,1,31
3850,833,826,125.87537414965986,127.96517006802722,14,15,90,2,7
3851,864,555,127.10603174603175,128.45278911564625,17,23,314,1,309
3852,864,729,127.10603174603175,128.54566893424035,17,21,149,1,135
3853,864,923,127.10603174603175,129.03328798185942,17,17,102,2,59
3854,864,832,127.10603174603175,129.3119274376417,17,13,100,2,32
3855,826,554,127.96517006802722,130.1710657596372,15,23,288,2,272
3856,826,632,127.96517006802722,130.1710657596372,15,20,216,2,194
3857,826,923,127.96517006802722,129.03328798185942,15,17,107,1,97
3858,826,832,127.96517006802722,129.3119274376417,15,13,58,1,6
3859,923,554,129.03328798185942,130.1710657596372,17,23,372,1,369
3860,923,546,129.03328798185942,131.03020408163266,17,22,387,2,377
3861,923,432,129.03328798185942,131.91256235827666,17,21,506,3,491
3862,923,632,129.03328798185942,130.1710657596372,17,20,295,1,291
3863,923,666,129.03328798185942,131.03020408163266,17,18,271,2,257
3864,923,642,129.03328798185942,131.86612244897958,17,18,306,3,281
3865,923,832,129.03328798185942,131.00698412698412,17,12,125,2,91
3866,923,831,129.03328798185942,131.4249433106576,17,13,138,2,92
3867,832,546,129.3119274376417,131.03020408163266,13,22,295,2,286
3868,832,432,129.3119274376417,131.91256235827666,13,21,415,3,400
3869,832,666,129.3119274376417,131.03020408163266,13,18,182,2,166
3870,832,642,129.3119274376417,131.86612244897958,13,18,220,3,190
3871,832,831,129.3119274376417,131.4249433106576,13,13,91,2,1
3872,832,339,131.00698412698412,132.74848072562358,12,24,499,2,493
3873,832,480,131.00698412698412,132.74848072562358,12,21,360,2,352
3874,832,555,131.00698412698412,133.60761904761904,12,22,299,3,277
3875,832,697,131.00698412698412,132.74848072562358,12,19,154,2,135
3876,832,647,131.00698412698412,133.58439909297053,12,18,216,3,185
3877,832,835,131.00698412698412,132.72526077097507,12,14,74,2,3
3878,831,339,131.4249433106576,132.74848072562358,13,24,495,1,492
3879,831,480,131.4249433106576,132.74848072562358,13,21,356,1,351
3880,831,555,131.4249433106576,133.60761904761904,13,22,292,2,276
3881,831,697,131.4249433106576,132.74848072562358,13,19,146,1,134
3882,831,647,131.4249433106576,133.58439909297053,13,18,206,2,184
3883,831,835,131.4249433106576,132.72526077097507,13,14,56,1,4
3884,831,832,131.4249433106576,133.58439909297053,13,13,93,2,1
3885,835,546,132.72526077097507,134.46675736961453,14,22,299,2,289
3886,835,649,132.72526077097507,134.443537414966,14,18,200,2,186
3887,835,832,132.72526077097507,134.443537414966,14,13,74,2,3
3888,835,833,132.72526077097507,135.32589569161,14,14,112,3,2
3889,832,546,133.58439909297053,136.1618140589569,13,22,307,3,286
3890,832,647,133.58439909297053,136.1618140589569,13,19,216,3,185
3891,832,833,133.58439909297053,135.32589569161,13,14,75,2,1
3892,832,546,134.443537414966,136.1618140589569,13,22,295,2,286
3893,832,580,134.443537414966,137.0209523809524,13,21,275,3,252
3894,832,647,134.443537414966,136.1618140589569,13,19,199,2,185
3895,832,649,134.443537414966,137.0209523809524,13,18,214,3,183
3896,833,580,135.32589569161,137.0209523809524,14,21,263,2,253
3897,833,546,135.32589569161,137.88009070294785,14,23,307,3,287
3898,833,649,135.32589569161,137.0209523809524,14,18,198,2,184
3899,833,632,135.32589569161,137.88009070294785,14,17,229,3,201
3900,833,832,135.32589569161,137.0209523809524,14,14,73,2,1
3901,833,832,135.32589569161,137.43891156462584,14,12,91,2,1
3902,832,425,137.0209523809524,138.87854875283446,14,20,415,2,407
3903,832,453,137.0209523809524,139.59836734693877,14,22,395,3,379
3904,832,639,137.0209523809524,138.7392290249433,14,18,207,2,193
3905,832,666,137.0209523809524,139.59836734693877,14,19,200,3,166
3906,832,835,137.0209523809524,138.7392290249433,14,13,74,2,3
3907,832,835,137.0209523809524,139.57514739229026,14,12,110,3,3
3908,832,425,137.43891156462584,138.87854875283446,12,20,412,1,407
3909,832,453,137.43891156462584,139.59836734693877,12,22,390,2,379
3910,832,639,137.43891156462584,138.7392290249433,12,18,201,1,193
3911,832,666,137.43891156462584,139.59836734693877,12,19,190,2,166
3912,832,835,137.43891156462584,138.7392290249433,12,13,56,1,3
3913,832,835,137.43891156462584,139.57514739229026,12,12,92,2,3
3914,835,493,138.7392290249433,140.45750566893423,13,22,350,2,342
3915,835,546,138.7392290249433,141.31664399092972,13,22,310,3,289
3916,835,666,138.7392290249433,140.45750566893423,13,18,184,2,169
3917,835,948,138.7392290249433,140.43428571428572,13,12,135,2,113
3918,835,840,138.7392290249433,141.29342403628118,13,13,110,3,5
3919,835,546,139.57514739229026,141.31664399092972,12,22,299,2,289
3920,835,697,139.57514739229026,142.17578231292518,12,18,178,3,138
3921,835,688,139.57514739229026,142.38476190476192,12,19,190,3,147
3922,835,840,139.57514739229026,141.29342403628118,12,13,74,2,5
3923,948,555,140.43428571428572,143.03492063492064,12,21,409,3,393
3924,948,697,140.43428571428572,142.17578231292518,12,18,262,2,251
3925,948,688,140.43428571428572,142.38476190476192,12,19,273,2,260
3926,948,835,140.43428571428572,143.0117006802721,12,12,158,3,113
3927,840,555,141.29342403628118,143.03492063492064,13,21,295,2,285
3928,840,493,141.29342403628118,143.8708390022676,13,22,364,3,347
3929,840,688,141.29342403628118,142.38476190476192,13,19,159,1,152
3930,840,632,141.29342403628118,143.8940589569161,13,19,236,3,208
3931,840,835,141.29342403628118,143.0117006802721,13,12,74,2,5
3932,840,910,141.29342403628118,143.8708390022676,13,12,131,3,70
3933,835,493,143.0117006802721,145.24081632653062,12,19,355,2,342
3934,835,574,143.0117006802721,145.28725623582767,12,15,279,2,261
3935,835,657,143.0117006802721,145.24081632653062,12,16,202,2,178
3936,835,629,143.0117006802721,145.28725623582767,12,16,228,2,206
3937,910,493,143.8708390022676,145.24081632653062,12,19,421,1,417
3938,910,574,143.8708390022676,145.28725623582767,12,15,341,1,336
3939,910,411,143.8708390022676,146.28571428571428,12,15,510,2,499
3940,910,657,143.8708390022676,145.24081632653062,12,16,260,1,253
3941,910,629,143.8708390022676,145.28725623582767,12,16,288,1,281
