,f0,f1,t0,t1,dB0,dB1,dist,utime,ufreq
0,56,7,0.6501587301587302,2.670294784580499,46,44,100,2,49
1,56,251,0.6501587301587302,2.8792743764172335,46,27,217,2,195
2,56,237,0.6501587301587302,3.01859410430839,46,30,208,2,181
3,56,410,0.6501587301587302,1.9040362811791383,46,10,358,1,354
4,56,410,0.6501587301587302,2.8328344671201813,46,19,366,2,354
5,56,410,0.6501587301587302,3.1579138321995464,46,17,370,3,354
6,10,7,1.5557369614512473,2.670294784580499,49,44,48,1,3
7,10,9,1.5557369614512473,3.7616326530612247,49,47,95,2,1
8,10,251,1.5557369614512473,2.8792743764172335,49,27,248,1,241
9,10,237,1.5557369614512473,3.01859410430839,49,30,236,1,227
10,10,226,1.5557369614512473,4.156371882086168,49,15,243,3,216
11,10,410,1.5557369614512473,2.8328344671201813,49,19,404,1,400
12,10,410,1.5557369614512473,3.1579138321995464,49,17,406,2,400
13,7,9,2.670294784580499,3.7616326530612247,44,47,47,1,2
14,7,14,2.670294784580499,4.899410430839002,44,45,96,2,7
15,7,56,2.670294784580499,5.479909297052155,44,44,131,3,49
16,7,226,2.670294784580499,4.156371882086168,44,15,228,1,219
17,7,240,2.670294784580499,5.27092970521542,44,28,259,3,233
18,7,413,2.670294784580499,4.551111111111111,44,7,414,2,406
19,7,415,2.670294784580499,5.294149659863946,44,9,423,3,408
20,9,14,3.7616326530612247,4.899410430839002,47,45,49,1,5
21,9,56,3.7616326530612247,5.479909297052155,47,44,88,2,47
22,9,12,3.7616326530612247,5.990748299319728,47,44,96,2,3
23,9,240,3.7616326530612247,5.27092970521542,47,28,240,2,231
24,9,235,3.7616326530612247,6.013968253968254,47,29,246,2,226
25,9,415,3.7616326530612247,5.294149659863946,47,9,411,2,406
26,9,451,3.7616326530612247,5.990748299319728,47,11,452,2,442
27,14,12,4.899410430839002,5.990748299319728,45,44,47,1,2
28,14,8,4.899410430839002,7.174965986394558,45,46,98,2,6
29,14,235,4.899410430839002,6.013968253968254,45,29,226,1,221
30,14,301,4.899410430839002,7.546485260770975,45,21,309,3,287
31,14,451,4.899410430839002,5.990748299319728,45,11,440,1,437
32,14,430,4.899410430839002,7.546485260770975,45,10,431,3,416
33,56,8,5.479909297052155,7.174965986394558,44,46,87,2,48
34,56,11,5.479909297052155,8.359183673469389,44,47,132,3,45
35,56,301,5.479909297052155,7.546485260770975,44,21,261,2,245
36,56,213,5.479909297052155,8.266303854875284,44,21,198,3,157
37,56,430,5.479909297052155,7.546485260770975,44,10,384,2,374
38,12,8,5.990748299319728,7.174965986394558,44,46,51,1,4
39,12,11,5.990748299319728,8.359183673469389,44,47,102,2,1
40,12,301,5.990748299319728,7.546485260770975,44,21,297,2,289
41,12,213,5.990748299319728,8.266303854875284,44,21,224,2,201
42,12,430,5.990748299319728,7.546485260770975,44,10,423,2,418
43,12,416,5.990748299319728,8.661043083900227,44,8,420,3,404
44,8,11,7.174965986394558,8.359183673469389,46,47,51,1,3
45,8,11,7.174965986394558,9.566621315192744,46,47,103,2,3
46,8,213,7.174965986394558,8.266303854875284,46,21,210,1,205
47,8,391,7.174965986394558,9.961360544217687,46,26,401,3,383
48,8,391,7.174965986394558,9.984580498866213,46,32,402,3,383
49,8,416,7.174965986394558,8.661043083900227,46,8,413,1,408
50,8,495,7.174965986394558,9.798820861678005,46,20,500,3,487
51,11,12,8.359183673469389,10.54185941043084,47,43,94,2,1
52,11,391,8.359183673469389,9.961360544217687,47,26,386,2,380
53,11,391,8.359183673469389,9.984580498866213,47,32,386,2,380
54,11,297,8.359183673469389,11.122358276643991,47,31,310,3,286
55,11,495,8.359183673469389,9.798820861678005,47,20,488,1,484
56,11,498,8.359183673469389,10.379319727891156,47,28,495,2,487
57,11,417,8.359183673469389,11.3081179138322,47,32,425,3,406
58,11,8,9.566621315192744,11.702857142857143,47,45,92,2,3
59,11,297,9.566621315192744,11.122358276643991,47,31,294,2,286
60,11,299,9.566621315192744,12.213696145124716,47,31,310,3,288
61,11,417,9.566621315192744,11.3081179138322,47,32,413,2,406
62,12,8,10.54185941043084,11.702857142857143,43,45,50,1,4
63,12,11,10.54185941043084,12.79419501133787,43,48,97,2,1
64,12,299,10.54185941043084,12.213696145124716,43,31,296,2,287
65,12,470,10.54185941043084,12.79419501133787,43,30,468,2,458
66,12,507,10.54185941043084,13.374693877551021,43,33,510,3,495
67,8,11,11.702857142857143,12.79419501133787,45,48,47,1,3
68,8,9,11.702857142857143,13.931972789115646,45,46,96,2,1
69,8,392,11.702857142857143,13.537233560090703,45,28,392,2,384
70,8,470,11.702857142857143,12.79419501133787,45,30,464,1,462
71,8,507,11.702857142857143,13.374693877551021,45,33,504,2,499
72,11,9,12.79419501133787,13.931972789115646,48,46,49,1,2
73,11,10,12.79419501133787,14.97687074829932,48,46,94,2,1
74,11,10,12.79419501133787,15.000090702947846,48,48,95,2,1
75,11,296,12.79419501133787,14.86077097505669,48,29,299,2,285
76,11,392,12.79419501133787,15.371609977324264,48,27,397,3,381
77,11,415,12.79419501133787,14.86077097505669,48,32,414,2,404
78,11,507,12.79419501133787,15.371609977324264,48,31,508,3,496
79,9,10,13.931972789115646,14.97687074829932,46,46,45,1,1
80,9,10,13.931972789115646,15.000090702947846,46,48,46,1,1
81,9,7,13.931972789115646,16.114648526077097,46,43,94,2,2
82,9,392,13.931972789115646,15.371609977324264,46,27,388,1,383
83,9,304,13.931972789115646,16.834467120181408,46,26,320,3,295
84,9,507,13.931972789115646,15.371609977324264,46,31,502,1,498
85,9,505,13.931972789115646,16.834467120181408,46,19,512,3,496
86,10,7,14.97687074829932,16.114648526077097,46,43,49,1,3
87,10,9,14.97687074829932,17.205986394557822,46,48,96,2,1
88,10,304,14.97687074829932,16.834467120181408,46,26,305,2,294
89,10,304,14.97687074829932,17.182766439909297,46,28,309,2,294
90,10,505,14.97687074829932,16.834467120181408,46,19,501,2,495
91,10,507,14.97687074829932,17.925804988662133,46,31,513,3,497
92,10,7,15.000090702947846,16.114648526077097,48,43,48,1,3
93,10,9,15.000090702947846,17.205986394557822,48,48,95,2,1
94,10,304,15.000090702947846,16.834467120181408,48,26,304,2,294
95,10,304,15.000090702947846,17.182766439909297,48,28,309,2,294
96,10,505,15.000090702947846,16.834467120181408,48,19,501,2,495
97,10,507,15.000090702947846,17.925804988662133,48,31,513,3,497
98,7,9,16.114648526077097,17.205986394557822,43,48,47,1,2
99,7,9,16.114648526077097,18.29732426303855,43,46,94,2,2
100,7,304,16.114648526077097,17.182766439909297,43,28,301,1,297
101,7,223,16.114648526077097,18.088344671201813,43,30,232,2,216
102,7,505,16.114648526077097,18.088344671201813,43,31,505,2,498
103,9,263,17.205986394557822,19.667301587301587,48,29,275,2,254
104,9,417,17.205986394557822,19.319002267573698,48,8,418,2,408
105,9,263,18.29732426303855,19.667301587301587,46,29,261,1,254
106,9,265,18.29732426303855,20.758639455782312,46,27,277,2,256
107,9,417,18.29732426303855,19.319002267573698,46,8,410,1,408
108,9,265,19.388662131519276,20.758639455782312,46,27,263,1,256
109,9,251,19.388662131519276,21.43201814058957,46,29,258,2,242
110,9,277,19.388662131519276,22.01251700680272,46,29,291,3,268
111,9,417,19.388662131519276,21.339138321995467,46,14,417,2,408
112,9,251,20.340680272108845,21.43201814058957,46,29,247,1,242
113,9,277,20.340680272108845,22.01251700680272,46,29,278,2,268
114,9,65,21.71065759637188,23.498594104308392,47,47,95,2,56
115,9,259,21.71065759637188,23.428934240362814,47,30,261,2,250
116,9,223,21.71065759637188,24.357732426303855,47,28,242,3,214
117,9,57,22.66267573696145,25.170430839002268,46,45,118,3,48
118,9,223,22.66267573696145,24.357732426303855,46,28,226,2,214
119,9,254,22.66267573696145,25.541950113378686,46,29,275,3,245
120,9,449,22.66267573696145,24.775691609977326,46,9,449,2,440
121,65,57,23.498594104308392,25.170430839002268,47,45,72,2,8
122,65,9,23.498594104308392,26.28498866213152,47,47,132,3,56
123,65,254,23.498594104308392,25.541950113378686,47,29,208,2,189
124,65,258,23.498594104308392,26.424308390022677,47,27,230,3,193
125,65,449,23.498594104308392,24.775691609977326,47,9,388,1,384
126,9,57,23.986213151927437,25.170430839002268,46,45,70,1,48
127,9,254,23.986213151927437,25.541950113378686,46,29,254,2,245
128,9,258,23.986213151927437,26.424308390022677,46,27,270,2,249
129,57,9,25.170430839002268,26.28498866213152,45,47,68,1,48
130,57,7,25.170430839002268,27.422766439909296,45,42,109,2,50
131,57,258,25.170430839002268,26.424308390022677,45,27,208,1,201
132,57,267,25.170430839002268,27.794285714285714,45,26,238,3,210
133,57,240,25.170430839002268,28.142585034013607,45,22,223,3,183
134,57,446,25.170430839002268,27.724625850340136,45,11,404,3,389
135,9,7,26.28498866213152,27.422766439909296,47,42,49,1,2
136,9,10,26.28498866213152,28.560544217687074,47,49,98,2,1
137,9,267,26.28498866213152,27.794285714285714,47,26,266,2,258
138,9,240,26.28498866213152,28.142585034013607,47,22,244,2,231
139,9,446,26.28498866213152,27.724625850340136,47,11,441,1,437
140,9,429,26.28498866213152,28.93206349206349,47,17,435,3,420
141,7,10,27.422766439909296,28.560544217687074,42,49,49,1,3
142,7,271,27.422766439909296,29.976961451247167,42,26,286,3,264
143,7,273,27.422766439909296,30.00018140589569,42,30,288,3,266
144,7,429,27.422766439909296,28.93206349206349,42,17,427,2,422
145,7,428,27.422766439909296,29.30358276643991,42,12,429,2,421
146,10,7,28.560544217687074,29.651882086167802,49,44,47,1,3
147,10,9,28.560544217687074,30.766439909297052,49,45,95,2,1
148,10,271,28.560544217687074,29.976961451247167,49,26,268,1,261
149,10,273,28.560544217687074,30.00018140589569,49,30,270,1,263
150,10,267,28.560544217687074,31.091519274376417,49,26,279,3,257
151,10,428,28.560544217687074,30.418140589569163,49,15,426,2,418
152,7,9,29.651882086167802,30.766439909297052,44,45,48,1,2
153,7,9,29.651882086167802,31.90421768707483,44,47,97,2,2
154,7,9,29.651882086167802,31.997097505668936,44,45,101,2,2
155,7,267,29.651882086167802,31.091519274376417,44,26,267,1,260
156,7,224,29.651882086167802,32.182857142857145,44,29,243,3,217
157,7,493,29.651882086167802,31.60235827664399,44,12,493,2,486
158,9,10,30.766439909297052,33.04199546485261,45,48,98,2,1
159,9,224,30.766439909297052,32.182857142857145,45,29,223,1,215
160,9,413,30.766439909297052,32.670476190476194,45,11,412,2,404
161,9,426,30.766439909297052,33.436734693877554,45,12,433,3,417
162,9,10,31.90421768707483,33.04199546485261,47,48,49,1,1
163,9,7,31.90421768707483,34.202993197278914,47,46,99,2,2
164,9,236,31.90421768707483,33.90113378684807,47,33,243,2,227
165,9,208,31.90421768707483,34.22621315192744,47,31,223,2,199
166,9,426,31.90421768707483,33.436734693877554,47,12,422,2,417
167,9,418,31.90421768707483,34.57451247165533,47,15,425,3,409
168,9,10,31.997097505668936,33.04199546485261,45,48,45,1,1
169,9,7,31.997097505668936,34.202993197278914,45,46,95,2,2
170,9,236,31.997097505668936,33.90113378684807,45,33,241,2,227
171,9,208,31.997097505668936,34.22621315192744,45,31,221,2,199
172,9,426,31.997097505668936,33.436734693877554,45,12,422,1,417
173,9,418,31.997097505668936,34.57451247165533,45,15,424,3,409
174,10,7,33.04199546485261,34.202993197278914,48,46,50,1,3
175,10,7,33.04199546485261,35.36399092970522,48,44,100,2,3
176,10,208,33.04199546485261,34.22621315192744,48,31,204,1,198
177,10,263,33.04199546485261,35.15501133786848,48,26,269,2,253
178,10,418,33.04199546485261,34.57451247165533,48,15,413,2,408
179,10,462,33.04199546485261,35.062131519274374,48,15,460,2,452
180,7,10,34.202993197278914,36.08380952380953,46,48,81,2,3
181,7,233,34.202993197278914,36.89650793650794,46,28,254,3,226
182,7,420,34.202993197278914,36.08380952380953,46,15,421,2,413
183,7,9,35.36399092970522,37.593106575963716,44,46,96,2,2
184,7,233,35.36399092970522,36.89650793650794,44,28,235,2,226
185,7,222,35.36399092970522,37.24480725623583,44,25,230,2,215
186,7,270,35.36399092970522,38.17360544217687,44,26,289,3,263
187,7,428,35.36399092970522,37.964625850340134,44,7,436,3,421
188,7,422,35.36399092970522,38.12716553287982,44,14,432,3,415
189,10,9,36.08380952380953,37.593106575963716,48,46,65,2,1
190,10,9,36.08380952380953,38.568344671201814,48,47,107,2,1
191,10,222,36.08380952380953,37.24480725623583,48,25,218,1,212
192,10,270,36.08380952380953,38.17360544217687,48,26,275,2,260
193,10,428,36.08380952380953,37.964625850340134,48,7,426,2,418
194,10,422,36.08380952380953,38.12716553287982,48,14,421,2,412
195,9,285,37.593106575963716,39.14884353741497,46,27,284,2,276
196,9,270,37.593106575963716,40.19374149659864,46,26,284,3,261
197,9,433,37.593106575963716,40.07764172335601,46,13,437,2,424
198,9,55,38.568344671201814,40.820680272108845,47,46,107,2,46
199,9,56,38.568344671201814,41.05287981859411,47,45,117,2,47
200,9,270,38.568344671201814,40.19374149659864,47,26,270,2,261
201,9,433,38.568344671201814,40.07764172335601,47,13,429,2,424
202,9,434,38.568344671201814,41.33151927437642,47,14,441,3,425
203,9,56,39.891882086167804,41.05287981859411,46,45,69,1,47
204,9,300,39.891882086167804,41.61015873015873,46,29,300,2,291
205,9,223,39.891882086167804,42.5621768707483,46,27,243,3,214
206,9,434,39.891882086167804,41.33151927437642,46,14,429,1,425
207,55,9,40.820680272108845,42.16743764172336,46,47,74,1,46
208,55,59,40.820680272108845,43.51419501133787,46,47,116,3,4
209,55,223,40.820680272108845,42.5621768707483,46,27,184,2,168
210,55,265,40.820680272108845,43.69995464852608,46,30,244,3,210
211,55,424,40.820680272108845,42.93369614512472,46,7,380,2,369
212,56,9,41.05287981859411,42.16743764172336,45,47,67,1,47
213,56,59,41.05287981859411,43.51419501133787,45,47,106,2,3
214,56,223,41.05287981859411,42.5621768707483,45,27,179,2,167
215,56,265,41.05287981859411,43.69995464852608,45,30,238,3,209
216,56,424,41.05287981859411,42.93369614512472,45,7,377,2,368
217,56,416,41.05287981859411,43.95537414965987,45,21,381,3,360
218,56,415,41.05287981859411,44.00181405895692,45,19,381,3,359
219,9,59,42.16743764172336,43.51419501133787,47,47,77,1,50
220,9,265,42.16743764172336,43.69995464852608,47,30,264,2,256
221,9,275,42.16743764172336,44.11791383219955,47,25,279,2,266
222,9,416,42.16743764172336,43.95537414965987,47,21,414,2,407
223,9,415,42.16743764172336,44.00181405895692,47,19,414,2,406
224,59,9,43.51419501133787,45.60399092970522,47,48,103,2,50
225,59,233,43.51419501133787,45.97551020408164,47,28,204,2,174
226,59,414,43.51419501133787,46.021950113378686,47,13,371,3,355
227,9,12,44.489433106575966,46.718548752834465,47,43,96,2,3
228,9,233,44.489433106575966,45.97551020408164,47,28,233,1,224
229,9,260,44.489433106575966,46.718548752834465,47,27,269,2,251
230,9,264,44.489433106575966,47.159727891156464,47,27,280,3,255
231,9,414,44.489433106575966,46.021950113378686,47,13,410,2,405
232,9,12,45.60399092970522,46.718548752834465,48,43,48,1,3
233,9,8,45.60399092970522,47.9027664399093,48,46,99,2,1
234,9,8,45.60399092970522,47.9956462585034,48,43,103,2,1
235,9,260,45.60399092970522,46.718548752834465,48,27,256,1,251
236,9,264,45.60399092970522,47.159727891156464,48,27,264,2,255
237,9,268,45.60399092970522,48.088526077097505,48,32,280,2,259
238,9,434,45.60399092970522,47.62412698412699,48,13,434,2,425
239,9,427,45.60399092970522,48.251065759637186,48,14,433,3,418
240,12,8,46.718548752834465,47.9027664399093,43,46,51,1,4
241,12,8,46.718548752834465,47.9956462585034,43,43,55,1,4
242,12,11,46.718548752834465,49.15664399092971,43,48,105,2,1
243,12,268,46.718548752834465,48.088526077097505,43,32,263,1,256
244,12,277,46.718548752834465,49.295963718820865,43,29,287,3,265
245,12,427,46.718548752834465,48.251065759637186,43,14,420,2,415
246,8,11,47.9027664399093,49.15664399092971,46,48,54,1,3
247,8,11,47.9027664399093,50.340861678004536,46,48,105,2,3
248,8,277,47.9027664399093,49.295963718820865,46,29,276,1,269
249,8,238,47.9027664399093,50.36408163265306,46,28,253,2,230
250,8,429,47.9027664399093,50.549841269841274,46,12,436,3,421
251,8,11,47.9956462585034,49.15664399092971,43,48,50,1,3
252,8,11,47.9956462585034,50.340861678004536,43,48,101,2,3
253,8,277,47.9956462585034,49.295963718820865,43,29,275,1,269
254,8,238,47.9956462585034,50.36408163265306,43,28,252,2,230
255,8,429,47.9956462585034,50.549841269841274,43,12,435,3,421
256,11,9,49.15664399092971,51.26965986394558,48,47,91,2,2
257,11,238,49.15664399092971,50.36408163265306,48,28,233,1,227
258,11,241,49.15664399092971,51.06068027210885,48,23,244,2,230
259,11,429,49.15664399092971,50.549841269841274,48,12,422,1,418
260,11,449,49.15664399092971,51.66439909297052,48,10,451,3,438
261,11,10,50.340861678004536,52.43065759637188,48,49,90,2,1
262,11,263,50.340861678004536,52.22167800453515,48,26,265,2,252
263,11,220,50.340861678004536,53.011156462585035,48,20,239,3,209
264,11,449,50.340861678004536,51.66439909297052,48,10,442,1,438
265,11,425,50.340861678004536,53.173696145124715,48,13,432,3,414
266,9,10,51.26965986394558,52.43065759637188,47,49,50,1,1
267,9,11,51.26965986394558,53.96317460317461,47,48,116,3,2
268,9,11,51.26965986394558,54.00961451247166,47,47,118,3,2
269,9,220,51.26965986394558,53.011156462585035,47,20,224,2,211
270,9,425,51.26965986394558,53.173696145124715,47,13,424,2,416
271,10,11,52.43065759637188,53.96317460317461,49,48,66,2,1
272,10,11,52.43065759637188,54.00961451247166,49,47,68,2,1
273,10,256,52.43065759637188,54.96163265306122,49,23,269,3,246
274,10,251,52.43065759637188,55.031292517006804,49,22,266,3,241
275,11,9,53.96317460317461,55.82077097505669,48,46,80,2,2
276,11,7,53.96317460317461,56.93532879818594,48,44,128,3,4
277,11,251,53.96317460317461,55.031292517006804,48,22,244,1,240
278,11,328,53.96317460317461,56.540589569161,48,22,336,3,317
279,11,450,53.96317460317461,56.540589569161,48,12,453,3,439
280,11,9,54.00961451247166,55.82077097505669,47,46,78,2,2
281,11,7,54.00961451247166,56.93532879818594,47,44,126,3,4
282,11,251,54.00961451247166,55.031292517006804,47,22,244,1,240
283,11,328,54.00961451247166,56.540589569161,47,22,335,3,317
284,11,450,54.00961451247166,56.540589569161,47,12,452,3,439
285,9,7,55.82077097505669,56.93532879818594,46,44,48,1,2
286,9,24,55.82077097505669,57.56226757369615,46,42,76,2,15
287,9,10,55.82077097505669,58.28208616780046,46,49,106,2,1
288,9,265,55.82077097505669,57.14430839002268,46,31,262,1,256
289,9,246,55.82077097505669,58.049886621315196,46,28,256,2,237
290,9,419,55.82077097505669,57.63192743764172,46,13,417,2,410
291,7,10,56.93532879818594,58.28208616780046,44,49,58,1,3
292,7,246,56.93532879818594,58.049886621315196,44,28,244,1,239
293,7,271,56.93532879818594,59.90748299319728,44,31,293,3,264
294,7,429,56.93532879818594,58.816145124716556,44,15,430,2,422
295,7,427,56.93532879818594,59.55918367346939,44,14,435,3,420
296,24,7,57.56226757369615,59.23410430839002,42,45,74,2,17
297,24,10,57.56226757369615,60.32544217687075,42,49,120,3,14
298,24,271,57.56226757369615,59.90748299319728,42,31,267,2,247
299,24,333,57.56226757369615,60.070022675736965,42,26,327,3,309
300,24,429,57.56226757369615,58.816145124716556,42,15,409,1,405
301,24,427,57.56226757369615,59.55918367346939,42,14,412,2,403
302,10,271,58.28208616780046,59.90748299319728,49,31,270,2,261
303,10,333,58.28208616780046,60.070022675736965,49,26,332,2,323
304,10,427,58.28208616780046,59.55918367346939,49,14,421,1,417
305,7,10,59.23410430839002,60.32544217687075,45,49,47,1,3
306,7,230,59.23410430839002,61.9740589569161,45,30,252,3,223
307,10,7,60.32544217687075,61.46321995464853,49,44,49,1,3
308,10,9,60.32544217687075,62.55455782312925,49,46,96,2,1
309,10,230,60.32544217687075,61.9740589569161,49,30,231,2,220
310,10,263,60.32544217687075,62.368798185941046,49,31,268,2,253
311,7,9,61.46321995464853,62.55455782312925,44,46,47,1,2
312,7,9,61.46321995464853,63.69233560090703,44,47,96,2,2
313,7,56,61.46321995464853,64.06385487528345,44,45,122,3,49
314,7,268,61.46321995464853,63.92453514739229,44,32,282,2,261
315,7,247,61.46321995464853,64.15673469387755,44,28,267,3,240
316,7,505,61.46321995464853,63.34403628117914,44,12,505,2,498
317,9,56,62.55455782312925,64.06385487528345,46,45,80,2,47
318,9,268,62.55455782312925,63.92453514739229,46,32,266,1,259
319,9,247,62.55455782312925,64.15673469387755,46,28,248,2,238
320,9,275,62.55455782312925,65.24807256235827,46,26,290,3,266
321,9,419,62.55455782312925,65.22485260770975,46,12,426,3,410
322,9,8,63.69233560090703,65.96789115646258,47,47,98,2,1
323,9,8,63.69233560090703,65.99111111111111,47,46,99,2,1
324,9,275,63.69233560090703,65.24807256235827,47,26,274,2,266
325,9,278,63.69233560090703,66.38585034013606,47,31,293,3,269
326,9,419,63.69233560090703,65.22485260770975,47,12,415,2,410
327,56,8,64.06385487528345,65.96789115646258,45,47,95,2,48
328,56,8,64.06385487528345,65.99111111111111,45,46,96,2,48
329,56,275,64.06385487528345,65.24807256235827,45,26,225,1,219
330,56,278,64.06385487528345,66.38585034013606,45,31,243,2,222
331,56,419,64.06385487528345,65.22485260770975,45,12,366,1,363
332,56,429,64.06385487528345,66.73414965986395,45,17,390,3,373
333,8,11,65.96789115646258,67.24498866213152,47,48,55,1,3
334,8,11,65.96789115646258,68.28988662131519,47,48,100,2,3
335,8,255,65.96789115646258,67.43074829931973,47,26,255,1,247
336,8,241,65.96789115646258,68.61496598639457,47,28,259,3,233
337,8,449,65.96789115646258,67.89514739229026,47,14,449,2,441
338,8,11,65.99111111111111,67.24498866213152,46,48,54,1,3
339,8,11,65.99111111111111,68.28988662131519,46,48,99,2,3
340,8,255,65.99111111111111,67.43074829931973,46,26,255,1,247
341,8,241,65.99111111111111,68.61496598639457,46,28,259,3,233
342,8,449,65.99111111111111,67.89514739229026,46,14,449,2,441
343,11,9,67.24498866213152,69.40444444444445,48,47,93,2,2
344,11,241,67.24498866213152,68.61496598639457,48,28,237,1,230
345,11,247,67.24498866213152,69.0097052154195,48,28,248,2,236
346,11,9,68.28988662131519,69.40444444444445,48,47,48,1,2
347,11,10,68.28988662131519,70.54222222222222,48,49,97,2,1
348,11,270,68.28988662131519,70.5190022675737,48,29,276,2,259
349,11,429,68.28988662131519,70.91374149659865,48,12,433,3,418
350,9,10,69.40444444444445,70.54222222222222,47,49,49,1,1
351,9,270,69.40444444444445,70.5190022675737,47,29,265,1,261
352,9,274,69.40444444444445,71.63356009070294,47,23,282,2,265
353,9,429,69.40444444444445,70.91374149659865,47,12,425,2,420
354,10,9,70.54222222222222,71.70321995464853,49,46,50,1,1
355,10,9,70.54222222222222,72.79455782312925,49,47,97,2,1
356,10,274,70.54222222222222,71.63356009070294,49,23,268,1,264
357,10,224,70.54222222222222,72.98031746031747,49,17,238,2,214
358,10,224,70.54222222222222,73.00353741496599,49,20,239,2,214
359,9,224,71.70321995464853,72.98031746031747,46,17,222,1,215
360,9,224,71.70321995464853,73.00353741496599,46,20,222,1,215
361,9,506,71.70321995464853,74.32707482993197,46,9,510,3,497
362,9,225,72.79455782312925,74.6985941043084,47,15,231,2,216
363,9,230,72.79455782312925,75.04689342403628,47,24,241,2,221
364,9,506,72.79455782312925,74.32707482993197,47,9,501,2,497
365,9,449,72.79455782312925,75.44163265306122,47,13,455,3,440
366,9,230,73.95555555555556,75.04689342403628,45,24,226,1,221
367,9,224,73.95555555555556,76.60263038548753,45,23,243,3,215
368,9,449,73.95555555555556,75.44163265306122,45,13,445,1,440
369,9,506,73.95555555555556,76.64907029478458,45,7,510,3,497
370,9,224,74.93079365079365,76.60263038548753,48,23,227,2,215
371,9,237,74.93079365079365,77.39210884353741,48,23,251,2,228
372,9,506,74.93079365079365,76.64907029478458,48,7,502,2,497
373,9,224,75.00045351473923,76.60263038548753,45,23,226,2,215
374,9,237,75.00045351473923,77.39210884353741,45,23,250,2,228
375,9,506,75.00045351473923,76.64907029478458,45,7,502,2,497
376,9,237,76.23111111111112,77.39210884353741,46,23,233,1,228
377,9,219,76.23111111111112,78.80852607709751,46,27,238,3,210
378,9,12,77.22956916099774,79.6908843537415,46,45,106,2,3
379,9,219,77.22956916099774,78.80852607709751,46,27,221,2,210
380,9,230,77.22956916099774,79.22648526077097,46,28,237,2,221
381,9,449,77.22956916099774,79.31936507936508,46,11,449,2,440
382,9,12,78.5298866213152,79.6908843537415,47,45,50,1,3
383,9,322,78.5298866213152,80.96798185941043,47,25,330,2,313
384,9,307,78.5298866213152,81.01442176870748,47,23,317,2,298
385,12,9,79.6908843537415,80.8518820861678,45,46,50,1,3
386,12,9,79.6908843537415,81.15374149659864,45,43,63,1,3
387,12,7,79.6908843537415,82.0128798185941,45,44,100,2,5
388,12,322,79.6908843537415,80.96798185941043,45,25,315,1,310
389,12,307,79.6908843537415,81.01442176870748,45,23,300,1,295
390,12,262,79.6908843537415,82.0128798185941,45,17,269,2,250
391,12,511,79.6908843537415,81.61814058956917,45,26,506,2,499
392,12,449,79.6908843537415,82.0128798185941,45,7,448,2,437
393,9,7,80.8518820861678,82.0128798185941,46,44,50,1,2
394,9,10,80.8518820861678,83.15065759637189,46,48,99,2,1
395,9,262,80.8518820861678,82.0128798185941,46,17,258,1,253
396,9,209,80.8518820861678,83.08099773242631,46,27,222,2,200
397,9,449,80.8518820861678,82.0128798185941,46,7,443,1,440
398,9,10,81.15374149659864,83.15065759637189,43,48,86,2,1
399,9,209,81.15374149659864,83.08099773242631,43,27,217,2,200
400,9,506,81.15374149659864,83.89369614512472,43,9,511,3,497
401,7,10,82.0128798185941,83.15065759637189,44,48,49,1,3
402,7,209,82.0128798185941,83.08099773242631,44,27,207,1,202
403,7,205,82.0128798185941,84.8457142857143,44,28,233,3,198
404,7,506,82.0128798185941,83.89369614512472,44,9,506,2,499
405,7,427,82.0128798185941,84.63673469387756,44,9,435,3,420
406,10,7,83.15065759637189,84.28843537414966,48,44,49,1,3
407,10,9,83.15065759637189,85.37977324263039,48,46,96,2,1
408,10,205,83.15065759637189,84.8457142857143,48,28,208,2,195
409,10,313,83.15065759637189,85.33333333333333,48,28,317,2,303
410,10,427,83.15065759637189,84.63673469387756,48,9,422,1,417
411,10,505,83.15065759637189,85.1243537414966,48,20,502,2,495
412,7,9,84.28843537414966,85.37977324263039,44,46,47,1,2
413,7,9,84.28843537414966,86.54077097505669,44,47,97,2,2
414,7,313,84.28843537414966,85.33333333333333,44,28,309,1,306
415,7,220,84.28843537414966,86.86585034013605,44,29,240,3,213
416,7,418,84.28843537414966,86.98195011337869,44,7,427,3,411
417,9,10,85.37977324263039,87.67854875283447,46,49,99,2,1
418,9,10,85.37977324263039,88.09650793650793,46,47,117,3,1
419,9,220,85.37977324263039,86.86585034013605,46,29,220,1,211
420,9,227,85.37977324263039,87.98040816326531,46,29,245,3,218
421,9,227,85.37977324263039,88.00362811791383,46,26,246,3,218
422,9,418,85.37977324263039,86.98195011337869,46,7,415,2,409
423,9,479,85.37977324263039,88.05006802721088,46,12,484,3,470
424,9,10,86.54077097505669,87.67854875283447,47,49,49,1,1
425,9,10,86.54077097505669,88.09650793650793,47,47,67,2,1
426,9,227,86.54077097505669,87.98040816326531,47,29,227,1,218
427,9,227,86.54077097505669,88.00362811791383,47,26,227,1,218
428,9,221,86.54077097505669,89.00208616780046,47,21,237,2,212
429,9,479,86.54077097505669,88.05006802721088,47,12,474,2,470
430,10,7,87.67854875283447,89.97732426303855,49,46,99,2,3
431,10,221,87.67854875283447,89.00208616780046,49,21,219,1,211
432,10,281,87.67854875283447,90.00054421768708,49,17,289,2,271
433,10,449,87.67854875283447,90.00054421768708,49,9,450,2,439
434,10,7,88.09650793650793,89.97732426303855,47,46,81,2,3
435,10,281,88.09650793650793,90.00054421768708,47,17,283,2,271
436,10,449,88.09650793650793,90.00054421768708,47,9,447,2,439
437,7,9,89.97732426303855,92.25287981859411,46,47,98,2,2
438,7,300,89.97732426303855,91.34730158730159,46,22,299,1,293
439,7,243,89.97732426303855,92.25287981859411,46,28,256,2,236
440,7,453,89.97732426303855,91.11510204081632,46,11,449,1,446
441,10,9,90.72036281179139,92.25287981859411,49,47,66,2,1
442,10,9,90.72036281179139,93.29777777777778,49,46,111,3,1
443,10,243,90.72036281179139,92.25287981859411,49,28,242,2,233
444,10,208,90.72036281179139,93.042358276644,49,39,222,2,198
445,7,9,91.13832199546485,92.25287981859411,44,47,48,1,2
446,7,9,91.13832199546485,93.29777777777778,44,46,93,2,2
447,7,243,91.13832199546485,92.25287981859411,44,28,241,1,236
448,7,208,91.13832199546485,93.042358276644,44,39,217,2,201
449,7,266,91.13832199546485,94.01759637188209,44,27,287,3,259
450,7,450,91.13832199546485,93.80861678004536,44,11,458,3,443
451,9,266,92.25287981859411,94.01759637188209,47,27,268,2,257
452,9,450,92.25287981859411,93.80861678004536,47,11,446,2,441
453,9,410,92.25287981859411,94.89995464852608,47,15,417,3,401
454,9,57,93.29777777777778,95.29469387755103,46,45,98,2,48
455,9,266,93.29777777777778,95.94485260770975,46,28,281,3,257
456,9,232,93.29777777777778,96.08417233560091,46,28,253,3,223
457,9,410,93.29777777777778,94.89995464852608,46,15,407,2,401
458,9,444,93.29777777777778,95.94485260770975,46,9,450,3,435
459,9,419,93.29777777777778,96.08417233560091,46,13,427,3,410
460,9,266,94.57487528344672,95.94485260770975,45,28,264,1,257
461,9,232,94.57487528344672,96.08417233560091,45,28,232,2,223
462,9,444,94.57487528344672,95.94485260770975,45,9,439,1,435
463,9,419,94.57487528344672,96.08417233560091,45,13,415,2,410
464,9,427,94.57487528344672,97.2451700680272,45,9,434,3,418
465,57,9,95.29469387755103,96.8736507936508,45,48,83,2,48
466,57,56,95.29469387755103,97.80244897959184,45,45,108,3,1
467,57,229,95.29469387755103,97.98820861678004,45,25,207,3,172
468,57,207,95.29469387755103,98.24362811791383,45,32,197,3,150
469,57,427,95.29469387755103,97.2451700680272,45,9,379,2,370
470,9,60,96.8736507936508,98.47582766439909,48,46,86,2,51
471,9,229,96.8736507936508,97.98820861678004,48,25,225,1,220
472,9,207,96.8736507936508,98.24362811791383,48,32,207,1,198
473,9,256,96.8736507936508,99.26530612244898,48,25,268,2,247
474,56,9,97.80244897959184,99.14920634920635,45,46,75,1,47
475,56,9,97.80244897959184,100.31020408163266,45,46,118,3,47
476,56,256,97.80244897959184,99.26530612244898,45,25,210,1,200
477,56,427,97.80244897959184,100.56562358276645,45,13,390,3,371
478,60,9,98.47582766439909,100.31020408163266,46,46,94,2,51
479,60,6,98.47582766439909,101.40154195011338,46,45,137,3,54
480,60,253,98.47582766439909,100.86748299319729,46,33,219,2,193
481,60,265,98.47582766439909,101.40154195011338,46,34,241,3,205
482,60,427,98.47582766439909,100.56562358276645,46,13,378,2,367
483,9,6,99.14920634920635,101.40154195011338,46,45,97,2,3
484,9,253,99.14920634920635,100.86748299319729,46,33,255,2,244
485,9,265,99.14920634920635,101.40154195011338,46,34,274,2,256
486,9,281,99.14920634920635,102.00526077097506,46,22,299,3,272
487,9,427,99.14920634920635,100.56562358276645,46,13,422,1,418
488,9,429,99.14920634920635,101.79628117913832,46,12,435,3,420
489,9,6,100.31020408163266,101.40154195011338,46,45,47,1,3
490,9,8,100.31020408163266,102.5857596371882,46,46,98,2,1
491,9,265,100.31020408163266,101.40154195011338,46,34,260,1,256
492,9,281,100.31020408163266,102.00526077097506,46,22,282,2,272
493,9,429,100.31020408163266,101.79628117913832,46,12,425,1,420
494,9,429,100.31020408163266,102.95727891156463,46,13,435,3,420
495,6,8,101.40154195011338,102.5857596371882,45,46,51,1,2
496,6,11,101.40154195011338,103.95573696145125,45,47,110,3,5
497,6,276,101.40154195011338,103.95573696145125,45,27,292,3,270
498,6,270,101.40154195011338,104.02539682539683,45,30,287,3,264
499,6,429,101.40154195011338,102.95727891156463,45,13,428,2,423
500,6,429,101.40154195011338,103.35201814058958,45,11,431,2,423
501,8,11,102.5857596371882,103.95573696145125,46,47,59,1,3
502,8,11,102.5857596371882,104.9774149659864,46,46,103,2,3
503,8,11,102.5857596371882,105.02385487528345,46,47,105,2,3
504,8,276,102.5857596371882,103.95573696145125,46,27,274,1,268
505,8,270,102.5857596371882,104.02539682539683,46,30,269,1,262
506,8,206,102.5857596371882,105.11673469387755,46,32,226,3,198
507,8,448,102.5857596371882,104.5362358276644,46,16,448,2,440
508,11,9,103.95573696145125,105.99909297052154,47,45,88,2,2
509,11,206,103.95573696145125,105.11673469387755,47,32,201,1,195
510,11,248,103.95573696145125,105.99909297052154,47,25,253,2,237
511,11,438,103.95573696145125,106.88145124716553,47,6,445,3,427
512,11,9,104.9774149659864,105.99909297052154,46,45,44,1,2
513,11,7,104.9774149659864,107.16009070294785,46,43,94,2,4
514,11,248,104.9774149659864,105.99909297052154,46,25,241,1,237
515,11,254,104.9774149659864,107.25297052154195,46,26,262,2,243
516,11,438,104.9774149659864,106.88145124716553,46,6,435,2,427
517,11,429,104.9774149659864,107.90312925170068,46,12,437,3,418
518,11,7,105.02385487528345,107.16009070294785,47,43,92,2,4
519,11,254,105.02385487528345,107.25297052154195,47,26,261,2,243
520,11,438,105.02385487528345,106.88145124716553,47,6,434,2,427
521,11,429,105.02385487528345,107.90312925170068,47,12,436,3,418
522,9,7,105.99909297052154,107.16009070294785,45,43,50,1,2
523,9,11,105.99909297052154,108.66938775510204,45,47,115,3,2
524,9,254,105.99909297052154,107.25297052154195,45,26,251,1,245
525,9,262,105.99909297052154,108.25142857142858,45,21,271,2,253
526,9,429,105.99909297052154,107.90312925170068,45,12,428,2,420
527,7,11,107.16009070294785,108.66938775510204,43,47,65,2,4
528,7,9,107.16009070294785,109.4356462585034,43,47,98,2,2
529,7,262,107.16009070294785,108.25142857142858,43,21,259,1,255
530,7,238,107.16009070294785,109.69106575963718,43,30,255,3,231
531,11,9,108.66938775510204,110.5966439909297,47,45,83,2,2
532,11,238,108.66938775510204,109.69106575963718,47,30,231,1,227
533,11,224,108.66938775510204,110.96816326530613,47,27,235,2,213
534,11,433,108.66938775510204,110.8520634920635,47,10,432,2,422
535,11,411,108.66938775510204,111.36290249433107,47,18,416,3,400
536,9,7,109.4356462585034,111.73442176870749,47,43,99,2,2
537,9,224,109.4356462585034,110.96816326530613,47,27,225,2,215
538,9,257,109.4356462585034,111.92018140589569,47,25,270,2,248
539,9,270,109.4356462585034,112.05950113378685,47,26,284,3,261
540,9,433,109.4356462585034,110.8520634920635,47,10,428,1,424
541,9,411,109.4356462585034,111.36290249433107,47,18,410,2,402
542,9,476,109.4356462585034,112.33814058956916,47,9,483,3,467
543,9,7,110.5966439909297,111.73442176870749,45,43,49,1,2
544,9,10,110.5966439909297,112.82575963718821,45,49,96,2,1
545,9,10,110.5966439909297,113.05795918367347,45,47,106,2,1
546,9,257,110.5966439909297,111.92018140589569,45,25,254,1,248
547,9,270,110.5966439909297,112.05950113378685,45,26,268,1,261
548,9,257,110.5966439909297,113.12761904761905,45,25,271,3,248
549,9,476,110.5966439909297,112.33814058956916,45,9,473,2,467
550,7,10,111.73442176870749,112.82575963718821,43,49,47,1,3
551,7,10,111.73442176870749,113.05795918367347,43,47,57,1,3
552,7,43,111.73442176870749,114.6833560090703,43,46,132,3,36
553,7,257,111.73442176870749,113.12761904761905,43,25,257,1,250
554,7,210,111.73442176870749,114.1492970521542,43,30,228,2,203
555,7,429,111.73442176870749,113.6152380952381,43,18,430,2,422
556,10,43,112.82575963718821,114.6833560090703,49,46,87,2,33
557,10,210,112.82575963718821,114.1492970521542,49,30,208,1,200
558,10,265,112.82575963718821,115.14775510204082,49,30,274,2,255
559,10,43,113.05795918367347,114.6833560090703,47,46,77,2,33
560,10,210,113.05795918367347,114.1492970521542,47,30,205,1,200
561,10,265,113.05795918367347,115.14775510204082,47,30,270,2,255
562,10,428,113.05795918367347,115.8443537414966,47,11,435,3,418
563,43,7,114.6833560090703,116.23909297052154,46,43,76,2,36
564,43,9,114.6833560090703,117.3536507936508,46,47,120,3,34
565,43,240,114.6833560090703,116.23909297052154,46,29,208,2,197
566,43,223,114.6833560090703,117.539410430839,46,26,218,3,180
567,43,428,114.6833560090703,115.8443537414966,46,11,388,1,385
568,43,429,114.6833560090703,116.58739229024944,46,14,395,2,386
569,10,7,115.1245351473923,116.23909297052154,48,43,48,1,3
570,10,9,115.1245351473923,117.3536507936508,48,47,96,2,1
571,10,240,115.1245351473923,116.23909297052154,48,29,235,1,230
572,10,223,115.1245351473923,117.539410430839,48,26,237,2,213
573,10,429,115.1245351473923,116.58739229024944,48,14,424,1,419
574,7,9,116.23909297052154,117.3536507936508,43,47,48,1,2
575,7,9,116.23909297052154,118.46820861678005,43,45,96,2,2
576,7,223,116.23909297052154,117.539410430839,43,26,223,1,216
577,7,270,116.23909297052154,118.74684807256236,43,31,284,3,263
578,7,264,116.23909297052154,119.21124716553288,43,30,287,3,257
579,9,12,117.3536507936508,119.58276643990929,47,45,96,2,3
580,9,270,117.3536507936508,118.74684807256236,47,31,268,1,261
581,9,264,117.3536507936508,119.21124716553288,47,30,267,2,255
582,9,449,117.3536507936508,119.97750566893424,47,13,454,3,440
583,9,449,117.3536507936508,120.00072562358277,47,12,455,3,440
584,9,12,118.46820861678005,119.58276643990929,45,45,48,1,3
585,9,48,118.46820861678005,120.92952380952381,45,46,113,2,39
586,9,237,118.46820861678005,120.92952380952381,45,32,251,2,228
587,9,449,118.46820861678005,119.97750566893424,45,13,445,2,440
588,9,449,118.46820861678005,120.00072562358277,45,12,445,2,440
589,12,48,119.58276643990929,120.92952380952381,45,46,68,1,36
590,12,11,119.58276643990929,121.85832199546485,45,48,98,2,1
591,12,11,119.58276643990929,122.02086167800454,45,46,105,2,1
592,12,237,119.58276643990929,120.92952380952381,45,32,232,1,225
593,12,243,119.58276643990929,121.46358276643991,45,28,245,2,231
594,12,296,119.58276643990929,122.18340136054422,45,26,305,3,284
595,12,451,119.58276643990929,121.51002267573696,45,13,447,2,439
596,12,450,119.58276643990929,122.2530612244898,45,14,453,3,438
597,48,11,120.92952380952381,122.02086167800454,46,46,60,1,37
598,48,11,120.92952380952381,123.15863945578232,46,48,103,2,37
599,48,296,120.92952380952381,122.18340136054422,46,26,254,1,248
600,48,219,120.92952380952381,123.73913832199547,46,31,209,3,171
601,48,450,120.92952380952381,122.2530612244898,46,14,406,1,402
602,11,9,121.85832199546485,124.11065759637188,48,46,97,2,2
603,11,219,121.85832199546485,123.73913832199547,48,31,223,2,208
604,11,271,121.85832199546485,124.4821768707483,48,26,283,3,260
605,11,9,122.02086167800454,124.11065759637188,46,46,90,2,2
606,11,219,122.02086167800454,123.73913832199547,46,31,221,2,208
607,11,271,122.02086167800454,124.4821768707483,46,26,281,2,260
608,11,10,123.15863945578232,125.27165532879819,48,47,91,2,1
609,11,271,123.15863945578232,124.4821768707483,48,26,266,1,260
610,11,219,123.15863945578232,125.08589569160998,48,29,224,2,208
611,11,428,123.15863945578232,125.66639455782312,48,13,431,3,417
612,11,429,123.15863945578232,126.03791383219955,48,9,436,3,418
613,9,10,124.11065759637188,125.27165532879819,46,47,50,1,1
614,9,245,124.11065759637188,126.9667120181406,46,26,266,3,236
615,9,428,124.11065759637188,125.66639455782312,46,13,424,2,419
616,9,429,124.11065759637188,126.03791383219955,46,9,428,2,420
617,10,9,125.27165532879819,126.4326530612245,47,46,50,1,1
618,10,9,125.27165532879819,127.08281179138322,47,39,78,2,1
619,10,245,125.27165532879819,126.9667120181406,47,26,246,2,235
620,10,212,125.27165532879819,127.36145124716553,47,26,221,2,202
621,9,299,126.4326530612245,128.96362811791383,46,21,310,3,290
622,9,300,126.4326530612245,129.24226757369615,46,23,315,3,291
623,9,299,127.08281179138322,128.96362811791383,39,21,301,2,290
624,9,300,127.08281179138322,129.24226757369615,39,23,305,2,291
625,213,7,0.7662585034013606,2.670294784580499,29,44,222,2,206
626,213,251,0.7662585034013606,2.8792743764172335,29,27,99,2,38
627,213,237,0.7662585034013606,3.01859410430839,29,30,100,2,24
628,213,410,0.7662585034013606,1.9040362811791383,29,10,203,1,197
629,213,410,0.7662585034013606,2.8328344671201813,29,19,216,2,197
630,213,410,0.7662585034013606,3.1579138321995464,29,17,222,2,197
631,213,685,0.7662585034013606,1.8808163265306124,29,7,474,1,472
632,213,632,0.7662585034013606,2.36843537414966,29,11,425,2,419
633,213,628,0.7662585034013606,3.4133333333333336,29,6,430,3,415
634,272,7,1.3003174603174603,2.670294784580499,22,44,271,1,265
635,272,9,1.3003174603174603,3.7616326530612247,22,47,284,2,263
636,272,251,1.3003174603174603,2.8792743764172335,22,27,71,2,21
637,272,237,1.3003174603174603,3.01859410430839,22,30,82,2,35
638,272,226,1.3003174603174603,4.156371882086168,22,15,131,3,46
639,272,410,1.3003174603174603,2.8328344671201813,22,19,153,2,138
640,272,410,1.3003174603174603,3.1579138321995464,22,17,160,2,138
641,272,632,1.3003174603174603,2.36843537414966,22,11,363,1,360
642,272,628,1.3003174603174603,3.4133333333333336,22,6,367,2,356
643,251,14,2.8792743764172335,4.899410430839002,27,45,252,2,237
644,251,56,2.8792743764172335,5.479909297052155,27,44,225,3,195
645,251,226,2.8792743764172335,4.156371882086168,27,15,60,1,25
646,251,240,2.8792743764172335,5.27092970521542,27,28,104,2,11
647,251,413,2.8792743764172335,4.551111111111111,27,7,177,2,162
648,251,415,2.8792743764172335,5.294149659863946,27,9,194,2,164
649,251,615,2.8792743764172335,4.551111111111111,27,5,371,2,364
650,251,662,2.8792743764172335,5.294149659863946,27,6,424,2,411
651,237,14,3.01859410430839,4.899410430839002,30,45,237,2,223
652,237,56,3.01859410430839,5.479909297052155,30,44,210,2,181
653,237,12,3.01859410430839,5.990748299319728,30,44,259,3,225
654,237,226,3.01859410430839,4.156371882086168,30,15,50,1,11
655,237,240,3.01859410430839,5.27092970521542,30,28,97,2,3
656,237,413,3.01859410430839,4.551111111111111,30,7,188,2,176
657,237,415,3.01859410430839,5.294149659863946,30,9,203,2,178
658,237,451,3.01859410430839,5.990748299319728,30,11,249,3,214
659,237,615,3.01859410430839,4.551111111111111,30,5,384,2,378
660,237,662,3.01859410430839,5.294149659863946,30,6,436,2,425
661,226,56,4.156371882086168,5.479909297052155,15,44,179,1,170
662,226,12,4.156371882086168,5.990748299319728,15,44,228,2,214
663,226,240,4.156371882086168,5.27092970521542,15,28,50,1,14
664,226,235,4.156371882086168,6.013968253968254,15,29,81,2,9
665,226,415,4.156371882086168,5.294149659863946,15,9,195,1,189
666,226,451,4.156371882086168,5.990748299319728,15,11,238,2,225
667,226,662,4.156371882086168,5.294149659863946,15,6,439,1,436
668,226,639,4.156371882086168,6.780226757369615,15,8,428,3,413
669,240,8,5.27092970521542,7.174965986394558,28,46,246,2,232
670,240,301,5.27092970521542,7.546485260770975,28,21,115,2,61
671,240,430,5.27092970521542,7.546485260770975,28,10,214,2,190
672,240,639,5.27092970521542,6.780226757369615,28,8,404,2,399
673,235,8,6.013968253968254,7.174965986394558,29,46,232,1,227
674,235,11,6.013968253968254,8.359183673469389,29,47,246,2,224
675,235,301,6.013968253968254,7.546485260770975,29,21,93,2,66
676,235,213,6.013968253968254,8.266303854875284,29,21,99,2,22
677,235,430,6.013968253968254,7.546485260770975,29,10,206,2,195
678,235,416,6.013968253968254,8.661043083900227,29,8,214,3,181
679,235,662,6.013968253968254,8.661043083900227,29,5,442,3,427
680,301,11,7.546485260770975,9.566621315192744,21,47,303,2,290
681,301,391,7.546485260770975,9.961360544217687,21,26,138,2,90
682,301,391,7.546485260770975,9.984580498866213,21,32,138,2,90
683,301,416,7.546485260770975,8.661043083900227,21,8,125,1,115
684,301,495,7.546485260770975,9.798820861678005,21,20,217,2,194
685,301,498,7.546485260770975,10.379319727891156,21,28,232,3,197
686,301,662,7.546485260770975,8.661043083900227,21,5,364,1,361
687,301,620,7.546485260770975,9.961360544217687,21,19,336,2,319
688,301,620,7.546485260770975,9.984580498866213,21,24,336,2,319
689,213,11,8.266303854875284,9.566621315192744,21,47,210,1,202
690,213,12,8.266303854875284,10.54185941043084,21,43,224,2,201
691,213,391,8.266303854875284,9.961360544217687,21,26,192,2,178
692,213,391,8.266303854875284,9.984580498866213,21,32,193,2,178
693,213,297,8.266303854875284,11.122358276643991,21,31,149,3,84
694,213,495,8.266303854875284,9.798820861678005,21,20,290,2,282
695,213,498,8.266303854875284,10.379319727891156,21,28,299,2,285
696,213,620,8.266303854875284,9.961360544217687,21,19,413,2,407
697,213,620,8.266303854875284,9.984580498866213,21,24,414,2,407
698,391,8,9.961360544217687,11.702857142857143,26,45,390,2,383
699,391,11,9.961360544217687,12.79419501133787,26,48,399,3,380
700,391,297,9.961360544217687,11.122358276643991,26,31,106,1,94
701,391,299,9.961360544217687,12.213696145124716,26,31,134,2,92
702,391,417,9.961360544217687,11.3081179138322,26,32,64,1,26
703,391,470,9.961360544217687,12.79419501133787,26,30,145,3,79
704,391,638,9.961360544217687,11.865396825396825,26,18,260,2,247
705,391,675,9.961360544217687,12.770975056689343,26,21,309,3,284
706,391,825,9.961360544217687,12.051156462585034,26,10,443,2,434
707,391,8,9.984580498866213,11.702857142857143,32,45,390,2,383
708,391,11,9.984580498866213,12.79419501133787,32,48,399,3,380
709,391,297,9.984580498866213,11.122358276643991,32,31,106,1,94
710,391,299,9.984580498866213,12.213696145124716,32,31,133,2,92
711,391,417,9.984580498866213,11.3081179138322,32,32,63,1,26
712,391,470,9.984580498866213,12.79419501133787,32,30,145,3,79
713,391,638,9.984580498866213,11.865396825396825,32,18,260,2,247
714,391,675,9.984580498866213,12.770975056689343,32,21,308,3,284
715,391,825,9.984580498866213,12.051156462585034,32,10,443,2,434
716,297,11,11.122358276643991,12.79419501133787,31,48,295,2,286
717,297,9,11.122358276643991,13.931972789115646,31,46,312,3,288
718,297,299,11.122358276643991,12.213696145124716,31,31,47,1,2
719,297,392,11.122358276643991,13.537233560090703,31,28,141,2,95
720,297,470,11.122358276643991,12.79419501133787,31,30,187,2,173
721,297,507,11.122358276643991,13.374693877551021,31,33,231,2,210
722,297,675,11.122358276643991,12.770975056689343,31,21,385,2,378
723,297,621,11.122358276643991,13.374693877551021,31,27,338,2,324
724,299,9,12.213696145124716,13.931972789115646,31,46,299,2,290
725,299,10,12.213696145124716,14.97687074829932,31,46,313,3,289
726,299,10,12.213696145124716,15.000090702947846,31,48,313,3,289
727,299,392,12.213696145124716,13.537233560090703,31,28,109,1,93
728,299,296,12.213696145124716,14.86077097505669,31,29,114,3,3
729,299,507,12.213696145124716,13.374693877551021,31,33,214,1,208
730,299,415,12.213696145124716,14.86077097505669,31,32,163,3,116
731,299,621,12.213696145124716,13.374693877551021,31,27,326,1,322
732,299,777,12.213696145124716,14.466031746031746,31,16,488,2,478
733,392,10,13.537233560090703,14.97687074829932,28,46,387,1,382
734,392,10,13.537233560090703,15.000090702947846,28,48,387,1,382
735,392,7,13.537233560090703,16.114648526077097,28,43,401,3,385
736,392,296,13.537233560090703,14.86077097505669,28,29,112,1,96
737,392,415,13.537233560090703,14.86077097505669,28,32,61,1,23
738,392,507,13.537233560090703,15.371609977324264,28,31,140,2,115
739,392,621,13.537233560090703,15.348390022675737,28,22,242,2,229
740,392,687,13.537233560090703,16.27718820861678,28,15,318,3,295
741,392,851,13.537233560090703,15.371609977324264,28,15,466,2,459
742,392,822,13.537233560090703,16.439727891156462,28,8,448,3,430
743,296,7,14.86077097505669,16.114648526077097,29,43,294,1,289
744,296,9,14.86077097505669,17.205986394557822,29,48,304,2,287
745,296,304,14.86077097505669,16.834467120181408,29,26,85,2,8
746,296,304,14.86077097505669,17.182766439909297,29,28,100,2,8
747,296,505,14.86077097505669,16.834467120181408,29,19,226,2,209
748,296,687,14.86077097505669,16.27718820861678,29,15,396,1,391
749,392,9,15.371609977324264,17.205986394557822,27,48,391,2,383
750,392,9,15.371609977324264,18.29732426303855,27,46,403,3,383
751,392,304,15.371609977324264,16.834467120181408,27,26,108,1,88
752,392,304,15.371609977324264,17.182766439909297,27,28,118,2,88
753,392,223,15.371609977324264,18.088344671201813,27,30,206,3,169
754,392,505,15.371609977324264,16.834467120181408,27,19,129,1,113
755,392,507,15.371609977324264,17.925804988662133,27,31,159,3,115
756,392,505,15.371609977324264,18.088344671201813,27,31,163,3,113
757,392,622,15.371609977324264,17.925804988662133,27,22,255,3,230
758,392,619,15.371609977324264,18.088344671201813,27,20,255,3,227
759,392,822,15.371609977324264,16.439727891156462,27,8,432,1,430
760,392,852,15.371609977324264,17.925804988662133,27,13,473,3,460
761,392,849,15.371609977324264,18.088344671201813,27,17,472,3,457
762,304,9,16.834467120181408,18.29732426303855,26,46,302,1,295
763,304,9,16.834467120181408,19.388662131519276,26,46,315,3,295
764,304,223,16.834467120181408,18.088344671201813,26,30,97,1,81
765,304,263,16.834467120181408,19.667301587301587,26,29,129,3,41
766,304,507,16.834467120181408,17.925804988662133,26,31,208,1,203
767,304,505,16.834467120181408,18.088344671201813,26,31,208,1,201
768,304,417,16.834467120181408,19.319002267573698,26,8,156,2,113
769,304,622,16.834467120181408,17.925804988662133,26,22,321,1,318
770,304,619,16.834467120181408,18.088344671201813,26,20,320,1,315
771,304,695,16.834467120181408,19.319002267573698,26,7,405,2,391
772,304,9,17.182766439909297,18.29732426303855,28,46,299,1,295
773,304,9,17.182766439909297,19.388662131519276,28,46,310,2,295
774,304,263,17.182766439909297,19.667301587301587,28,29,115,2,41
775,304,417,17.182766439909297,19.319002267573698,28,8,146,2,113
776,304,695,17.182766439909297,19.319002267573698,28,7,402,2,391
777,223,9,18.088344671201813,19.388662131519276,30,46,221,1,214
778,223,9,18.088344671201813,20.340680272108845,30,46,235,2,214
779,223,263,18.088344671201813,19.667301587301587,30,29,79,2,40
780,223,265,18.088344671201813,20.758639455782312,30,27,122,3,42
781,223,417,18.088344671201813,19.319002267573698,30,8,201,1,194
782,223,613,18.088344671201813,20.688979591836734,30,12,406,3,390
783,223,695,18.088344671201813,19.319002267573698,30,7,475,1,472
784,223,625,18.088344671201813,20.735419501133787,30,13,418,3,402
785,263,9,19.667301587301587,21.71065759637188,29,47,269,2,254
786,263,265,19.667301587301587,20.758639455782312,29,27,47,1,2
787,263,251,19.667301587301587,21.43201814058957,29,29,77,2,12
788,263,277,19.667301587301587,22.01251700680272,29,29,102,2,14
789,263,613,19.667301587301587,20.688979591836734,29,12,353,1,350
790,263,417,19.667301587301587,21.339138321995467,29,14,170,2,154
791,263,625,19.667301587301587,20.735419501133787,29,13,365,1,362
792,263,667,19.667301587301587,21.966077097505668,29,10,416,2,404
793,265,9,20.758639455782312,22.66267573696145,27,46,269,2,256
794,265,65,20.758639455782312,23.498594104308392,27,47,232,3,200
795,265,277,20.758639455782312,22.01251700680272,27,29,55,1,12
796,265,259,20.758639455782312,23.428934240362814,27,30,115,3,6
797,265,601,20.758639455782312,22.918095238095237,27,11,349,2,336
798,265,613,20.758639455782312,23.475374149659864,27,15,367,3,348
799,265,667,20.758639455782312,21.966077097505668,27,10,405,1,402
800,265,683,20.758639455782312,22.894875283446712,27,11,428,2,418
801,265,648,20.758639455782312,23.521814058956917,27,16,401,3,383
802,251,9,21.43201814058957,22.66267573696145,29,46,248,1,242
803,251,65,21.43201814058957,23.498594104308392,29,47,206,2,186
804,251,9,21.43201814058957,23.986213151927437,29,46,266,3,242
805,251,259,21.43201814058957,23.428934240362814,29,30,86,2,8
806,251,223,21.43201814058957,24.357732426303855,29,28,129,3,28
807,251,601,21.43201814058957,22.918095238095237,29,11,356,1,350
808,251,613,21.43201814058957,23.475374149659864,29,15,373,2,362
809,251,683,21.43201814058957,22.894875283446712,29,11,437,1,432
810,251,648,21.43201814058957,23.521814058956917,29,16,407,2,397
811,277,65,22.01251700680272,23.498594104308392,29,47,221,1,212
812,277,9,22.01251700680272,23.986213151927437,29,46,281,2,268
813,277,259,22.01251700680272,23.428934240362814,29,30,64,1,18
814,277,223,22.01251700680272,24.357732426303855,29,28,115,2,54
815,277,613,22.01251700680272,23.475374149659864,29,15,342,1,336
816,277,449,22.01251700680272,24.775691609977326,29,9,209,3,172
817,277,648,22.01251700680272,23.521814058956917,29,16,377,2,371
818,277,644,22.01251700680272,24.938231292517006,29,7,388,3,367
819,259,57,23.428934240362814,25.170430839002268,30,45,215,2,202
820,259,9,23.428934240362814,26.28498866213152,30,47,279,3,250
821,259,254,23.428934240362814,25.541950113378686,30,29,91,2,5
822,259,449,23.428934240362814,24.775691609977326,30,9,199,1,190
823,259,592,23.428934240362814,25.56517006802721,30,12,345,2,333
824,259,644,23.428934240362814,24.938231292517006,30,7,390,2,385
825,259,676,23.428934240362814,25.240090702947846,30,13,424,2,417
826,223,9,24.357732426303855,26.28498866213152,28,47,230,2,214
827,223,254,24.357732426303855,25.541950113378686,28,29,60,1,31
828,223,258,24.357732426303855,26.424308390022677,28,27,96,2,35
829,223,592,24.357732426303855,25.56517006802721,28,12,373,1,369
830,223,605,24.357732426303855,26.424308390022677,28,8,392,2,382
831,254,7,25.541950113378686,27.422766439909296,29,42,260,2,247
832,254,267,25.541950113378686,27.794285714285714,29,26,98,2,13
833,254,240,25.541950113378686,28.142585034013607,29,22,113,3,14
834,254,446,25.541950113378686,27.724625850340136,29,11,214,2,192
835,254,683,25.541950113378686,27.70140589569161,29,9,439,2,429
836,254,750,25.541950113378686,28.0497052154195,29,8,508,3,496
837,258,10,26.424308390022677,28.560544217687074,27,49,265,2,248
838,258,267,26.424308390022677,27.794285714285714,27,26,60,1,9
839,258,240,26.424308390022677,28.142585034013607,27,22,76,2,18
840,258,446,26.424308390022677,27.724625850340136,27,11,196,1,188
841,258,429,26.424308390022677,28.93206349206349,27,17,202,3,171
842,258,428,26.424308390022677,29.30358276643991,27,12,210,3,170
843,258,683,26.424308390022677,27.70140589569161,27,9,429,1,425
844,258,750,26.424308390022677,28.0497052154195,27,8,497,2,492
845,267,7,27.794285714285714,29.651882086167802,26,44,272,2,260
846,267,9,27.794285714285714,30.766439909297052,26,45,288,3,258
847,267,271,27.794285714285714,29.976961451247167,26,26,94,2,4
848,267,273,27.794285714285714,30.00018140589569,26,30,95,2,6
849,267,429,27.794285714285714,28.93206349206349,26,17,169,1,162
850,267,428,27.794285714285714,29.30358276643991,26,12,174,2,161
851,267,428,27.794285714285714,30.418140589569163,26,15,197,3,161
852,267,626,27.794285714285714,30.418140589569163,26,11,376,3,359
853,240,7,28.142585034013607,29.651882086167802,22,44,242,2,233
854,240,9,28.142585034013607,30.766439909297052,22,45,257,3,231
855,240,271,28.142585034013607,29.976961451247167,22,26,85,2,31
856,240,273,28.142585034013607,30.00018140589569,22,30,87,2,33
857,240,267,28.142585034013607,31.091519274376417,22,26,130,3,27
858,240,428,28.142585034013607,29.30358276643991,22,12,195,1,188
859,240,428,28.142585034013607,30.418140589569163,22,15,212,2,188
860,240,626,28.142585034013607,30.418140589569163,22,11,398,2,386
861,271,9,29.976961451247167,31.90421768707483,26,47,275,2,262
862,271,9,29.976961451247167,31.997097505668936,26,45,276,2,262
863,271,267,29.976961451247167,31.091519274376417,26,26,48,1,4
864,271,224,29.976961451247167,32.182857142857145,26,29,106,2,47
865,271,493,29.976961451247167,31.60235827664399,26,12,233,2,222
866,271,413,29.976961451247167,32.670476190476194,26,11,183,3,142
867,271,677,29.976961451247167,31.60235827664399,26,10,412,2,406
868,271,667,29.976961451247167,32.76335600907029,26,12,414,3,396
869,273,9,30.00018140589569,31.90421768707483,30,47,276,2,264
870,273,9,30.00018140589569,31.997097505668936,30,45,278,2,264
871,273,267,30.00018140589569,31.091519274376417,30,26,47,1,6
872,273,224,30.00018140589569,32.182857142857145,30,29,106,2,49
873,273,493,30.00018140589569,31.60235827664399,30,12,231,2,220
874,273,413,30.00018140589569,32.670476190476194,30,11,181,3,140
875,273,677,30.00018140589569,31.60235827664399,30,10,410,2,404
876,273,667,30.00018140589569,32.76335600907029,30,12,412,3,394
877,267,10,31.091519274376417,33.04199546485261,26,48,270,2,257
878,267,224,31.091519274376417,32.182857142857145,26,29,64,1,43
879,267,236,31.091519274376417,33.90113378684807,26,33,125,3,31
880,267,413,31.091519274376417,32.670476190476194,26,11,161,2,146
881,267,426,31.091519274376417,33.436734693877554,26,12,188,2,159
882,267,667,31.091519274376417,32.76335600907029,26,12,406,2,400
883,267,699,31.091519274376417,33.8314739229025,26,10,448,3,432
884,224,7,32.182857142857145,34.202993197278914,29,46,234,2,217
885,224,236,32.182857142857145,33.90113378684807,29,33,75,2,12
886,224,208,32.182857142857145,34.22621315192744,29,31,89,2,16
887,224,263,32.182857142857145,35.15501133786848,29,26,134,3,39
888,224,426,32.182857142857145,33.436734693877554,29,12,209,1,202
889,224,418,32.182857142857145,34.57451247165533,29,15,220,2,194
890,224,462,32.182857142857145,35.062131519274374,29,15,268,3,238
891,224,699,32.182857142857145,33.8314739229025,29,10,480,2,475
892,224,668,32.182857142857145,35.085351473922906,29,13,461,3,444
893,236,7,33.90113378684807,35.36399092970522,33,44,238,1,229
894,236,10,33.90113378684807,36.08380952380953,33,48,245,2,226
895,236,263,33.90113378684807,35.15501133786848,33,26,60,1,27
896,236,462,33.90113378684807,35.062131519274374,33,15,231,1,226
897,236,420,33.90113378684807,36.08380952380953,33,15,207,2,184
898,236,668,33.90113378684807,35.085351473922906,33,13,435,1,432
899,236,715,33.90113378684807,36.060589569160996,33,7,488,2,479
900,208,7,34.22621315192744,35.36399092970522,31,44,207,1,201
901,208,10,34.22621315192744,36.08380952380953,31,48,214,2,198
902,208,233,34.22621315192744,36.89650793650794,31,28,118,3,25
903,208,420,34.22621315192744,36.08380952380953,31,15,227,2,212
904,263,9,35.15501133786848,37.593106575963716,26,46,275,2,254
905,263,233,35.15501133786848,36.89650793650794,26,28,81,2,30
906,263,222,35.15501133786848,37.24480725623583,26,25,99,2,41
907,263,428,35.15501133786848,37.964625850340134,26,7,205,3,165
908,263,422,35.15501133786848,38.12716553287982,26,14,204,3,159
909,263,666,35.15501133786848,38.10394557823129,26,12,423,3,403
910,233,9,36.89650793650794,38.568344671201814,28,47,235,2,224
911,233,270,36.89650793650794,38.17360544217687,28,26,66,1,37
912,233,285,36.89650793650794,39.14884353741497,28,27,110,2,52
913,233,428,36.89650793650794,37.964625850340134,28,7,200,1,195
914,233,422,36.89650793650794,38.12716553287982,28,14,196,1,189
915,233,593,36.89650793650794,39.14884353741497,28,12,373,2,360
916,233,666,36.89650793650794,38.10394557823129,28,12,436,1,433
917,222,9,37.24480725623583,38.568344671201814,25,47,220,1,213
918,222,9,37.24480725623583,39.891882086167804,25,46,242,3,213
919,222,285,37.24480725623583,39.14884353741497,25,27,103,2,63
920,222,270,37.24480725623583,40.19374149659864,25,26,136,3,48
921,222,593,37.24480725623583,39.14884353741497,25,12,380,2,371
922,222,433,37.24480725623583,40.07764172335601,25,13,244,3,211
923,222,661,37.24480725623583,40.07764172335601,25,9,456,3,439
924,270,9,38.17360544217687,39.891882086167804,26,46,271,2,261
925,270,55,38.17360544217687,40.820680272108845,26,46,243,3,215
926,270,56,38.17360544217687,41.05287981859411,26,45,247,3,214
927,270,433,38.17360544217687,40.07764172335601,26,13,182,2,163
928,270,661,38.17360544217687,40.07764172335601,26,9,400,2,391
929,270,638,38.17360544217687,41.05287981859411,26,14,388,3,368
930,285,55,39.14884353741497,40.820680272108845,27,46,241,2,230
931,285,56,39.14884353741497,41.05287981859411,27,45,243,2,229
932,285,270,39.14884353741497,40.19374149659864,27,26,47,1,15
933,285,300,39.14884353741497,41.61015873015873,27,29,107,2,15
934,285,434,39.14884353741497,41.33151927437642,27,14,176,2,149
935,285,638,39.14884353741497,41.05287981859411,27,14,362,2,353
936,270,9,40.19374149659864,42.16743764172336,26,47,274,2,261
937,270,300,40.19374149659864,41.61015873015873,26,29,68,1,30
938,270,223,40.19374149659864,42.5621768707483,26,27,112,2,47
939,270,434,40.19374149659864,41.33151927437642,26,14,171,1,164
940,270,424,40.19374149659864,42.93369614512472,26,7,194,3,154
941,300,59,41.61015873015873,43.51419501133787,29,47,255,2,241
942,300,9,41.61015873015873,44.489433106575966,29,47,316,3,291
943,300,265,41.61015873015873,43.69995464852608,29,30,97,2,35
944,300,275,41.61015873015873,44.11791383219955,29,25,111,3,25
945,300,424,41.61015873015873,42.93369614512472,29,7,136,1,124
946,300,416,41.61015873015873,43.95537414965987,29,21,154,2,116
947,300,415,41.61015873015873,44.00181405895692,29,19,154,2,115
948,300,648,41.61015873015873,43.95537414965987,29,13,362,2,348
949,300,680,41.61015873015873,44.00181405895692,29,9,394,2,380
950,223,9,42.5621768707483,44.489433106575966,27,47,230,2,214
951,223,265,42.5621768707483,43.69995464852608,27,30,65,1,42
952,223,275,42.5621768707483,44.11791383219955,27,25,85,2,52
953,223,416,42.5621768707483,43.95537414965987,27,21,202,1,193
954,223,415,42.5621768707483,44.00181405895692,27,19,202,1,192
955,223,648,42.5621768707483,43.95537414965987,27,13,429,1,425
956,223,680,42.5621768707483,44.00181405895692,27,9,461,1,457
957,265,9,43.69995464852608,45.60399092970522,30,48,269,2,256
958,265,233,43.69995464852608,45.97551020408164,30,28,103,2,32
959,265,612,43.69995464852608,45.97551020408164,30,12,361,2,347
960,265,414,43.69995464852608,46.021950113378686,30,13,179,2,149
961,265,670,43.69995464852608,45.97551020408164,30,12,417,2,405
962,265,736,43.69995464852608,46.04517006802721,30,11,482,2,471
963,275,9,44.11791383219955,45.60399092970522,25,48,274,1,266
964,275,12,44.11791383219955,46.718548752834465,25,43,286,3,263
965,275,233,44.11791383219955,45.97551020408164,25,28,90,2,42
966,275,260,44.11791383219955,46.718548752834465,25,27,113,3,15
967,275,612,44.11791383219955,45.97551020408164,25,12,346,2,337
968,275,414,44.11791383219955,46.021950113378686,25,13,161,2,139
969,275,670,44.11791383219955,45.97551020408164,25,12,403,2,395
970,275,736,44.11791383219955,46.04517006802721,25,11,468,2,461
971,275,670,44.11791383219955,47.09006802721088,25,12,415,3,395
972,233,8,45.97551020408164,47.9027664399093,28,46,240,2,225
973,233,8,45.97551020408164,47.9956462585034,28,43,241,2,225
974,233,264,45.97551020408164,47.159727891156464,28,27,60,1,31
975,233,268,45.97551020408164,48.088526077097505,28,32,97,2,35
976,233,434,45.97551020408164,47.62412698412699,28,13,213,2,201
977,233,427,45.97551020408164,48.251065759637186,28,14,217,2,194
978,233,670,45.97551020408164,47.09006802721088,28,12,440,1,437
979,233,625,45.97551020408164,48.27428571428572,28,8,404,2,392
980,260,8,46.718548752834465,47.9027664399093,27,46,257,1,252
981,260,8,46.718548752834465,47.9956462585034,27,43,258,1,252
982,260,11,46.718548752834465,49.15664399092971,27,48,270,2,249
983,260,268,46.718548752834465,48.088526077097505,27,32,60,1,8
984,260,277,46.718548752834465,49.295963718820865,27,29,112,3,17
985,260,427,46.718548752834465,48.251065759637186,27,14,180,2,167
986,260,601,46.718548752834465,49.342403628117914,27,12,359,3,341
987,260,625,46.718548752834465,48.27428571428572,27,8,371,2,365
988,260,637,46.718548752834465,49.295963718820865,27,13,393,3,377
989,264,11,47.159727891156464,49.15664399092971,27,48,267,2,253
990,264,277,47.159727891156464,49.295963718820865,27,29,93,2,13
991,264,427,47.159727891156464,48.251065759637186,27,14,170,1,163
992,264,601,47.159727891156464,49.342403628117914,27,12,350,2,337
993,264,625,47.159727891156464,48.27428571428572,27,8,364,1,361
994,264,637,47.159727891156464,49.295963718820865,27,13,384,2,373
995,268,11,48.088526077097505,49.15664399092971,32,48,261,1,257
996,268,11,48.088526077097505,50.340861678004536,32,48,275,2,257
997,268,277,48.088526077097505,49.295963718820865,32,29,53,1,9
998,268,238,48.088526077097505,50.36408163265306,32,28,102,2,30
999,268,241,48.088526077097505,51.06068027210885,32,23,131,3,27
1000,268,601,48.088526077097505,49.342403628117914,32,12,337,1,333
1001,268,429,48.088526077097505,50.549841269841274,32,12,193,2,161
1002,268,637,48.088526077097505,49.295963718820865,32,13,373,1,369
1003,268,696,48.088526077097505,50.52662131519274,32,7,441,2,428
1004,277,11,49.295963718820865,50.340861678004536,29,48,270,1,266
1005,277,9,49.295963718820865,51.26965986394558,29,47,281,2,268
1006,277,238,49.295963718820865,50.36408163265306,29,28,60,1,39
1007,277,241,49.295963718820865,51.06068027210885,29,23,84,2,36
1008,277,263,49.295963718820865,52.22167800453515,29,26,127,3,14
1009,277,429,49.295963718820865,50.549841269841274,29,12,161,1,152
1010,277,449,49.295963718820865,51.66439909297052,29,10,200,2,172
1011,277,589,49.295963718820865,52.17523809523809,29,11,336,3,312
1012,277,696,49.295963718820865,50.52662131519274,29,7,422,1,419
1013,277,677,49.295963718820865,51.66439909297052,29,7,413,2,400
1014,277,673,49.295963718820865,52.17523809523809,29,12,415,3,396
1015,238,10,50.36408163265306,52.43065759637188,28,49,245,2,228
1016,238,263,50.36408163265306,52.22167800453515,28,26,84,2,25
1017,238,220,50.36408163265306,53.011156462585035,28,20,115,3,18
1018,238,449,50.36408163265306,51.66439909297052,28,10,218,1,211
1019,238,589,50.36408163265306,52.17523809523809,28,11,360,2,351
1020,238,425,50.36408163265306,53.173696145124715,28,13,223,3,187
1021,238,677,50.36408163265306,51.66439909297052,28,7,443,1,439
1022,238,673,50.36408163265306,52.17523809523809,28,12,442,2,435
1023,241,10,51.06068027210885,52.43065759637188,23,49,238,1,231
1024,241,11,51.06068027210885,53.96317460317461,23,48,262,3,230
1025,241,11,51.06068027210885,54.00961451247166,23,47,263,3,230
1026,241,263,51.06068027210885,52.22167800453515,23,26,55,1,22
1027,241,220,51.06068027210885,53.011156462585035,23,20,87,2,21
1028,241,589,51.06068027210885,52.17523809523809,23,11,351,1,348
1029,241,425,51.06068027210885,53.173696145124715,23,13,205,2,184
1030,241,673,51.06068027210885,52.17523809523809,23,12,435,1,432
1031,241,705,51.06068027210885,53.452335600907034,23,11,475,2,464
1032,263,11,52.22167800453515,53.96317460317461,26,48,263,2,252
1033,263,11,52.22167800453515,54.00961451247166,26,47,264,2,252
1034,263,256,52.22167800453515,54.96163265306122,26,23,118,3,7
1035,263,251,52.22167800453515,55.031292517006804,26,22,122,3,12
1036,263,705,52.22167800453515,53.452335600907034,26,11,445,1,442
1037,220,9,53.011156462585035,55.82077097505669,20,46,243,3,211
1038,220,256,53.011156462585035,54.96163265306122,20,23,91,2,36
1039,220,251,53.011156462585035,55.031292517006804,20,22,92,2,31
1040,220,513,53.011156462585035,55.35637188208617,20,21,310,2,293
1041,220,657,53.011156462585035,55.33315192743764,20,14,448,2,437
1042,256,7,54.96163265306122,56.93532879818594,23,44,263,2,249
1043,256,24,54.96163265306122,57.56226757369615,23,42,258,3,232
1044,256,328,54.96163265306122,56.540589569161,23,22,99,2,72
1045,256,265,54.96163265306122,57.14430839002268,23,31,94,2,9
1046,256,450,54.96163265306122,56.540589569161,23,12,206,2,194
1047,256,419,54.96163265306122,57.63192743764172,23,13,199,3,163
1048,256,628,54.96163265306122,56.540589569161,23,9,378,2,372
1049,251,7,55.031292517006804,56.93532879818594,22,44,257,2,244
1050,251,24,55.031292517006804,57.56226757369615,22,42,252,3,227
1051,251,328,55.031292517006804,56.540589569161,22,22,101,2,77
1052,251,265,55.031292517006804,57.14430839002268,22,31,92,2,14
1053,251,450,55.031292517006804,56.540589569161,22,12,209,2,199
1054,251,419,55.031292517006804,57.63192743764172,22,13,202,3,168
1055,251,628,55.031292517006804,56.540589569161,22,9,383,2,377
1056,328,24,56.540589569161,57.56226757369615,22,42,307,1,304
1057,328,10,56.540589569161,58.28208616780046,22,49,327,2,318
1058,328,7,56.540589569161,59.23410430839002,22,45,341,3,321
1059,328,246,56.540589569161,58.049886621315196,22,28,105,2,82
1060,328,419,56.540589569161,57.63192743764172,22,13,102,1,91
1061,328,429,56.540589569161,58.816145124716556,22,15,141,2,101
1062,328,784,56.540589569161,57.95700680272109,22,11,460,1,456
1063,328,669,56.540589569161,58.79292517006803,22,13,355,2,341
1064,265,10,57.14430839002268,58.28208616780046,31,49,260,1,255
1065,265,7,57.14430839002268,59.23410430839002,31,45,273,2,258
1066,265,271,57.14430839002268,59.90748299319728,31,31,119,3,6
1067,265,333,57.14430839002268,60.070022675736965,31,26,143,3,68
1068,265,429,57.14430839002268,58.816145124716556,31,15,179,2,164
1069,265,427,57.14430839002268,59.55918367346939,31,14,193,2,162
1070,265,669,57.14430839002268,58.79292517006803,31,13,410,2,404
1071,246,7,58.049886621315196,59.23410430839002,28,45,244,1,239
1072,246,10,58.049886621315196,60.32544217687075,28,49,256,2,236
1073,246,271,58.049886621315196,59.90748299319728,28,31,84,2,25
1074,246,333,58.049886621315196,60.070022675736965,28,26,123,2,87
1075,246,427,58.049886621315196,59.55918367346939,28,14,192,2,181
1076,246,607,58.049886621315196,60.557641723356014,28,11,377,3,361
1077,246,660,58.049886621315196,60.162902494331064,28,11,424,2,414
1078,271,7,59.90748299319728,61.46321995464853,31,44,272,2,264
1079,271,9,59.90748299319728,62.55455782312925,31,46,286,3,262
1080,271,230,59.90748299319728,61.9740589569161,31,30,98,2,41
1081,271,263,59.90748299319728,62.368798185941046,31,31,106,2,8
1082,271,605,59.90748299319728,61.648979591836735,31,14,342,2,334
1083,271,596,59.90748299319728,62.368798185941046,31,13,342,2,325
1084,271,736,59.90748299319728,61.648979591836735,31,16,471,2,465
1085,333,7,60.070022675736965,61.46321995464853,26,44,331,1,326
1086,333,9,60.070022675736965,62.55455782312925,26,46,341,2,324
1087,333,230,60.070022675736965,61.9740589569161,26,30,132,2,103
1088,333,263,60.070022675736965,62.368798185941046,26,31,121,2,70
1089,333,605,60.070022675736965,61.648979591836735,26,14,280,2,272
1090,333,596,60.070022675736965,62.368798185941046,26,13,281,2,263
1091,333,736,60.070022675736965,61.648979591836735,26,16,409,2,403
1092,333,789,60.070022675736965,62.80997732426304,26,11,471,3,456
1093,230,9,61.9740589569161,63.69233560090703,30,47,233,2,221
1094,230,56,61.9740589569161,64.06385487528345,30,45,196,2,174
1095,230,268,61.9740589569161,63.92453514739229,30,32,92,2,38
1096,230,247,61.9740589569161,64.15673469387755,30,28,96,2,17
1097,230,505,61.9740589569161,63.34403628117914,30,12,281,1,275
1098,230,604,61.9740589569161,64.71401360544218,30,16,392,3,374
1099,230,619,61.9740589569161,63.92453514739229,30,8,398,2,389
1100,230,644,61.9740589569161,64.7372335600907,30,18,431,3,414
1101,263,9,62.368798185941046,63.69233560090703,31,47,260,1,254
1102,263,56,62.368798185941046,64.06385487528345,31,45,219,2,207
1103,263,268,62.368798185941046,63.92453514739229,31,32,67,2,5
1104,263,247,62.368798185941046,64.15673469387755,31,28,79,2,16
1105,263,275,62.368798185941046,65.24807256235827,31,26,125,3,12
1106,263,604,62.368798185941046,64.71401360544218,31,16,356,2,341
1107,263,419,62.368798185941046,65.22485260770975,31,12,199,3,156
1108,263,619,62.368798185941046,63.92453514739229,31,8,362,2,356
1109,263,644,62.368798185941046,64.7372335600907,31,18,394,2,381
1110,263,741,62.368798185941046,65.24807256235827,31,10,494,3,478
1111,268,8,63.92453514739229,65.96789115646258,32,47,274,2,260
1112,268,8,63.92453514739229,65.99111111111111,32,46,275,2,260
1113,268,275,63.92453514739229,65.24807256235827,32,26,57,1,7
1114,268,278,63.92453514739229,66.38585034013606,32,31,106,2,10
1115,268,419,63.92453514739229,65.22485260770975,32,12,161,1,151
1116,268,429,63.92453514739229,66.73414965986395,32,17,201,3,161
1117,268,741,63.92453514739229,65.24807256235827,32,10,476,1,473
1118,268,667,63.92453514739229,66.38585034013606,32,10,413,2,399
1119,247,8,64.15673469387755,65.96789115646258,28,47,251,2,239
1120,247,8,64.15673469387755,65.99111111111111,28,46,252,2,239
1121,247,275,64.15673469387755,65.24807256235827,28,26,55,1,28
1122,247,278,64.15673469387755,66.38585034013606,28,31,101,2,31
1123,247,419,64.15673469387755,65.22485260770975,28,12,178,1,172
1124,247,429,64.15673469387755,66.73414965986395,28,17,213,3,182
1125,247,741,64.15673469387755,65.24807256235827,28,10,496,1,494
1126,247,667,64.15673469387755,66.38585034013606,28,10,431,2,420
1127,275,11,65.24807256235827,67.24498866213152,26,48,278,2,264
1128,275,278,65.24807256235827,66.38585034013606,26,31,49,1,3
1129,275,255,65.24807256235827,67.43074829931973,26,26,96,2,20
1130,275,429,65.24807256235827,66.73414965986395,26,17,167,1,154
1131,275,449,65.24807256235827,67.89514739229026,26,14,208,3,174
1132,275,667,65.24807256235827,66.38585034013606,26,10,395,1,392
1133,275,636,65.24807256235827,67.89514739229026,26,10,379,3,361
1134,278,11,66.38585034013606,68.28988662131519,31,48,279,2,267
1135,278,255,66.38585034013606,67.43074829931973,31,26,51,1,23
1136,278,241,66.38585034013606,68.61496598639457,31,28,103,2,37
1137,278,247,66.38585034013606,69.0097052154195,31,28,117,3,31
1138,278,449,66.38585034013606,67.89514739229026,31,14,183,2,171
1139,278,597,66.38585034013606,68.42920634920635,31,20,331,2,319
1140,278,609,66.38585034013606,69.24190476190476,31,10,353,3,331
1141,278,636,66.38585034013606,67.89514739229026,31,10,364,2,358
1142,278,627,66.38585034013606,68.42920634920635,31,16,360,2,349
1143,278,698,66.38585034013606,69.24190476190476,31,13,438,3,420
1144,255,9,67.43074829931973,69.40444444444445,26,47,260,2,246
1145,255,241,67.43074829931973,68.61496598639457,26,28,53,1,14
1146,255,247,67.43074829931973,69.0097052154195,26,28,68,2,8
1147,255,609,67.43074829931973,69.24190476190476,26,10,362,2,354
1148,255,698,67.43074829931973,69.24190476190476,26,13,450,2,443
1149,241,10,68.61496598639457,70.54222222222222,28,49,245,2,231
1150,241,270,68.61496598639457,70.5190022675737,28,29,87,2,29
1151,241,429,68.61496598639457,70.91374149659865,28,12,212,2,188
1152,247,10,69.0097052154195,70.54222222222222,28,49,246,2,237
1153,247,9,69.0097052154195,71.70321995464853,28,46,265,3,238
1154,247,270,69.0097052154195,70.5190022675737,28,29,69,2,23
1155,247,274,69.0097052154195,71.63356009070294,28,23,116,3,27
1156,247,429,69.0097052154195,70.91374149659865,28,12,200,2,182
1157,270,9,70.5190022675737,71.70321995464853,29,46,266,1,261
1158,270,9,70.5190022675737,72.79455782312925,29,47,279,2,261
1159,270,274,70.5190022675737,71.63356009070294,29,23,48,1,4
1160,270,224,70.5190022675737,72.98031746031747,29,17,116,2,46
1161,270,224,70.5190022675737,73.00353741496599,29,20,116,2,46
1162,274,9,71.63356009070294,72.79455782312925,23,47,270,1,265
1163,274,9,71.63356009070294,73.95555555555556,23,45,283,2,265
1164,274,224,71.63356009070294,72.98031746031747,23,17,77,1,50
1165,274,224,71.63356009070294,73.00353741496599,23,20,77,1,50
1166,274,506,71.63356009070294,74.32707482993197,23,9,259,3,232
1167,224,9,72.98031746031747,74.93079365079365,17,48,231,2,215
1168,224,9,72.98031746031747,75.00045351473923,17,45,232,2,215
1169,224,225,72.98031746031747,74.6985941043084,17,15,74,2,1
1170,224,230,72.98031746031747,75.04689342403628,17,24,89,2,6
1171,224,506,72.98031746031747,74.32707482993197,17,9,288,1,282
1172,224,449,72.98031746031747,75.44163265306122,17,13,249,2,225
1173,224,626,72.98031746031747,75.13977324263038,17,14,413,2,402
1174,224,9,73.00353741496599,74.93079365079365,20,48,230,2,215
1175,224,9,73.00353741496599,75.00045351473923,20,45,232,2,215
1176,224,225,73.00353741496599,74.6985941043084,20,15,73,2,1
1177,224,230,73.00353741496599,75.04689342403628,20,24,88,2,6
1178,224,506,73.00353741496599,74.32707482993197,20,9,288,1,282
1179,224,449,73.00353741496599,75.44163265306122,20,13,248,2,225
1180,224,626,73.00353741496599,75.13977324263038,20,14,412,2,402
1181,225,9,74.6985941043084,76.23111111111112,15,46,226,2,216
1182,225,9,74.6985941043084,77.22956916099774,15,46,242,3,216
1183,225,224,74.6985941043084,76.60263038548753,15,23,82,2,1
1184,225,237,74.6985941043084,77.39210884353741,15,23,117,3,12
1185,225,506,74.6985941043084,76.64907029478458,15,7,293,2,281
1186,225,612,74.6985941043084,77.2063492063492,15,18,402,3,387
1187,225,620,74.6985941043084,77.2063492063492,15,17,409,3,395
1188,230,9,75.04689342403628,76.23111111111112,24,46,227,1,221
1189,230,9,75.04689342403628,77.22956916099774,24,46,240,2,221
1190,230,224,75.04689342403628,76.60263038548753,24,23,67,2,6
1191,230,237,75.04689342403628,77.39210884353741,24,23,101,2,7
1192,230,506,75.04689342403628,76.64907029478458,24,7,284,2,276
1193,230,612,75.04689342403628,77.2063492063492,24,18,393,2,382
1194,230,620,75.04689342403628,77.2063492063492,24,17,401,2,390
1195,224,9,76.60263038548753,78.5298866213152,23,47,230,2,215
1196,224,219,76.60263038548753,78.80852607709751,23,27,95,2,5
1197,224,230,76.60263038548753,79.22648526077097,23,28,113,3,6
1198,224,578,76.60263038548753,78.7156462585034,23,18,366,2,354
1199,224,449,76.60263038548753,79.31936507936508,23,11,254,3,225
1200,224,627,76.60263038548753,78.69242630385487,23,19,413,2,403
1201,237,9,77.39210884353741,78.5298866213152,23,47,233,1,228
1202,237,12,77.39210884353741,79.6908843537415,23,45,246,2,225
1203,237,219,77.39210884353741,78.80852607709751,23,27,64,1,18
1204,237,230,77.39210884353741,79.22648526077097,23,28,79,2,7
1205,237,578,77.39210884353741,78.7156462585034,23,18,346,1,341
1206,237,449,77.39210884353741,79.31936507936508,23,11,228,2,212
1207,237,627,77.39210884353741,78.69242630385487,23,19,394,1,390
1208,219,9,78.80852607709751,80.8518820861678,27,46,228,2,210
1209,219,9,78.80852607709751,81.15374149659864,27,43,233,2,210
1210,219,322,78.80852607709751,80.96798185941043,27,25,139,2,103
1211,219,307,78.80852607709751,81.01442176870748,27,23,129,2,88
1212,219,606,78.80852607709751,80.99120181405895,27,19,398,2,387
1213,219,511,78.80852607709751,81.61814058956917,27,26,316,3,292
1214,219,668,78.80852607709751,80.99120181405895,27,21,459,2,449
1215,230,9,79.22648526077097,80.8518820861678,28,46,232,2,221
1216,230,9,79.22648526077097,81.15374149659864,28,43,236,2,221
1217,230,7,79.22648526077097,82.0128798185941,28,44,253,3,223
1218,230,322,79.22648526077097,80.96798185941043,28,25,119,2,92
1219,230,307,79.22648526077097,81.01442176870748,28,23,109,2,77
1220,230,262,79.22648526077097,82.0128798185941,28,17,124,3,32
1221,230,606,79.22648526077097,80.99120181405895,28,19,384,2,376
1222,230,511,79.22648526077097,81.61814058956917,28,26,299,2,281
1223,230,449,79.22648526077097,82.0128798185941,28,7,250,3,219
1224,230,668,79.22648526077097,80.99120181405895,28,21,445,2,438
1225,322,7,80.96798185941043,82.0128798185941,25,44,318,1,315
1226,322,10,80.96798185941043,83.15065759637189,25,48,326,2,312
1227,322,262,80.96798185941043,82.0128798185941,25,17,75,1,60
1228,322,209,80.96798185941043,83.08099773242631,25,27,145,2,113
1229,322,449,80.96798185941043,82.0128798185941,25,7,135,1,127
1230,322,506,80.96798185941043,83.89369614512472,25,9,223,3,184
1231,322,807,80.96798185941043,83.10421768707484,25,5,494,2,485
1232,307,10,81.01442176870748,83.15065759637189,23,48,311,2,297
1233,307,209,81.01442176870748,83.08099773242631,23,27,132,2,98
1234,307,506,81.01442176870748,83.89369614512472,23,9,234,3,199
1235,262,10,82.0128798185941,83.15065759637189,17,48,257,1,252
1236,262,7,82.0128798185941,84.28843537414966,17,44,273,2,255
1237,262,209,82.0128798185941,83.08099773242631,17,27,70,1,53
1238,262,205,82.0128798185941,84.8457142857143,17,28,135,3,57
1239,262,506,82.0128798185941,83.89369614512472,17,9,257,2,244
1240,262,427,82.0128798185941,84.63673469387756,17,9,200,3,165
1241,209,7,83.08099773242631,84.28843537414966,27,44,209,1,202
1242,209,9,83.08099773242631,85.37977324263039,27,46,223,2,200
1243,209,205,83.08099773242631,84.8457142857143,27,28,76,2,4
1244,209,313,83.08099773242631,85.33333333333333,27,28,142,2,104
1245,209,427,83.08099773242631,84.63673469387756,27,9,228,2,218
1246,209,505,83.08099773242631,85.1243537414966,27,20,309,2,296
1247,209,620,83.08099773242631,85.1243537414966,27,19,420,2,411
1248,205,9,84.8457142857143,86.54077097505669,28,47,209,2,196
1249,205,10,84.8457142857143,87.67854875283447,28,49,230,3,195
1250,205,220,84.8457142857143,86.86585034013605,28,29,88,2,15
1251,205,418,84.8457142857143,86.98195011337869,28,7,232,2,213
1252,205,602,84.8457142857143,87.07482993197279,28,15,408,2,397
1253,205,658,84.8457142857143,87.07482993197279,28,14,463,2,453
1254,313,9,85.33333333333333,86.54077097505669,28,47,308,1,304
1255,313,10,85.33333333333333,87.67854875283447,28,49,319,2,303
1256,313,10,85.33333333333333,88.09650793650793,28,47,326,3,303
1257,313,220,85.33333333333333,86.86585034013605,28,29,114,2,93
1258,313,227,85.33333333333333,87.98040816326531,28,29,143,3,86
1259,313,227,85.33333333333333,88.00362811791383,28,26,144,3,86
1260,313,418,85.33333333333333,86.98195011337869,28,7,127,2,105
1261,313,602,85.33333333333333,87.07482993197279,28,15,299,2,289
1262,313,479,85.33333333333333,88.05006802721088,28,12,203,3,166
1263,313,658,85.33333333333333,87.07482993197279,28,14,353,2,345
1264,313,710,85.33333333333333,88.05006802721088,28,12,414,3,397
1265,220,10,86.86585034013605,88.09650793650793,29,47,217,1,210
1266,220,227,86.86585034013605,87.98040816326531,29,29,49,1,7
1267,220,227,86.86585034013605,88.00362811791383,29,26,49,1,7
1268,220,221,86.86585034013605,89.00208616780046,29,21,92,2,1
1269,220,479,86.86585034013605,88.05006802721088,29,12,264,1,259
1270,220,511,86.86585034013605,89.16462585034014,29,19,307,2,291
1271,220,710,86.86585034013605,88.05006802721088,29,12,493,1,490
1272,220,700,86.86585034013605,89.1414058956916,29,15,490,2,480
1273,227,7,87.98040816326531,89.97732426303855,29,46,236,2,220
1274,227,10,87.98040816326531,90.72036281179139,29,49,247,3,217
1275,227,221,87.98040816326531,89.00208616780046,29,21,44,1,6
1276,227,281,87.98040816326531,90.00054421768708,29,17,102,2,54
1277,227,511,87.98040816326531,89.16462585034014,29,19,289,1,284
1278,227,449,87.98040816326531,90.00054421768708,29,9,238,2,222
1279,227,700,87.98040816326531,89.1414058956916,29,15,476,1,473
1280,227,675,87.98040816326531,90.72036281179139,29,8,463,3,448
1281,227,7,88.00362811791383,89.97732426303855,26,46,236,2,220
1282,227,10,88.00362811791383,90.72036281179139,26,49,247,3,217
1283,227,281,88.00362811791383,90.00054421768708,26,17,102,2,54
1284,227,511,88.00362811791383,89.16462585034014,26,19,288,1,284
1285,227,449,88.00362811791383,90.00054421768708,26,9,238,2,222
1286,227,700,88.00362811791383,89.1414058956916,26,15,476,1,473
1287,227,675,88.00362811791383,90.72036281179139,26,8,463,3,448
1288,221,10,89.00208616780046,90.72036281179139,21,49,224,2,211
1289,221,7,89.00208616780046,91.13832199546485,21,44,233,2,214
1290,221,300,89.00208616780046,91.34730158730159,21,22,128,2,79
1291,221,453,89.00208616780046,91.11510204081632,21,11,249,2,232
1292,221,675,89.00208616780046,90.72036281179139,21,8,460,2,454
1293,221,679,89.00208616780046,91.11510204081632,21,8,467,2,458
1294,281,7,90.00054421768708,91.13832199546485,17,44,278,1,274
1295,281,9,90.00054421768708,92.25287981859411,17,47,289,2,272
1296,281,300,90.00054421768708,91.34730158730159,17,22,61,1,19
1297,281,243,90.00054421768708,92.25287981859411,17,28,104,2,38
1298,281,453,90.00054421768708,91.11510204081632,17,11,179,1,172
1299,281,679,90.00054421768708,91.11510204081632,17,8,401,1,398
1300,300,9,91.34730158730159,93.29777777777778,22,46,303,2,291
1301,300,208,91.34730158730159,93.042358276644,22,39,117,2,92
1302,300,266,91.34730158730159,94.01759637188209,22,27,120,3,34
1303,300,450,91.34730158730159,93.80861678004536,22,11,184,2,150
1304,300,769,91.34730158730159,93.01913832199547,22,8,474,2,469
1305,300,640,91.34730158730159,94.20335600907029,22,11,362,3,340
1306,243,9,92.25287981859411,93.29777777777778,28,46,238,1,234
1307,243,9,92.25287981859411,94.57487528344672,28,45,254,2,234
1308,243,266,92.25287981859411,94.01759637188209,28,27,79,2,23
1309,243,450,92.25287981859411,93.80861678004536,28,11,218,2,207
1310,243,410,92.25287981859411,94.89995464852608,28,15,202,3,167
1311,243,640,92.25287981859411,94.20335600907029,28,11,406,2,397
1312,208,9,93.042358276644,94.57487528344672,39,45,210,2,199
1313,208,57,93.042358276644,95.29469387755103,39,45,179,2,151
1314,208,266,93.042358276644,95.94485260770975,39,28,138,3,58
1315,208,410,93.042358276644,94.89995464852608,39,15,217,2,202
1316,208,444,93.042358276644,95.94485260770975,39,9,267,3,236
1317,208,640,93.042358276644,94.20335600907029,39,11,435,1,432
1318,208,678,93.042358276644,95.31791383219955,39,10,480,2,470
1319,266,57,94.01759637188209,95.29469387755103,27,45,216,1,209
1320,266,9,94.01759637188209,96.8736507936508,27,48,285,3,257
1321,266,232,94.01759637188209,96.08417233560091,27,28,95,2,34
1322,266,444,94.01759637188209,95.94485260770975,27,9,196,2,178
1323,266,419,94.01759637188209,96.08417233560091,27,13,177,2,153
1324,266,678,94.01759637188209,95.31791383219955,27,10,416,1,412
1325,266,638,94.01759637188209,96.08417233560091,27,9,382,2,372
1326,266,56,95.94485260770975,97.80244897959184,28,45,225,2,210
1327,266,60,95.94485260770975,98.47582766439909,28,46,233,3,206
1328,266,229,95.94485260770975,97.98820861678004,28,25,95,2,37
1329,266,207,95.94485260770975,98.24362811791383,28,32,115,2,59
1330,266,427,95.94485260770975,97.2451700680272,28,9,170,1,161
1331,266,598,95.94485260770975,98.45260770975057,28,12,349,3,332
1332,266,628,95.94485260770975,98.45260770975057,28,15,378,3,362
1333,232,56,96.08417233560091,97.80244897959184,28,45,191,2,176
1334,232,60,96.08417233560091,98.47582766439909,28,46,200,2,172
1335,232,229,96.08417233560091,97.98820861678004,28,25,82,2,3
1336,232,207,96.08417233560091,98.24362811791383,28,32,96,2,25
1337,232,427,96.08417233560091,97.2451700680272,28,9,201,1,195
1338,232,598,96.08417233560091,98.45260770975057,28,12,380,2,366
1339,232,628,96.08417233560091,98.45260770975057,28,15,409,2,396
1340,229,9,97.98820861678004,99.14920634920635,25,46,226,1,220
1341,229,9,97.98820861678004,100.31020408163266,25,46,242,2,220
1342,229,256,97.98820861678004,99.26530612244898,25,25,61,1,27
1343,229,253,97.98820861678004,100.86748299319729,25,33,126,3,24
1344,229,598,97.98820861678004,99.26530612244898,25,10,373,1,369
1345,229,427,97.98820861678004,100.56562358276645,25,13,227,3,198
1346,229,627,97.98820861678004,99.26530612244898,25,10,402,1,398
1347,229,667,97.98820861678004,100.58884353741497,25,11,452,3,438
1348,207,9,98.24362811791383,100.31020408163266,32,46,217,2,198
1349,207,256,98.24362811791383,99.26530612244898,32,25,66,1,49
1350,207,253,98.24362811791383,100.86748299319729,32,33,122,3,46
1351,207,598,98.24362811791383,99.26530612244898,32,10,393,1,391
1352,207,427,98.24362811791383,100.56562358276645,32,13,242,2,220
1353,207,627,98.24362811791383,99.26530612244898,32,10,422,1,420
1354,207,667,98.24362811791383,100.58884353741497,32,11,471,2,460
1355,256,9,99.26530612244898,100.31020408163266,25,46,251,1,247
1356,256,6,99.26530612244898,101.40154195011338,25,45,266,2,250
1357,256,253,99.26530612244898,100.86748299319729,25,33,69,2,3
1358,256,265,99.26530612244898,101.40154195011338,25,34,92,2,9
1359,256,281,99.26530612244898,102.00526077097506,25,22,121,3,25
1360,256,427,99.26530612244898,100.56562358276645,25,13,180,1,171
1361,256,429,99.26530612244898,101.79628117913832,25,12,204,3,173
1362,256,667,99.26530612244898,100.58884353741497,25,11,415,1,411
1363,256,667,99.26530612244898,101.79628117913832,25,11,425,3,411
1364,253,8,100.86748299319729,102.5857596371882,33,46,256,2,245
1365,253,281,100.86748299319729,102.00526077097506,33,22,56,1,28
1366,253,429,100.86748299319729,102.95727891156463,33,13,198,2,176
1367,253,429,100.86748299319729,103.35201814058958,33,11,206,2,176
1368,253,653,100.86748299319729,102.88761904761905,33,11,409,2,400
1369,253,615,100.86748299319729,103.23591836734694,33,9,376,2,362
1370,265,8,101.40154195011338,102.5857596371882,34,46,262,1,257
1371,265,11,101.40154195011338,103.95573696145125,34,47,277,3,254
1372,265,276,101.40154195011338,103.95573696145125,34,27,111,3,11
1373,265,270,101.40154195011338,104.02539682539683,34,30,113,3,5
1374,265,429,101.40154195011338,102.95727891156463,34,13,177,2,164
1375,265,429,101.40154195011338,103.35201814058958,34,11,184,2,164
1376,265,653,101.40154195011338,102.88761904761905,34,11,393,1,388
1377,265,615,101.40154195011338,103.23591836734694,34,9,359,2,350
1378,281,11,102.00526077097506,103.95573696145125,22,47,283,2,270
1379,281,11,102.00526077097506,104.9774149659864,22,46,299,3,270
1380,281,276,102.00526077097506,103.95573696145125,22,27,84,2,5
1381,281,270,102.00526077097506,104.02539682539683,22,30,88,2,11
1382,281,429,102.00526077097506,103.35201814058958,22,11,159,1,148
1383,281,448,102.00526077097506,104.5362358276644,22,16,199,3,167
1384,281,615,102.00526077097506,103.23591836734694,22,9,338,1,334
1385,281,661,102.00526077097506,104.48979591836735,22,9,395,2,380
1386,276,11,103.95573696145125,104.9774149659864,27,46,269,1,265
1387,276,11,103.95573696145125,105.02385487528345,27,47,269,1,265
1388,276,9,103.95573696145125,105.99909297052154,27,45,281,2,267
1389,276,206,103.95573696145125,105.11673469387755,27,32,86,1,70
1390,276,248,103.95573696145125,105.99909297052154,27,25,92,2,28
1391,276,554,103.95573696145125,105.76689342403628,27,11,289,2,278
1392,276,438,103.95573696145125,106.88145124716553,27,6,205,3,162
1393,276,678,103.95573696145125,106.88145124716553,27,9,421,3,402
1394,270,9,104.02539682539683,105.99909297052154,30,45,274,2,261
1395,270,206,104.02539682539683,105.11673469387755,30,32,79,1,64
1396,270,248,104.02539682539683,105.99909297052154,30,25,88,2,22
1397,270,554,104.02539682539683,105.76689342403628,30,11,294,2,284
1398,270,438,104.02539682539683,106.88145124716553,30,6,208,3,168
1399,270,678,104.02539682539683,106.88145124716553,30,9,426,3,408
1400,206,7,105.11673469387755,107.16009070294785,32,43,218,2,199
1401,206,254,105.11673469387755,107.25297052154195,32,26,104,2,48
1402,206,438,105.11673469387755,106.88145124716553,32,6,244,2,232
1403,206,429,105.11673469387755,107.90312925170068,32,12,253,3,223
1404,206,678,105.11673469387755,106.88145124716553,32,9,478,2,472
1405,248,7,105.99909297052154,107.16009070294785,25,43,246,1,241
1406,248,11,105.99909297052154,108.66938775510204,25,47,263,3,237
1407,248,254,105.99909297052154,107.25297052154195,25,26,54,1,6
1408,248,262,105.99909297052154,108.25142857142858,25,21,98,2,14
1409,248,429,105.99909297052154,107.90312925170068,25,12,199,2,181
1410,254,11,107.25297052154195,108.66938775510204,26,47,251,1,243
1411,254,9,107.25297052154195,109.4356462585034,26,47,262,2,245
1412,254,238,107.25297052154195,109.69106575963718,26,30,106,2,16
1413,254,585,107.25297052154195,109.69106575963718,26,11,347,2,331
1414,254,657,107.25297052154195,109.69106575963718,26,8,416,2,403
1415,262,9,108.25142857142858,109.4356462585034,21,47,258,1,253
1416,262,9,108.25142857142858,110.5966439909297,21,45,272,2,253
1417,262,238,108.25142857142858,109.69106575963718,21,30,66,1,24
1418,262,224,108.25142857142858,110.96816326530613,21,27,123,3,38
1419,262,585,108.25142857142858,109.69106575963718,21,11,329,1,323
1420,262,433,108.25142857142858,110.8520634920635,21,10,204,3,171
1421,262,657,108.25142857142858,109.69106575963718,21,8,400,1,395
1422,238,7,109.69106575963718,111.73442176870749,30,43,247,2,231
1423,238,224,109.69106575963718,110.96816326530613,30,27,57,1,14
1424,238,257,109.69106575963718,111.92018140589569,30,25,98,2,19
1425,238,270,109.69106575963718,112.05950113378685,30,26,107,2,32
1426,238,433,109.69106575963718,110.8520634920635,30,10,201,1,195
1427,238,411,109.69106575963718,111.36290249433107,30,18,187,2,173
1428,238,476,109.69106575963718,112.33814058956916,30,9,264,3,238
1429,238,682,109.69106575963718,111.36290249433107,30,8,450,2,444
1430,238,651,109.69106575963718,112.33814058956916,30,6,428,3,413
1431,224,10,110.96816326530613,112.82575963718821,27,49,228,2,214
1432,224,10,110.96816326530613,113.05795918367347,27,47,232,2,214
1433,224,270,110.96816326530613,112.05950113378685,27,26,66,1,46
1434,224,257,110.96816326530613,113.12761904761905,27,25,99,2,33
1435,224,476,110.96816326530613,112.33814058956916,27,9,259,1,252
1436,224,429,110.96816326530613,113.6152380952381,27,18,235,3,205
1437,224,651,110.96816326530613,112.33814058956916,27,6,431,1,427
1438,224,628,110.96816326530613,113.6152380952381,27,14,420,3,404
1439,257,10,111.92018140589569,113.05795918367347,25,47,252,1,247
1440,257,43,111.92018140589569,114.6833560090703,25,46,245,3,214
1441,257,210,111.92018140589569,114.1492970521542,25,30,107,2,47
1442,257,429,111.92018140589569,113.6152380952381,25,18,187,2,172
1443,257,613,111.92018140589569,114.77623582766441,25,15,377,3,356
1444,257,628,111.92018140589569,113.6152380952381,25,14,378,2,371
1445,257,662,111.92018140589569,114.79945578231293,25,17,424,3,405
1446,270,43,112.05950113378685,114.6833560090703,26,46,254,3,227
1447,270,257,112.05950113378685,113.12761904761905,26,25,48,1,13
1448,270,210,112.05950113378685,114.1492970521542,26,30,108,2,60
1449,270,429,112.05950113378685,113.6152380952381,26,18,173,2,159
1450,270,613,112.05950113378685,114.77623582766441,26,15,362,3,343
1451,270,628,112.05950113378685,113.6152380952381,26,14,364,2,358
1452,270,662,112.05950113378685,114.79945578231293,26,17,409,3,392
1453,257,43,113.12761904761905,114.6833560090703,25,46,224,2,214
1454,257,10,113.12761904761905,115.1245351473923,25,48,262,2,247
1455,257,210,113.12761904761905,114.1492970521542,25,30,64,1,47
1456,257,265,113.12761904761905,115.14775510204082,25,30,87,2,8
1457,257,613,113.12761904761905,114.77623582766441,25,15,363,2,356
1458,257,428,113.12761904761905,115.8443537414966,25,11,207,3,171
1459,257,662,113.12761904761905,114.79945578231293,25,17,411,2,405
1460,257,616,113.12761904761905,115.63537414965987,25,7,375,3,359
1461,210,7,114.1492970521542,116.23909297052154,30,43,222,2,203
1462,210,240,114.1492970521542,116.23909297052154,30,29,95,2,30
1463,210,428,114.1492970521542,115.8443537414966,30,11,230,2,218
1464,210,429,114.1492970521542,116.58739229024944,30,14,243,2,219
1465,210,616,114.1492970521542,115.63537414965987,30,7,411,1,406
1466,210,651,114.1492970521542,116.56417233560092,30,9,453,2,441
1467,265,7,115.14775510204082,116.23909297052154,30,43,262,1,258
1468,265,9,115.14775510204082,117.3536507936508,30,47,273,2,256
1469,265,240,115.14775510204082,116.23909297052154,30,29,53,1,25
1470,265,223,115.14775510204082,117.539410430839,30,26,111,2,42
1471,265,429,115.14775510204082,116.58739229024944,30,14,175,1,164
1472,265,545,115.14775510204082,117.51619047619047,30,6,298,2,280
1473,265,651,115.14775510204082,116.56417233560092,30,9,391,1,386
1474,265,650,115.14775510204082,117.51619047619047,30,5,398,2,385
1475,240,9,116.23909297052154,117.3536507936508,29,47,236,1,231
1476,240,9,116.23909297052154,118.46820861678005,29,45,250,2,231
1477,240,223,116.23909297052154,117.539410430839,29,26,59,1,17
1478,240,270,116.23909297052154,118.74684807256236,29,31,112,3,30
1479,240,264,116.23909297052154,119.21124716553288,29,30,130,3,24
1480,240,545,116.23909297052154,117.51619047619047,29,6,310,1,305
1481,240,600,116.23909297052154,118.70040816326531,29,11,375,2,360
1482,240,650,116.23909297052154,117.51619047619047,29,5,414,1,410
1483,240,620,116.23909297052154,118.74684807256236,29,9,395,3,380
1484,223,12,117.539410430839,119.58276643990929,26,45,229,2,211
1485,223,270,117.539410430839,118.74684807256236,26,31,70,1,47
1486,223,264,117.539410430839,119.21124716553288,26,30,83,2,41
1487,223,600,117.539410430839,118.70040816326531,26,11,380,1,377
1488,223,449,117.539410430839,119.97750566893424,26,13,249,2,226
1489,223,449,117.539410430839,120.00072562358277,26,12,250,2,226
1490,223,620,117.539410430839,118.74684807256236,26,9,400,1,397
1491,270,48,118.74684807256236,120.92952380952381,31,46,241,2,222
1492,270,237,118.74684807256236,120.92952380952381,31,32,100,2,33
1493,270,243,118.74684807256236,121.46358276643991,31,28,120,3,27
1494,270,449,118.74684807256236,119.97750566893424,31,13,187,1,179
1495,270,449,118.74684807256236,120.00072562358277,31,12,187,1,179
1496,270,451,118.74684807256236,121.51002267573696,31,13,217,3,181
1497,270,747,118.74684807256236,120.37224489795919,31,7,482,2,477
1498,270,649,118.74684807256236,121.69578231292518,31,12,400,3,379
1499,264,48,119.21124716553288,120.92952380952381,30,46,228,2,216
1500,264,11,119.21124716553288,121.85832199546485,30,48,277,3,253
1501,264,11,119.21124716553288,122.02086167800454,30,46,280,3,253
1502,264,237,119.21124716553288,120.92952380952381,30,32,79,2,27
1503,264,243,119.21124716553288,121.46358276643991,30,28,99,2,21
1504,264,296,119.21124716553288,122.18340136054422,30,26,132,3,32
1505,264,451,119.21124716553288,121.51002267573696,30,13,212,2,187
1506,264,747,119.21124716553288,120.37224489795919,30,7,486,1,483
1507,264,649,119.21124716553288,121.69578231292518,30,12,400,2,385
1508,237,11,120.92952380952381,122.02086167800454,32,46,231,1,226
1509,237,11,120.92952380952381,123.15863945578232,32,48,246,2,226
1510,237,296,120.92952380952381,122.18340136054422,32,26,80,1,59
1511,237,219,120.92952380952381,123.73913832199547,32,31,122,3,18
1512,237,450,120.92952380952381,122.2530612244898,32,14,220,1,213
1513,237,596,120.92952380952381,123.87845804988662,32,13,381,3,359
1514,237,633,120.92952380952381,122.71746031746032,32,11,403,2,396
1515,237,659,120.92952380952381,123.8552380952381,32,15,440,3,422
1516,243,11,121.46358276643991,123.15863945578232,28,48,243,2,232
1517,243,9,121.46358276643991,124.11065759637188,28,46,260,3,234
1518,243,219,121.46358276643991,123.73913832199547,28,31,101,2,24
1519,243,596,121.46358276643991,123.87845804988662,28,13,368,2,353
1520,243,613,121.46358276643991,124.06421768707483,28,15,387,3,370
1521,243,633,121.46358276643991,122.71746031746032,28,11,394,1,390
1522,243,659,121.46358276643991,123.8552380952381,28,15,429,2,416
1523,243,620,121.46358276643991,124.01777777777778,28,16,393,3,377
1524,296,9,122.18340136054422,124.11065759637188,26,46,299,2,287
1525,296,219,122.18340136054422,123.73913832199547,26,31,102,2,77
1526,296,271,122.18340136054422,124.4821768707483,26,26,102,2,25
1527,296,219,122.18340136054422,125.08589569160998,26,29,147,3,77
1528,296,596,122.18340136054422,123.87845804988662,26,13,309,2,300
1529,296,613,122.18340136054422,124.06421768707483,26,15,327,2,317
1530,296,659,122.18340136054422,123.8552380952381,26,15,370,2,363
1531,296,620,122.18340136054422,124.01777777777778,26,16,333,2,324
1532,219,10,123.73913832199547,125.27165532879819,31,47,219,2,209
1533,219,9,123.73913832199547,126.4326530612245,31,46,240,3,210
1534,219,428,123.73913832199547,125.66639455782312,31,13,225,2,209
1535,219,429,123.73913832199547,126.03791383219955,31,9,232,2,210
1536,271,9,124.4821768707483,126.4326530612245,26,46,275,2,262
1537,271,9,124.4821768707483,127.08281179138322,26,39,285,3,262
1538,271,245,124.4821768707483,126.9667120181406,26,26,110,2,26
1539,271,212,124.4821768707483,127.36145124716553,26,26,137,3,59
1540,271,428,124.4821768707483,125.66639455782312,26,13,165,1,157
1541,271,429,124.4821768707483,126.03791383219955,26,9,172,2,158
1542,271,643,124.4821768707483,126.9667120181406,26,11,387,2,372
1543,271,638,124.4821768707483,127.01315192743765,26,6,383,3,367
1544,219,9,125.08589569160998,126.4326530612245,29,46,218,1,210
1545,219,9,125.08589569160998,127.08281179138322,29,39,227,2,210
1546,219,245,125.08589569160998,126.9667120181406,29,26,85,2,26
1547,219,212,125.08589569160998,127.36145124716553,29,26,98,2,7
1548,219,643,125.08589569160998,126.9667120181406,29,11,432,2,424
1549,219,638,125.08589569160998,127.01315192743765,29,6,427,2,419
1550,245,9,126.9667120181406,128.96362811791383,26,47,251,2,236
1551,245,9,126.9667120181406,129.01006802721088,26,46,252,2,236
1552,245,299,126.9667120181406,128.96362811791383,26,21,102,2,54
1553,245,300,126.9667120181406,129.24226757369615,26,23,112,2,55
1554,212,9,127.36145124716553,128.96362811791383,26,47,214,2,203
1555,212,9,127.36145124716553,129.01006802721088,26,46,215,2,203
1556,212,9,127.36145124716553,130.0085260770975,26,38,233,3,203
1557,212,299,127.36145124716553,128.96362811791383,26,21,111,2,87
1558,212,300,127.36145124716553,129.24226757369615,26,23,120,2,88
1559,299,9,128.96362811791383,130.0085260770975,21,38,293,1,290
1560,299,9,128.96362811791383,131.00698412698412,21,27,303,2,290
1561,300,9,129.24226757369615,131.00698412698412,23,27,301,2,291
1562,461,7,0.9287981859410431,2.670294784580499,12,44,460,2,454
1563,461,9,0.9287981859410431,3.7616326530612247,12,47,468,3,452
1564,461,251,0.9287981859410431,2.8792743764172335,12,27,226,2,210
1565,461,237,0.9287981859410431,3.01859410430839,12,30,241,2,224
1566,461,410,0.9287981859410431,2.8328344671201813,12,19,97,2,51
1567,461,410,0.9287981859410431,3.1579138321995464,12,17,109,2,51
1568,461,632,0.9287981859410431,2.36843537414966,12,11,182,1,171
1569,461,628,0.9287981859410431,3.4133333333333336,12,6,198,2,167
1570,410,9,1.9040362811791383,3.7616326530612247,10,47,409,2,401
1571,410,237,1.9040362811791383,3.01859410430839,10,30,180,1,173
1572,410,226,1.9040362811791383,4.156371882086168,10,15,208,2,184
1573,410,413,1.9040362811791383,4.551111111111111,10,7,114,3,3
1574,410,628,1.9040362811791383,3.4133333333333336,10,6,227,2,218
1575,410,615,1.9040362811791383,4.551111111111111,10,5,235,3,205
1576,410,14,2.8328344671201813,4.899410430839002,19,45,406,2,396
1577,410,56,2.8328344671201813,5.479909297052155,19,44,372,3,354
1578,410,226,2.8328344671201813,4.156371882086168,19,15,193,1,184
1579,410,240,2.8328344671201813,5.27092970521542,19,28,200,2,170
1580,410,413,2.8328344671201813,4.551111111111111,19,7,74,2,3
1581,410,415,2.8328344671201813,5.294149659863946,19,9,106,2,5
1582,410,615,2.8328344671201813,4.551111111111111,19,5,218,2,205
1583,410,662,2.8328344671201813,5.294149659863946,19,6,273,2,252
1584,410,14,3.1579138321995464,4.899410430839002,17,45,403,2,396
1585,410,56,3.1579138321995464,5.479909297052155,17,44,368,2,354
1586,410,12,3.1579138321995464,5.990748299319728,17,44,416,3,398
1587,410,240,3.1579138321995464,5.27092970521542,17,28,193,2,170
1588,410,235,3.1579138321995464,6.013968253968254,17,29,214,3,175
1589,410,413,3.1579138321995464,4.551111111111111,17,7,60,1,3
1590,410,415,3.1579138321995464,5.294149659863946,17,9,92,2,5
1591,410,451,3.1579138321995464,5.990748299319728,17,11,129,3,41
1592,410,615,3.1579138321995464,4.551111111111111,17,5,214,1,205
1593,410,662,3.1579138321995464,5.294149659863946,17,6,268,2,252
1594,413,12,4.551111111111111,5.990748299319728,7,44,406,1,401
1595,413,8,4.551111111111111,7.174965986394558,7,46,420,3,405
1596,413,235,4.551111111111111,6.013968253968254,7,29,189,1,178
1597,413,451,4.551111111111111,5.990748299319728,7,11,73,1,38
1598,413,639,4.551111111111111,6.780226757369615,7,8,246,2,226
1599,415,8,5.294149659863946,7.174965986394558,9,46,415,2,407
1600,415,301,5.294149659863946,7.546485260770975,9,21,150,2,114
1601,415,213,5.294149659863946,8.266303854875284,9,21,239,3,202
1602,415,430,5.294149659863946,7.546485260770975,9,10,98,2,15
1603,415,639,5.294149659863946,6.780226757369615,9,8,233,1,224
1604,451,8,5.990748299319728,7.174965986394558,11,46,446,1,443
1605,451,11,5.990748299319728,8.359183673469389,11,47,452,2,440
1606,451,301,5.990748299319728,7.546485260770975,11,21,164,2,150
1607,451,213,5.990748299319728,8.266303854875284,11,21,257,2,238
1608,451,430,5.990748299319728,7.546485260770975,11,10,70,2,21
1609,451,416,5.990748299319728,8.661043083900227,11,8,120,3,35
1610,451,662,5.990748299319728,8.661043083900227,11,5,240,3,211
1611,430,11,7.546485260770975,9.566621315192744,10,47,428,2,419
1612,430,391,7.546485260770975,9.961360544217687,10,26,111,2,39
1613,430,391,7.546485260770975,9.984580498866213,10,32,112,2,39
1614,430,416,7.546485260770975,8.661043083900227,10,8,50,1,14
1615,430,495,7.546485260770975,9.798820861678005,10,20,117,2,65
1616,430,498,7.546485260770975,10.379319727891156,10,28,140,3,68
1617,430,662,7.546485260770975,8.661043083900227,10,5,237,1,232
1618,430,620,7.546485260770975,9.961360544217687,10,19,217,2,190
1619,430,620,7.546485260770975,9.984580498866213,10,24,217,2,190
1620,430,829,7.546485260770975,9.798820861678005,10,15,411,2,399
1621,416,12,8.661043083900227,10.54185941043084,8,43,412,2,404
1622,416,391,8.661043083900227,9.961360544217687,8,26,61,1,25
1623,416,391,8.661043083900227,9.984580498866213,8,32,62,1,25
1624,416,297,8.661043083900227,11.122358276643991,8,31,159,2,119
1625,416,495,8.661043083900227,9.798820861678005,8,20,93,1,79
1626,416,498,8.661043083900227,10.379319727891156,8,28,110,2,82
1627,416,417,8.661043083900227,11.3081179138322,8,32,114,3,1
1628,416,620,8.661043083900227,9.961360544217687,8,19,212,1,204
1629,416,620,8.661043083900227,9.984580498866213,8,24,212,1,204
1630,416,829,8.661043083900227,9.798820861678005,8,15,416,1,413
1631,416,907,8.661043083900227,11.3081179138322,8,13,504,3,491
1632,495,8,9.798820861678005,11.702857142857143,20,45,494,2,487
1633,495,297,9.798820861678005,11.122358276643991,20,31,206,1,198
1634,495,299,9.798820861678005,12.213696145124716,20,31,222,2,196
1635,495,417,9.798820861678005,11.3081179138322,20,32,102,2,78
1636,495,638,9.798820861678005,11.865396825396825,20,18,168,2,143
1637,495,675,9.798820861678005,12.770975056689343,20,21,221,3,180
1638,495,907,9.798820861678005,11.3081179138322,20,13,417,2,412
1639,495,825,9.798820861678005,12.051156462585034,20,10,344,2,330
1640,498,8,10.379319727891156,11.702857142857143,28,45,493,1,490
1641,498,11,10.379319727891156,12.79419501133787,28,48,498,2,487
1642,498,299,10.379319727891156,12.213696145124716,28,31,214,2,199
1643,498,470,10.379319727891156,12.79419501133787,28,30,108,2,28
1644,498,638,10.379319727891156,11.865396825396825,28,18,154,1,140
1645,498,675,10.379319727891156,12.770975056689343,28,21,205,2,177
1646,498,825,10.379319727891156,12.051156462585034,28,10,335,2,327
1647,498,852,10.379319727891156,13.351473922902494,28,16,376,3,354
1648,417,11,11.3081179138322,12.79419501133787,32,48,411,1,406
1649,417,9,11.3081179138322,13.931972789115646,32,46,423,3,408
1650,417,392,11.3081179138322,13.537233560090703,32,28,99,2,25
1651,417,470,11.3081179138322,12.79419501133787,32,30,83,1,53
1652,417,507,11.3081179138322,13.374693877551021,32,33,127,2,90
1653,417,675,11.3081179138322,12.770975056689343,32,21,266,1,258
1654,417,621,11.3081179138322,13.374693877551021,32,27,223,2,204
1655,417,852,11.3081179138322,13.351473922902494,32,16,444,2,435
1656,470,9,12.79419501133787,13.931972789115646,30,46,464,1,461
1657,470,10,12.79419501133787,14.97687074829932,30,46,470,2,460
1658,470,10,12.79419501133787,15.000090702947846,30,48,470,2,460
1659,470,296,12.79419501133787,14.86077097505669,30,29,195,2,174
1660,470,392,12.79419501133787,15.371609977324264,30,27,136,3,78
1661,470,415,12.79419501133787,14.86077097505669,30,32,105,2,55
1662,470,507,12.79419501133787,15.371609977324264,30,31,117,3,37
1663,470,777,12.79419501133787,14.466031746031746,30,16,315,2,307
1664,470,621,12.79419501133787,15.348390022675737,30,22,187,3,151
1665,470,824,12.79419501133787,14.466031746031746,30,9,361,2,354
1666,470,851,12.79419501133787,15.371609977324264,30,15,397,3,381
1667,507,10,13.374693877551021,14.97687074829932,33,46,502,2,497
1668,507,10,13.374693877551021,15.000090702947846,33,48,502,2,497
1669,507,296,13.374693877551021,14.86077097505669,33,29,220,1,211
1670,507,392,13.374693877551021,15.371609977324264,33,27,144,2,115
1671,507,415,13.374693877551021,14.86077097505669,33,32,112,1,92
1672,507,777,13.374693877551021,14.466031746031746,33,16,274,1,270
1673,507,621,13.374693877551021,15.348390022675737,33,22,142,2,114
1674,507,687,13.374693877551021,16.27718820861678,33,15,219,3,180
1675,507,824,13.374693877551021,14.466031746031746,33,9,320,1,317
1676,507,851,13.374693877551021,15.371609977324264,33,15,355,2,344
1677,415,7,14.86077097505669,16.114648526077097,32,43,412,1,408
1678,415,9,14.86077097505669,17.205986394557822,32,48,418,2,406
1679,415,304,14.86077097505669,16.834467120181408,32,26,140,2,111
1680,415,304,14.86077097505669,17.182766439909297,32,28,149,2,111
1681,415,505,14.86077097505669,16.834467120181408,32,19,124,2,90
1682,415,687,14.86077097505669,16.27718820861678,32,15,279,1,272
1683,415,822,14.86077097505669,16.439727891156462,32,8,413,2,407
1684,507,9,15.371609977324264,17.205986394557822,31,48,504,2,498
1685,507,9,15.371609977324264,18.29732426303855,31,46,514,3,498
1686,507,304,15.371609977324264,16.834467120181408,31,26,213,1,203
1687,507,304,15.371609977324264,17.182766439909297,31,28,217,2,203
1688,507,223,15.371609977324264,18.088344671201813,31,30,307,3,284
1689,507,505,15.371609977324264,16.834467120181408,31,19,63,1,2
1690,507,505,15.371609977324264,18.088344671201813,31,31,117,3,2
1691,507,622,15.371609977324264,17.925804988662133,31,22,159,3,115
1692,507,619,15.371609977324264,18.088344671201813,31,20,162,3,112
1693,507,822,15.371609977324264,16.439727891156462,31,8,318,1,315
1694,507,852,15.371609977324264,17.925804988662133,31,13,362,3,345
1695,507,849,15.371609977324264,18.088344671201813,31,17,361,3,342
1696,505,9,16.834467120181408,18.29732426303855,19,46,500,1,496
1697,505,9,16.834467120181408,19.388662131519276,19,46,508,3,496
1698,505,223,16.834467120181408,18.088344671201813,19,30,287,1,282
1699,505,263,16.834467120181408,19.667301587301587,19,29,271,3,242
1700,505,507,16.834467120181408,17.925804988662133,19,31,47,1,2
1701,505,417,16.834467120181408,19.319002267573698,19,8,139,2,88
1702,505,622,16.834467120181408,17.925804988662133,19,22,126,1,117
1703,505,619,16.834467120181408,18.088344671201813,19,20,126,1,114
1704,505,695,16.834467120181408,19.319002267573698,19,7,218,2,190
1705,505,852,16.834467120181408,17.925804988662133,19,13,350,1,347
1706,505,849,16.834467120181408,18.088344671201813,19,17,348,1,344
1707,507,9,17.925804988662133,19.388662131519276,31,46,502,1,498
1708,507,9,17.925804988662133,20.340680272108845,31,46,509,2,498
1709,507,263,17.925804988662133,19.667301587301587,31,29,255,2,244
1710,507,265,17.925804988662133,20.758639455782312,31,27,271,3,242
1711,507,417,17.925804988662133,19.319002267573698,31,8,108,1,90
1712,507,613,17.925804988662133,20.688979591836734,31,12,159,3,106
1713,507,695,17.925804988662133,19.319002267573698,31,7,197,1,188
1714,507,625,17.925804988662133,20.735419501133787,31,13,169,3,118
1715,507,885,17.925804988662133,20.66575963718821,31,5,396,3,378
1716,505,9,18.088344671201813,19.388662131519276,31,46,499,1,496
1717,505,9,18.088344671201813,20.340680272108845,31,46,505,2,496
1718,505,263,18.088344671201813,19.667301587301587,31,29,251,2,242
1719,505,265,18.088344671201813,20.758639455782312,31,27,266,3,240
1720,505,417,18.088344671201813,19.319002267573698,31,8,103,1,88
1721,505,613,18.088344671201813,20.688979591836734,31,12,156,3,108
1722,505,695,18.088344671201813,19.319002267573698,31,7,197,1,190
1723,505,625,18.088344671201813,20.735419501133787,31,13,166,3,120
1724,505,885,18.088344671201813,20.66575963718821,31,5,396,3,380
1725,417,9,19.319002267573698,20.340680272108845,8,46,410,1,408
1726,417,9,19.319002267573698,21.71065759637188,8,47,421,2,408
1727,417,265,19.319002267573698,20.758639455782312,8,27,164,1,152
1728,417,251,19.319002267573698,21.43201814058957,8,29,189,2,166
1729,417,277,19.319002267573698,22.01251700680272,8,29,182,3,140
1730,417,613,19.319002267573698,20.688979591836734,8,12,205,1,196
1731,417,625,19.319002267573698,20.735419501133787,8,13,217,1,208
1732,417,667,19.319002267573698,21.966077097505668,8,10,275,3,250
1733,417,885,19.319002267573698,20.66575963718821,8,5,472,1,468
1734,613,277,20.688979591836734,22.01251700680272,12,29,341,1,336
1735,613,259,20.688979591836734,23.428934240362814,12,30,373,3,354
1736,613,601,20.688979591836734,22.918095238095237,12,11,97,2,12
1737,613,667,20.688979591836734,21.966077097505668,12,10,77,1,54
1738,613,683,20.688979591836734,22.894875283446712,12,11,118,2,70
1739,613,648,20.688979591836734,23.521814058956917,12,16,127,3,35
1740,417,9,21.339138321995467,22.66267573696145,14,46,412,1,408
1741,417,65,21.339138321995467,23.498594104308392,14,47,364,2,352
1742,417,9,21.339138321995467,23.986213151927437,14,46,424,3,408
1743,417,259,21.339138321995467,23.428934240362814,14,30,182,2,158
1744,417,601,21.339138321995467,22.918095238095237,14,11,196,2,184
1745,417,613,21.339138321995467,23.475374149659864,14,15,217,2,196
1746,417,683,21.339138321995467,22.894875283446712,14,11,274,2,266
1747,417,648,21.339138321995467,23.521814058956917,14,16,249,2,231
1748,601,223,22.918095238095237,24.357732426303855,11,28,383,1,378
1749,601,254,22.918095238095237,25.541950113378686,11,29,365,3,347
1750,601,449,22.918095238095237,24.775691609977326,11,9,172,2,152
1751,601,592,22.918095238095237,25.56517006802721,11,12,114,3,9
1752,601,644,22.918095238095237,24.938231292517006,11,7,97,2,43
1753,601,676,22.918095238095237,25.240090702947846,11,13,125,2,75
1754,613,254,23.475374149659864,25.541950113378686,15,29,370,2,359
1755,613,258,23.475374149659864,26.424308390022677,15,27,377,3,355
1756,613,449,23.475374149659864,24.775691609977326,15,9,173,1,164
1757,613,592,23.475374149659864,25.56517006802721,15,12,92,2,21
1758,613,605,23.475374149659864,26.424308390022677,15,8,127,3,8
1759,613,644,23.475374149659864,24.938231292517006,15,7,70,1,31
1760,613,676,23.475374149659864,25.240090702947846,15,13,99,2,63
1761,449,9,24.775691609977326,26.28498866213152,9,47,445,2,440
1762,449,7,24.775691609977326,27.422766439909296,9,42,456,3,442
1763,449,258,24.775691609977326,26.424308390022677,9,27,204,2,191
1764,449,605,24.775691609977326,26.424308390022677,9,8,171,2,156
1765,449,446,24.775691609977326,27.724625850340136,9,11,127,3,3
1766,449,683,24.775691609977326,27.70140589569161,9,9,266,3,234
1767,592,267,25.56517006802721,27.794285714285714,12,26,339,2,325
1768,592,240,25.56517006802721,28.142585034013607,12,22,369,3,352
1769,592,446,25.56517006802721,27.724625850340136,12,11,173,2,146
1770,592,683,25.56517006802721,27.70140589569161,12,9,129,2,91
1771,592,750,25.56517006802721,28.0497052154195,12,8,191,2,158
1772,592,831,25.56517006802721,27.794285714285714,12,6,258,2,239
1773,592,860,25.56517006802721,28.0497052154195,12,6,289,2,268
1774,605,267,26.424308390022677,27.794285714285714,8,26,343,1,338
1775,605,240,26.424308390022677,28.142585034013607,8,22,372,2,365
1776,605,446,26.424308390022677,27.724625850340136,8,11,169,1,159
1777,605,429,26.424308390022677,28.93206349206349,8,17,206,3,176
1778,605,428,26.424308390022677,29.30358276643991,8,12,216,3,177
1779,605,683,26.424308390022677,27.70140589569161,8,9,95,1,78
1780,605,750,26.424308390022677,28.0497052154195,8,8,161,2,145
1781,605,831,26.424308390022677,27.794285714285714,8,6,234,1,226
1782,605,860,26.424308390022677,28.0497052154195,8,6,264,2,255
1783,446,7,27.724625850340136,29.651882086167802,11,44,447,2,439
1784,446,271,27.724625850340136,29.976961451247167,11,26,200,2,175
1785,446,273,27.724625850340136,30.00018140589569,11,30,199,2,173
1786,446,429,27.724625850340136,28.93206349206349,11,17,55,1,17
1787,446,428,27.724625850340136,29.30358276643991,11,12,70,2,18
1788,446,428,27.724625850340136,30.418140589569163,11,15,117,3,18
1789,446,626,27.724625850340136,30.418140589569163,11,11,214,3,180
1790,429,9,28.93206349206349,30.766439909297052,17,45,427,2,420
1791,429,9,28.93206349206349,31.90421768707483,17,47,439,3,420
1792,429,271,28.93206349206349,29.976961451247167,17,26,164,1,158
1793,429,273,28.93206349206349,30.00018140589569,17,30,163,1,156
1794,429,267,28.93206349206349,31.091519274376417,17,26,187,2,162
1795,429,428,28.93206349206349,30.418140589569163,17,15,64,1,1
1796,429,493,28.93206349206349,31.60235827664399,17,12,132,3,64
1797,429,626,28.93206349206349,30.418140589569163,17,11,207,1,197
1798,429,677,28.93206349206349,31.60235827664399,17,10,273,3,248
1799,428,9,29.30358276643991,30.766439909297052,12,45,424,1,419
1800,428,9,29.30358276643991,31.90421768707483,12,47,434,3,419
1801,428,9,29.30358276643991,31.997097505668936,12,45,435,3,419
1802,428,267,29.30358276643991,31.091519274376417,12,26,178,2,161
1803,428,224,29.30358276643991,32.182857142857145,12,29,239,3,204
1804,428,493,29.30358276643991,31.60235827664399,12,12,118,2,65
1805,428,626,29.30358276643991,30.418140589569163,12,11,204,1,198
1806,428,677,29.30358276643991,31.60235827664399,12,10,268,2,249
1807,428,9,30.418140589569163,31.90421768707483,15,47,424,1,419
1808,428,9,30.418140589569163,31.997097505668936,15,45,424,2,419
1809,428,10,30.418140589569163,33.04199546485261,15,48,433,3,418
1810,428,224,30.418140589569163,32.182857142857145,15,29,218,2,204
1811,428,493,30.418140589569163,31.60235827664399,15,12,83,1,65
1812,428,413,30.418140589569163,32.670476190476194,15,11,98,2,15
1813,428,677,30.418140589569163,31.60235827664399,15,10,254,1,249
1814,428,667,30.418140589569163,32.76335600907029,15,12,259,2,239
1815,493,10,31.60235827664399,33.04199546485261,12,48,487,1,483
1816,493,7,31.60235827664399,34.202993197278914,12,46,499,3,486
1817,493,236,31.60235827664399,33.90113378684807,12,33,275,2,257
1818,493,208,31.60235827664399,34.22621315192744,12,31,307,3,285
1819,493,413,31.60235827664399,32.670476190476194,12,11,92,1,80
1820,493,426,31.60235827664399,33.436734693877554,12,12,104,2,67
1821,493,418,31.60235827664399,34.57451247165533,12,15,148,3,75
1822,493,667,31.60235827664399,32.76335600907029,12,12,181,1,174
1823,493,699,31.60235827664399,33.8314739229025,12,10,227,2,206
1824,493,777,31.60235827664399,34.22621315192744,12,9,306,3,284
1825,413,7,32.670476190476194,34.202993197278914,11,46,411,2,406
1826,413,7,32.670476190476194,35.36399092970522,11,44,422,3,406
1827,413,236,32.670476190476194,33.90113378684807,11,33,185,1,177
1828,413,208,32.670476190476194,34.22621315192744,11,31,216,2,205
1829,413,263,32.670476190476194,35.15501133786848,11,26,184,2,150
1830,413,418,32.670476190476194,34.57451247165533,11,15,82,2,5
1831,413,462,32.670476190476194,35.062131519274374,11,15,114,2,49
1832,413,699,32.670476190476194,33.8314739229025,11,10,290,1,286
1833,413,777,32.670476190476194,34.22621315192744,11,9,370,2,364
1834,413,668,32.670476190476194,35.085351473922906,11,13,275,2,255
1835,413,825,32.670476190476194,35.15501133786848,11,8,426,2,412
1836,426,7,33.436734693877554,35.36399092970522,12,44,427,2,419
1837,426,10,33.436734693877554,36.08380952380953,12,48,431,3,416
1838,426,263,33.436734693877554,35.15501133786848,12,26,179,2,163
1839,426,418,33.436734693877554,34.57451247165533,12,15,50,1,8
1840,426,462,33.436734693877554,35.062131519274374,12,15,79,2,36
1841,426,420,33.436734693877554,36.08380952380953,12,15,114,3,6
1842,426,668,33.436734693877554,35.085351473922906,12,13,252,2,242
1843,426,715,33.436734693877554,36.060589569160996,12,7,310,3,289
1844,426,825,33.436734693877554,35.15501133786848,12,8,406,2,399
1845,418,10,34.57451247165533,36.08380952380953,15,48,413,2,408
1846,418,233,34.57451247165533,36.89650793650794,15,28,210,2,185
1847,418,222,34.57451247165533,37.24480725623583,15,25,227,3,196
1848,418,420,34.57451247165533,36.08380952380953,15,15,65,2,2
1849,418,715,34.57451247165533,36.060589569160996,15,7,304,1,297
1850,462,10,35.062131519274374,36.08380952380953,15,48,454,1,452
1851,462,9,35.062131519274374,37.593106575963716,15,46,466,3,453
1852,462,233,35.062131519274374,36.89650793650794,15,28,242,2,229
1853,462,222,35.062131519274374,37.24480725623583,15,25,258,2,240
1854,462,420,35.062131519274374,36.08380952380953,15,15,61,1,42
1855,462,428,35.062131519274374,37.964625850340134,15,7,130,3,34
1856,420,9,36.08380952380953,37.593106575963716,15,46,416,2,411
1857,420,9,36.08380952380953,38.568344671201814,15,47,425,2,411
1858,420,222,36.08380952380953,37.24480725623583,15,25,204,1,198
1859,420,270,36.08380952380953,38.17360544217687,15,26,175,2,150
1860,420,428,36.08380952380953,37.964625850340134,15,7,81,2,8
1861,420,422,36.08380952380953,38.12716553287982,15,14,88,2,2
1862,420,666,36.08380952380953,38.10394557823129,15,12,261,2,246
1863,420,839,36.08380952380953,38.196825396825396,15,5,429,2,419
1864,428,9,37.964625850340134,39.891882086167804,7,46,427,2,419
1865,428,55,37.964625850340134,40.820680272108845,7,46,393,3,373
1866,428,285,37.964625850340134,39.14884353741497,7,27,152,1,143
1867,428,270,37.964625850340134,40.19374149659864,7,26,185,2,158
1868,428,593,37.964625850340134,39.14884353741497,7,12,173,1,165
1869,428,433,37.964625850340134,40.07764172335601,7,13,91,2,5
1870,428,783,37.964625850340134,39.14884353741497,7,13,359,1,355
1871,428,661,37.964625850340134,40.07764172335601,7,9,250,2,233
1872,428,842,37.964625850340134,39.10240362811791,7,10,417,1,414
1873,422,9,38.12716553287982,39.891882086167804,14,46,420,2,413
1874,422,55,38.12716553287982,40.820680272108845,14,46,385,3,367
1875,422,56,38.12716553287982,41.05287981859411,14,45,387,3,366
1876,422,285,38.12716553287982,39.14884353741497,14,27,144,1,137
1877,422,270,38.12716553287982,40.19374149659864,14,26,176,2,152
1878,422,593,38.12716553287982,39.14884353741497,14,12,177,1,171
1879,422,433,38.12716553287982,40.07764172335601,14,13,85,2,11
1880,422,783,38.12716553287982,39.14884353741497,14,13,364,1,361
1881,422,661,38.12716553287982,40.07764172335601,14,9,253,2,239
1882,422,638,38.12716553287982,41.05287981859411,14,14,250,3,216
1883,593,270,39.14884353741497,40.19374149659864,12,26,326,1,323
1884,593,300,39.14884353741497,41.61015873015873,12,29,312,2,293
1885,593,434,39.14884353741497,41.33151927437642,12,14,185,2,159
1886,593,638,39.14884353741497,41.05287981859411,12,14,94,2,45
1887,593,822,39.14884353741497,41.703038548752836,12,5,254,3,229
1888,433,9,40.07764172335601,42.16743764172336,13,47,433,2,424
1889,433,300,40.07764172335601,41.61015873015873,13,29,148,2,133
1890,433,223,40.07764172335601,42.5621768707483,13,27,236,2,210
1891,433,434,40.07764172335601,41.33151927437642,13,14,54,1,1
1892,433,424,40.07764172335601,42.93369614512472,13,7,123,3,9
1893,433,783,40.07764172335601,42.4692970521542,13,6,365,2,350
1894,433,822,40.07764172335601,41.703038548752836,13,5,395,2,389
1895,434,59,41.33151927437642,43.51419501133787,14,47,387,2,375
1896,434,223,41.33151927437642,42.5621768707483,14,27,218,1,211
1897,434,265,41.33151927437642,43.69995464852608,14,30,197,2,169
1898,434,275,41.33151927437642,44.11791383219955,14,25,199,3,159
1899,434,424,41.33151927437642,42.93369614512472,14,7,70,2,10
1900,434,416,41.33151927437642,43.95537414965987,14,21,114,3,18
1901,434,415,41.33151927437642,44.00181405895692,14,19,117,3,19
1902,434,783,41.33151927437642,42.4692970521542,14,6,352,1,349
1903,434,648,41.33151927437642,43.95537414965987,14,13,242,3,214
1904,434,680,41.33151927437642,44.00181405895692,14,9,272,3,246
1905,424,9,42.93369614512472,44.489433106575966,7,47,420,2,415
1906,424,9,42.93369614512472,45.60399092970522,7,48,431,3,415
1907,424,275,42.93369614512472,44.11791383219955,7,25,157,1,149
1908,424,416,42.93369614512472,43.95537414965987,7,21,45,1,8
1909,424,415,42.93369614512472,44.00181405895692,7,19,47,1,9
1910,424,648,42.93369614512472,43.95537414965987,7,13,228,1,224
1911,424,680,42.93369614512472,44.00181405895692,7,9,260,1,256
1912,416,9,43.95537414965987,45.60399092970522,21,48,413,2,407
1913,416,12,43.95537414965987,46.718548752834465,21,43,421,3,404
1914,416,233,43.95537414965987,45.97551020408164,21,28,203,2,183
1915,416,260,43.95537414965987,46.718548752834465,21,27,196,3,156
1916,416,612,43.95537414965987,45.97551020408164,21,12,214,2,196
1917,416,414,43.95537414965987,46.021950113378686,21,13,89,2,2
1918,416,670,43.95537414965987,45.97551020408164,21,12,268,2,254
1919,416,736,43.95537414965987,46.04517006802721,21,11,332,2,320
1920,415,9,44.00181405895692,45.60399092970522,19,48,412,2,406
1921,415,12,44.00181405895692,46.718548752834465,19,43,420,3,403
1922,415,233,44.00181405895692,45.97551020408164,19,28,201,2,182
1923,415,260,44.00181405895692,46.718548752834465,19,27,194,3,155
1924,415,612,44.00181405895692,45.97551020408164,19,12,215,2,197
1925,415,414,44.00181405895692,46.021950113378686,19,13,87,2,1
1926,415,670,44.00181405895692,45.97551020408164,19,12,269,2,255
1927,415,736,44.00181405895692,46.04517006802721,19,11,333,2,321
1928,612,264,45.97551020408164,47.159727891156464,12,27,352,1,348
1929,612,268,45.97551020408164,48.088526077097505,12,32,356,2,344
1930,612,434,45.97551020408164,47.62412698412699,12,13,192,2,178
1931,612,427,45.97551020408164,48.251065759637186,12,14,209,2,185
1932,612,670,45.97551020408164,47.09006802721088,12,12,75,1,58
1933,612,625,45.97551020408164,48.27428571428572,12,8,100,2,13
1934,414,8,46.021950113378686,47.9027664399093,13,46,414,2,406
1935,414,8,46.021950113378686,47.9956462585034,13,43,415,2,406
1936,414,264,46.021950113378686,47.159727891156464,13,27,158,1,150
1937,414,268,46.021950113378686,48.088526077097505,13,32,171,2,146
1938,414,434,46.021950113378686,47.62412698412699,13,13,72,2,20
1939,414,427,46.021950113378686,48.251065759637186,13,14,97,2,13
1940,414,670,46.021950113378686,47.09006802721088,13,12,260,1,256
1941,414,625,46.021950113378686,48.27428571428572,13,8,232,2,211
1942,434,11,47.62412698412699,49.15664399092971,13,48,428,2,423
1943,434,11,47.62412698412699,50.340861678004536,13,48,439,3,423
1944,434,277,47.62412698412699,49.295963718820865,13,29,173,2,157
1945,434,238,47.62412698412699,50.36408163265306,13,28,229,3,196
1946,434,601,47.62412698412699,49.342403628117914,13,12,183,2,167
1947,434,429,47.62412698412699,50.549841269841274,13,12,126,3,5
1948,434,637,47.62412698412699,49.295963718820865,13,13,215,2,203
1949,434,696,47.62412698412699,50.52662131519274,13,7,290,3,262
1950,427,11,48.251065759637186,50.340861678004536,14,48,426,2,416
1951,427,277,48.251065759637186,49.295963718820865,14,29,157,1,150
1952,427,238,48.251065759637186,50.36408163265306,14,28,210,2,189
1953,427,241,48.251065759637186,51.06068027210885,14,23,222,3,186
1954,427,601,48.251065759637186,49.342403628117914,14,12,180,1,174
1955,427,429,48.251065759637186,50.549841269841274,14,12,99,2,2
1956,427,637,48.251065759637186,49.295963718820865,14,13,215,1,210
1957,427,696,48.251065759637186,50.52662131519274,14,7,286,2,269
1958,601,238,49.342403628117914,50.36408163265306,12,28,366,1,363
1959,601,241,49.342403628117914,51.06068027210885,12,23,368,2,360
1960,601,263,49.342403628117914,52.22167800453515,12,26,360,3,338
1961,601,429,49.342403628117914,50.549841269841274,12,12,180,1,172
1962,601,449,49.342403628117914,51.66439909297052,12,10,182,2,152
1963,601,589,49.342403628117914,52.17523809523809,12,11,123,3,12
1964,601,696,49.342403628117914,50.52662131519274,12,7,108,1,95
1965,601,677,49.342403628117914,51.66439909297052,12,7,126,2,76
1966,601,673,49.342403628117914,52.17523809523809,12,12,142,3,72
1967,601,821,49.342403628117914,52.22167800453515,12,6,253,3,220
1968,429,10,50.549841269841274,52.43065759637188,12,49,427,2,419
1969,429,263,50.549841269841274,52.22167800453515,12,26,181,2,166
1970,429,220,50.549841269841274,53.011156462585035,12,20,234,2,209
1971,429,449,50.549841269841274,51.66439909297052,12,10,52,1,20
1972,429,589,50.549841269841274,52.17523809523809,12,11,175,2,160
1973,429,425,50.549841269841274,53.173696145124715,12,13,113,3,4
1974,429,677,50.549841269841274,51.66439909297052,12,7,253,1,248
1975,429,673,50.549841269841274,52.17523809523809,12,12,254,2,244
1976,429,705,50.549841269841274,53.452335600907034,12,11,303,3,276
1977,429,821,50.549841269841274,52.22167800453515,12,6,399,2,392
1978,449,11,51.66439909297052,53.96317460317461,10,48,449,2,438
1979,449,11,51.66439909297052,54.00961451247166,10,47,449,2,438
1980,449,220,51.66439909297052,53.011156462585035,10,20,236,1,229
1981,449,425,51.66439909297052,53.173696145124715,10,13,69,2,24
1982,449,705,51.66439909297052,53.452335600907034,10,11,267,2,256
1983,589,256,52.17523809523809,54.96163265306122,11,23,354,3,333
1984,589,251,52.17523809523809,55.031292517006804,11,22,360,3,338
1985,589,705,52.17523809523809,53.452335600907034,11,11,128,1,116
1986,425,9,53.173696145124715,55.82077097505669,13,46,431,3,416
1987,425,256,53.173696145124715,54.96163265306122,13,23,186,2,169
1988,425,251,53.173696145124715,55.031292517006804,13,22,192,2,174
1989,425,513,53.173696145124715,55.35637188208617,13,21,129,2,88
1990,425,657,53.173696145124715,55.33315192743764,13,14,250,2,232
1991,425,881,53.173696145124715,55.33315192743764,13,7,465,2,456
1992,513,24,55.35637188208617,57.56226757369615,21,42,498,2,489
1993,513,328,55.35637188208617,56.540589569161,21,22,192,1,185
1994,513,265,55.35637188208617,57.14430839002268,21,31,260,2,248
1995,513,246,55.35637188208617,58.049886621315196,21,28,291,3,267
1996,513,450,55.35637188208617,56.540589569161,21,12,81,1,63
1997,513,419,55.35637188208617,57.63192743764172,21,13,136,2,94
1998,513,628,55.35637188208617,56.540589569161,21,9,126,1,115
1999,513,784,55.35637188208617,57.95700680272109,21,11,293,3,271
2000,513,824,55.35637188208617,57.30684807256236,21,7,322,2,311
2001,450,24,56.540589569161,57.56226757369615,12,42,428,1,426
2002,450,10,56.540589569161,58.28208616780046,12,49,446,2,440
2003,450,7,56.540589569161,59.23410430839002,12,45,458,3,443
2004,450,246,56.540589569161,58.049886621315196,12,28,214,2,204
2005,450,419,56.540589569161,57.63192743764172,12,13,56,1,31
2006,450,429,56.540589569161,58.816145124716556,12,15,100,2,21
2007,450,784,56.540589569161,57.95700680272109,12,11,340,1,334
2008,450,669,56.540589569161,58.79292517006803,12,13,240,2,219
2009,450,839,56.540589569161,58.79292517006803,12,8,401,2,389
2010,419,7,57.63192743764172,59.23410430839002,13,45,418,2,412
2011,419,10,57.63192743764172,60.32544217687075,13,49,425,3,409
2012,419,271,57.63192743764172,59.90748299319728,13,31,178,2,148
2013,419,333,57.63192743764172,60.070022675736965,13,26,136,2,86
2014,419,429,57.63192743764172,58.816145124716556,13,15,52,1,10
2015,419,427,57.63192743764172,59.55918367346939,13,14,83,2,8
2016,419,607,57.63192743764172,60.557641723356014,13,11,226,3,188
2017,419,669,57.63192743764172,58.79292517006803,13,13,255,1,250
2018,419,811,57.63192743764172,59.55918367346939,13,10,401,2,392
2019,419,660,57.63192743764172,60.162902494331064,13,11,265,3,241
2020,419,839,57.63192743764172,58.79292517006803,13,8,423,1,420
2021,419,849,57.63192743764172,60.13968253968254,13,6,443,3,430
2022,429,10,58.816145124716556,60.32544217687075,15,49,424,2,419
2023,429,7,58.816145124716556,61.46321995464853,15,44,437,3,422
2024,429,271,58.816145124716556,59.90748299319728,15,31,165,1,158
2025,429,333,58.816145124716556,60.070022675736965,15,26,110,1,96
2026,429,607,58.816145124716556,60.557641723356014,15,11,193,2,178
2027,429,605,58.816145124716556,61.648979591836735,15,14,214,3,176
2028,429,660,58.816145124716556,60.162902494331064,15,11,238,1,231
2029,429,736,58.816145124716556,61.648979591836735,15,16,330,3,307
2030,429,849,58.816145124716556,60.13968253968254,15,6,424,1,420
2031,429,842,58.816145124716556,61.67219954648526,15,7,431,3,413
2032,427,7,59.55918367346939,61.46321995464853,14,44,428,2,420
2033,427,230,59.55918367346939,61.9740589569161,14,30,223,2,197
2034,427,263,59.55918367346939,62.368798185941046,14,31,204,3,164
2035,427,605,59.55918367346939,61.648979591836735,14,14,199,2,178
2036,427,596,59.55918367346939,62.368798185941046,14,13,208,3,169
2037,427,736,59.55918367346939,61.648979591836735,14,16,322,2,309
2038,427,842,59.55918367346939,61.67219954648526,14,7,425,2,415
2039,607,230,60.557641723356014,61.9740589569161,11,30,382,1,377
2040,607,263,60.557641723356014,62.368798185941046,11,31,353,2,344
2041,607,605,60.557641723356014,61.648979591836735,11,14,47,1,2
2042,607,596,60.557641723356014,62.368798185941046,11,13,79,2,11
2043,607,505,60.557641723356014,63.34403628117914,11,12,157,3,102
2044,607,736,60.557641723356014,61.648979591836735,11,16,137,1,129
2045,607,789,60.557641723356014,62.80997732426304,11,11,206,2,182
2046,607,842,60.557641723356014,61.67219954648526,11,7,240,1,235
2047,605,268,61.648979591836735,63.92453514739229,14,32,351,2,337
2048,605,247,61.648979591836735,64.15673469387755,14,28,374,3,358
2049,605,505,61.648979591836735,63.34403628117914,14,12,124,2,100
2050,605,789,61.648979591836735,62.80997732426304,14,11,191,1,184
2051,605,619,61.648979591836735,63.92453514739229,14,8,99,2,14
2052,596,268,62.368798185941046,63.92453514739229,13,32,335,2,328
2053,596,247,62.368798185941046,64.15673469387755,13,28,357,2,349
2054,596,275,62.368798185941046,65.24807256235827,13,26,344,3,321
2055,596,604,62.368798185941046,64.71401360544218,13,16,101,2,8
2056,596,419,62.368798185941046,65.22485260770975,13,12,216,3,177
2057,596,619,62.368798185941046,63.92453514739229,13,8,71,2,23
2058,596,644,62.368798185941046,64.7372335600907,13,18,113,2,48
2059,596,741,62.368798185941046,65.24807256235827,13,10,191,3,145
2060,596,827,62.368798185941046,64.7372335600907,13,9,253,2,231
2061,505,8,63.34403628117914,65.96789115646258,12,47,510,3,497
2062,505,8,63.34403628117914,65.99111111111111,12,46,510,3,497
2063,505,275,63.34403628117914,65.24807256235827,12,26,244,2,230
2064,505,604,63.34403628117914,64.71401360544218,12,16,115,1,99
2065,505,419,63.34403628117914,65.22485260770975,12,12,118,2,86
2066,505,644,63.34403628117914,64.7372335600907,12,18,151,1,139
2067,505,741,63.34403628117914,65.24807256235827,12,10,250,2,236
2068,505,827,63.34403628117914,64.7372335600907,12,9,328,1,322
2069,604,278,64.71401360544218,66.38585034013606,16,31,334,2,326
2070,604,255,64.71401360544218,67.43074829931973,16,26,368,3,349
2071,604,429,64.71401360544218,66.73414965986395,16,17,195,2,175
2072,604,667,64.71401360544218,66.38585034013606,16,10,96,2,63
2073,419,11,65.22485260770975,67.24498866213152,12,48,417,2,408
2074,419,278,65.22485260770975,66.38585034013606,12,31,150,1,141
2075,419,255,65.22485260770975,67.43074829931973,12,26,190,2,164
2076,419,429,65.22485260770975,66.73414965986395,12,17,66,2,10
2077,419,449,65.22485260770975,67.89514739229026,12,14,119,3,30
2078,419,667,65.22485260770975,66.38585034013606,12,10,253,1,248
2079,419,636,65.22485260770975,67.89514739229026,12,10,246,3,217
2080,429,11,66.73414965986395,68.28988662131519,17,48,423,2,418
2081,429,9,66.73414965986395,69.40444444444445,17,47,435,3,420
2082,429,241,66.73414965986395,68.61496598639457,17,28,205,2,188
2083,429,247,66.73414965986395,69.0097052154195,17,28,207,2,182
2084,429,449,66.73414965986395,67.89514739229026,17,14,54,1,20
2085,429,597,66.73414965986395,68.42920634920635,17,20,183,2,168
2086,429,609,66.73414965986395,69.24190476190476,17,10,210,3,180
2087,429,636,66.73414965986395,67.89514739229026,17,10,213,1,207
2088,429,627,66.73414965986395,68.42920634920635,17,16,211,2,198
2089,429,698,66.73414965986395,69.24190476190476,17,13,290,3,269
2090,429,835,66.73414965986395,68.70784580498866,17,8,415,2,406
2091,429,843,66.73414965986395,69.24190476190476,17,8,428,3,414
2092,449,9,67.89514739229026,69.40444444444445,14,47,445,2,440
2093,449,10,67.89514739229026,70.54222222222222,14,49,454,3,439
2094,449,247,67.89514739229026,69.0097052154195,14,28,208,1,202
2095,449,270,67.89514739229026,70.5190022675737,14,29,212,3,179
2096,449,609,67.89514739229026,69.24190476190476,14,10,170,1,160
2097,449,698,67.89514739229026,69.24190476190476,14,13,256,1,249
2098,449,790,67.89514739229026,70.56544217687075,14,5,360,3,341
2099,449,843,67.89514739229026,69.24190476190476,14,8,398,1,394
2100,597,270,68.42920634920635,70.5190022675737,20,29,339,2,327
2101,597,429,68.42920634920635,70.91374149659865,20,12,199,2,168
2102,597,790,68.42920634920635,70.56544217687075,20,5,214,2,193
2103,609,270,69.24190476190476,70.5190022675737,10,29,343,1,339
2104,609,274,69.24190476190476,71.63356009070294,10,23,350,2,335
2105,609,429,69.24190476190476,70.91374149659865,10,12,194,2,180
2106,609,790,69.24190476190476,70.56544217687075,10,5,190,1,181
2107,429,9,70.91374149659865,72.79455782312925,12,47,428,2,420
2108,429,224,70.91374149659865,72.98031746031747,12,17,223,2,205
2109,429,224,70.91374149659865,73.00353741496599,12,20,224,2,205
2110,506,9,74.32707482993197,76.23111111111112,9,46,504,2,497
2111,506,9,74.32707482993197,77.22956916099774,9,46,512,3,497
2112,506,224,74.32707482993197,76.60263038548753,9,23,299,2,282
2113,506,449,74.32707482993197,75.44163265306122,9,13,75,1,57
2114,506,612,74.32707482993197,77.2063492063492,9,18,163,3,106
2115,506,620,74.32707482993197,77.2063492063492,9,17,168,3,114
2116,506,822,74.32707482993197,77.2063492063492,9,11,339,3,316
2117,449,9,75.44163265306122,77.22956916099774,13,46,447,2,440
2118,449,224,75.44163265306122,76.60263038548753,13,23,230,1,225
2119,449,237,75.44163265306122,77.39210884353741,13,23,228,2,212
2120,449,506,75.44163265306122,76.64907029478458,13,7,77,1,57
2121,449,612,75.44163265306122,77.2063492063492,13,18,180,2,163
2122,449,620,75.44163265306122,77.2063492063492,13,17,187,2,171
2123,449,822,75.44163265306122,77.2063492063492,13,11,381,2,373
2124,506,9,76.64907029478458,78.5298866213152,7,47,504,2,497
2125,506,219,76.64907029478458,78.80852607709751,7,27,302,2,287
2126,506,230,76.64907029478458,79.22648526077097,7,28,297,3,276
2127,506,578,76.64907029478458,78.7156462585034,7,18,114,2,72
2128,506,449,76.64907029478458,79.31936507936508,7,11,128,3,57
2129,506,627,76.64907029478458,78.69242630385487,7,19,150,2,121
2130,506,844,76.64907029478458,78.69242630385487,7,12,349,2,338
2131,612,219,77.2063492063492,78.80852607709751,18,27,399,2,393
2132,612,230,77.2063492063492,79.22648526077097,18,28,392,2,382
2133,612,578,77.2063492063492,78.7156462585034,18,18,73,2,34
2134,612,449,77.2063492063492,79.31936507936508,18,11,187,2,163
2135,612,627,77.2063492063492,78.69242630385487,18,19,66,1,15
2136,612,844,77.2063492063492,78.69242630385487,18,12,241,1,232
2137,578,322,78.7156462585034,80.96798185941043,18,25,274,2,256
2138,578,307,78.7156462585034,81.01442176870748,18,23,289,2,271
2139,578,606,78.7156462585034,80.99120181405895,18,19,102,2,28
2140,578,511,78.7156462585034,81.61814058956917,18,26,142,3,67
2141,578,668,78.7156462585034,80.99120181405895,18,21,133,2,90
2142,578,771,78.7156462585034,81.61814058956917,18,20,230,3,193
2143,578,838,78.7156462585034,80.96798185941043,18,13,278,2,260
2144,578,860,78.7156462585034,81.61814058956917,18,10,308,3,282
2145,449,9,79.31936507936508,80.8518820861678,11,46,445,2,440
2146,449,9,79.31936507936508,81.15374149659864,11,43,447,2,440
2147,449,7,79.31936507936508,82.0128798185941,11,44,457,3,442
2148,449,322,79.31936507936508,80.96798185941043,11,25,145,2,127
2149,449,307,79.31936507936508,81.01442176870748,11,23,160,2,142
2150,449,262,79.31936507936508,82.0128798185941,11,17,220,3,187
2151,449,606,79.31936507936508,80.99120181405895,11,19,173,2,157
2152,449,511,79.31936507936508,81.61814058956917,11,26,117,2,62
2153,449,668,79.31936507936508,80.99120181405895,11,21,231,2,219
2154,449,771,79.31936507936508,81.61814058956917,11,20,337,2,322
2155,449,838,79.31936507936508,80.96798185941043,11,13,395,2,389
2156,449,860,79.31936507936508,81.61814058956917,11,10,423,2,411
2157,606,262,80.99120181405895,82.0128798185941,19,17,347,1,344
2158,606,209,80.99120181405895,83.08099773242631,19,27,407,2,397
2159,606,449,80.99120181405895,82.0128798185941,19,7,163,1,157
2160,606,506,80.99120181405895,83.89369614512472,19,9,160,3,100
2161,606,807,80.99120181405895,83.10421768707484,19,5,221,2,201
2162,511,209,81.61814058956917,83.08099773242631,26,27,309,1,302
2163,511,506,81.61814058956917,83.89369614512472,26,9,98,2,5
2164,511,807,81.61814058956917,83.10421768707484,26,5,303,1,296
2165,449,10,82.0128798185941,83.15065759637189,7,48,442,1,439
2166,449,7,82.0128798185941,84.28843537414966,7,44,453,2,442
2167,449,209,82.0128798185941,83.08099773242631,7,27,244,1,240
2168,449,205,82.0128798185941,84.8457142857143,7,28,273,3,244
2169,449,506,82.0128798185941,83.89369614512472,7,9,99,2,57
2170,449,427,82.0128798185941,84.63673469387756,7,9,115,3,22
2171,449,807,82.0128798185941,83.10421768707484,7,5,361,1,358
2172,449,819,82.0128798185941,84.89215419501134,7,8,390,3,370
2173,449,820,82.0128798185941,84.86893424036282,7,7,391,3,371
2174,506,9,83.89369614512472,85.37977324263039,9,46,501,1,497
2175,506,9,83.89369614512472,86.54077097505669,9,47,510,3,497
2176,506,313,83.89369614512472,85.33333333333333,9,28,203,1,193
2177,506,220,83.89369614512472,86.86585034013605,9,29,313,3,286
2178,506,505,83.89369614512472,85.1243537414966,9,20,53,1,1
2179,506,620,83.89369614512472,85.1243537414966,9,19,126,1,114
2180,506,816,83.89369614512472,86.84263038548752,9,7,335,3,310
2181,506,840,83.89369614512472,85.61197278911565,9,10,342,2,334
2182,506,829,83.89369614512472,86.84263038548752,9,6,347,3,323
2183,427,9,84.63673469387756,86.54077097505669,9,47,426,2,418
2184,427,220,84.63673469387756,86.86585034013605,9,29,228,2,207
2185,427,418,84.63673469387756,86.98195011337869,9,7,101,2,9
2186,427,602,84.63673469387756,87.07482993197279,9,15,204,2,175
2187,427,816,84.63673469387756,86.84263038548752,9,7,400,2,389
2188,427,658,84.63673469387756,87.07482993197279,9,14,254,2,231
2189,427,829,84.63673469387756,86.84263038548752,9,6,413,2,402
2190,427,834,84.63673469387756,87.09804988662131,9,9,421,2,407
2191,505,9,85.1243537414966,86.54077097505669,20,47,500,1,496
2192,505,10,85.1243537414966,87.67854875283447,20,49,507,3,495
2193,505,10,85.1243537414966,88.09650793650793,20,47,511,3,495
2194,505,220,85.1243537414966,86.86585034013605,20,29,295,2,285
2195,505,227,85.1243537414966,87.98040816326531,20,29,304,3,278
2196,505,227,85.1243537414966,88.00362811791383,20,26,304,3,278
2197,505,418,85.1243537414966,86.98195011337869,20,7,118,2,87
2198,505,602,85.1243537414966,87.07482993197279,20,15,128,2,97
2199,505,479,85.1243537414966,88.05006802721088,20,12,129,3,26
2200,505,816,85.1243537414966,86.84263038548752,20,7,320,2,311
2201,505,658,85.1243537414966,87.07482993197279,20,14,175,2,153
2202,505,710,85.1243537414966,88.05006802721088,20,12,241,3,205
2203,505,829,85.1243537414966,86.84263038548752,20,6,332,2,324
2204,505,834,85.1243537414966,87.09804988662131,20,9,340,2,329
2205,418,10,86.98195011337869,88.09650793650793,7,47,411,1,408
2206,418,227,86.98195011337869,88.00362811791383,7,26,196,1,191
2207,418,221,86.98195011337869,89.00208616780046,7,21,215,2,197
2208,418,479,86.98195011337869,88.05006802721088,7,12,76,1,61
2209,418,511,86.98195011337869,89.16462585034014,7,19,132,2,93
2210,418,710,86.98195011337869,88.05006802721088,7,12,296,1,292
2211,418,700,86.98195011337869,89.1414058956916,7,15,297,2,282
2212,418,831,86.98195011337869,89.1414058956916,7,9,423,2,413
2213,602,221,87.07482993197279,89.00208616780046,15,21,390,2,381
2214,602,281,87.07482993197279,90.00054421768708,15,17,345,3,321
2215,602,511,87.07482993197279,89.16462585034014,15,19,128,2,91
2216,602,449,87.07482993197279,90.00054421768708,15,9,198,3,153
2217,602,700,87.07482993197279,89.1414058956916,15,15,132,2,98
2218,602,831,87.07482993197279,89.1414058956916,15,9,246,2,229
2219,479,7,88.05006802721088,89.97732426303855,12,46,479,2,472
2220,479,10,88.05006802721088,90.72036281179139,12,49,483,3,469
2221,479,281,88.05006802721088,90.00054421768708,12,17,215,2,198
2222,479,511,88.05006802721088,89.16462585034014,12,19,58,1,32
2223,479,449,88.05006802721088,90.00054421768708,12,9,89,2,30
2224,479,700,88.05006802721088,89.1414058956916,12,15,226,1,221
2225,479,675,88.05006802721088,90.72036281179139,12,8,227,3,196
2226,479,831,88.05006802721088,89.1414058956916,12,9,355,1,352
2227,511,300,89.16462585034014,91.34730158730159,19,22,231,2,211
2228,511,453,89.16462585034014,91.11510204081632,19,11,102,2,58
2229,511,675,89.16462585034014,90.72036281179139,19,8,177,2,164
2230,511,679,89.16462585034014,91.11510204081632,19,8,188,2,168
2231,449,7,90.00054421768708,91.13832199546485,9,44,445,1,442
2232,449,9,90.00054421768708,92.25287981859411,9,47,451,2,440
2233,449,300,90.00054421768708,91.34730158730159,9,22,160,1,149
2234,449,243,90.00054421768708,92.25287981859411,9,28,228,2,206
2235,449,453,90.00054421768708,91.11510204081632,9,11,48,1,4
2236,449,679,90.00054421768708,91.11510204081632,9,8,235,1,230
2237,453,9,91.11510204081632,92.25287981859411,11,47,447,1,444
2238,453,9,91.11510204081632,93.29777777777778,11,46,454,2,444
2239,453,243,91.11510204081632,92.25287981859411,11,28,216,1,210
2240,453,208,91.11510204081632,93.042358276644,11,39,259,2,245
2241,453,266,91.11510204081632,94.01759637188209,11,27,225,3,187
2242,453,450,91.11510204081632,93.80861678004536,11,11,116,3,3
2243,453,769,91.11510204081632,93.01913832199547,11,8,326,2,316
2244,453,825,91.11510204081632,93.11201814058957,11,6,382,2,372
2245,450,57,93.80861678004536,95.29469387755103,11,45,398,1,393
2246,450,266,93.80861678004536,95.94485260770975,11,28,206,2,184
2247,450,232,93.80861678004536,96.08417233560091,11,28,239,2,218
2248,450,410,93.80861678004536,94.89995464852608,11,15,62,1,40
2249,450,444,93.80861678004536,95.94485260770975,11,9,92,2,6
2250,450,419,93.80861678004536,96.08417233560091,11,13,103,2,31
2251,450,678,93.80861678004536,95.31791383219955,11,10,237,2,228
2252,450,638,93.80861678004536,96.08417233560091,11,9,212,2,188
2253,410,9,94.89995464852608,96.8736507936508,15,48,410,2,401
2254,410,56,94.89995464852608,97.80244897959184,15,45,375,3,354
2255,410,266,94.89995464852608,95.94485260770975,15,28,151,1,144
2256,410,232,94.89995464852608,96.08417233560091,15,28,185,1,178
2257,410,444,94.89995464852608,95.94485260770975,15,9,56,1,34
2258,410,419,94.89995464852608,96.08417233560091,15,13,52,1,9
2259,410,427,94.89995464852608,97.2451700680272,15,9,102,2,17
2260,410,638,94.89995464852608,96.08417233560091,15,9,234,1,228
2261,444,56,95.94485260770975,97.80244897959184,9,45,396,2,388
2262,444,60,95.94485260770975,98.47582766439909,9,46,399,3,384
2263,444,229,95.94485260770975,97.98820861678004,9,25,232,2,215
2264,444,207,95.94485260770975,98.24362811791383,9,32,257,2,237
2265,444,427,95.94485260770975,97.2451700680272,9,9,59,1,17
2266,444,598,95.94485260770975,98.45260770975057,9,12,188,3,154
2267,444,628,95.94485260770975,98.45260770975057,9,15,213,3,184
2268,419,56,96.08417233560091,97.80244897959184,13,45,370,2,363
2269,419,60,96.08417233560091,98.47582766439909,13,46,373,2,359
2270,419,229,96.08417233560091,97.98820861678004,13,25,207,2,190
2271,419,207,96.08417233560091,98.24362811791383,13,32,232,2,212
2272,419,427,96.08417233560091,97.2451700680272,13,9,51,1,8
2273,419,598,96.08417233560091,98.45260770975057,13,12,206,2,179
2274,419,628,96.08417233560091,98.45260770975057,13,15,233,2,209
2275,427,60,97.2451700680272,98.47582766439909,9,46,371,1,367
2276,427,9,97.2451700680272,99.14920634920635,9,46,426,2,418
2277,427,256,97.2451700680272,99.26530612244898,9,25,192,2,171
2278,427,598,97.2451700680272,98.45260770975057,9,12,179,1,171
2279,427,598,97.2451700680272,99.26530612244898,9,10,192,2,171
2280,427,628,97.2451700680272,98.45260770975057,9,15,208,1,201
2281,427,627,97.2451700680272,99.26530612244898,9,10,218,2,200
2282,598,253,98.45260770975057,100.86748299319729,12,33,360,2,345
2283,598,265,98.45260770975057,101.40154195011338,12,34,356,3,333
2284,598,427,98.45260770975057,100.56562358276645,12,13,194,2,171
2285,598,667,98.45260770975057,100.58884353741497,12,11,115,2,69
2286,598,832,98.45260770975057,100.56562358276645,12,9,251,2,234
2287,598,253,99.26530612244898,100.86748299319729,10,33,352,2,345
2288,598,265,99.26530612244898,101.40154195011338,10,34,345,2,333
2289,598,281,99.26530612244898,102.00526077097506,10,22,338,3,317
2290,598,427,99.26530612244898,100.56562358276645,10,13,180,1,171
2291,598,429,99.26530612244898,101.79628117913832,10,12,201,3,169
2292,598,667,99.26530612244898,100.58884353741497,10,11,89,1,69
2293,598,667,99.26530612244898,101.79628117913832,10,11,129,3,69
2294,598,832,99.26530612244898,100.56562358276645,10,9,241,1,234
2295,427,8,100.56562358276645,102.5857596371882,13,46,428,2,419
2296,427,281,100.56562358276645,102.00526077097506,13,22,159,1,146
2297,427,429,100.56562358276645,101.79628117913832,13,12,53,1,2
2298,427,429,100.56562358276645,102.95727891156463,13,13,103,2,2
2299,427,429,100.56562358276645,103.35201814058958,13,11,120,3,2
2300,427,667,100.56562358276645,101.79628117913832,13,11,246,1,240
2301,427,653,100.56562358276645,102.88761904761905,13,11,247,2,226
2302,427,615,100.56562358276645,103.23591836734694,13,9,220,3,188
2303,429,11,101.79628117913832,103.95573696145125,12,47,428,2,418
2304,429,276,101.79628117913832,103.95573696145125,12,27,179,2,153
2305,429,270,101.79628117913832,104.02539682539683,12,30,186,2,159
2306,429,448,101.79628117913832,104.5362358276644,12,16,120,3,19
2307,429,653,101.79628117913832,102.88761904761905,12,11,229,1,224
2308,429,615,101.79628117913832,103.23591836734694,12,9,196,1,186
2309,429,661,101.79628117913832,104.48979591836735,12,9,259,3,232
2310,429,11,102.95727891156463,104.9774149659864,13,46,427,2,418
2311,429,11,102.95727891156463,105.02385487528345,13,47,427,2,418
2312,429,270,102.95727891156463,104.02539682539683,13,30,166,1,159
2313,429,206,102.95727891156463,105.11673469387755,13,32,242,2,223
2314,429,448,102.95727891156463,104.5362358276644,13,16,71,2,19
2315,429,554,102.95727891156463,105.76689342403628,13,11,174,3,125
2316,429,661,102.95727891156463,104.48979591836735,13,9,241,2,232
2317,429,11,103.35201814058958,104.9774149659864,11,46,424,2,418
2318,429,11,103.35201814058958,105.02385487528345,11,47,424,2,418
2319,429,9,103.35201814058958,105.99909297052154,11,45,435,3,420
2320,429,206,103.35201814058958,105.11673469387755,11,32,236,2,223
2321,429,248,103.35201814058958,105.99909297052154,11,25,214,3,181
2322,429,448,103.35201814058958,104.5362358276644,11,16,54,1,19
2323,429,554,103.35201814058958,105.76689342403628,11,11,163,2,125
2324,429,661,103.35201814058958,104.48979591836735,11,9,237,1,232
2325,448,9,104.5362358276644,105.99909297052154,16,45,443,1,439
2326,448,7,104.5362358276644,107.16009070294785,16,43,455,3,441
2327,448,248,104.5362358276644,105.99909297052154,16,25,210,1,200
2328,448,254,104.5362358276644,107.25297052154195,16,26,227,3,194
2329,448,554,104.5362358276644,105.76689342403628,16,11,119,1,106
2330,448,438,104.5362358276644,106.88145124716553,16,6,101,2,10
2331,448,678,104.5362358276644,106.88145124716553,16,9,251,2,230
2332,554,254,105.76689342403628,107.25297052154195,11,26,307,1,300
2333,554,262,105.76689342403628,108.25142857142858,11,21,311,2,292
2334,554,438,105.76689342403628,106.88145124716553,11,6,126,1,116
2335,554,429,105.76689342403628,107.90312925170068,11,12,155,2,125
2336,554,678,105.76689342403628,106.88145124716553,11,9,133,1,124
2337,438,11,106.88145124716553,108.66938775510204,6,47,434,2,427
2338,438,9,106.88145124716553,109.4356462585034,6,47,443,3,429
2339,438,262,106.88145124716553,108.25142857142858,6,21,186,1,176
2340,438,238,106.88145124716553,109.69106575963718,6,30,234,3,200
2341,438,429,106.88145124716553,107.90312925170068,6,12,45,1,9
2342,438,585,106.88145124716553,109.69106575963718,6,11,190,3,147
2343,438,657,106.88145124716553,109.69106575963718,6,8,250,3,219
2344,429,9,107.90312925170068,109.4356462585034,12,47,425,2,420
2345,429,9,107.90312925170068,110.5966439909297,12,45,436,3,420
2346,429,238,107.90312925170068,109.69106575963718,12,30,206,2,191
2347,429,585,107.90312925170068,109.69106575963718,12,11,174,2,156
2348,429,433,107.90312925170068,110.8520634920635,12,10,127,3,4
2349,429,657,107.90312925170068,109.69106575963718,12,8,241,2,228
2350,585,224,109.69106575963718,110.96816326530613,11,27,365,1,361
2351,585,257,109.69106575963718,111.92018140589569,11,25,342,2,328
2352,585,270,109.69106575963718,112.05950113378685,11,26,331,2,315
2353,585,433,109.69106575963718,110.8520634920635,11,10,160,1,152
2354,585,411,109.69106575963718,111.36290249433107,11,18,188,2,174
2355,585,476,109.69106575963718,112.33814058956916,11,9,158,3,109
2356,585,682,109.69106575963718,111.36290249433107,11,8,121,2,97
2357,585,651,109.69106575963718,112.33814058956916,11,6,132,3,66
2358,433,10,110.8520634920635,112.82575963718821,10,49,431,2,423
2359,433,10,110.8520634920635,113.05795918367347,10,47,434,2,423
2360,433,257,110.8520634920635,111.92018140589569,10,25,182,1,176
2361,433,270,110.8520634920635,112.05950113378685,10,26,171,1,163
2362,433,257,110.8520634920635,113.12761904761905,10,25,201,2,176
2363,433,476,110.8520634920635,112.33814058956916,10,9,77,1,43
2364,433,429,110.8520634920635,113.6152380952381,10,18,119,3,4
2365,433,651,110.8520634920635,112.33814058956916,10,6,227,1,218
2366,433,628,110.8520634920635,113.6152380952381,10,14,228,3,195
2367,411,10,111.36290249433107,112.82575963718821,18,49,406,1,401
2368,411,10,111.36290249433107,113.05795918367347,18,47,408,2,401
2369,411,257,111.36290249433107,113.12761904761905,18,25,172,2,154
2370,411,210,111.36290249433107,114.1492970521542,18,30,234,3,201
2371,411,429,111.36290249433107,113.6152380952381,18,18,99,2,18
2372,411,628,111.36290249433107,113.6152380952381,18,14,238,2,217
2373,476,43,112.33814058956916,114.6833560090703,9,46,445,2,433
2374,476,10,112.33814058956916,115.1245351473923,9,48,481,3,466
2375,476,210,112.33814058956916,114.1492970521542,9,30,277,2,266
2376,476,265,112.33814058956916,115.14775510204082,9,30,243,3,211
2377,476,429,112.33814058956916,113.6152380952381,9,18,72,1,47
2378,476,613,112.33814058956916,114.77623582766441,9,15,173,2,137
2379,476,628,112.33814058956916,113.6152380952381,9,14,162,1,152
2380,476,662,112.33814058956916,114.79945578231293,9,17,214,2,186
2381,476,838,112.33814058956916,114.77623582766441,9,11,377,2,362
2382,429,43,113.6152380952381,114.6833560090703,18,46,389,1,386
2383,429,10,113.6152380952381,115.1245351473923,18,48,424,2,419
2384,429,7,113.6152380952381,116.23909297052154,18,43,437,3,422
2385,429,265,113.6152380952381,115.14775510204082,18,30,177,2,164
2386,429,240,113.6152380952381,116.23909297052154,18,29,220,3,189
2387,429,613,113.6152380952381,114.77623582766441,18,15,191,1,184
2388,429,428,113.6152380952381,115.8443537414966,18,11,96,2,1
2389,429,662,113.6152380952381,114.79945578231293,18,17,239,1,233
2390,429,616,113.6152380952381,115.63537414965987,18,7,206,2,187
2391,429,651,113.6152380952381,116.56417233560092,18,9,256,3,222
2392,429,838,113.6152380952381,114.77623582766441,18,11,412,1,409
2393,613,240,114.77623582766441,116.23909297052154,15,29,378,1,373
2394,613,223,114.77623582766441,117.539410430839,15,26,408,3,390
2395,613,428,114.77623582766441,115.8443537414966,15,11,191,1,185
2396,613,429,114.77623582766441,116.58739229024944,15,14,200,2,184
2397,613,545,114.77623582766441,117.51619047619047,15,6,136,3,68
2398,613,651,114.77623582766441,116.56417233560092,15,9,86,2,38
2399,613,650,114.77623582766441,117.51619047619047,15,5,124,3,37
2400,428,9,115.8443537414966,117.3536507936508,11,47,424,2,419
2401,428,9,115.8443537414966,118.46820861678005,11,45,434,3,419
2402,428,223,115.8443537414966,117.539410430839,11,26,218,2,205
2403,428,270,115.8443537414966,118.74684807256236,11,31,201,3,158
2404,428,545,115.8443537414966,117.51619047619047,11,6,137,2,117
2405,428,600,115.8443537414966,118.70040816326531,11,11,211,3,172
2406,428,650,115.8443537414966,117.51619047619047,11,5,233,2,222
2407,428,620,115.8443537414966,118.74684807256236,11,9,229,3,192
2408,429,9,116.58739229024944,118.46820861678005,14,45,428,2,420
2409,429,270,116.58739229024944,118.74684807256236,14,31,184,2,159
2410,429,264,116.58739229024944,119.21124716553288,14,30,200,3,165
2411,429,600,116.58739229024944,118.70040816326531,14,11,194,2,171
2412,429,620,116.58739229024944,118.74684807256236,14,9,212,2,191
2413,429,730,116.58739229024944,119.51310657596372,14,13,326,3,301
2414,429,866,116.58739229024944,119.51310657596372,14,9,455,3,437
2415,545,270,117.51619047619047,118.74684807256236,6,31,280,1,275
2416,545,264,117.51619047619047,119.21124716553288,6,30,290,2,281
2417,545,600,117.51619047619047,118.70040816326531,6,11,75,1,55
2418,545,449,117.51619047619047,119.97750566893424,6,13,143,2,96
2419,545,449,117.51619047619047,120.00072562358277,6,12,144,2,96
2420,545,620,117.51619047619047,118.74684807256236,6,9,92,1,75
2421,545,730,117.51619047619047,119.51310657596372,6,13,204,2,185
2422,545,747,117.51619047619047,120.37224489795919,6,7,237,3,202
2423,545,866,117.51619047619047,119.51310657596372,6,9,332,2,321
2424,600,237,118.70040816326531,120.92952380952381,11,32,375,2,363
2425,600,243,118.70040816326531,121.46358276643991,11,28,376,3,357
2426,600,449,118.70040816326531,119.97750566893424,11,13,161,1,151
2427,600,449,118.70040816326531,120.00072562358277,11,12,161,1,151
2428,600,451,118.70040816326531,121.51002267573696,11,13,192,3,149
2429,600,747,118.70040816326531,120.37224489795919,11,7,164,2,147
2430,449,11,119.97750566893424,121.85832199546485,13,48,445,2,438
2431,449,11,119.97750566893424,122.02086167800454,13,46,447,2,438
2432,449,243,119.97750566893424,121.46358276643991,13,28,216,1,206
2433,449,296,119.97750566893424,122.18340136054422,13,26,180,2,153
2434,449,451,119.97750566893424,121.51002267573696,13,13,66,2,2
2435,449,450,119.97750566893424,122.2530612244898,13,14,98,2,1
2436,449,649,119.97750566893424,121.69578231292518,13,12,213,2,200
2437,449,633,119.97750566893424,122.71746031746032,13,11,219,3,184
2438,449,841,119.97750566893424,121.7190022675737,13,6,399,2,392
2439,449,11,120.00072562358277,121.85832199546485,12,48,445,2,438
2440,449,11,120.00072562358277,122.02086167800454,12,46,447,2,438
2441,449,243,120.00072562358277,121.46358276643991,12,28,215,1,206
2442,449,296,120.00072562358277,122.18340136054422,12,26,180,2,153
2443,449,451,120.00072562358277,121.51002267573696,12,13,65,2,2
2444,449,450,120.00072562358277,122.2530612244898,12,14,97,2,1
2445,449,649,120.00072562358277,121.69578231292518,12,12,213,2,200
2446,449,633,120.00072562358277,122.71746031746032,12,11,218,3,184
2447,449,841,120.00072562358277,121.7190022675737,12,6,399,2,392
2448,451,11,121.51002267573696,123.15863945578232,13,48,446,2,440
2449,451,9,121.51002267573696,124.11065759637188,13,46,456,3,442
2450,451,219,121.51002267573696,123.73913832199547,13,31,251,2,232
2451,451,271,121.51002267573696,124.4821768707483,13,26,221,3,180
2452,451,596,121.51002267573696,123.87845804988662,13,13,177,2,145
2453,451,613,121.51002267573696,124.06421768707483,13,15,196,3,162
2454,451,633,121.51002267573696,122.71746031746032,13,11,189,1,182
2455,451,659,121.51002267573696,123.8552380952381,13,15,231,2,208
2456,451,620,121.51002267573696,124.01777777777778,13,16,201,3,169
2457,450,9,122.2530612244898,124.11065759637188,14,46,448,2,441
2458,450,219,122.2530612244898,123.73913832199547,14,31,240,1,231
2459,450,271,122.2530612244898,124.4821768707483,14,26,203,2,179
2460,450,219,122.2530612244898,125.08589569160998,14,29,261,3,231
2461,450,596,122.2530612244898,123.87845804988662,14,13,162,2,146
2462,450,613,122.2530612244898,124.06421768707483,14,15,181,2,163
2463,450,659,122.2530612244898,123.8552380952381,14,15,220,2,209
2464,450,620,122.2530612244898,124.01777777777778,14,16,186,2,170
2465,450,911,122.2530612244898,124.90013605442176,14,7,475,3,461
2466,596,219,123.87845804988662,125.08589569160998,13,29,381,1,377
2467,596,428,123.87845804988662,125.66639455782312,13,13,185,2,168
2468,596,429,123.87845804988662,126.03791383219955,13,9,191,2,167
2469,596,911,123.87845804988662,124.90013605442176,13,7,318,1,315
2470,613,219,124.06421768707483,125.08589569160998,15,29,396,1,394
2471,613,245,124.06421768707483,126.9667120181406,15,26,389,3,368
2472,613,428,124.06421768707483,125.66639455782312,15,13,197,2,185
2473,613,429,124.06421768707483,126.03791383219955,15,9,203,2,184
2474,613,643,124.06421768707483,126.9667120181406,15,11,129,3,30
2475,613,638,124.06421768707483,127.01315192743765,15,6,129,3,25
2476,428,9,125.66639455782312,127.08281179138322,13,39,423,1,419
2477,428,245,125.66639455782312,126.9667120181406,13,26,191,1,183
2478,428,212,125.66639455782312,127.36145124716553,13,26,228,2,216
2479,428,643,125.66639455782312,126.9667120181406,13,11,222,1,215
2480,428,638,125.66639455782312,127.01315192743765,13,6,218,1,210
2481,429,9,126.03791383219955,127.08281179138322,9,39,422,1,420
2482,429,9,126.03791383219955,128.96362811791383,9,47,438,3,420
2483,429,9,126.03791383219955,129.01006802721088,9,46,439,3,420
2484,429,212,126.03791383219955,127.36145124716553,9,26,224,1,217
2485,429,299,126.03791383219955,128.96362811791383,9,21,181,3,130
2486,685,237,1.8808163265306124,3.01859410430839,7,30,451,1,448
2487,685,226,1.8808163265306124,4.156371882086168,7,15,469,2,459
2488,685,410,1.8808163265306124,3.1579138321995464,7,17,280,1,275
2489,685,413,1.8808163265306124,4.551111111111111,7,7,295,3,272
2490,685,628,1.8808163265306124,3.4133333333333336,7,6,87,2,57
2491,685,615,1.8808163265306124,4.551111111111111,7,5,135,3,70
2492,632,226,2.36843537414966,4.156371882086168,11,15,413,2,406
2493,632,240,2.36843537414966,5.27092970521542,11,28,411,3,392
2494,632,413,2.36843537414966,4.551111111111111,11,7,238,2,219
2495,632,415,2.36843537414966,5.294149659863946,11,9,251,3,217
2496,632,628,2.36843537414966,3.4133333333333336,11,6,45,1,4
2497,632,615,2.36843537414966,4.551111111111111,11,5,96,2,17
2498,632,662,2.36843537414966,5.294149659863946,11,6,130,3,30
2499,628,240,3.4133333333333336,5.27092970521542,6,28,396,2,388
2500,628,235,3.4133333333333336,6.013968253968254,6,29,409,3,393
2501,628,413,3.4133333333333336,4.551111111111111,6,7,221,1,215
2502,628,415,3.4133333333333336,5.294149659863946,6,9,228,2,213
2503,628,451,3.4133333333333336,5.990748299319728,6,11,209,3,177
2504,628,615,3.4133333333333336,4.551111111111111,6,5,51,1,13
2505,628,662,3.4133333333333336,5.294149659863946,6,6,88,2,34
2506,615,235,4.551111111111111,6.013968253968254,5,29,385,1,380
2507,615,451,4.551111111111111,5.990748299319728,5,11,175,1,164
2508,615,639,4.551111111111111,6.780226757369615,5,8,99,2,24
2509,662,301,5.294149659863946,7.546485260770975,6,21,374,2,361
2510,662,213,5.294149659863946,8.266303854875284,6,21,467,3,449
2511,662,430,5.294149659863946,7.546485260770975,6,10,251,2,232
2512,662,639,5.294149659863946,6.780226757369615,6,8,68,1,23
2513,639,213,6.780226757369615,8.266303854875284,8,21,431,1,426
2514,639,416,6.780226757369615,8.661043083900227,8,8,237,2,223
2515,639,662,6.780226757369615,8.661043083900227,8,5,84,2,23
2516,662,391,8.661043083900227,9.961360544217687,5,26,277,1,271
2517,662,391,8.661043083900227,9.984580498866213,5,32,277,1,271
2518,662,297,8.661043083900227,11.122358276643991,5,31,380,2,365
2519,662,495,8.661043083900227,9.798820861678005,5,20,174,1,167
2520,662,498,8.661043083900227,10.379319727891156,5,28,180,2,164
2521,662,417,8.661043083900227,11.3081179138322,5,32,270,3,245
2522,662,620,8.661043083900227,9.961360544217687,5,19,70,1,42
2523,662,620,8.661043083900227,9.984580498866213,5,24,71,1,42
2524,662,829,8.661043083900227,9.798820861678005,5,15,174,1,167
2525,662,934,8.661043083900227,10.356099773242631,5,15,282,2,272
2526,662,907,8.661043083900227,11.3081179138322,5,13,270,3,245
2527,620,297,9.961360544217687,11.122358276643991,19,31,327,1,323
2528,620,299,9.961360544217687,12.213696145124716,19,31,335,2,321
2529,620,417,9.961360544217687,11.3081179138322,19,32,211,1,203
2530,620,470,9.961360544217687,12.79419501133787,19,30,193,3,150
2531,620,638,9.961360544217687,11.865396825396825,19,18,84,2,18
2532,620,675,9.961360544217687,12.770975056689343,19,21,133,3,55
2533,620,907,9.961360544217687,11.3081179138322,19,13,293,1,287
2534,620,825,9.961360544217687,12.051156462585034,19,10,224,2,205
2535,620,297,9.984580498866213,11.122358276643991,24,31,327,1,323
2536,620,299,9.984580498866213,12.213696145124716,24,31,335,2,321
2537,620,417,9.984580498866213,11.3081179138322,24,32,211,1,203
2538,620,470,9.984580498866213,12.79419501133787,24,30,193,3,150
2539,620,638,9.984580498866213,11.865396825396825,24,18,83,2,18
2540,620,675,9.984580498866213,12.770975056689343,24,21,132,3,55
2541,620,907,9.984580498866213,11.3081179138322,24,13,293,1,287
2542,620,825,9.984580498866213,12.051156462585034,24,10,223,2,205
2543,638,392,11.865396825396825,13.537233560090703,18,28,256,2,246
2544,638,507,11.865396825396825,13.374693877551021,18,33,146,2,131
2545,638,621,11.865396825396825,13.374693877551021,18,27,67,2,17
2546,638,777,11.865396825396825,14.466031746031746,18,16,179,3,139
2547,638,852,11.865396825396825,13.351473922902494,18,16,223,1,214
2548,638,824,11.865396825396825,14.466031746031746,18,9,217,3,186
2549,675,296,12.770975056689343,14.86077097505669,21,29,390,2,379
2550,675,392,12.770975056689343,15.371609977324264,21,27,304,3,283
2551,675,415,12.770975056689343,14.86077097505669,21,32,275,2,260
2552,675,507,12.770975056689343,15.371609977324264,21,31,202,3,168
2553,675,777,12.770975056689343,14.466031746031746,21,16,125,2,102
2554,675,621,12.770975056689343,15.348390022675737,21,22,123,3,54
2555,675,824,12.770975056689343,14.466031746031746,21,9,166,2,149
2556,675,851,12.770975056689343,15.371609977324264,21,15,209,3,176
2557,621,296,13.374693877551021,14.86077097505669,27,29,331,1,325
2558,621,392,13.374693877551021,15.371609977324264,27,27,245,2,229
2559,621,415,13.374693877551021,14.86077097505669,27,32,216,1,206
2560,621,507,13.374693877551021,15.371609977324264,27,31,143,2,114
2561,621,777,13.374693877551021,14.466031746031746,27,16,163,1,156
2562,621,687,13.374693877551021,16.27718820861678,27,15,141,3,66
2563,621,824,13.374693877551021,14.466031746031746,27,9,208,1,203
2564,621,851,13.374693877551021,15.371609977324264,27,15,246,2,230
2565,777,304,14.466031746031746,16.834467120181408,16,26,484,2,473
2566,777,304,14.466031746031746,17.182766439909297,16,28,487,3,473
2567,777,505,14.466031746031746,16.834467120181408,16,19,290,2,272
2568,777,687,14.466031746031746,16.27718820861678,16,15,119,2,90
2569,777,822,14.466031746031746,16.439727891156462,16,8,96,2,45
2570,621,304,15.348390022675737,16.834467120181408,22,26,323,1,317
2571,621,304,15.348390022675737,17.182766439909297,22,28,327,2,317
2572,621,223,15.348390022675737,18.088344671201813,22,30,415,3,398
2573,621,505,15.348390022675737,16.834467120181408,22,19,132,1,116
2574,621,507,15.348390022675737,17.925804988662133,22,31,159,3,114
2575,621,505,15.348390022675737,18.088344671201813,22,31,165,3,116
2576,621,622,15.348390022675737,17.925804988662133,22,22,111,3,1
2577,621,619,15.348390022675737,18.088344671201813,22,20,118,3,2
2578,621,822,15.348390022675737,16.439727891156462,22,8,206,1,201
2579,621,852,15.348390022675737,17.925804988662133,22,13,256,3,231
2580,621,849,15.348390022675737,18.088344671201813,22,17,257,3,228
2581,687,223,16.27718820861678,18.088344671201813,15,30,471,2,464
2582,687,507,16.27718820861678,17.925804988662133,15,31,193,2,180
2583,687,505,16.27718820861678,18.088344671201813,15,31,198,2,182
2584,687,622,16.27718820861678,17.925804988662133,15,22,96,2,65
2585,687,619,16.27718820861678,18.088344671201813,15,20,103,2,68
2586,687,852,16.27718820861678,17.925804988662133,15,13,180,2,165
2587,687,849,16.27718820861678,18.088344671201813,15,17,180,2,162
2588,622,263,17.925804988662133,19.667301587301587,22,29,367,2,359
2589,622,265,17.925804988662133,20.758639455782312,22,27,377,3,357
2590,622,417,17.925804988662133,19.319002267573698,22,8,214,1,205
2591,622,613,17.925804988662133,20.688979591836734,22,12,119,3,9
2592,622,695,17.925804988662133,19.319002267573698,22,7,94,1,73
2593,622,625,17.925804988662133,20.735419501133787,22,13,121,3,3
2594,622,885,17.925804988662133,20.66575963718821,22,5,288,3,263
2595,619,263,18.088344671201813,19.667301587301587,20,29,362,2,356
2596,619,265,18.088344671201813,20.758639455782312,20,27,372,3,354
2597,619,417,18.088344671201813,19.319002267573698,20,8,209,1,202
2598,619,613,18.088344671201813,20.688979591836734,20,12,112,3,6
2599,619,695,18.088344671201813,19.319002267573698,20,7,93,1,76
2600,619,625,18.088344671201813,20.735419501133787,20,13,114,3,6
2601,619,885,18.088344671201813,20.66575963718821,20,5,288,3,266
2602,695,265,19.319002267573698,20.758639455782312,7,27,434,1,430
2603,695,251,19.319002267573698,21.43201814058957,7,29,453,2,444
2604,695,277,19.319002267573698,22.01251700680272,7,29,434,3,418
2605,695,613,19.319002267573698,20.688979591836734,7,12,101,1,82
2606,695,417,19.319002267573698,21.339138321995467,7,14,291,2,278
2607,695,625,19.319002267573698,20.735419501133787,7,13,93,1,70
2608,695,667,19.319002267573698,21.966077097505668,7,10,117,3,28
2609,695,885,19.319002267573698,20.66575963718821,7,5,199,1,190
2610,625,277,20.735419501133787,22.01251700680272,13,29,352,1,348
2611,625,259,20.735419501133787,23.428934240362814,13,30,384,3,366
2612,625,601,20.735419501133787,22.918095238095237,13,11,97,2,24
2613,625,613,20.735419501133787,23.475374149659864,13,15,119,3,12
2614,625,667,20.735419501133787,21.966077097505668,13,10,68,1,42
2615,625,683,20.735419501133787,22.894875283446712,13,11,110,2,58
2616,625,648,20.735419501133787,23.521814058956917,13,16,122,3,23
2617,667,259,21.966077097505668,23.428934240362814,10,30,413,1,408
2618,667,223,21.966077097505668,24.357732426303855,10,28,456,2,444
2619,667,613,21.966077097505668,23.475374149659864,10,15,85,2,54
2620,667,449,21.966077097505668,24.775691609977326,10,9,249,3,218
2621,667,648,21.966077097505668,23.521814058956917,10,16,70,2,19
2622,667,644,21.966077097505668,24.938231292517006,10,7,130,3,23
2623,683,223,22.894875283446712,24.357732426303855,11,28,464,1,460
2624,683,254,22.894875283446712,25.541950113378686,11,29,444,3,429
2625,683,449,22.894875283446712,24.775691609977326,11,9,248,2,234
2626,683,592,22.894875283446712,25.56517006802721,11,12,147,3,91
2627,683,644,22.894875283446712,24.938231292517006,11,7,96,2,39
2628,683,676,22.894875283446712,25.240090702947846,11,13,101,2,7
2629,648,254,23.521814058956917,25.541950113378686,16,29,403,2,394
2630,648,258,23.521814058956917,26.424308390022677,16,27,410,3,390
2631,648,449,23.521814058956917,24.775691609977326,16,9,206,1,199
2632,648,592,23.521814058956917,25.56517006802721,16,12,104,2,56
2633,648,605,23.521814058956917,26.424308390022677,16,8,132,3,43
2634,648,644,23.521814058956917,24.938231292517006,16,7,61,1,4
2635,648,676,23.521814058956917,25.240090702947846,16,13,79,2,28
2636,644,258,24.938231292517006,26.424308390022677,7,27,391,1,386
2637,644,267,24.938231292517006,27.794285714285714,7,26,397,3,377
2638,644,605,24.938231292517006,26.424308390022677,7,8,75,1,39
2639,644,446,24.938231292517006,27.724625850340136,7,11,232,3,198
2640,644,683,24.938231292517006,27.70140589569161,7,9,125,3,39
2641,644,831,24.938231292517006,27.794285714285714,7,6,224,3,187
2642,676,258,25.240090702947846,26.424308390022677,13,27,421,1,418
2643,676,267,25.240090702947846,27.794285714285714,13,26,424,3,409
2644,676,240,25.240090702947846,28.142585034013607,13,22,454,3,436
2645,676,605,25.240090702947846,26.424308390022677,13,8,87,1,71
2646,676,446,25.240090702947846,27.724625850340136,13,11,254,2,230
2647,676,683,25.240090702947846,27.70140589569161,13,9,106,2,7
2648,676,750,25.240090702947846,28.0497052154195,13,8,142,3,74
2649,676,831,25.240090702947846,27.794285714285714,13,6,190,3,155
2650,676,860,25.240090702947846,28.0497052154195,13,6,220,3,184
2651,683,271,27.70140589569161,29.976961451247167,9,26,423,2,412
2652,683,273,27.70140589569161,30.00018140589569,9,30,422,2,410
2653,683,429,27.70140589569161,28.93206349206349,9,17,259,1,254
2654,683,428,27.70140589569161,29.30358276643991,9,12,264,2,255
2655,683,428,27.70140589569161,30.418140589569163,9,15,281,3,255
2656,683,626,27.70140589569161,30.418140589569163,9,11,130,3,57
2657,750,271,28.0497052154195,29.976961451247167,8,26,486,2,479
2658,750,273,28.0497052154195,30.00018140589569,8,30,484,2,477
2659,750,428,28.0497052154195,29.30358276643991,8,12,326,1,322
2660,750,428,28.0497052154195,30.418140589569163,8,15,338,2,322
2661,750,626,28.0497052154195,30.418140589569163,8,11,161,2,124
2662,626,224,30.418140589569163,32.182857142857145,11,29,409,2,402
2663,626,493,30.418140589569163,31.60235827664399,11,12,142,1,133
2664,626,413,30.418140589569163,32.670476190476194,11,11,234,2,213
2665,626,677,30.418140589569163,31.60235827664399,11,10,72,1,51
2666,626,667,30.418140589569163,32.76335600907029,11,12,109,2,41
2667,677,236,31.60235827664399,33.90113378684807,10,33,452,2,441
2668,677,208,31.60235827664399,34.22621315192744,10,31,482,3,469
2669,677,413,31.60235827664399,32.670476190476194,10,11,268,1,264
2670,677,426,31.60235827664399,33.436734693877554,10,12,263,2,251
2671,677,418,31.60235827664399,34.57451247165533,10,15,289,3,259
2672,677,667,31.60235827664399,32.76335600907029,10,12,51,1,10
2673,677,699,31.60235827664399,33.8314739229025,10,10,98,2,22
2674,677,777,31.60235827664399,34.22621315192744,10,9,151,3,100
2675,667,236,32.76335600907029,33.90113378684807,12,33,434,1,431
2676,667,208,32.76335600907029,34.22621315192744,12,31,463,1,459
2677,667,263,32.76335600907029,35.15501133786848,12,26,417,2,404
2678,667,418,32.76335600907029,34.57451247165533,12,15,261,2,249
2679,667,462,32.76335600907029,35.062131519274374,12,15,228,2,205
2680,667,699,32.76335600907029,33.8314739229025,12,10,56,1,32
2681,667,777,32.76335600907029,34.22621315192744,12,9,127,1,110
2682,667,668,32.76335600907029,35.085351473922906,12,13,100,2,1
2683,667,825,32.76335600907029,35.15501133786848,12,8,189,2,158
2684,699,263,33.8314739229025,35.15501133786848,10,26,440,1,436
2685,699,462,33.8314739229025,35.062131519274374,10,15,243,1,237
2686,699,420,33.8314739229025,36.08380952380953,10,15,295,2,279
2687,699,668,33.8314739229025,35.085351473922906,10,13,62,1,31
2688,699,715,33.8314739229025,36.060589569160996,10,7,97,2,16
2689,699,825,33.8314739229025,35.15501133786848,10,8,138,1,126
2690,777,420,34.22621315192744,36.08380952380953,9,15,366,2,357
2691,777,715,34.22621315192744,36.060589569160996,9,7,100,2,62
2692,668,233,35.085351473922906,36.89650793650794,13,28,442,2,435
2693,668,222,35.085351473922906,37.24480725623583,13,25,456,2,446
2694,668,428,35.085351473922906,37.964625850340134,13,7,270,3,240
2695,715,222,36.060589569160996,37.24480725623583,7,25,496,1,493
2696,715,270,36.060589569160996,38.17360544217687,7,26,454,2,445
2697,715,428,36.060589569160996,37.964625850340134,7,7,298,2,287
2698,715,422,36.060589569160996,38.12716553287982,7,14,306,2,293
2699,715,666,36.060589569160996,38.10394557823129,7,12,101,2,49
2700,715,839,36.060589569160996,38.196825396825396,7,5,154,2,124
2701,666,285,38.10394557823129,39.14884353741497,12,27,384,1,381
2702,666,270,38.10394557823129,40.19374149659864,12,26,406,2,396
2703,666,593,38.10394557823129,39.14884353741497,12,12,86,1,73
2704,666,433,38.10394557823129,40.07764172335601,12,13,248,2,233
2705,666,783,38.10394557823129,39.14884353741497,12,13,125,1,117
2706,666,661,38.10394557823129,40.07764172335601,12,9,85,2,5
2707,666,638,38.10394557823129,41.05287981859411,12,14,130,3,28
2708,783,300,39.14884353741497,41.61015873015873,13,29,494,2,483
2709,783,434,39.14884353741497,41.33151927437642,13,14,361,2,349
2710,783,638,39.14884353741497,41.05287981859411,13,14,167,2,145
2711,783,822,39.14884353741497,41.703038548752836,13,5,117,3,39
2712,661,300,40.07764172335601,41.61015873015873,9,29,367,2,361
2713,661,223,40.07764172335601,42.5621768707483,9,27,451,2,438
2714,661,434,40.07764172335601,41.33151927437642,9,14,233,1,227
2715,661,424,40.07764172335601,42.93369614512472,9,7,267,3,237
2716,661,783,40.07764172335601,42.4692970521542,9,6,160,2,122
2717,661,822,40.07764172335601,41.703038548752836,9,5,176,2,161
2718,638,223,41.05287981859411,42.5621768707483,14,27,420,2,415
2719,638,265,41.05287981859411,43.69995464852608,14,30,390,3,373
2720,638,424,41.05287981859411,42.93369614512472,14,7,229,2,214
2721,638,416,41.05287981859411,43.95537414965987,14,21,255,3,222
2722,638,415,41.05287981859411,44.00181405895692,14,19,257,3,223
2723,638,783,41.05287981859411,42.4692970521542,14,6,157,1,145
2724,638,648,41.05287981859411,43.95537414965987,14,13,125,3,10
2725,638,680,41.05287981859411,44.00181405895692,14,9,134,3,42
2726,783,416,42.4692970521542,43.95537414965987,6,21,373,1,367
2727,783,415,42.4692970521542,44.00181405895692,6,19,374,2,368
2728,783,648,42.4692970521542,43.95537414965987,6,13,149,1,135
2729,783,680,42.4692970521542,44.00181405895692,6,9,122,2,103
2730,648,233,43.95537414965987,45.97551020408164,13,28,424,2,415
2731,648,260,43.95537414965987,46.718548752834465,13,27,406,3,388
2732,648,612,43.95537414965987,45.97551020408164,13,12,94,2,36
2733,648,414,43.95537414965987,46.021950113378686,13,13,250,2,234
2734,648,670,43.95537414965987,45.97551020408164,13,12,90,2,22
2735,648,736,43.95537414965987,46.04517006802721,13,11,126,2,88
2736,680,233,44.00181405895692,45.97551020408164,9,28,455,2,447
2737,680,260,44.00181405895692,46.718548752834465,9,27,436,3,420
2738,680,612,44.00181405895692,45.97551020408164,9,12,109,2,68
2739,680,414,44.00181405895692,46.021950113378686,9,13,280,2,266
2740,680,670,44.00181405895692,45.97551020408164,9,12,86,2,10
2741,680,736,44.00181405895692,46.04517006802721,9,11,104,2,56
2742,670,264,45.97551020408164,47.159727891156464,12,27,409,1,406
2743,670,268,45.97551020408164,48.088526077097505,12,32,412,2,402
2744,670,434,45.97551020408164,47.62412698412699,12,13,246,2,236
2745,670,427,45.97551020408164,48.251065759637186,12,14,262,2,243
2746,670,625,45.97551020408164,48.27428571428572,12,8,109,2,45
2747,736,264,46.04517006802721,47.159727891156464,11,27,474,1,472
2748,736,268,46.04517006802721,48.088526077097505,11,32,476,2,468
2749,736,434,46.04517006802721,47.62412698412699,11,13,310,2,302
2750,736,427,46.04517006802721,48.251065759637186,11,14,323,2,309
2751,736,670,46.04517006802721,47.09006802721088,11,12,80,1,66
2752,736,625,46.04517006802721,48.27428571428572,11,8,147,2,111
2753,670,277,47.09006802721088,49.295963718820865,12,29,404,2,393
2754,670,427,47.09006802721088,48.251065759637186,12,14,248,1,243
2755,670,601,47.09006802721088,49.342403628117914,12,12,119,2,69
2756,670,625,47.09006802721088,48.27428571428572,12,8,68,1,45
2757,670,637,47.09006802721088,49.295963718820865,12,13,101,2,33
2758,625,277,48.27428571428572,49.295963718820865,8,29,351,1,348
2759,625,238,48.27428571428572,50.36408163265306,8,28,397,2,387
2760,625,241,48.27428571428572,51.06068027210885,8,23,402,3,384
2761,625,601,48.27428571428572,49.342403628117914,8,12,52,1,24
2762,625,429,48.27428571428572,50.549841269841274,8,12,219,2,196
2763,625,637,48.27428571428572,49.295963718820865,8,13,46,1,12
2764,625,696,48.27428571428572,50.52662131519274,8,7,120,2,71
2765,637,238,49.295963718820865,50.36408163265306,13,28,402,1,399
2766,637,241,49.295963718820865,51.06068027210885,13,23,403,2,396
2767,637,263,49.295963718820865,52.22167800453515,13,26,395,3,374
2768,637,429,49.295963718820865,50.549841269841274,13,12,215,1,208
2769,637,449,49.295963718820865,51.66439909297052,13,10,214,2,188
2770,637,589,49.295963718820865,52.17523809523809,13,11,133,3,48
2771,637,696,49.295963718820865,50.52662131519274,13,7,79,1,59
2772,637,677,49.295963718820865,51.66439909297052,13,7,110,2,40
2773,637,673,49.295963718820865,52.17523809523809,13,12,129,3,36
2774,637,821,49.295963718820865,52.22167800453515,13,6,223,3,184
2775,696,263,50.52662131519274,52.22167800453515,7,26,439,2,433
2776,696,220,50.52662131519274,53.011156462585035,7,20,488,2,476
2777,696,449,50.52662131519274,51.66439909297052,7,10,252,1,247
2778,696,589,50.52662131519274,52.17523809523809,7,11,128,2,107
2779,696,425,50.52662131519274,53.173696145124715,7,13,294,3,271
2780,696,677,50.52662131519274,51.66439909297052,7,7,53,1,19
2781,696,673,50.52662131519274,52.17523809523809,7,12,75,2,23
2782,696,705,50.52662131519274,53.452335600907034,7,11,126,3,9
2783,696,821,50.52662131519274,52.22167800453515,7,6,145,2,125
2784,677,220,51.66439909297052,53.011156462585035,7,20,461,1,457
2785,677,425,51.66439909297052,53.173696145124715,7,13,260,2,252
2786,677,705,51.66439909297052,53.452335600907034,7,11,82,2,28
2787,673,256,52.17523809523809,54.96163265306122,12,23,434,3,417
2788,673,251,52.17523809523809,55.031292517006804,12,22,440,3,422
2789,673,705,52.17523809523809,53.452335600907034,12,11,64,1,32
2790,705,256,53.452335600907034,54.96163265306122,11,23,454,2,449
2791,705,251,53.452335600907034,55.031292517006804,11,22,459,2,454
2792,705,513,53.452335600907034,55.35637188208617,11,21,209,2,192
2793,705,657,53.452335600907034,55.33315192743764,11,14,94,2,48
2794,705,881,53.452335600907034,55.33315192743764,11,7,194,2,176
2795,657,328,55.33315192743764,56.540589569161,14,22,333,1,329
2796,657,265,55.33315192743764,57.14430839002268,14,31,400,2,392
2797,657,246,55.33315192743764,58.049886621315196,14,28,427,3,411
2798,657,450,55.33315192743764,56.540589569161,14,12,213,1,207
2799,657,419,55.33315192743764,57.63192743764172,14,13,258,2,238
2800,657,628,55.33315192743764,56.540589569161,14,9,60,1,29
2801,657,784,55.33315192743764,57.95700680272109,14,11,170,3,127
2802,657,824,55.33315192743764,57.30684807256236,14,7,187,2,167
2803,628,246,56.540589569161,58.049886621315196,9,28,387,2,382
2804,628,419,56.540589569161,57.63192743764172,9,13,214,1,209
2805,628,429,56.540589569161,58.816145124716556,9,15,222,2,199
2806,628,784,56.540589569161,57.95700680272109,9,11,168,1,156
2807,628,669,56.540589569161,58.79292517006803,9,13,105,2,41
2808,628,839,56.540589569161,58.79292517006803,9,8,232,2,211
2809,784,333,57.95700680272109,60.070022675736965,11,26,460,2,451
2810,784,427,57.95700680272109,59.55918367346939,11,14,364,2,357
2811,784,607,57.95700680272109,60.557641723356014,11,11,209,3,177
2812,784,811,57.95700680272109,59.55918367346939,11,10,74,2,27
2813,784,660,57.95700680272109,60.162902494331064,11,11,156,2,124
2814,784,849,57.95700680272109,60.13968253968254,11,6,114,2,65
2815,669,271,58.79292517006803,59.90748299319728,13,31,401,1,398
2816,669,333,58.79292517006803,60.070022675736965,13,26,340,1,336
2817,669,607,58.79292517006803,60.557641723356014,13,11,98,2,62
2818,669,605,58.79292517006803,61.648979591836735,13,14,139,3,64
2819,669,660,58.79292517006803,60.162902494331064,13,11,60,1,9
2820,669,736,58.79292517006803,61.648979591836735,13,16,140,3,67
2821,669,849,58.79292517006803,60.13968253968254,13,6,189,1,180
2822,669,842,58.79292517006803,61.67219954648526,13,7,213,3,173
2823,811,605,59.55918367346939,61.648979591836735,10,14,225,2,206
2824,811,596,59.55918367346939,62.368798185941046,10,13,247,3,215
2825,811,736,59.55918367346939,61.648979591836735,10,16,117,2,75
2826,811,842,59.55918367346939,61.67219954648526,10,7,96,2,31
2827,660,230,60.162902494331064,61.9740589569161,11,30,437,2,430
2828,660,263,60.162902494331064,62.368798185941046,11,31,408,2,397
2829,660,605,60.162902494331064,61.648979591836735,11,14,84,1,55
2830,660,596,60.162902494331064,62.368798185941046,11,13,115,2,64
2831,660,736,60.162902494331064,61.648979591836735,11,16,99,1,76
2832,660,789,60.162902494331064,62.80997732426304,11,11,172,3,129
2833,660,842,60.162902494331064,61.67219954648526,11,7,193,2,182
2834,736,268,61.648979591836735,63.92453514739229,16,32,478,2,468
2835,736,247,61.648979591836735,64.15673469387755,16,28,501,3,489
2836,736,505,61.648979591836735,63.34403628117914,16,12,242,2,231
2837,736,789,61.648979591836735,62.80997732426304,16,11,73,1,53
2838,736,619,61.648979591836735,63.92453514739229,16,8,153,2,117
2839,789,604,62.80997732426304,64.71401360544218,11,16,202,2,185
2840,789,419,62.80997732426304,65.22485260770975,11,12,384,2,370
2841,789,619,62.80997732426304,63.92453514739229,11,8,177,1,170
2842,789,644,62.80997732426304,64.7372335600907,11,18,167,2,145
2843,789,741,62.80997732426304,65.24807256235827,11,10,115,2,48
2844,789,827,62.80997732426304,64.7372335600907,11,9,91,2,38
2845,619,275,63.92453514739229,65.24807256235827,8,26,349,1,344
2846,619,278,63.92453514739229,66.38585034013606,8,31,357,2,341
2847,619,419,63.92453514739229,65.22485260770975,8,12,208,1,200
2848,619,429,63.92453514739229,66.73414965986395,8,17,225,3,190
2849,619,741,63.92453514739229,65.24807256235827,8,10,135,1,122
2850,619,667,63.92453514739229,66.38585034013606,8,10,116,2,48
2851,644,278,64.7372335600907,66.38585034013606,18,31,373,2,366
2852,644,255,64.7372335600907,67.43074829931973,18,26,406,3,389
2853,644,429,64.7372335600907,66.73414965986395,18,17,232,2,215
2854,644,667,64.7372335600907,66.38585034013606,18,10,75,2,23
2855,741,278,65.24807256235827,66.38585034013606,10,31,466,1,463
2856,741,255,65.24807256235827,67.43074829931973,10,26,495,2,486
2857,741,429,65.24807256235827,66.73414965986395,10,17,318,1,312
2858,741,449,65.24807256235827,67.89514739229026,10,14,313,3,292
2859,741,667,65.24807256235827,66.38585034013606,10,10,89,1,74
2860,741,636,65.24807256235827,67.89514739229026,10,10,155,3,105
2861,667,255,66.38585034013606,67.43074829931973,10,26,414,1,412
2862,667,241,66.38585034013606,68.61496598639457,10,28,437,2,426
2863,667,247,66.38585034013606,69.0097052154195,10,28,435,3,420
2864,667,449,66.38585034013606,67.89514739229026,10,14,227,2,218
2865,667,597,66.38585034013606,68.42920634920635,10,20,112,2,70
2866,667,609,66.38585034013606,69.24190476190476,10,10,136,3,58
2867,667,636,66.38585034013606,67.89514739229026,10,10,72,2,31
2868,667,627,66.38585034013606,68.42920634920635,10,16,97,2,40
2869,667,698,66.38585034013606,69.24190476190476,10,13,127,3,31
2870,667,835,66.38585034013606,68.70784580498866,10,8,196,2,168
2871,667,843,66.38585034013606,69.24190476190476,10,8,215,3,176
2872,636,247,67.89514739229026,69.0097052154195,10,28,392,1,389
2873,636,270,67.89514739229026,70.5190022675737,10,29,383,3,366
2874,636,609,67.89514739229026,69.24190476190476,10,10,64,1,27
2875,636,698,67.89514739229026,69.24190476190476,10,13,85,1,62
2876,636,790,67.89514739229026,70.56544217687075,10,5,192,3,154
2877,636,843,67.89514739229026,69.24190476190476,10,8,215,1,207
2878,627,270,68.42920634920635,70.5190022675737,16,29,368,2,357
2879,627,429,68.42920634920635,70.91374149659865,16,12,225,2,198
2880,627,790,68.42920634920635,70.56544217687075,16,5,187,2,163
2881,698,270,69.24190476190476,70.5190022675737,13,29,432,1,428
2882,698,274,69.24190476190476,71.63356009070294,13,23,436,2,424
2883,698,429,69.24190476190476,70.91374149659865,13,12,278,2,269
2884,698,790,69.24190476190476,70.56544217687075,13,5,108,1,92
2885,626,224,75.13977324263038,76.60263038548753,14,23,407,1,402
2886,626,237,75.13977324263038,77.39210884353741,14,23,401,2,389
2887,626,506,75.13977324263038,76.64907029478458,14,7,136,2,120
2888,626,612,75.13977324263038,77.2063492063492,14,18,90,2,14
2889,626,620,75.13977324263038,77.2063492063492,14,17,89,2,6
2890,626,822,75.13977324263038,77.2063492063492,14,11,215,2,196
2891,620,219,77.2063492063492,78.80852607709751,17,27,407,2,401
2892,620,230,77.2063492063492,79.22648526077097,17,28,400,2,390
2893,620,578,77.2063492063492,78.7156462585034,17,18,77,2,42
2894,620,449,77.2063492063492,79.31936507936508,17,11,194,2,171
2895,620,627,77.2063492063492,78.69242630385487,17,19,64,1,7
2896,620,844,77.2063492063492,78.69242630385487,17,12,233,1,224
2897,627,322,78.69242630385487,80.96798185941043,19,25,320,2,305
2898,627,307,78.69242630385487,81.01442176870748,19,23,335,2,320
2899,627,606,78.69242630385487,80.99120181405895,19,19,101,2,21
2900,627,511,78.69242630385487,81.61814058956917,19,26,171,3,116
2901,627,668,78.69242630385487,80.99120181405895,19,21,107,2,41
2902,627,771,78.69242630385487,81.61814058956917,19,20,191,3,144
2903,627,838,78.69242630385487,80.96798185941043,19,13,233,2,211
2904,627,860,78.69242630385487,81.61814058956917,19,10,265,3,233
2905,668,262,80.99120181405895,82.0128798185941,21,17,408,1,406
2906,668,209,80.99120181405895,83.08099773242631,21,27,468,2,459
2907,668,449,80.99120181405895,82.0128798185941,21,7,223,1,219
2908,668,506,80.99120181405895,83.89369614512472,21,9,205,3,162
2909,668,807,80.99120181405895,83.10421768707484,21,5,166,2,139
2910,771,506,81.61814058956917,83.89369614512472,20,9,283,2,265
2911,771,807,81.61814058956917,83.10421768707484,20,5,73,1,36
2912,807,313,83.10421768707484,85.33333333333333,5,28,503,2,494
2913,807,427,83.10421768707484,84.63673469387756,5,9,386,2,380
2914,807,505,83.10421768707484,85.1243537414966,5,20,314,2,302
2915,807,819,83.10421768707484,84.89215419501134,5,8,78,2,12
2916,807,620,83.10421768707484,85.1243537414966,5,19,206,2,187
2917,807,820,83.10421768707484,84.86893424036282,5,7,77,2,13
2918,807,840,83.10421768707484,85.61197278911565,5,10,113,3,33
2919,819,418,84.89215419501134,86.98195011337869,8,7,411,2,401
2920,819,602,84.89215419501134,87.07482993197279,8,15,236,2,217
2921,819,816,84.89215419501134,86.84263038548752,8,7,84,2,3
2922,819,658,84.89215419501134,87.07482993197279,8,14,186,2,161
2923,819,829,84.89215419501134,86.84263038548752,8,6,85,2,10
2924,819,834,84.89215419501134,87.09804988662131,8,9,96,2,15
2925,620,220,85.1243537414966,86.86585034013605,19,29,407,2,400
2926,620,227,85.1243537414966,87.98040816326531,19,29,412,3,393
2927,620,227,85.1243537414966,88.00362811791383,19,26,412,3,393
2928,620,418,85.1243537414966,86.98195011337869,19,7,217,2,202
2929,620,602,85.1243537414966,87.07482993197279,19,15,86,2,18
2930,620,479,85.1243537414966,88.05006802721088,19,12,189,3,141
2931,620,816,85.1243537414966,86.84263038548752,19,7,210,2,196
2932,620,658,85.1243537414966,87.07482993197279,19,14,92,2,38
2933,620,710,85.1243537414966,88.05006802721088,19,12,155,3,90
2934,620,829,85.1243537414966,86.84263038548752,19,6,222,2,209
2935,620,834,85.1243537414966,87.09804988662131,19,9,230,2,214
2936,816,479,86.84263038548752,88.05006802721088,7,12,341,1,337
2937,816,511,86.84263038548752,89.16462585034014,7,19,321,2,305
2938,816,710,86.84263038548752,88.05006802721088,7,12,118,1,106
2939,816,700,86.84263038548752,89.1414058956916,7,15,153,2,116
2940,816,831,86.84263038548752,89.1414058956916,7,9,100,2,15
2941,658,221,87.07482993197279,89.00208616780046,14,21,445,2,437
2942,658,281,87.07482993197279,90.00054421768708,14,17,397,3,377
2943,658,511,87.07482993197279,89.16462585034014,14,19,172,2,147
2944,658,449,87.07482993197279,90.00054421768708,14,9,244,3,209
2945,658,700,87.07482993197279,89.1414058956916,14,15,98,2,42
2946,658,831,87.07482993197279,89.1414058956916,14,9,195,2,173
2947,710,281,88.05006802721088,90.00054421768708,12,17,437,2,429
2948,710,511,88.05006802721088,89.16462585034014,12,19,205,1,199
2949,710,449,88.05006802721088,90.00054421768708,12,9,274,2,261
2950,710,700,88.05006802721088,89.1414058956916,12,15,48,1,10
2951,710,675,88.05006802721088,90.72036281179139,12,8,120,3,35
2952,710,831,88.05006802721088,89.1414058956916,12,9,130,1,121
2953,700,300,89.1414058956916,91.34730158730159,15,22,411,2,400
2954,700,453,89.1414058956916,91.11510204081632,15,11,261,2,247
2955,700,675,89.1414058956916,90.72036281179139,15,8,72,2,25
2956,700,679,89.1414058956916,91.11510204081632,15,8,88,2,21
2957,675,243,90.72036281179139,92.25287981859411,8,28,437,2,432
2958,675,208,90.72036281179139,93.042358276644,8,39,478,2,467
2959,675,769,90.72036281179139,93.01913832199547,8,8,137,2,94
2960,675,825,90.72036281179139,93.11201814058957,8,6,182,2,150
2961,679,243,91.11510204081632,92.25287981859411,8,28,439,1,436
2962,679,208,91.11510204081632,93.042358276644,8,39,478,2,471
2963,679,266,91.11510204081632,94.01759637188209,8,27,432,3,413
2964,679,450,91.11510204081632,93.80861678004536,8,11,257,3,229
2965,679,769,91.11510204081632,93.01913832199547,8,8,122,2,90
2966,679,825,91.11510204081632,93.11201814058957,8,6,169,2,146
2967,769,410,93.01913832199547,94.89995464852608,8,15,368,2,359
2968,769,444,93.01913832199547,95.94485260770975,8,9,349,3,325
2969,769,640,93.01913832199547,94.20335600907029,8,11,139,1,129
2970,769,678,93.01913832199547,95.31791383219955,8,10,134,2,91
2971,640,266,94.20335600907029,95.94485260770975,11,28,381,2,374
2972,640,232,94.20335600907029,96.08417233560091,11,28,416,2,408
2973,640,444,94.20335600907029,95.94485260770975,11,9,210,2,196
2974,640,419,94.20335600907029,96.08417233560091,11,13,235,2,221
2975,640,678,94.20335600907029,95.31791383219955,11,10,61,1,38
2976,640,638,94.20335600907029,96.08417233560091,11,9,81,2,2
2977,678,229,95.31791383219955,97.98820861678004,10,25,463,3,449
2978,678,207,95.31791383219955,98.24362811791383,10,32,488,3,471
2979,678,427,95.31791383219955,97.2451700680272,10,9,264,2,251
2980,638,229,96.08417233560091,97.98820861678004,9,25,417,2,409
2981,638,207,96.08417233560091,98.24362811791383,9,32,441,2,431
2982,638,427,96.08417233560091,97.2451700680272,9,9,217,1,211
2983,638,598,96.08417233560091,98.45260770975057,9,12,110,2,40
2984,638,628,96.08417233560091,98.45260770975057,9,15,102,2,10
2985,628,253,98.45260770975057,100.86748299319729,15,33,389,2,375
2986,628,265,98.45260770975057,101.40154195011338,15,34,385,3,363
2987,628,427,98.45260770975057,100.56562358276645,15,13,221,2,201
2988,628,667,98.45260770975057,100.58884353741497,15,11,100,2,39
2989,628,832,98.45260770975057,100.56562358276645,15,9,223,2,204
2990,627,253,99.26530612244898,100.86748299319729,10,33,380,2,374
2991,627,265,99.26530612244898,101.40154195011338,10,34,374,2,362
2992,627,281,99.26530612244898,102.00526077097506,10,22,366,3,346
2993,627,427,99.26530612244898,100.56562358276645,10,13,208,1,200
2994,627,429,99.26530612244898,101.79628117913832,10,12,226,3,198
2995,627,667,99.26530612244898,100.58884353741497,10,11,70,1,40
2996,627,667,99.26530612244898,101.79628117913832,10,11,116,3,40
2997,627,832,99.26530612244898,100.56562358276645,10,9,213,1,205
2998,667,281,100.58884353741497,102.00526077097506,11,22,391,1,386
2999,667,429,100.58884353741497,101.79628117913832,11,12,244,1,238
3000,667,429,100.58884353741497,102.95727891156463,11,13,259,2,238
3001,667,429,100.58884353741497,103.35201814058958,11,11,266,3,238
3002,667,653,100.58884353741497,102.88761904761905,11,11,100,2,14
3003,667,615,100.58884353741497,103.23591836734694,11,9,125,3,52
3004,667,276,101.79628117913832,103.95573696145125,11,27,402,2,391
3005,667,270,101.79628117913832,104.02539682539683,11,30,408,2,397
3006,667,429,101.79628117913832,102.95727891156463,11,13,243,1,238
3007,667,429,101.79628117913832,103.35201814058958,11,11,247,2,238
3008,667,448,101.79628117913832,104.5362358276644,11,16,249,3,219
3009,667,653,101.79628117913832,102.88761904761905,11,11,49,1,14
3010,667,615,101.79628117913832,103.23591836734694,11,9,81,1,52
3011,667,661,101.79628117913832,104.48979591836735,11,9,116,3,6
3012,653,276,102.88761904761905,103.95573696145125,11,27,380,1,377
3013,653,270,102.88761904761905,104.02539682539683,11,30,386,1,383
3014,653,206,102.88761904761905,105.11673469387755,11,32,457,2,447
3015,653,448,102.88761904761905,104.5362358276644,11,16,217,2,205
3016,653,554,102.88761904761905,105.76689342403628,11,11,159,3,99
3017,653,661,102.88761904761905,104.48979591836735,11,9,69,2,8
3018,615,206,103.23591836734694,105.11673469387755,9,32,417,2,409
3019,615,248,103.23591836734694,105.99909297052154,9,25,386,3,367
3020,615,448,103.23591836734694,104.5362358276644,9,16,176,1,167
3021,615,554,103.23591836734694,105.76689342403628,9,11,125,3,61
3022,615,661,103.23591836734694,104.48979591836735,9,9,71,1,46
3023,661,248,104.48979591836735,105.99909297052154,9,25,418,2,413
3024,661,254,104.48979591836735,107.25297052154195,9,26,424,3,407
3025,661,554,104.48979591836735,105.76689342403628,9,11,120,1,107
3026,661,438,104.48979591836735,106.88145124716553,9,6,246,2,223
3027,661,678,104.48979591836735,106.88145124716553,9,9,104,2,17
3028,678,262,106.88145124716553,108.25142857142858,9,21,420,1,416
3029,678,238,106.88145124716553,109.69106575963718,9,30,456,3,440
3030,678,429,106.88145124716553,107.90312925170068,9,12,253,1,249
3031,678,585,106.88145124716553,109.69106575963718,9,11,153,3,93
3032,678,657,106.88145124716553,109.69106575963718,9,8,123,3,21
3033,657,224,109.69106575963718,110.96816326530613,8,27,436,1,433
3034,657,257,109.69106575963718,111.92018140589569,8,25,411,2,400
3035,657,270,109.69106575963718,112.05950113378685,8,26,400,2,387
3036,657,433,109.69106575963718,110.8520634920635,8,10,230,1,224
3037,657,411,109.69106575963718,111.36290249433107,8,18,256,2,246
3038,657,476,109.69106575963718,112.33814058956916,8,9,214,3,181
3039,657,682,109.69106575963718,111.36290249433107,8,8,76,2,25
3040,657,651,109.69106575963718,112.33814058956916,8,6,114,3,6
3041,682,257,111.36290249433107,113.12761904761905,8,25,432,2,425
3042,682,210,111.36290249433107,114.1492970521542,8,30,487,3,472
3043,682,429,111.36290249433107,113.6152380952381,8,18,271,2,253
3044,682,628,111.36290249433107,113.6152380952381,8,14,111,2,54
3045,651,210,112.33814058956916,114.1492970521542,6,30,448,2,441
3046,651,265,112.33814058956916,115.14775510204082,6,30,405,3,386
3047,651,429,112.33814058956916,113.6152380952381,6,18,229,1,222
3048,651,613,112.33814058956916,114.77623582766441,6,15,112,2,38
3049,651,628,112.33814058956916,113.6152380952381,6,14,60,1,23
3050,651,662,112.33814058956916,114.79945578231293,6,17,107,2,11
3051,651,838,112.33814058956916,114.77623582766441,6,11,214,2,187
3052,628,265,113.6152380952381,115.14775510204082,14,30,369,2,363
3053,628,240,113.6152380952381,116.23909297052154,14,29,404,3,388
3054,628,613,113.6152380952381,114.77623582766441,14,15,52,1,15
3055,628,428,113.6152380952381,115.8443537414966,14,11,222,2,200
3056,628,429,113.6152380952381,116.58739229024944,14,14,237,3,199
3057,628,662,113.6152380952381,114.79945578231293,14,17,61,1,34
3058,628,616,113.6152380952381,115.63537414965987,14,7,88,2,12
3059,628,651,113.6152380952381,116.56417233560092,14,9,129,3,23
3060,628,838,113.6152380952381,114.77623582766441,14,11,216,1,210
3061,662,240,114.79945578231293,116.23909297052154,17,29,427,1,422
3062,662,223,114.79945578231293,117.539410430839,17,26,455,3,439
3063,662,428,114.79945578231293,115.8443537414966,17,11,238,1,234
3064,662,429,114.79945578231293,116.58739229024944,17,14,245,2,233
3065,662,545,114.79945578231293,117.51619047619047,17,6,165,3,117
3066,662,651,114.79945578231293,116.56417233560092,17,9,77,2,11
3067,662,650,114.79945578231293,117.51619047619047,17,5,118,3,12
3068,616,223,115.63537414965987,117.539410430839,7,26,401,2,393
3069,616,545,115.63537414965987,117.51619047619047,7,6,108,2,71
3070,616,650,115.63537414965987,117.51619047619047,7,5,88,2,34
3071,651,270,116.56417233560092,118.74684807256236,9,31,392,2,381
3072,651,264,116.56417233560092,119.21124716553288,9,30,403,3,387
3073,651,600,116.56417233560092,118.70040816326531,9,11,105,2,51
3074,651,620,116.56417233560092,118.74684807256236,9,9,99,2,31
3075,651,730,116.56417233560092,119.51310657596372,9,13,150,3,79
3076,651,866,116.56417233560092,119.51310657596372,9,9,250,3,215
3077,650,270,117.51619047619047,118.74684807256236,5,31,384,1,380
3078,650,264,117.51619047619047,119.21124716553288,5,30,393,2,386
3079,650,600,117.51619047619047,118.70040816326531,5,11,71,1,50
3080,650,449,117.51619047619047,119.97750566893424,5,13,227,2,201
3081,650,449,117.51619047619047,120.00072562358277,5,12,228,2,201
3082,650,620,117.51619047619047,118.74684807256236,5,9,61,1,30
3083,650,730,117.51619047619047,119.51310657596372,5,13,117,2,80
3084,650,747,117.51619047619047,120.37224489795919,5,7,157,3,97
3085,650,866,117.51619047619047,119.51310657596372,5,9,232,2,216
3086,620,237,118.74684807256236,120.92952380952381,9,32,394,2,383
3087,620,243,118.74684807256236,121.46358276643991,9,28,395,3,377
3088,620,449,118.74684807256236,119.97750566893424,9,13,179,1,171
3089,620,449,118.74684807256236,120.00072562358277,9,12,179,1,171
3090,620,451,118.74684807256236,121.51002267573696,9,13,207,3,169
3091,620,747,118.74684807256236,120.37224489795919,9,7,145,2,127
3092,620,649,118.74684807256236,121.69578231292518,9,12,130,3,29
3093,620,841,118.74684807256236,121.7190022675737,9,6,255,3,221
3094,730,237,119.51310657596372,120.92952380952381,13,32,497,1,493
3095,730,243,119.51310657596372,121.46358276643991,13,28,494,2,487
3096,730,296,119.51310657596372,122.18340136054422,13,26,449,3,434
3097,730,451,119.51310657596372,121.51002267573696,13,13,292,2,279
3098,730,450,119.51310657596372,122.2530612244898,13,14,304,3,280
3099,730,649,119.51310657596372,121.69578231292518,13,12,124,2,81
3100,730,841,119.51310657596372,121.7190022675737,13,6,146,2,111
3101,747,296,120.37224489795919,122.18340136054422,7,26,458,2,451
3102,747,451,120.37224489795919,121.51002267573696,7,13,300,1,296
3103,747,450,120.37224489795919,122.2530612244898,7,14,308,2,297
3104,747,649,120.37224489795919,121.69578231292518,7,12,113,1,98
3105,747,633,120.37224489795919,122.71746031746032,7,11,152,2,114
3106,747,841,120.37224489795919,121.7190022675737,7,6,110,1,94
3107,649,219,121.69578231292518,123.73913832199547,12,31,439,2,430
3108,649,271,121.69578231292518,124.4821768707483,12,26,397,3,378
3109,649,596,121.69578231292518,123.87845804988662,12,13,108,2,53
3110,649,613,121.69578231292518,124.06421768707483,12,15,108,2,36
3111,649,633,121.69578231292518,122.71746031746032,12,11,47,1,16
3112,649,659,121.69578231292518,123.8552380952381,12,15,94,2,10
3113,649,620,121.69578231292518,124.01777777777778,12,16,104,2,29
3114,633,219,122.71746031746032,123.73913832199547,11,31,416,1,414
3115,633,271,122.71746031746032,124.4821768707483,11,26,370,2,362
3116,633,219,122.71746031746032,125.08589569160998,11,29,426,2,414
3117,633,596,122.71746031746032,123.87845804988662,11,13,62,1,37
3118,633,613,122.71746031746032,124.06421768707483,11,15,61,1,20
3119,633,428,122.71746031746032,125.66639455782312,11,13,241,3,205
3120,633,659,122.71746031746032,123.8552380952381,11,15,55,1,26
3121,633,620,122.71746031746032,124.01777777777778,11,16,57,1,13
3122,633,911,122.71746031746032,124.90013605442176,11,7,293,2,278
3123,659,219,123.8552380952381,125.08589569160998,15,29,443,1,440
3124,659,428,123.8552380952381,125.66639455782312,15,13,244,2,231
3125,659,429,123.8552380952381,126.03791383219955,15,9,248,2,230
3126,659,911,123.8552380952381,124.90013605442176,15,7,256,1,252
3127,620,219,124.01777777777778,125.08589569160998,16,29,404,1,401
3128,620,245,124.01777777777778,126.9667120181406,16,26,396,3,375
3129,620,428,124.01777777777778,125.66639455782312,16,13,205,2,192
3130,620,429,124.01777777777778,126.03791383219955,16,9,210,2,191
3131,620,643,124.01777777777778,126.9667120181406,16,11,129,3,23
3132,643,299,126.9667120181406,128.96362811791383,11,21,355,2,344
3133,643,300,126.9667120181406,129.24226757369615,11,23,357,2,343
3134,638,299,127.01315192743765,128.96362811791383,6,21,349,2,339
3135,638,300,127.01315192743765,129.24226757369615,6,23,351,2,338
3136,829,417,9.798820861678005,11.3081179138322,15,32,417,2,412
3137,829,638,9.798820861678005,11.865396825396825,15,18,211,2,191
3138,829,675,9.798820861678005,12.770975056689343,15,21,200,3,154
3139,829,907,9.798820861678005,11.3081179138322,15,13,102,2,78
3140,829,825,9.798820861678005,12.051156462585034,15,10,97,2,4
3141,934,470,10.356099773242631,12.79419501133787,15,30,476,2,464
3142,934,638,10.356099773242631,11.865396825396825,15,18,303,2,296
3143,934,675,10.356099773242631,12.770975056689343,15,21,279,2,259
3144,934,825,10.356099773242631,12.051156462585034,15,10,131,2,109
3145,907,470,11.3081179138322,12.79419501133787,13,30,442,1,437
3146,907,507,11.3081179138322,13.374693877551021,13,33,410,2,400
3147,907,675,11.3081179138322,12.770975056689343,13,21,240,1,232
3148,907,621,11.3081179138322,13.374693877551021,13,27,300,2,286
3149,907,852,11.3081179138322,13.351473922902494,13,16,104,2,55
3150,825,392,12.051156462585034,13.537233560090703,10,28,438,1,433
3151,825,507,12.051156462585034,13.374693877551021,10,33,323,1,318
3152,825,415,12.051156462585034,14.86077097505669,10,32,427,3,410
3153,825,621,12.051156462585034,13.374693877551021,10,27,212,1,204
3154,825,777,12.051156462585034,14.466031746031746,10,16,115,2,48
3155,825,852,12.051156462585034,13.351473922902494,10,16,62,1,27
3156,825,824,12.051156462585034,14.466031746031746,10,9,104,2,1
3157,852,392,13.351473922902494,15.371609977324264,16,27,468,2,460
3158,852,415,13.351473922902494,14.86077097505669,16,32,442,2,437
3159,852,507,13.351473922902494,15.371609977324264,16,31,356,2,345
3160,852,777,13.351473922902494,14.466031746031746,16,16,89,1,75
3161,852,621,13.351473922902494,15.348390022675737,16,22,246,2,231
3162,852,687,13.351473922902494,16.27718820861678,16,15,208,3,165
3163,852,824,13.351473922902494,14.466031746031746,16,9,56,1,28
3164,852,851,13.351473922902494,15.371609977324264,16,15,87,2,1
3165,824,505,14.466031746031746,16.834467120181408,9,19,335,2,319
3166,824,687,14.466031746031746,16.27718820861678,9,15,158,2,137
3167,824,822,14.466031746031746,16.439727891156462,9,8,85,2,2
3168,851,505,15.371609977324264,16.834467120181408,15,19,352,1,346
3169,851,507,15.371609977324264,17.925804988662133,15,31,361,3,344
3170,851,505,15.371609977324264,18.088344671201813,15,31,365,3,346
3171,851,622,15.371609977324264,17.925804988662133,15,22,254,3,229
3172,851,619,15.371609977324264,18.088344671201813,15,20,260,3,232
3173,851,822,15.371609977324264,16.439727891156462,15,8,54,1,29
3174,851,852,15.371609977324264,17.925804988662133,15,13,110,3,1
3175,851,849,15.371609977324264,18.088344671201813,15,17,117,3,2
3176,822,507,16.439727891156462,17.925804988662133,8,31,321,1,315
3177,822,505,16.439727891156462,18.088344671201813,8,31,325,2,317
3178,822,417,16.439727891156462,19.319002267573698,8,8,424,3,405
3179,822,622,16.439727891156462,17.925804988662133,8,22,210,1,200
3180,822,619,16.439727891156462,18.088344671201813,8,20,215,2,203
3181,822,695,16.439727891156462,19.319002267573698,8,7,177,3,127
3182,822,852,16.439727891156462,17.925804988662133,8,13,71,1,30
3183,822,849,16.439727891156462,18.088344671201813,8,17,76,2,27
3184,852,417,17.925804988662133,19.319002267573698,13,8,439,1,435
3185,852,613,17.925804988662133,20.688979591836734,13,12,267,3,239
3186,852,695,17.925804988662133,19.319002267573698,13,7,168,1,157
3187,852,625,17.925804988662133,20.735419501133787,13,13,257,3,227
3188,852,885,17.925804988662133,20.66575963718821,13,5,123,3,33
3189,849,417,18.088344671201813,19.319002267573698,17,8,435,1,432
3190,849,613,18.088344671201813,20.688979591836734,17,12,261,3,236
3191,849,695,18.088344671201813,19.319002267573698,17,7,163,1,154
3192,849,625,18.088344671201813,20.735419501133787,17,13,251,3,224
3193,849,885,18.088344671201813,20.66575963718821,17,5,117,3,36
3194,885,601,20.66575963718821,22.918095238095237,5,11,300,2,284
3195,885,613,20.66575963718821,23.475374149659864,5,15,298,3,272
3196,885,667,20.66575963718821,21.966077097505668,5,10,225,1,218
3197,885,683,20.66575963718821,22.894875283446712,5,11,224,2,202
3198,885,648,20.66575963718821,23.521814058956917,5,16,267,3,237
3199,831,429,27.794285714285714,28.93206349206349,6,17,405,1,402
3200,831,428,27.794285714285714,29.30358276643991,6,12,408,2,403
3201,831,428,27.794285714285714,30.418140589569163,6,15,419,3,403
3202,831,626,27.794285714285714,30.418140589569163,6,11,234,3,205
3203,860,428,28.0497052154195,29.30358276643991,6,12,435,1,432
3204,860,428,28.0497052154195,30.418140589569163,6,15,444,2,432
3205,860,626,28.0497052154195,30.418140589569163,6,11,255,2,234
3206,825,428,35.15501133786848,37.964625850340134,8,7,415,3,397
3207,825,422,35.15501133786848,38.12716553287982,8,14,423,3,403
3208,825,666,35.15501133786848,38.10394557823129,8,12,203,3,159
3209,839,433,38.196825396825396,40.07764172335601,5,13,414,2,406
3210,839,661,38.196825396825396,40.07764172335601,5,9,196,2,178
3211,839,638,38.196825396825396,41.05287981859411,5,14,236,3,201
3212,842,434,39.10240362811791,41.33151927437642,10,14,419,2,408
3213,842,638,39.10240362811791,41.05287981859411,10,14,221,2,204
3214,842,822,39.10240362811791,41.703038548752836,10,5,114,3,20
3215,822,424,41.703038548752836,42.93369614512472,5,7,402,1,398
3216,822,416,41.703038548752836,43.95537414965987,5,21,417,2,406
3217,822,415,41.703038548752836,44.00181405895692,5,19,419,2,407
3218,822,648,41.703038548752836,43.95537414965987,5,13,199,2,174
3219,822,680,41.703038548752836,44.00181405895692,5,9,173,2,142
3220,821,705,52.22167800453515,53.452335600907034,6,11,128,1,116
3221,881,450,55.33315192743764,56.540589569161,7,12,434,1,431
3222,881,419,55.33315192743764,57.63192743764172,7,13,472,2,462
3223,881,628,55.33315192743764,56.540589569161,7,9,258,1,253
3224,881,784,55.33315192743764,57.95700680272109,7,11,149,3,97
3225,881,824,55.33315192743764,57.30684807256236,7,7,102,2,57
3226,824,333,57.30684807256236,60.070022675736965,7,26,505,3,491
3227,824,429,57.30684807256236,58.816145124716556,7,15,400,2,395
3228,824,427,57.30684807256236,59.55918367346939,7,14,409,2,397
3229,824,669,57.30684807256236,58.79292517006803,7,13,168,1,155
3230,824,811,57.30684807256236,59.55918367346939,7,10,98,2,13
3231,824,660,57.30684807256236,60.162902494331064,7,11,205,3,164
3232,824,839,57.30684807256236,58.79292517006803,7,8,66,1,15
3233,824,849,57.30684807256236,60.13968253968254,7,6,125,3,25
3234,839,607,58.79292517006803,60.557641723356014,8,11,244,2,232
3235,839,605,58.79292517006803,61.648979591836735,8,14,264,3,234
3236,839,660,58.79292517006803,60.162902494331064,8,11,188,1,179
3237,839,736,58.79292517006803,61.648979591836735,8,16,160,3,103
3238,839,849,58.79292517006803,60.13968253968254,8,6,59,1,10
3239,839,842,58.79292517006803,61.67219954648526,8,7,124,3,3
3240,849,605,60.13968253968254,61.648979591836735,6,14,253,2,244
3241,849,596,60.13968253968254,62.368798185941046,6,13,271,2,253
3242,849,736,60.13968253968254,61.648979591836735,6,16,130,2,113
3243,849,789,60.13968253968254,62.80997732426304,6,11,130,3,60
3244,849,842,60.13968253968254,61.67219954648526,6,7,66,2,7
3245,842,505,61.67219954648526,63.34403628117914,7,12,345,2,337
3246,842,789,61.67219954648526,62.80997732426304,7,11,72,1,53
3247,842,619,61.67219954648526,63.92453514739229,7,8,243,2,223
3248,827,429,64.7372335600907,66.73414965986395,9,17,407,2,398
3249,827,667,64.7372335600907,66.38585034013606,9,10,175,2,160
3250,835,429,68.70784580498866,70.91374149659865,8,12,417,2,406
3251,835,790,68.70784580498866,70.56544217687075,8,5,92,2,45
3252,843,429,69.24190476190476,70.91374149659865,8,12,420,2,414
3253,843,790,69.24190476190476,70.56544217687075,8,5,78,1,53
3254,865,506,75.16299319727891,76.64907029478458,11,7,365,1,359
3255,865,612,75.16299319727891,77.2063492063492,11,18,268,2,253
3256,865,620,75.16299319727891,77.2063492063492,11,17,260,2,245
3257,865,822,75.16299319727891,77.2063492063492,11,11,98,2,43
3258,822,578,77.2063492063492,78.7156462585034,11,18,253,2,244
3259,822,449,77.2063492063492,79.31936507936508,11,11,384,2,373
3260,822,627,77.2063492063492,78.69242630385487,11,19,205,1,195
3261,822,844,77.2063492063492,78.69242630385487,11,12,68,1,22
3262,844,606,78.69242630385487,80.99120181405895,12,19,258,2,238
3263,844,511,78.69242630385487,81.61814058956917,12,26,356,3,333
3264,844,668,78.69242630385487,80.99120181405895,12,21,202,2,176
3265,844,771,78.69242630385487,81.61814058956917,12,20,146,3,73
3266,844,838,78.69242630385487,80.96798185941043,12,13,98,2,6
3267,844,860,78.69242630385487,81.61814058956917,12,10,127,3,16
3268,838,449,80.96798185941043,82.0128798185941,13,7,392,1,389
3269,838,506,80.96798185941043,83.89369614512472,13,9,355,3,332
3270,838,807,80.96798185941043,83.10421768707484,13,5,97,2,31
3271,860,506,81.61814058956917,83.89369614512472,10,9,367,2,354
3272,860,807,81.61814058956917,83.10421768707484,10,5,83,1,53
3273,820,418,84.86893424036282,86.98195011337869,7,7,412,2,402
3274,820,602,84.86893424036282,87.07482993197279,7,15,238,2,218
3275,820,816,84.86893424036282,86.84263038548752,7,7,85,2,4
3276,820,658,84.86893424036282,87.07482993197279,7,14,188,2,162
3277,820,829,84.86893424036282,86.84263038548752,7,6,85,2,9
3278,820,834,84.86893424036282,87.09804988662131,7,9,97,2,14
3279,840,418,85.61197278911565,86.98195011337869,10,7,426,1,422
3280,840,602,85.61197278911565,87.07482993197279,10,15,246,1,238
3281,840,479,85.61197278911565,88.05006802721088,10,12,376,2,361
3282,840,816,85.61197278911565,86.84263038548752,10,7,58,1,24
3283,840,658,85.61197278911565,87.07482993197279,10,14,193,1,182
3284,840,710,85.61197278911565,88.05006802721088,10,12,167,2,130
3285,840,829,85.61197278911565,86.84263038548752,10,6,54,1,11
3286,840,834,85.61197278911565,87.09804988662131,10,9,64,1,6
3287,829,479,86.84263038548752,88.05006802721088,6,12,354,1,350
3288,829,511,86.84263038548752,89.16462585034014,6,19,333,2,318
3289,829,710,86.84263038548752,88.05006802721088,6,12,130,1,119
3290,829,700,86.84263038548752,89.1414058956916,6,15,163,2,129
3291,829,831,86.84263038548752,89.1414058956916,6,9,99,2,2
3292,834,511,87.09804988662131,89.16462585034014,9,19,335,2,323
3293,834,449,87.09804988662131,90.00054421768708,9,9,405,3,385
3294,834,700,87.09804988662131,89.1414058956916,9,15,160,2,134
3295,834,831,87.09804988662131,89.1414058956916,9,9,88,2,3
3296,831,453,89.1414058956916,91.11510204081632,9,11,387,2,378
3297,831,675,89.1414058956916,90.72036281179139,9,8,170,2,156
3298,831,679,89.1414058956916,91.11510204081632,9,8,174,2,152
3299,825,410,93.11201814058957,94.89995464852608,6,15,422,2,415
3300,825,444,93.11201814058957,95.94485260770975,6,9,400,3,381
3301,825,419,93.11201814058957,96.08417233560091,6,13,426,3,406
3302,825,640,93.11201814058957,94.20335600907029,6,11,191,1,185
3303,825,678,93.11201814058957,95.31791383219955,6,10,175,2,147
3304,825,638,93.11201814058957,96.08417233560091,6,9,227,3,187
3305,832,429,100.56562358276645,101.79628117913832,9,12,406,1,403
3306,832,429,100.56562358276645,102.95727891156463,9,13,416,2,403
3307,832,429,100.56562358276645,103.35201814058958,9,11,420,3,403
3308,832,667,100.56562358276645,101.79628117913832,9,11,173,1,165
3309,832,653,100.56562358276645,102.88761904761905,9,11,205,2,179
3310,832,615,100.56562358276645,103.23591836734694,9,9,246,3,217
3311,838,428,114.77623582766441,115.8443537414966,11,11,413,1,410
3312,838,429,114.77623582766441,116.58739229024944,11,14,416,2,409
3313,838,545,114.77623582766441,117.51619047619047,11,6,316,3,293
3314,838,651,114.77623582766441,116.56417233560092,11,9,202,2,187
3315,838,650,114.77623582766441,117.51619047619047,11,5,222,3,188
3316,866,451,119.51310657596372,121.51002267573696,9,13,424,2,415
3317,866,450,119.51310657596372,122.2530612244898,9,14,432,3,416
3318,866,649,119.51310657596372,121.69578231292518,9,12,236,2,217
3319,866,841,119.51310657596372,121.7190022675737,9,6,98,2,25
3320,841,596,121.7190022675737,123.87845804988662,6,13,262,2,245
3321,841,613,121.7190022675737,124.06421768707483,6,15,249,2,228
3322,841,659,121.7190022675737,123.8552380952381,6,15,204,2,182
3323,841,620,121.7190022675737,124.01777777777778,6,16,242,2,221
3324,911,429,124.90013605442176,126.03791383219955,7,9,484,1,482
3325,911,643,124.90013605442176,126.9667120181406,7,11,282,2,268
3326,911,638,124.90013605442176,127.01315192743765,7,6,288,2,273
