,f0,f1,t0,t1,dB0,dB1,dist,utime,ufreq
0,46,70,1.4396371882086167,3.8545124716553287,16,20,107,2,24
1,46,70,2.4380952380952383,3.8545124716553287,21,20,66,1,24
2,46,44,2.4380952380952383,5.38702947845805,21,22,127,3,2
3,70,44,3.8545124716553287,5.38702947845805,20,22,71,2,26
4,70,59,3.8545124716553287,6.362267573696145,20,23,109,3,11
5,46,59,4.62077097505669,6.362267573696145,21,23,76,2,13
6,44,69,5.38702947845805,7.7090249433106575,22,21,103,2,25
7,59,69,6.362267573696145,7.7090249433106575,23,21,59,1,10
8,59,65,6.362267573696145,8.498503401360544,23,23,92,2,6
9,59,52,6.362267573696145,9.311201814058958,23,23,127,3,7
10,69,52,7.7090249433106575,9.311201814058958,21,23,71,2,17
11,65,46,8.498503401360544,10.913378684807256,23,20,106,2,19
12,52,46,9.311201814058958,10.913378684807256,23,20,69,2,6
13,52,4,9.311201814058958,12.004716553287983,23,31,126,3,48
14,46,4,10.913378684807256,12.004716553287983,20,31,63,1,42
15,46,4,10.913378684807256,12.585215419501134,20,35,83,2,42
16,46,4,10.913378684807256,13.119274376417234,20,38,104,2,42
17,4,24,17.60072562358277,19.853061224489796,30,37,99,2,20
18,4,24,18.436643990929706,19.853061224489796,27,37,64,1,20
19,4,26,18.436643990929706,20.735419501133787,27,40,101,2,22
20,24,52,19.853061224489796,21.61777777777778,37,34,81,2,28
21,52,26,21.61777777777778,22.84843537414966,34,39,59,1,26
22,52,25,21.61777777777778,23.91655328798186,34,35,103,2,27
23,52,49,21.61777777777778,24.264852607709752,34,36,114,3,3
24,26,25,22.84843537414966,23.91655328798186,39,35,46,1,1
25,26,49,22.84843537414966,24.264852607709752,39,36,65,1,23
26,26,24,22.84843537414966,25.495510204081633,39,39,114,3,2
27,25,24,23.91655328798186,25.495510204081633,35,39,68,2,1
28,25,26,23.91655328798186,26.40108843537415,35,39,107,2,1
29,49,24,24.264852607709752,25.495510204081633,36,39,59,1,25
30,49,26,24.264852607709752,26.40108843537415,36,39,95,2,23
31,24,58,25.495510204081633,27.794285714285714,39,35,105,2,34
32,26,58,26.40108843537415,27.794285714285714,39,35,68,1,32
33,26,51,26.40108843537415,29.23392290249433,39,33,125,3,25
34,58,51,27.794285714285714,29.23392290249433,35,33,62,1,7
35,26,73,28.53732426303855,30.998639455782314,41,42,116,2,47
36,26,244,28.53732426303855,30.998639455782314,41,21,242,2,218
37,26,387,28.53732426303855,31.161179138321994,41,26,378,3,361
38,51,73,29.23392290249433,30.998639455782314,33,42,79,2,22
39,51,49,29.23392290249433,32.04353741496599,33,42,121,3,2
40,51,244,29.23392290249433,30.998639455782314,33,21,207,2,193
41,51,387,29.23392290249433,31.161179138321994,33,26,346,2,336
42,51,413,29.23392290249433,32.113197278911564,33,26,383,3,362
43,51,412,29.23392290249433,32.15963718820862,33,30,382,3,361
44,73,49,30.998639455782314,32.04353741496599,42,42,51,1,24
45,73,24,30.998639455782314,32.60081632653061,42,41,85,2,49
46,73,51,30.998639455782314,33.483174603174604,42,42,109,2,22
47,73,388,30.998639455782314,32.60081632653061,42,27,322,2,315
48,73,413,30.998639455782314,32.113197278911564,42,26,343,1,340
49,73,412,30.998639455782314,32.15963718820862,42,30,343,1,339
50,49,51,32.04353741496599,33.483174603174604,42,42,62,1,2
51,49,73,32.04353741496599,34.13333333333333,42,41,93,2,24
52,49,386,32.04353741496599,34.0172335600907,42,29,348,2,337
53,49,450,32.04353741496599,34.78349206349206,42,21,418,3,401
54,24,73,32.60081632653061,34.13333333333333,41,41,82,2,49
55,24,386,32.60081632653061,34.0172335600907,41,29,367,1,362
56,24,316,32.60081632653061,35.085351473922906,41,23,311,2,292
57,24,450,32.60081632653061,34.78349206349206,41,21,436,2,426
58,51,24,33.483174603174604,35.50331065759637,42,42,91,2,27
59,51,52,33.483174603174604,36.31600907029478,42,43,122,3,1
60,51,316,33.483174603174604,35.085351473922906,42,23,274,2,265
61,51,267,33.483174603174604,35.92126984126984,42,27,240,2,216
62,51,450,33.483174603174604,34.78349206349206,42,21,403,1,399
63,51,414,33.483174603174604,35.9677097505669,42,25,378,2,363
64,73,24,34.13333333333333,35.50331065759637,41,42,77,1,49
65,73,52,34.13333333333333,36.31600907029478,41,43,96,2,21
66,73,267,34.13333333333333,35.92126984126984,41,27,209,2,194
67,73,261,34.13333333333333,36.80362811791383,41,28,220,3,188
68,73,414,34.13333333333333,35.9677097505669,41,25,350,2,341
69,73,410,34.13333333333333,36.87328798185941,41,23,357,3,337
70,24,39,35.50331065759637,37.45378684807256,42,43,85,2,15
71,24,49,35.50331065759637,38.33614512471655,42,41,125,3,25
72,24,261,35.50331065759637,36.80362811791383,42,28,244,1,237
73,24,244,35.50331065759637,38.01106575963719,42,24,245,3,220
74,24,219,35.50331065759637,38.2897052154195,42,33,229,3,195
75,24,410,35.50331065759637,36.87328798185941,42,23,390,1,386
76,52,39,36.31600907029478,37.45378684807256,43,43,51,1,13
77,52,49,36.31600907029478,38.33614512471655,43,41,87,2,3
78,52,244,36.31600907029478,38.01106575963719,43,24,205,2,192
79,52,219,36.31600907029478,38.2897052154195,43,33,187,2,167
80,52,259,36.31600907029478,39.14884353741497,43,29,240,3,207
81,39,24,37.45378684807256,39.38104308390023,43,41,84,2,15
82,39,259,37.45378684807256,39.14884353741497,43,29,232,2,220
83,49,24,38.33614512471655,39.38104308390023,41,41,51,1,25
84,49,26,38.33614512471655,40.56526077097506,41,42,99,2,23
85,49,207,38.33614512471655,40.49560090702948,41,27,183,2,158
86,24,26,39.38104308390023,40.56526077097506,41,42,51,1,2
87,24,49,39.38104308390023,41.28507936507937,41,40,86,2,25
88,24,5,39.38104308390023,42.306757369614516,41,49,127,3,19
89,24,207,39.38104308390023,40.49560090702948,41,27,189,1,183
90,24,230,39.38104308390023,41.56371882086168,41,24,226,2,206
91,26,5,40.56526077097506,42.306757369614516,42,49,78,2,21
92,26,288,40.56526077097506,42.70149659863946,42,33,278,2,262
93,49,5,41.28507936507937,42.306757369614516,40,49,62,1,44
94,49,5,41.28507936507937,43.69995464852608,40,50,113,2,44
95,49,288,41.28507936507937,42.70149659863946,40,33,247,1,239
96,49,263,41.28507936507937,43.560634920634925,40,33,235,2,214
97,49,548,41.28507936507937,42.840816326530614,40,19,503,2,499
98,49,518,41.28507936507937,44.04825396825397,40,19,484,3,469
99,5,263,42.306757369614516,43.560634920634925,49,33,264,1,258
100,5,292,42.306757369614516,44.81451247165533,49,28,307,3,287
101,5,431,42.306757369614516,44.72163265306123,49,19,439,2,426
102,5,6,43.69995464852608,45.81297052154195,50,50,91,2,1
103,5,292,43.69995464852608,44.81451247165533,50,28,291,1,287
104,5,229,43.69995464852608,45.51111111111111,50,32,237,2,224
105,5,431,43.69995464852608,44.72163265306123,50,19,428,1,426
106,5,425,43.69995464852608,45.51111111111111,50,20,427,2,420
107,5,4,45.11637188208617,47.06684807256236,49,48,84,2,1
108,5,233,45.11637188208617,46.741768707483,49,30,239,2,228
109,5,263,45.11637188208617,47.600907029478456,49,30,279,2,258
110,5,431,45.11637188208617,47.53124716553288,49,18,439,2,426
111,6,4,45.81297052154195,47.06684807256236,50,48,54,1,2
112,6,5,45.81297052154195,47.94920634920635,50,49,92,2,1
113,6,5,45.81297052154195,48.66902494331066,50,49,123,3,1
114,6,263,45.81297052154195,47.600907029478456,50,30,268,2,257
115,6,255,45.81297052154195,48.34394557823129,50,28,272,3,249
116,6,431,45.81297052154195,47.53124716553288,50,18,431,2,425
117,4,5,47.06684807256236,48.66902494331066,48,49,69,2,1
118,4,5,47.06684807256236,49.36562358276644,48,50,99,2,1
119,4,255,47.06684807256236,48.34394557823129,48,28,257,1,251
120,4,205,47.06684807256236,49.24952380952381,48,29,222,2,201
121,5,205,47.94920634920635,49.24952380952381,49,29,208,1,200
122,5,261,48.66902494331066,51.13034013605442,49,32,277,2,256
123,5,421,48.66902494331066,51.17678004535148,49,21,430,3,416
124,5,261,49.36562358276644,51.13034013605442,50,32,267,2,256
125,5,259,49.36562358276644,51.85015873015873,50,33,276,2,254
126,5,421,49.36562358276644,51.17678004535148,50,21,423,2,416
127,5,4,50.78204081632653,52.7092970521542,49,47,83,2,1
128,5,8,50.78204081632653,53.38267573696145,49,50,112,3,3
129,5,259,50.78204081632653,51.85015873015873,49,33,258,1,254
130,5,262,50.78204081632653,52.54675736961451,49,33,268,2,257
131,5,4,51.45541950113379,52.7092970521542,50,47,54,1,1
132,5,8,51.45541950113379,53.38267573696145,50,50,83,2,3
133,5,262,51.45541950113379,52.54675736961451,50,33,261,1,257
134,5,232,51.45541950113379,54.19537414965986,50,30,256,3,227
135,5,438,51.45541950113379,54.19537414965986,50,21,449,3,433
136,4,5,52.7092970521542,55.00807256235828,47,49,99,2,1
137,4,232,52.7092970521542,54.19537414965986,47,30,237,1,228
138,4,260,52.7092970521542,54.79909297052154,47,33,271,2,256
139,4,271,52.7092970521542,55.24027210884354,47,22,288,3,267
140,4,438,52.7092970521542,54.19537414965986,47,21,439,1,434
141,4,453,52.7092970521542,54.89197278911565,47,24,459,2,449
142,8,5,53.38267573696145,55.00807256235828,50,49,70,2,3
143,8,5,53.38267573696145,55.70467120181406,50,48,100,2,3
144,8,260,53.38267573696145,54.79909297052154,50,33,259,1,252
145,8,271,53.38267573696145,55.24027210884354,50,22,275,2,263
146,8,453,53.38267573696145,54.89197278911565,50,24,450,2,445
147,8,422,53.38267573696145,55.843990929705214,50,20,427,2,414
148,5,233,55.00807256235828,57.0746485260771,49,27,245,2,228
149,5,292,55.00807256235828,57.65514739229025,49,29,309,3,287
150,5,436,55.00807256235828,56.91210884353742,49,19,439,2,431
151,5,421,55.00807256235828,57.67836734693878,49,25,432,3,416
152,5,233,55.70467120181406,57.0746485260771,48,27,236,1,228
153,5,292,55.70467120181406,57.65514739229025,48,29,299,2,287
154,5,259,55.70467120181406,58.583945578231294,48,25,283,3,254
155,5,436,55.70467120181406,56.91210884353742,48,19,434,1,431
156,5,421,55.70467120181406,57.67836734693878,48,25,425,2,416
157,5,292,56.42448979591837,57.65514739229025,49,29,292,1,287
158,5,259,56.42448979591837,58.583945578231294,49,25,270,2,254
159,5,421,56.42448979591837,57.67836734693878,49,25,419,1,416
160,5,431,56.42448979591837,58.83936507936508,49,19,439,2,426
161,5,4,57.84090702947846,60.186122448979596,47,44,101,2,1
162,5,258,57.84090702947846,59.90748299319728,47,26,268,2,253
163,5,291,57.84090702947846,60.53442176870748,47,28,309,3,286
164,5,4,58.537505668934244,60.186122448979596,49,44,71,2,1
165,5,258,58.537505668934244,59.90748299319728,49,26,260,1,253
166,5,291,58.537505668934244,60.53442176870748,49,28,299,2,286
167,4,5,60.186122448979596,61.90439909297052,44,46,74,2,1
168,4,5,60.186122448979596,62.252698412698415,44,45,89,2,1
169,4,271,60.186122448979596,62.11337868480726,44,30,280,2,267
170,4,261,60.186122448979596,62.415238095238095,44,33,274,2,257
171,5,271,60.65052154195011,62.11337868480726,46,30,273,1,266
172,5,261,60.65052154195011,62.415238095238095,46,33,267,2,256
173,5,7,61.90439909297052,64.57469387755103,46,50,115,3,2
174,5,262,61.90439909297052,63.831655328798185,46,34,270,2,257
175,5,7,62.252698412698415,64.57469387755103,45,50,100,2,2
176,5,262,62.252698412698415,63.831655328798185,45,34,266,2,257
177,5,387,62.252698412698415,65.03909297052154,45,26,400,3,382
178,5,7,63.34403628117914,64.57469387755103,44,50,53,1,2
179,5,8,63.34403628117914,65.38739229024944,44,49,88,2,3
180,5,387,63.34403628117914,65.03909297052154,44,26,389,2,382
181,5,233,63.34403628117914,65.36417233560091,44,26,244,2,228
182,5,412,63.34403628117914,66.03755102040816,44,31,423,3,407
183,7,5,64.57469387755103,66.98956916099773,50,49,104,2,2
184,7,283,64.57469387755103,67.26820861678004,50,29,299,3,276
185,7,412,64.57469387755103,66.03755102040816,50,31,410,1,405
186,7,415,64.57469387755103,66.6877097505669,50,24,418,2,408
187,7,412,64.57469387755103,67.43074829931973,50,21,423,3,405
188,8,5,65.38739229024944,66.98956916099773,49,49,69,2,3
189,8,5,65.38739229024944,67.70938775510204,49,47,100,2,3
190,8,283,65.38739229024944,67.26820861678004,49,29,287,2,275
191,8,386,65.38739229024944,67.89514739229026,49,30,393,3,378
192,8,415,65.38739229024944,66.6877097505669,49,24,411,1,407
193,8,412,65.38739229024944,67.43074829931973,49,21,413,2,404
194,5,8,66.98956916099773,69.72952380952381,49,50,118,3,3
195,5,211,66.98956916099773,68.70784580498866,49,25,219,2,206
196,5,266,66.98956916099773,69.38122448979593,49,26,281,2,261
197,5,436,66.98956916099773,68.63818594104309,49,23,437,2,431
198,5,414,66.98956916099773,69.84562358276644,49,25,427,3,409
199,5,8,67.70938775510204,69.72952380952381,47,50,87,2,3
200,5,266,67.70938775510204,69.38122448979593,47,26,271,2,261
201,5,256,67.70938775510204,70.31002267573696,47,28,275,3,251
202,5,414,67.70938775510204,69.84562358276644,47,25,419,2,409
203,5,8,68.40598639455783,69.72952380952381,49,50,57,1,3
204,5,256,68.40598639455783,70.31002267573696,49,28,264,2,251
205,5,414,68.40598639455783,69.84562358276644,49,25,414,1,409
206,5,410,68.40598639455783,70.75120181405896,49,21,417,2,405
207,8,5,69.72952380952381,71.23882086167801,50,48,65,2,3
208,8,6,69.72952380952381,71.91219954648527,50,45,94,2,2
209,8,5,69.72952380952381,72.65523809523809,50,49,126,3,3
210,8,219,69.72952380952381,72.16761904761906,50,34,236,2,211
211,8,410,69.72952380952381,70.75120181405896,50,21,404,1,402
212,5,363,71.23882086167801,72.79455782312925,48,29,364,2,358
213,5,258,71.23882086167801,73.51437641723356,48,30,271,2,253
214,5,411,71.23882086167801,73.09641723356009,48,22,414,2,406
215,6,5,71.91219954648527,73.3750566893424,45,50,63,1,1
216,6,5,71.91219954648527,74.76825396825397,45,48,123,3,1
217,6,258,71.91219954648527,73.51437641723356,45,30,261,2,252
218,6,206,71.91219954648527,74.39673469387755,45,30,227,2,200
219,6,411,71.91219954648527,73.09641723356009,45,22,408,1,405
220,5,8,72.65523809523809,75.58095238095238,49,50,126,3,3
221,5,206,72.65523809523809,74.39673469387755,49,30,215,2,201
222,5,8,73.3750566893424,75.58095238095238,50,50,95,2,3
223,5,206,73.3750566893424,74.39673469387755,50,30,206,1,201
224,5,217,73.3750566893424,76.06857142857143,50,24,242,3,212
225,5,217,74.76825396825397,76.06857142857143,48,24,219,1,212
226,5,387,74.76825396825397,76.39365079365079,48,24,388,2,382
227,5,413,74.76825396825397,77.29922902494332,48,27,422,3,408
228,5,412,74.76825396825397,77.32244897959184,48,29,422,3,407
229,8,5,75.58095238095238,76.88126984126984,50,49,56,1,3
230,8,5,75.58095238095238,78.29768707482994,50,49,117,3,3
231,8,388,75.58095238095238,77.78684807256236,50,27,392,2,380
232,8,413,75.58095238095238,77.29922902494332,50,27,412,2,405
233,8,412,75.58095238095238,77.32244897959184,50,29,411,2,404
234,8,414,75.58095238095238,78.43700680272109,50,24,424,3,406
235,5,387,76.88126984126984,79.18004535147392,49,29,395,2,382
236,5,414,76.88126984126984,78.43700680272109,49,24,414,2,409
237,5,8,78.29768707482994,81.01442176870748,49,50,117,3,3
238,5,316,78.29768707482994,80.27138321995464,49,24,322,2,311
239,5,388,78.29768707482994,81.24662131519274,49,24,404,3,383
240,5,437,78.29768707482994,79.92308390022676,49,22,438,2,432
241,5,414,78.29768707482994,81.15374149659864,49,26,427,3,409
242,5,8,78.99428571428571,81.01442176870748,48,50,87,2,3
243,5,8,78.99428571428571,81.57170068027212,48,51,111,3,3
244,5,316,78.99428571428571,80.27138321995464,48,24,316,1,311
245,5,388,78.99428571428571,81.24662131519274,48,24,395,2,383
246,5,414,78.99428571428571,81.15374149659864,48,26,419,2,409
247,5,410,78.99428571428571,81.61814058956917,48,19,420,3,405
248,5,8,79.71410430839002,81.01442176870748,49,50,56,1,3
249,5,8,79.71410430839002,81.57170068027212,49,51,80,2,3
250,5,8,79.71410430839002,82.33795918367348,49,48,113,3,3
251,5,388,79.71410430839002,81.24662131519274,49,24,389,2,383
252,5,256,79.71410430839002,82.03609977324263,49,28,270,2,251
253,5,314,79.71410430839002,82.63981859410431,49,23,334,3,309
254,5,414,79.71410430839002,81.15374149659864,49,26,414,1,409
255,5,410,79.71410430839002,81.61814058956917,49,19,413,2,405
256,8,5,81.01442176870748,83.94013605442177,50,48,126,3,3
257,8,256,81.01442176870748,82.03609977324263,50,28,252,1,248
258,8,314,81.01442176870748,82.63981859410431,50,23,314,2,306
259,8,218,81.01442176870748,83.47573696145125,50,33,235,2,210
260,8,5,81.57170068027212,83.94013605442177,51,48,102,2,3
261,8,314,81.57170068027212,82.63981859410431,51,23,309,1,306
262,8,218,81.57170068027212,83.47573696145125,51,33,225,2,210
263,8,5,82.33795918367348,83.94013605442177,48,48,69,2,3
264,8,5,82.33795918367348,84.65995464852608,48,49,100,2,3
265,8,218,82.33795918367348,83.47573696145125,48,33,216,1,210
266,8,258,82.33795918367348,84.82249433106576,48,29,272,2,250
267,5,8,83.94013605442177,86.16925170068028,48,49,96,2,3
268,5,6,83.94013605442177,86.74975056689343,48,49,121,3,1
269,5,206,83.94013605442177,85.68163265306123,48,28,215,2,201
270,5,289,83.94013605442177,86.51755102040816,48,24,305,3,284
271,5,429,83.94013605442177,86.35501133786848,48,19,437,2,424
272,5,8,84.65995464852608,86.16925170068028,49,49,65,2,3
273,5,6,84.65995464852608,86.74975056689343,49,49,90,2,1
274,5,206,84.65995464852608,85.68163265306123,49,28,206,1,201
275,5,289,84.65995464852608,86.51755102040816,49,24,295,2,284
276,5,429,84.65995464852608,86.35501133786848,49,19,430,2,424
277,8,97,86.16925170068028,88.00362811791383,49,41,119,2,89
278,8,227,86.16925170068028,88.16616780045352,49,29,235,2,219
279,8,333,86.16925170068028,88.51446712018141,49,20,340,2,325
280,6,97,86.74975056689343,88.00362811791383,49,41,106,1,91
281,6,58,86.74975056689343,89.28072562358277,49,41,121,3,52
282,6,227,86.74975056689343,88.16616780045352,49,29,229,1,221
283,6,333,86.74975056689343,88.51446712018141,49,20,336,2,327
284,6,231,86.74975056689343,89.44326530612246,49,23,253,3,225
285,6,489,86.74975056689343,89.62902494331065,49,18,499,3,483
286,97,58,88.00362811791383,89.28072562358277,41,41,67,1,39
287,97,5,88.00362811791383,90.30240362811791,41,49,135,2,92
288,97,231,88.00362811791383,89.44326530612246,41,23,148,1,134
289,97,489,88.00362811791383,89.62902494331065,41,18,398,2,392
290,97,438,88.00362811791383,90.58104308390023,41,20,359,3,341
291,58,5,89.28072562358277,90.30240362811791,41,49,69,1,53
292,58,5,89.28072562358277,90.9990022675737,41,50,91,2,53
293,58,4,89.28072562358277,92.25287981859411,41,48,139,3,54
294,58,228,89.28072562358277,91.02222222222223,41,33,186,2,170
295,58,207,89.28072562358277,91.69560090702949,41,28,182,2,149
296,58,438,89.28072562358277,90.58104308390023,41,20,384,1,380
297,58,410,89.28072562358277,91.60272108843537,41,20,366,2,352
298,5,4,90.30240362811791,92.25287981859411,49,48,84,2,1
299,5,207,90.30240362811791,91.69560090702949,49,28,211,1,202
300,5,254,90.30240362811791,92.71727891156463,49,21,270,2,249
301,5,410,90.30240362811791,91.60272108843537,49,20,409,1,405
302,5,431,90.30240362811791,92.71727891156463,49,19,439,2,426
303,5,4,90.9990022675737,92.25287981859411,50,48,54,1,1
304,5,254,90.9990022675737,92.71727891156463,50,21,260,2,249
305,5,260,90.9990022675737,93.80861678004536,50,29,282,3,255
306,5,431,90.9990022675737,92.71727891156463,50,19,432,2,426
307,4,5,92.25287981859411,93.83183673469388,48,49,68,2,1
308,4,5,92.25287981859411,94.52843537414967,48,50,98,2,1
309,4,260,92.25287981859411,93.80861678004536,48,29,265,2,256
310,4,231,92.25287981859411,94.55165532879819,48,29,248,2,227
311,4,436,92.25287981859411,94.11047619047619,48,19,439,2,432
312,5,231,93.11201814058957,94.55165532879819,49,29,234,1,226
313,5,284,93.83183673469388,96.26993197278912,49,24,298,2,279
314,5,227,93.83183673469388,96.66467120181406,49,29,253,3,222
315,5,284,94.52843537414967,96.26993197278912,50,24,289,2,279
316,5,227,94.52843537414967,96.66467120181406,50,29,240,2,222
317,5,8,95.96807256235827,98.5687074829932,49,50,112,3,3
318,5,231,95.96807256235827,97.54702947845806,49,29,236,2,226
319,5,8,96.64145124716553,98.5687074829932,50,50,83,2,3
320,5,205,96.64145124716553,99.40462585034014,50,27,233,3,200
321,5,431,96.64145124716553,99.07954648526078,50,18,439,2,426
322,5,205,98.24362811791383,99.40462585034014,48,27,206,1,200
323,5,227,98.24362811791383,100.33342403628119,48,32,240,2,222
324,5,411,98.24362811791383,100.00834467120181,48,21,413,2,406
325,5,431,98.24362811791383,101.19256235827665,48,19,445,3,426
326,8,5,98.5687074829932,100.1708843537415,50,50,69,2,3
327,8,5,98.5687074829932,100.89070294784581,50,49,100,2,3
328,8,227,98.5687074829932,100.33342403628119,50,32,232,2,219
329,8,260,98.5687074829932,101.26222222222222,50,31,277,3,252
330,8,411,98.5687074829932,100.00834467120181,50,21,408,1,403
331,8,431,98.5687074829932,101.19256235827665,50,19,438,3,423
332,5,4,100.1708843537415,103.07337868480725,50,47,125,3,1
333,5,260,100.1708843537415,101.26222222222222,50,31,259,1,255
334,5,262,100.1708843537415,102.33034013605442,50,25,273,2,257
335,5,259,100.1708843537415,102.51609977324263,50,30,273,2,254
336,5,431,100.1708843537415,101.19256235827665,50,19,428,1,426
337,5,436,100.1708843537415,102.5857596371882,50,20,443,2,431
338,5,4,100.89070294784581,103.07337868480725,49,47,94,2,1
339,5,262,100.89070294784581,102.33034013605442,49,25,264,1,257
340,5,259,100.89070294784581,102.51609977324263,49,30,263,2,254
341,5,436,100.89070294784581,102.5857596371882,49,20,437,2,431
342,5,206,102.28390022675737,104.04861678004535,50,34,215,2,201
343,5,431,102.28390022675737,104.02539682539683,50,18,433,2,426
344,4,5,103.07337868480725,104.42013605442177,47,49,58,1,1
345,4,5,103.07337868480725,105.13995464852609,47,49,89,2,1
346,4,5,103.07337868480725,105.83655328798186,47,50,119,3,1
347,4,257,103.07337868480725,105.30249433106576,47,28,271,2,253
348,4,411,103.07337868480725,105.30249433106576,47,23,418,2,407
349,5,257,104.42013605442177,106.41705215419502,49,28,266,2,252
350,5,258,104.42013605442177,106.53315192743764,49,25,269,2,253
351,5,431,104.42013605442177,106.83501133786848,49,18,439,2,426
352,5,257,105.13995464852609,106.41705215419502,49,28,258,1,252
353,5,258,105.13995464852609,106.53315192743764,49,25,260,1,253
354,5,431,105.13995464852609,106.83501133786848,49,18,432,2,426
355,5,431,105.13995464852609,107.53160997732427,49,19,438,2,426
356,5,52,105.83655328798186,108.62294784580499,50,42,129,3,47
357,5,234,105.83655328798186,108.43718820861679,50,24,255,3,229
358,5,431,105.83655328798186,107.53160997732427,50,19,432,2,426
359,5,412,105.83655328798186,108.66938775510204,50,21,425,3,407
360,5,52,107.25297052154195,108.62294784580499,49,42,75,1,47
361,5,234,107.25297052154195,108.43718820861679,49,24,235,1,229
362,5,260,107.25297052154195,109.38920634920635,49,31,271,2,255
363,5,412,107.25297052154195,108.66938775510204,49,21,412,1,407
364,5,442,107.25297052154195,110.15546485260771,49,20,455,3,437
365,5,260,107.92634920634922,109.38920634920635,50,31,263,1,255
366,5,255,107.92634920634922,110.24834467120182,50,29,269,2,250
367,5,442,107.92634920634922,110.15546485260771,50,20,447,2,437
368,52,5,108.62294784580499,110.06258503401361,42,47,78,1,47
369,52,5,108.62294784580499,111.45578231292517,42,49,131,3,47
370,52,5,108.62294784580499,111.4790022675737,42,49,132,3,47
371,52,255,108.62294784580499,110.24834467120182,42,29,215,2,203
372,52,261,108.62294784580499,111.36290249433107,42,25,240,3,209
373,52,442,108.62294784580499,110.15546485260771,42,20,396,2,390
374,5,261,110.06258503401361,111.36290249433107,47,25,262,1,256
375,5,259,110.06258503401361,112.1059410430839,47,23,269,2,254
376,5,423,110.06258503401361,112.29170068027211,47,21,429,2,418
377,5,255,111.45578231292517,113.05795918367347,49,28,259,2,250
378,5,270,111.45578231292517,114.42793650793651,49,27,294,3,265
379,5,431,111.45578231292517,113.19727891156462,49,20,433,2,426
380,5,482,111.45578231292517,114.0564172335601,49,18,490,3,477
381,5,255,111.4790022675737,113.05795918367347,49,28,259,2,250
382,5,270,111.4790022675737,114.42793650793651,49,27,294,3,265
383,5,431,111.4790022675737,113.19727891156462,49,20,432,2,426
384,5,482,111.4790022675737,114.0564172335601,49,18,490,3,477
385,5,4,112.89541950113379,115.58893424036282,50,45,116,3,1
386,5,270,112.89541950113379,114.42793650793651,50,27,273,2,265
387,5,259,112.89541950113379,115.05487528344672,50,26,270,2,254
388,5,259,112.89541950113379,115.79791383219955,50,26,283,3,254
389,5,482,112.89541950113379,114.0564172335601,50,18,480,1,477
390,5,428,112.89541950113379,115.3102947845805,50,18,436,2,423
391,5,4,113.59201814058957,115.58893424036282,49,45,86,2,1
392,5,259,113.59201814058957,115.05487528344672,49,26,262,1,254
393,5,259,113.59201814058957,115.79791383219955,49,26,271,2,254
394,5,428,113.59201814058957,115.3102947845805,49,18,429,2,423
395,5,423,113.59201814058957,116.05333333333334,49,19,431,2,418
396,5,259,115.00843537414966,117.02857142857142,49,29,268,2,254
397,5,423,115.00843537414966,116.05333333333334,49,19,420,1,418
398,5,421,115.00843537414966,117.8877097505669,49,18,434,3,416
399,4,5,115.58893424036282,117.12145124716554,45,45,66,2,1
400,4,5,115.58893424036282,118.02702947845805,45,45,105,2,1
401,4,259,115.58893424036282,117.02857142857142,45,29,262,1,255
402,4,258,115.58893424036282,118.46820861678005,45,26,283,3,254
403,4,421,115.58893424036282,117.8877097505669,45,18,429,2,417
404,5,258,117.12145124716554,118.46820861678005,45,26,260,1,253
405,5,227,117.12145124716554,118.93260770975057,45,34,235,2,222
406,5,438,117.12145124716554,118.9558276643991,45,22,440,2,433
407,5,227,118.02702947845805,120.48834467120182,45,36,246,2,222
408,5,227,118.02702947845805,120.51156462585034,45,33,246,2,222
409,5,434,118.02702947845805,120.1168253968254,45,17,438,2,429
410,5,462,118.02702947845805,120.79020408163265,45,23,472,3,457
411,5,4,119.4898866213152,121.34748299319727,44,48,80,2,1
412,5,49,119.4898866213152,122.39238095238096,44,44,133,3,44
413,5,227,119.4898866213152,120.51156462585034,44,33,226,1,222
414,5,387,119.4898866213152,121.51002267573696,44,26,392,2,382
415,5,462,119.4898866213152,120.79020408163265,44,23,460,1,457
416,5,4,119.81496598639455,121.34748299319727,44,48,66,2,1
417,5,49,119.81496598639455,122.39238095238096,44,44,119,3,44
418,5,387,119.81496598639455,121.51002267573696,44,26,389,2,382
419,5,412,119.81496598639455,122.50848072562358,44,31,423,3,407
420,5,411,119.81496598639455,122.53170068027211,44,27,423,3,406
421,4,49,121.34748299319727,122.39238095238096,48,44,64,1,45
422,4,5,121.34748299319727,124.15709750566894,48,48,121,3,1
423,4,266,121.34748299319727,123.20507936507937,48,26,274,2,262
424,4,412,121.34748299319727,122.50848072562358,48,31,411,1,408
425,4,411,121.34748299319727,122.53170068027211,48,27,410,1,407
426,49,4,122.39238095238096,123.46049886621316,44,47,64,1,45
427,49,5,122.39238095238096,124.15709750566894,44,48,88,2,44
428,49,39,122.39238095238096,124.90013605442176,44,42,108,3,10
429,49,387,122.39238095238096,124.36607709750567,44,29,349,2,338
430,49,270,122.39238095238096,124.76081632653062,44,27,243,2,221
431,4,39,123.46049886621316,124.90013605442176,47,42,71,1,35
432,4,270,123.46049886621316,124.76081632653062,47,27,272,1,266
433,4,266,123.46049886621316,125.57351473922903,47,25,277,2,262
434,4,414,123.46049886621316,126.31655328798186,47,24,428,3,410
435,5,4,124.15709750566894,126.29333333333334,48,49,92,2,1
436,5,4,124.15709750566894,127.01315192743765,48,48,123,3,1
437,5,266,124.15709750566894,125.57351473922903,48,25,268,1,261
438,5,256,124.15709750566894,126.78095238095239,48,30,275,3,251
439,5,414,124.15709750566894,126.31655328798186,48,24,419,2,409
440,39,4,124.90013605442176,126.29333333333334,42,49,69,1,35
441,39,4,124.90013605442176,127.01315192743765,42,48,97,2,35
442,39,256,124.90013605442176,126.78095238095239,42,30,232,2,217
443,39,414,124.90013605442176,126.31655328798186,42,24,380,1,375
444,4,6,126.29333333333334,129.07972789115647,49,47,120,3,2
445,4,295,126.29333333333334,128.45278911564625,49,26,305,2,291
446,4,219,126.29333333333334,128.63854875283448,49,32,238,2,215
447,4,6,127.01315192743765,129.07972789115647,48,47,89,2,2
448,4,5,127.01315192743765,129.79954648526078,48,49,120,3,1
449,4,295,127.01315192743765,128.45278911564625,48,26,298,1,291
450,4,219,127.01315192743765,128.63854875283448,48,32,226,2,215
451,4,5,128.4063492063492,129.79954648526078,47,49,60,1,1
452,4,5,128.4063492063492,130.79800453514738,47,44,103,2,1
453,4,258,128.4063492063492,130.0085260770975,47,29,263,2,254
454,4,232,128.4063492063492,130.86766439909297,47,30,251,2,228
455,6,5,129.07972789115647,130.79800453514738,47,44,74,2,1
456,6,5,129.07972789115647,131.93578231292517,47,49,123,3,1
457,6,232,129.07972789115647,130.86766439909297,47,30,239,2,226
458,6,218,129.07972789115647,131.79646258503402,47,29,242,3,212
459,6,443,129.07972789115647,131.84290249433107,47,20,453,3,437
460,5,232,129.79954648526078,130.86766439909297,49,30,232,1,227
461,5,218,129.79954648526078,131.79646258503402,49,29,230,2,213
462,5,206,129.79954648526078,132.77170068027212,49,24,238,3,201
463,5,443,129.79954648526078,131.84290249433107,49,20,447,2,438
464,5,9,130.79800453514738,133.2825396825397,44,49,107,2,4
465,5,206,130.79800453514738,132.77170068027212,44,24,218,2,201
466,5,443,130.79800453514738,131.84290249433107,44,20,440,1,438
467,5,9,131.93578231292517,133.2825396825397,49,49,58,1,4
468,5,388,131.93578231292517,134.2577777777778,49,27,396,2,383
469,5,412,131.93578231292517,133.79337868480727,49,29,415,2,407
470,5,414,131.93578231292517,134.9079365079365,49,25,429,3,409
471,9,5,133.2825396825397,134.76861678004536,49,49,64,1,4
472,9,5,133.2825396825397,136.18503401360545,49,49,125,3,4
473,9,282,133.2825396825397,135.0008163265306,49,29,283,2,273
474,9,386,133.2825396825397,135.65097505668933,49,29,391,2,377
475,9,414,133.2825396825397,134.9079365079365,49,25,411,2,405
476,5,386,134.07201814058956,135.65097505668933,49,29,387,2,381
477,5,263,134.07201814058956,136.57977324263038,49,27,280,3,258
478,5,437,134.07201814058956,136.39401360544218,49,23,443,2,432
479,5,8,134.76861678004536,137.48535147392292,49,50,117,3,3
480,5,263,134.76861678004536,136.57977324263038,49,27,270,2,258
481,5,437,134.76861678004536,136.39401360544218,49,23,438,2,432
482,5,413,134.76861678004536,137.55501133786848,49,21,425,3,408
483,5,414,134.76861678004536,137.62467120181407,49,25,427,3,409
484,5,8,136.18503401360545,137.48535147392292,49,50,56,1,3
485,5,257,136.18503401360545,138.019410430839,49,28,264,2,252
486,5,413,136.18503401360545,137.55501133786848,49,21,412,1,408
487,5,414,136.18503401360545,137.62467120181407,49,25,414,1,409
488,8,5,137.48535147392292,138.9946485260771,50,47,65,2,3
489,8,5,137.48535147392292,140.41106575963718,50,48,126,3,3
490,8,211,137.48535147392292,139.29650793650794,50,24,217,2,203
491,8,219,137.48535147392292,139.94666666666666,50,32,236,2,211
492,8,430,137.48535147392292,139.29650793650794,50,20,429,2,422
493,5,211,137.76399092970522,139.29650793650794,48,24,216,2,206
494,5,219,137.76399092970522,139.94666666666666,48,32,234,2,214
495,5,430,137.76399092970522,139.29650793650794,48,20,430,2,425
496,5,258,138.9946485260771,141.27020408163267,47,30,271,2,253
497,5,8,140.41106575963718,143.33678004535147,48,50,126,3,3
498,5,262,140.41106575963718,142.1990022675737,48,29,268,2,257
499,5,218,140.41106575963718,143.12780045351474,48,30,243,3,213
500,5,8,141.15410430839003,143.33678004535147,49,50,94,2,3
501,5,262,141.15410430839003,142.1990022675737,49,29,261,1,257
502,5,218,141.15410430839003,143.12780045351474,49,30,229,2,213
503,5,206,141.15410430839003,144.12625850340137,49,31,238,3,201
504,5,8,141.8274829931973,143.33678004535147,49,50,65,2,3
505,5,218,141.8274829931973,143.12780045351474,49,30,220,1,213
506,5,206,141.8274829931973,144.12625850340137,49,31,224,2,201
507,8,26,143.33678004535147,144.9621768707483,50,40,72,2,18
508,8,48,143.33678004535147,145.70521541950114,50,34,110,2,40
509,5,26,143.77795918367346,144.9621768707483,49,40,55,1,21
510,5,48,143.77795918367346,145.70521541950114,49,34,93,2,43
511,5,213,143.77795918367346,146.40181405895692,49,13,237,3,208
512,26,213,144.9621768707483,146.40181405895692,40,13,197,1,187
513,48,26,145.70521541950114,147.0984126984127,34,38,64,1,22
514,26,48,147.0984126984127,148.49160997732426,38,36,64,1,22
515,26,77,147.0984126984127,149.3275283446712,38,36,109,2,51
516,26,24,147.0984126984127,149.74548752834468,38,37,114,3,2
517,26,257,147.0984126984127,149.2346485260771,38,25,249,2,231
518,48,24,148.49160997732426,149.74548752834468,36,37,59,1,24
519,48,29,148.49160997732426,150.95292517006803,36,37,108,2,19
520,77,29,149.3275283446712,150.95292517006803,36,37,85,2,48
521,77,73,149.3275283446712,152.23002267573696,36,38,125,3,4
522,24,29,149.74548752834468,150.95292517006803,37,37,52,1,5
523,24,73,149.74548752834468,152.23002267573696,37,38,118,2,49
524,24,25,149.74548752834468,152.71764172335602,37,40,128,3,1
525,24,258,149.74548752834468,152.57832199546485,37,28,264,3,234
526,29,73,150.95292517006803,152.23002267573696,37,38,70,1,44
527,29,25,150.95292517006803,152.71764172335602,37,40,76,2,4
528,29,258,150.95292517006803,152.57832199546485,37,28,239,2,229
529,29,207,150.95292517006803,153.4374603174603,37,28,208,2,178
530,29,260,150.95292517006803,153.64643990929704,37,25,258,3,231
531,73,39,152.23002267573696,154.64489795918368,38,36,109,2,34
532,73,39,152.23002267573696,154.6681179138322,38,37,110,2,34
533,73,207,152.23002267573696,153.4374603174603,38,28,144,1,134
534,73,260,152.23002267573696,153.64643990929704,38,25,197,1,187
535,73,268,152.23002267573696,154.6681179138322,38,16,221,2,195
536,25,39,152.71764172335602,154.64489795918368,40,36,84,2,14
537,25,39,152.71764172335602,154.6681179138322,40,37,85,2,14
538,25,86,152.71764172335602,155.66657596371883,40,27,141,3,61
539,25,268,152.71764172335602,154.6681179138322,40,16,257,2,243
540,39,86,154.64489795918368,155.66657596371883,36,27,64,1,47
541,39,43,154.64489795918368,156.66503401360544,36,14,87,2,4
542,39,43,154.6681179138322,156.66503401360544,37,14,86,2,4
543,244,49,30.998639455782314,32.04353741496599,21,42,200,1,195
544,244,24,30.998639455782314,32.60081632653061,21,41,231,2,220
545,244,51,30.998639455782314,33.483174603174604,21,42,221,2,193
546,244,388,30.998639455782314,32.60081632653061,21,27,160,2,144
547,244,413,30.998639455782314,32.113197278911564,21,26,176,1,169
548,244,412,30.998639455782314,32.15963718820862,21,30,175,1,168
549,244,592,30.998639455782314,33.41351473922902,21,24,363,2,348
550,244,630,30.998639455782314,32.15963718820862,21,20,389,1,386
551,244,637,30.998639455782314,33.69215419501134,21,21,410,3,393
552,387,24,31.161179138321994,32.60081632653061,26,41,368,1,363
553,387,51,31.161179138321994,33.483174603174604,26,42,351,2,336
554,387,73,31.161179138321994,34.13333333333333,26,41,339,3,314
555,387,388,31.161179138321994,32.60081632653061,26,27,62,1,1
556,387,386,31.161179138321994,34.0172335600907,26,29,123,3,1
557,387,592,31.161179138321994,33.41351473922902,26,24,227,2,205
558,387,637,31.161179138321994,33.69215419501134,26,21,273,3,250
559,387,873,31.161179138321994,33.69215419501134,26,22,498,3,486
560,388,73,32.60081632653061,34.13333333333333,27,41,322,2,315
561,388,24,32.60081632653061,35.50331065759637,27,42,385,3,364
562,388,386,32.60081632653061,34.0172335600907,27,29,61,1,2
563,388,316,32.60081632653061,35.085351473922906,27,23,129,2,72
564,388,450,32.60081632653061,34.78349206349206,27,21,113,2,62
565,388,637,32.60081632653061,33.69215419501134,27,21,253,1,249
566,388,700,32.60081632653061,34.22621315192744,27,20,320,2,312
567,388,873,32.60081632653061,33.69215419501134,27,22,487,1,485
568,388,843,32.60081632653061,34.22621315192744,27,20,460,2,455
569,386,24,34.0172335600907,35.50331065759637,29,42,368,1,362
570,386,52,34.0172335600907,36.31600907029478,29,43,348,2,334
571,386,316,34.0172335600907,35.085351473922906,29,23,84,1,70
572,386,267,34.0172335600907,35.92126984126984,29,27,145,2,119
573,386,261,34.0172335600907,36.80362811791383,29,28,173,3,125
574,386,414,34.0172335600907,35.9677097505669,29,25,89,2,28
575,386,410,34.0172335600907,36.87328798185941,29,23,125,3,24
576,386,776,34.0172335600907,36.08380952380953,29,20,400,2,390
577,386,796,34.0172335600907,36.385668934240364,29,25,422,2,410
578,386,850,34.0172335600907,35.944489795918365,29,18,471,2,464
579,386,821,34.0172335600907,36.40888888888889,29,20,447,2,435
580,316,52,35.085351473922906,36.31600907029478,23,43,269,1,264
581,316,39,35.085351473922906,37.45378684807256,23,43,295,2,277
582,316,261,35.085351473922906,36.80362811791383,23,28,92,2,55
583,316,244,35.085351473922906,38.01106575963719,23,24,145,3,72
584,316,410,35.085351473922906,36.87328798185941,23,23,122,2,94
585,316,796,35.085351473922906,36.385668934240364,23,25,483,1,480
586,316,618,35.085351473922906,37.70920634920635,23,18,322,3,302
587,267,39,35.92126984126984,37.45378684807256,27,43,237,2,228
588,267,49,35.92126984126984,38.33614512471655,27,41,242,2,218
589,267,244,35.92126984126984,38.01106575963719,27,24,93,2,23
590,267,219,35.92126984126984,38.2897052154195,27,33,113,2,48
591,267,590,35.92126984126984,38.080725623582765,27,23,336,2,323
592,267,560,35.92126984126984,38.26648526077098,27,24,310,2,293
593,267,618,35.92126984126984,37.70920634920635,27,18,359,2,351
594,267,657,35.92126984126984,38.26648526077098,27,20,403,2,390
595,261,49,36.80362811791383,38.33614512471655,28,41,222,2,212
596,261,24,36.80362811791383,39.38104308390023,28,41,262,3,237
597,261,244,36.80362811791383,38.01106575963719,28,24,55,1,17
598,261,219,36.80362811791383,38.2897052154195,28,33,77,1,42
599,261,259,36.80362811791383,39.14884353741497,28,29,101,2,2
600,261,590,36.80362811791383,38.080725623582765,28,23,334,1,329
601,261,560,36.80362811791383,38.26648526077098,28,24,306,1,299
602,261,566,36.80362811791383,39.68290249433107,28,27,329,3,305
603,261,657,36.80362811791383,38.26648526077098,28,20,401,1,396
604,261,617,36.80362811791383,39.68290249433107,28,23,377,3,356
605,244,24,38.01106575963719,39.38104308390023,24,41,228,1,220
606,244,26,38.01106575963719,40.56526077097506,24,42,244,3,218
607,244,259,38.01106575963719,39.14884353741497,24,29,51,1,15
608,244,207,38.01106575963719,40.49560090702948,24,27,113,2,37
609,244,566,38.01106575963719,39.68290249433107,24,27,330,2,322
610,244,576,38.01106575963719,40.72780045351474,24,25,352,3,332
611,244,617,38.01106575963719,39.68290249433107,24,23,380,2,373
612,244,634,38.01106575963719,40.72780045351474,24,23,407,3,390
613,219,24,38.2897052154195,39.38104308390023,33,41,201,1,195
614,219,26,38.2897052154195,40.56526077097506,33,42,216,2,193
615,219,207,38.2897052154195,40.49560090702948,33,27,96,2,12
616,219,566,38.2897052154195,39.68290249433107,33,27,352,1,347
617,219,576,38.2897052154195,40.72780045351474,33,25,372,2,357
618,219,617,38.2897052154195,39.68290249433107,33,23,402,1,398
619,219,634,38.2897052154195,40.72780045351474,33,23,428,2,415
620,259,26,39.14884353741497,40.56526077097506,29,42,241,1,233
621,259,49,39.14884353741497,41.28507936507937,29,40,229,2,210
622,259,207,39.14884353741497,40.49560090702948,29,27,78,1,52
623,259,230,39.14884353741497,41.56371882086168,29,24,108,2,29
624,259,576,39.14884353741497,40.72780045351474,29,25,324,2,317
625,259,596,39.14884353741497,41.28507936507937,29,11,349,2,337
626,259,634,39.14884353741497,40.72780045351474,29,23,381,2,375
627,259,736,39.14884353741497,41.308299319727894,29,13,486,2,477
628,207,5,40.49560090702948,42.306757369614516,27,49,217,2,202
629,207,230,40.49560090702948,41.56371882086168,27,24,51,1,23
630,207,288,40.49560090702948,42.70149659863946,27,33,125,2,81
631,207,548,40.49560090702948,42.840816326530614,27,19,356,2,341
632,207,643,40.49560090702948,42.678276643990934,27,19,446,2,436
633,230,5,41.56371882086168,43.69995464852608,24,50,243,2,225
634,230,288,41.56371882086168,42.70149659863946,24,33,76,1,58
635,230,263,41.56371882086168,43.560634920634925,24,33,92,2,33
636,230,548,41.56371882086168,42.840816326530614,24,19,323,1,318
637,230,518,41.56371882086168,44.04825396825397,24,19,307,2,288
638,230,643,41.56371882086168,42.678276643990934,24,19,416,1,413
639,230,622,41.56371882086168,44.00181405895692,24,16,406,2,392
640,288,5,42.70149659863946,45.11637188208617,33,49,302,2,283
641,288,292,42.70149659863946,44.81451247165533,33,28,91,2,4
642,288,229,42.70149659863946,45.51111111111111,33,32,135,3,59
643,288,518,42.70149659863946,44.04825396825397,33,19,237,1,230
644,288,431,42.70149659863946,44.72163265306123,33,19,167,2,143
645,288,425,42.70149659863946,45.51111111111111,33,20,183,3,137
646,288,622,42.70149659863946,44.00181405895692,33,16,339,1,334
647,288,643,42.70149659863946,44.81451247165533,33,17,366,2,355
648,263,5,43.560634920634925,45.11637188208617,33,49,267,2,258
649,263,6,43.560634920634925,45.81297052154195,33,50,275,2,257
650,263,292,43.560634920634925,44.81451247165533,33,28,61,1,29
651,263,229,43.560634920634925,45.51111111111111,33,32,91,2,34
652,263,431,43.560634920634925,44.72163265306123,33,19,175,1,168
653,263,425,43.560634920634925,45.51111111111111,33,20,182,2,162
654,263,554,43.560634920634925,46.439909297052154,33,23,316,3,291
655,263,643,43.560634920634925,44.81451247165533,33,17,384,1,380
656,263,632,43.560634920634925,46.11482993197279,33,17,385,3,369
657,263,623,43.560634920634925,46.32380952380952,33,19,379,3,360
658,292,4,44.81451247165533,47.06684807256236,28,48,304,2,288
659,292,233,44.81451247165533,46.741768707483,28,30,102,2,59
660,292,263,44.81451247165533,47.600907029478456,28,30,123,3,29
661,292,554,44.81451247165533,46.439909297052154,28,23,271,2,262
662,292,431,44.81451247165533,47.53124716553288,28,18,182,3,139
663,292,632,44.81451247165533,46.11482993197279,28,17,345,1,340
664,292,623,44.81451247165533,46.32380952380952,28,19,337,2,331
665,292,634,44.81451247165533,47.53124716553288,28,18,361,3,342
666,229,4,45.51111111111111,47.06684807256236,32,48,235,2,225
667,229,5,45.51111111111111,47.94920634920635,32,49,247,2,224
668,229,233,45.51111111111111,46.741768707483,32,30,53,1,4
669,229,263,45.51111111111111,47.600907029478456,32,30,96,2,34
670,229,255,45.51111111111111,48.34394557823129,32,28,125,3,26
671,229,431,45.51111111111111,47.53124716553288,32,18,220,2,202
672,229,606,45.51111111111111,48.34394557823129,32,19,396,3,377
673,229,634,45.51111111111111,47.53124716553288,32,18,414,2,405
674,229,635,45.51111111111111,48.22784580498866,32,18,423,3,406
675,233,5,46.741768707483,47.94920634920635,30,49,234,1,228
676,233,5,46.741768707483,48.66902494331066,30,49,243,2,228
677,233,5,46.741768707483,49.36562358276644,30,50,254,3,228
678,233,255,46.741768707483,48.34394557823129,30,28,72,2,22
679,233,205,46.741768707483,49.24952380952381,30,29,112,3,28
680,233,606,46.741768707483,48.34394557823129,30,19,379,2,373
681,233,583,46.741768707483,49.24952380952381,30,19,366,3,350
682,233,635,46.741768707483,48.22784580498866,30,18,407,1,402
683,233,642,46.741768707483,49.24952380952381,30,18,423,3,409
684,263,5,47.600907029478456,48.66902494331066,30,49,262,1,258
685,263,5,47.600907029478456,49.36562358276644,30,50,269,2,258
686,263,205,47.600907029478456,49.24952380952381,30,29,92,2,58
687,263,583,47.600907029478456,49.24952380952381,30,19,328,2,320
688,263,642,47.600907029478456,49.24952380952381,30,18,386,2,379
689,255,5,48.34394557823129,49.36562358276644,28,50,254,1,250
690,255,5,48.34394557823129,50.78204081632653,28,49,271,2,250
691,255,261,48.34394557823129,51.13034013605442,28,32,120,3,6
692,255,421,48.34394557823129,51.17678004535148,28,21,206,3,166
693,205,5,49.24952380952381,50.78204081632653,29,49,211,2,200
694,205,5,49.24952380952381,51.45541950113379,29,50,221,2,200
695,205,261,49.24952380952381,51.13034013605442,29,32,98,2,56
696,205,259,49.24952380952381,51.85015873015873,29,33,124,3,54
697,205,421,49.24952380952381,51.17678004535148,29,21,231,2,216
698,205,583,49.24952380952381,51.89659863945578,29,25,395,3,378
699,205,615,49.24952380952381,51.89659863945578,29,23,426,3,410
700,261,4,51.13034013605442,52.7092970521542,32,47,266,2,257
701,261,8,51.13034013605442,53.38267573696145,32,50,271,2,253
702,261,262,51.13034013605442,52.54675736961451,32,33,61,1,1
703,261,589,51.13034013605442,52.7092970521542,32,20,335,2,328
704,261,615,51.13034013605442,53.173696145124715,32,17,365,2,354
705,261,615,51.13034013605442,53.8702947845805,32,16,373,3,354
706,259,8,51.85015873015873,53.38267573696145,33,50,260,2,251
707,259,232,51.85015873015873,54.19537414965986,33,30,105,2,27
708,259,260,51.85015873015873,54.79909297052154,33,33,127,3,1
709,259,438,51.85015873015873,54.19537414965986,33,21,206,2,179
710,259,615,51.85015873015873,53.173696145124715,33,17,361,1,356
711,259,615,51.85015873015873,53.8702947845805,33,16,366,2,356
712,259,650,51.85015873015873,54.77587301587302,33,18,411,3,391
713,262,5,52.54675736961451,55.00807256235828,33,49,278,2,257
714,262,232,52.54675736961451,54.19537414965986,33,30,77,2,30
715,262,260,52.54675736961451,54.79909297052154,33,33,97,2,2
716,262,271,52.54675736961451,55.24027210884354,33,22,116,3,9
717,262,438,52.54675736961451,54.19537414965986,33,21,190,2,176
718,262,453,52.54675736961451,54.89197278911565,33,24,216,2,191
719,262,615,52.54675736961451,53.8702947845805,33,16,358,1,353
720,262,650,52.54675736961451,54.77587301587302,33,18,400,2,388
721,262,620,52.54675736961451,55.28671201814059,33,15,377,3,358
722,232,5,54.19537414965986,55.70467120181406,30,48,236,2,227
723,232,5,54.19537414965986,56.42448979591837,30,49,246,2,227
724,232,271,54.19537414965986,55.24027210884354,30,22,60,1,39
725,232,233,54.19537414965986,57.0746485260771,30,27,124,3,1
726,232,422,54.19537414965986,55.843990929705214,30,20,203,2,190
727,232,436,54.19537414965986,56.91210884353742,30,19,235,3,204
728,232,620,54.19537414965986,55.28671201814059,30,15,391,1,388
729,232,650,54.19537414965986,56.679909297052156,30,16,431,2,418
730,260,5,54.79909297052154,56.42448979591837,33,49,264,2,255
731,260,233,54.79909297052154,57.0746485260771,33,27,102,2,27
732,260,292,54.79909297052154,57.65514739229025,33,29,127,3,32
733,260,422,54.79909297052154,55.843990929705214,33,20,168,1,162
734,260,436,54.79909297052154,56.91210884353742,33,19,198,2,176
735,260,421,54.79909297052154,57.67836734693878,33,25,203,3,161
736,260,650,54.79909297052154,56.679909297052156,33,16,398,2,390
737,260,618,54.79909297052154,57.58548752834467,33,20,378,3,358
738,271,5,55.24027210884354,56.42448979591837,22,49,271,1,266
739,271,5,55.24027210884354,57.84090702947846,22,47,289,3,266
740,271,233,55.24027210884354,57.0746485260771,22,27,88,2,38
741,271,292,55.24027210884354,57.65514739229025,22,29,106,2,21
742,271,436,55.24027210884354,56.91210884353742,22,19,180,2,165
743,271,421,55.24027210884354,57.67836734693878,22,25,183,2,150
744,271,650,55.24027210884354,56.679909297052156,22,16,384,1,379
745,271,618,55.24027210884354,57.58548752834467,22,20,361,2,347
746,233,5,57.0746485260771,58.537505668934244,27,49,237,1,228
747,233,259,57.0746485260771,58.583945578231294,27,25,70,2,26
748,233,258,57.0746485260771,59.90748299319728,27,26,125,3,25
749,233,431,57.0746485260771,58.83936507936508,27,19,212,2,198
750,233,517,57.0746485260771,59.97714285714286,27,21,310,3,284
751,233,616,57.0746485260771,58.816145124716556,27,15,390,2,383
752,233,646,57.0746485260771,59.97714285714286,27,16,432,3,413
753,292,4,57.65514739229025,60.186122448979596,29,44,308,3,288
754,292,258,57.65514739229025,59.90748299319728,29,26,103,2,34
755,292,291,57.65514739229025,60.53442176870748,29,28,124,3,1
756,292,431,57.65514739229025,58.83936507936508,29,19,148,1,139
757,292,517,57.65514739229025,59.97714285714286,29,21,246,2,225
758,292,549,57.65514739229025,60.51120181405896,29,24,285,3,257
759,292,616,57.65514739229025,58.816145124716556,29,15,328,1,324
760,292,646,57.65514739229025,59.97714285714286,29,16,368,2,354
761,292,619,57.65514739229025,60.395102040816326,29,21,348,3,327
762,259,4,58.583945578231294,60.186122448979596,25,44,264,2,255
763,259,5,58.583945578231294,60.65052154195011,25,46,269,2,254
764,259,258,58.583945578231294,59.90748299319728,25,26,57,1,1
765,259,291,58.583945578231294,60.53442176870748,25,28,90,2,32
766,259,517,58.583945578231294,59.97714285714286,25,21,265,1,258
767,259,549,58.583945578231294,60.51120181405896,25,24,302,2,290
768,259,646,58.583945578231294,59.97714285714286,25,16,392,1,387
769,259,619,58.583945578231294,60.395102040816326,25,21,368,2,360
770,258,5,59.90748299319728,61.90439909297052,26,46,267,2,253
771,258,5,59.90748299319728,62.252698412698415,26,45,272,2,253
772,258,271,59.90748299319728,62.11337868480726,26,30,96,2,13
773,258,261,59.90748299319728,62.415238095238095,26,33,108,3,3
774,258,579,59.90748299319728,62.04371882086168,26,23,334,2,321
775,258,757,59.90748299319728,62.136598639455784,26,21,508,2,499
776,291,5,60.53442176870748,61.90439909297052,28,46,292,1,286
777,291,5,60.53442176870748,62.252698412698415,28,45,295,2,286
778,291,5,60.53442176870748,63.34403628117914,28,44,311,3,286
779,291,271,60.53442176870748,62.11337868480726,28,30,71,2,20
780,291,261,60.53442176870748,62.415238095238095,28,33,86,2,30
781,291,579,60.53442176870748,62.04371882086168,28,23,295,2,288
782,291,551,60.53442176870748,63.181496598639455,28,25,284,3,260
783,291,580,60.53442176870748,63.43691609977324,28,24,315,3,289
784,291,757,60.53442176870748,62.136598639455784,28,21,471,2,466
785,291,615,60.53442176870748,63.181496598639455,28,23,343,3,324
786,291,764,60.53442176870748,63.506575963718824,28,18,490,3,473
787,271,5,62.11337868480726,63.34403628117914,30,44,271,1,266
788,271,7,62.11337868480726,64.57469387755103,30,50,284,2,264
789,271,262,62.11337868480726,63.831655328798185,30,34,75,2,9
790,271,387,62.11337868480726,65.03909297052154,30,26,171,3,116
791,271,551,62.11337868480726,63.181496598639455,30,25,284,1,280
792,271,580,62.11337868480726,63.43691609977324,30,24,314,1,309
793,271,615,62.11337868480726,63.181496598639455,30,23,347,1,344
794,271,764,62.11337868480726,63.506575963718824,30,18,497,1,493
795,271,621,62.11337868480726,65.06231292517008,30,23,372,3,350
796,261,7,62.415238095238095,64.57469387755103,33,50,270,2,254
797,261,8,62.415238095238095,65.38739229024944,33,49,284,3,253
798,261,262,62.415238095238095,63.831655328798185,33,34,61,1,1
799,261,387,62.415238095238095,65.03909297052154,33,26,169,3,126
800,261,233,62.415238095238095,65.36417233560091,33,26,130,3,28
801,261,580,62.415238095238095,63.43691609977324,33,24,322,1,319
802,261,566,62.415238095238095,65.10875283446713,33,21,326,3,305
803,261,621,62.415238095238095,65.06231292517008,33,23,378,3,360
804,262,8,63.831655328798185,65.38739229024944,34,49,263,2,254
805,262,387,63.831655328798185,65.03909297052154,34,26,135,1,125
806,262,233,63.831655328798185,65.36417233560091,34,26,72,2,29
807,262,566,63.831655328798185,65.10875283446713,34,21,309,1,304
808,262,412,63.831655328798185,66.03755102040816,34,31,178,2,150
809,262,415,63.831655328798185,66.6877097505669,34,24,196,3,153
810,262,621,63.831655328798185,65.06231292517008,34,23,363,1,359
811,262,628,63.831655328798185,65.92145124716554,34,21,377,2,366
812,262,726,63.831655328798185,66.50195011337868,34,20,478,3,464
813,387,5,65.03909297052154,66.98956916099773,26,49,391,2,382
814,387,5,65.03909297052154,67.70938775510204,26,47,399,3,382
815,387,283,65.03909297052154,67.26820861678004,26,29,142,2,104
816,387,386,65.03909297052154,67.89514739229026,26,30,123,3,1
817,387,415,65.03909297052154,66.6877097505669,26,24,76,2,28
818,387,412,65.03909297052154,67.43074829931973,26,21,106,2,25
819,387,726,65.03909297052154,66.50195011337868,26,20,345,1,339
820,387,757,65.03909297052154,67.57006802721088,26,22,386,3,370
821,233,5,65.36417233560091,66.98956916099773,26,49,239,2,228
822,233,5,65.36417233560091,67.70938775510204,26,47,249,2,228
823,233,283,65.36417233560091,67.26820861678004,26,29,96,2,50
824,233,386,65.36417233560091,67.89514739229026,26,30,188,3,153
825,233,415,65.36417233560091,66.6877097505669,26,24,191,1,182
826,233,412,65.36417233560091,67.43074829931973,26,21,200,2,179
827,233,726,65.36417233560091,66.50195011337868,26,20,495,1,493
828,283,5,67.26820861678004,68.40598639455783,29,49,282,1,278
829,283,8,67.26820861678004,69.72952380952381,29,50,295,2,275
830,283,211,67.26820861678004,68.70784580498866,29,25,95,1,72
831,283,266,67.26820861678004,69.38122448979593,29,26,93,2,17
832,283,436,67.26820861678004,68.63818594104309,29,23,164,1,153
833,283,414,67.26820861678004,69.84562358276644,29,25,172,3,131
834,283,632,67.26820861678004,68.70784580498866,29,20,354,1,349
835,386,8,67.89514739229026,69.72952380952381,30,50,386,2,378
836,386,266,67.89514739229026,69.38122448979593,30,26,136,1,120
837,386,256,67.89514739229026,70.31002267573696,30,28,166,2,130
838,386,414,67.89514739229026,69.84562358276644,30,25,89,2,28
839,386,410,67.89514739229026,70.75120181405896,30,21,125,3,24
840,386,796,67.89514739229026,70.26358276643991,30,24,422,2,410
841,386,615,67.89514739229026,70.28680272108843,30,23,251,2,229
842,386,821,67.89514739229026,70.26358276643991,30,18,447,2,435
843,386,821,67.89514739229026,70.28680272108843,30,21,447,2,435
844,211,8,68.70784580498866,69.72952380952381,25,50,208,1,203
845,211,5,68.70784580498866,71.23882086167801,25,48,233,3,206
846,211,256,68.70784580498866,70.31002267573696,25,28,82,2,45
847,211,414,68.70784580498866,69.84562358276644,25,25,209,1,203
848,211,410,68.70784580498866,70.75120181405896,25,21,218,2,199
849,211,615,68.70784580498866,70.28680272108843,25,23,410,2,404
850,266,5,69.38122448979593,71.23882086167801,26,48,273,2,261
851,266,6,69.38122448979593,71.91219954648527,26,45,282,3,260
852,266,219,69.38122448979593,72.16761904761906,26,34,129,3,47
853,266,410,69.38122448979593,70.75120181405896,26,21,156,1,144
854,266,560,69.38122448979593,72.14439909297052,26,26,317,3,294
855,266,657,69.38122448979593,72.14439909297052,26,21,409,3,391
856,256,6,70.31002267573696,71.91219954648527,28,45,259,2,250
857,256,5,70.31002267573696,72.65523809523809,28,49,271,2,251
858,256,219,70.31002267573696,72.16761904761906,28,34,88,2,37
859,256,363,70.31002267573696,72.79455782312925,28,29,151,2,107
860,256,560,70.31002267573696,72.14439909297052,28,26,314,2,304
861,256,411,70.31002267573696,73.09641723356009,28,22,196,3,155
862,256,657,70.31002267573696,72.14439909297052,28,21,409,2,401
863,256,621,70.31002267573696,72.93387755102042,28,20,382,3,365
864,219,5,72.16761904761906,73.3750566893424,34,50,220,1,214
865,219,5,72.16761904761906,74.76825396825397,34,48,242,3,214
866,219,258,72.16761904761906,73.51437641723356,34,30,70,1,39
867,219,206,72.16761904761906,74.39673469387755,34,30,97,2,13
868,219,566,72.16761904761906,73.56081632653061,34,28,352,1,347
869,219,576,72.16761904761906,74.62893424036281,34,26,372,2,357
870,219,695,72.16761904761906,73.58403628117914,34,23,480,1,476
871,219,634,72.16761904761906,74.60571428571428,34,25,428,2,415
872,363,5,72.79455782312925,74.76825396825397,29,48,368,2,358
873,363,8,72.79455782312925,75.58095238095238,29,50,375,3,355
874,363,206,72.79455782312925,74.39673469387755,29,30,171,2,157
875,363,576,72.79455782312925,74.62893424036281,29,26,227,2,213
876,363,552,72.79455782312925,75.7667120181406,29,20,228,3,189
877,363,634,72.79455782312925,74.60571428571428,29,25,282,2,271
878,363,634,72.79455782312925,75.7667120181406,29,17,300,3,271
879,258,5,73.51437641723356,74.76825396825397,30,48,259,1,253
880,258,8,73.51437641723356,75.58095238095238,30,50,265,2,250
881,258,217,73.51437641723356,76.06857142857143,30,24,117,3,41
882,258,387,73.51437641723356,76.39365079365079,30,24,179,3,129
883,258,576,73.51437641723356,74.62893424036281,30,26,322,1,318
884,258,552,73.51437641723356,75.7667120181406,30,20,310,2,294
885,258,634,73.51437641723356,74.60571428571428,30,25,379,1,376
886,258,634,73.51437641723356,75.7667120181406,30,17,388,2,376
887,258,621,73.51437641723356,76.37043083900227,30,22,383,3,363
888,206,8,74.39673469387755,75.58095238095238,30,50,204,1,198
889,206,5,74.39673469387755,76.88126984126984,30,49,228,2,201
890,206,217,74.39673469387755,76.06857142857143,30,24,73,2,11
891,206,387,74.39673469387755,76.39365079365079,30,24,200,2,181
892,206,552,74.39673469387755,75.7667120181406,30,20,351,1,346
893,206,413,74.39673469387755,77.29922902494332,30,27,242,3,207
894,206,412,74.39673469387755,77.32244897959184,30,29,241,3,206
895,206,634,74.39673469387755,75.7667120181406,30,17,432,1,428
896,206,621,74.39673469387755,76.37043083900227,30,22,424,2,415
897,206,630,74.39673469387755,77.34566893424036,30,21,443,3,424
898,217,5,76.06857142857143,78.29768707482994,24,49,233,2,212
899,217,5,76.06857142857143,78.99428571428571,24,48,247,3,212
900,217,388,76.06857142857143,77.78684807256236,24,27,186,2,171
901,217,413,76.06857142857143,77.29922902494332,24,27,203,1,196
902,217,412,76.06857142857143,77.32244897959184,24,29,202,1,195
903,217,414,76.06857142857143,78.43700680272109,24,24,222,2,197
904,217,630,76.06857142857143,77.34566893424036,24,21,417,1,413
905,387,5,76.39365079365079,78.29768707482994,24,49,391,2,382
906,387,5,76.39365079365079,78.99428571428571,24,48,398,3,382
907,387,388,76.39365079365079,77.78684807256236,24,27,60,1,1
908,387,414,76.39365079365079,78.43700680272109,24,24,92,2,27
909,387,757,76.39365079365079,78.85496598639456,24,21,385,2,370
910,387,872,76.39365079365079,78.85496598639456,24,23,496,2,485
911,388,5,77.78684807256236,78.99428571428571,27,48,387,1,383
912,388,5,77.78684807256236,79.71410430839002,27,49,392,2,383
913,388,387,77.78684807256236,79.18004535147392,27,29,60,1,1
914,388,316,77.78684807256236,80.27138321995464,27,24,129,2,72
915,388,437,77.78684807256236,79.92308390022676,27,22,104,2,49
916,388,757,77.78684807256236,78.85496598639456,27,21,372,1,369
917,388,633,77.78684807256236,79.99274376417233,27,19,263,2,245
918,388,872,77.78684807256236,78.85496598639456,27,23,486,1,484
919,388,843,77.78684807256236,79.41224489795918,27,20,460,2,455
920,387,8,79.18004535147392,81.01442176870748,29,50,387,2,379
921,387,8,79.18004535147392,81.57170068027212,29,51,393,2,379
922,387,316,79.18004535147392,80.27138321995464,29,24,85,1,71
923,387,388,79.18004535147392,81.24662131519274,29,24,89,2,1
924,387,256,79.18004535147392,82.03609977324263,29,28,180,3,131
925,387,414,79.18004535147392,81.15374149659864,29,26,89,2,27
926,387,410,79.18004535147392,81.61814058956917,29,19,107,2,23
927,387,776,79.18004535147392,81.24662131519274,29,20,399,2,389
928,387,796,79.18004535147392,81.57170068027212,29,24,422,2,409
929,387,851,79.18004535147392,81.13052154195012,29,18,472,2,464
930,387,821,79.18004535147392,81.59492063492064,29,21,446,2,434
931,316,8,80.27138321995464,81.57170068027212,24,51,313,1,308
932,316,8,80.27138321995464,82.33795918367348,24,48,321,2,308
933,316,256,80.27138321995464,82.03609977324263,24,28,97,2,60
934,316,314,80.27138321995464,82.63981859410431,24,23,102,2,2
935,316,410,80.27138321995464,81.61814058956917,24,19,110,1,94
936,316,796,80.27138321995464,81.57170068027212,24,24,483,1,480
937,316,622,80.27138321995464,82.84879818594105,24,17,326,3,306
938,388,8,81.24662131519274,82.33795918367348,24,48,383,1,380
939,388,5,81.24662131519274,83.94013605442177,24,48,400,3,383
940,388,314,81.24662131519274,82.63981859410431,24,23,95,1,74
941,388,218,81.24662131519274,83.47573696145125,24,33,195,2,170
942,388,590,81.24662131519274,83.26675736961451,24,22,220,2,202
943,388,558,81.24662131519274,83.47573696145125,24,25,195,2,170
944,388,622,81.24662131519274,82.84879818594105,24,17,244,2,234
945,388,657,81.24662131519274,83.4292970521542,24,20,285,2,269
946,256,5,82.03609977324263,83.94013605442177,28,48,264,2,251
947,256,5,82.03609977324263,84.65995464852608,28,49,275,3,251
948,256,218,82.03609977324263,83.47573696145125,28,33,73,1,38
949,256,258,82.03609977324263,84.82249433106576,28,29,120,3,2
950,256,590,82.03609977324263,83.26675736961451,28,22,338,1,334
951,256,558,82.03609977324263,83.47573696145125,28,25,308,1,302
952,256,566,82.03609977324263,84.8457142857143,28,28,333,3,310
953,256,657,82.03609977324263,83.4292970521542,28,20,405,1,401
954,256,617,82.03609977324263,84.8457142857143,28,23,381,3,361
955,314,5,82.63981859410431,83.94013605442177,23,48,314,1,309
956,314,5,82.63981859410431,84.65995464852608,23,49,321,2,309
957,314,258,82.63981859410431,84.82249433106576,23,29,109,2,56
958,314,566,82.63981859410431,84.8457142857143,23,28,269,2,252
959,314,617,82.63981859410431,84.8457142857143,23,23,318,2,303
960,218,5,83.47573696145125,84.65995464852608,33,49,219,1,213
961,218,8,83.47573696145125,86.16925170068028,33,49,240,3,210
962,218,258,83.47573696145125,84.82249433106576,33,29,70,1,40
963,218,206,83.47573696145125,85.68163265306123,33,28,96,2,12
964,218,566,83.47573696145125,84.8457142857143,33,28,353,1,348
965,218,576,83.47573696145125,85.91383219954649,33,26,373,2,358
966,218,429,83.47573696145125,86.35501133786848,33,19,245,3,211
967,218,617,83.47573696145125,84.8457142857143,33,23,403,1,399
968,218,634,83.47573696145125,85.91383219954649,33,24,429,2,416
969,258,8,84.82249433106576,86.16925170068028,29,49,257,1,250
970,258,6,84.82249433106576,86.74975056689343,29,49,265,2,252
971,258,289,84.82249433106576,86.51755102040816,29,24,79,2,31
972,258,576,84.82249433106576,85.91383219954649,29,26,321,1,318
973,258,429,84.82249433106576,86.35501133786848,29,19,183,2,171
974,258,561,84.82249433106576,87.74820861678005,29,16,328,3,303
975,258,634,84.82249433106576,85.91383219954649,29,24,379,1,376
976,258,621,84.82249433106576,87.05160997732426,29,18,375,2,363
977,206,6,85.68163265306123,86.74975056689343,28,49,205,1,200
978,206,97,85.68163265306123,88.00362811791383,28,41,148,2,109
979,206,227,85.68163265306123,88.16616780045352,28,29,109,2,21
980,206,333,85.68163265306123,88.51446712018141,28,20,176,3,127
981,206,561,85.68163265306123,87.74820861678005,28,16,366,2,355
982,206,621,85.68163265306123,87.05160997732426,28,18,419,1,415
983,289,97,86.51755102040816,88.00362811791383,24,41,202,1,192
984,289,58,86.51755102040816,89.28072562358277,24,41,260,3,231
985,289,227,86.51755102040816,88.16616780045352,24,29,94,2,62
986,289,333,86.51755102040816,88.51446712018141,24,20,97,2,44
987,289,231,86.51755102040816,89.44326530612246,24,23,139,3,58
988,289,561,86.51755102040816,87.74820861678005,24,16,277,1,272
989,289,608,86.51755102040816,89.32716553287982,24,16,341,3,319
990,289,666,86.51755102040816,89.35038548752834,24,18,396,3,377
991,289,636,86.51755102040816,89.46648526077098,24,20,370,3,347
992,227,58,88.16616780045352,89.28072562358277,29,41,176,1,169
993,227,5,88.16616780045352,90.30240362811791,29,49,240,2,222
994,227,5,88.16616780045352,90.9990022675737,29,50,253,3,222
995,227,231,88.16616780045352,89.44326530612246,29,23,55,1,4
996,227,228,88.16616780045352,91.02222222222223,29,33,123,3,1
997,227,608,88.16616780045352,89.32716553287982,29,16,384,1,381
998,227,489,88.16616780045352,89.62902494331065,29,18,269,1,262
999,227,438,88.16616780045352,90.58104308390023,29,20,235,2,211
1000,227,666,88.16616780045352,89.35038548752834,29,18,442,1,439
1001,227,636,88.16616780045352,89.46648526077098,29,20,413,1,409
1002,227,615,88.16616780045352,90.58104308390023,29,18,402,2,388
1003,333,5,88.51446712018141,90.30240362811791,20,49,337,2,328
1004,333,5,88.51446712018141,90.9990022675737,20,50,345,2,328
1005,333,228,88.51446712018141,91.02222222222223,20,33,151,3,105
1006,333,489,88.51446712018141,89.62902494331065,20,18,163,1,156
1007,333,438,88.51446712018141,90.58104308390023,20,20,138,2,105
1008,333,615,88.51446712018141,90.58104308390023,20,18,296,2,282
1009,231,5,89.44326530612246,90.9990022675737,23,50,236,2,226
1010,231,4,89.44326530612246,92.25287981859411,23,48,257,3,227
1011,231,228,89.44326530612246,91.02222222222223,23,33,68,2,3
1012,231,207,89.44326530612246,91.69560090702949,23,28,100,2,24
1013,231,438,89.44326530612246,90.58104308390023,23,20,213,1,207
1014,231,410,89.44326530612246,91.60272108843537,23,20,202,2,179
1015,231,615,89.44326530612246,90.58104308390023,23,18,387,1,384
1016,228,4,91.02222222222223,92.25287981859411,33,48,230,1,224
1017,228,5,91.02222222222223,93.11201814058957,33,49,240,2,223
1018,228,5,91.02222222222223,93.83183673469388,33,49,254,3,223
1019,228,254,91.02222222222223,92.71727891156463,33,21,77,2,26
1020,228,260,91.02222222222223,93.80861678004536,33,29,124,3,32
1021,228,431,91.02222222222223,92.71727891156463,33,19,216,2,203
1022,228,627,91.02222222222223,92.71727891156463,33,14,406,2,399
1023,207,5,91.69560090702949,93.11201814058957,28,49,211,1,202
1024,207,5,91.69560090702949,93.83183673469388,28,49,222,2,202
1025,207,5,91.69560090702949,94.52843537414967,28,50,236,3,202
1026,207,254,91.69560090702949,92.71727891156463,28,21,64,1,47
1027,207,260,91.69560090702949,93.80861678004536,28,29,105,2,53
1028,207,231,91.69560090702949,94.55165532879819,28,29,125,3,24
1029,207,431,91.69560090702949,92.71727891156463,28,19,228,1,224
1030,207,436,91.69560090702949,94.11047619047619,28,19,252,2,229
1031,207,627,91.69560090702949,92.71727891156463,28,14,422,1,420
1032,254,5,92.71727891156463,93.83183673469388,21,49,254,1,249
1033,254,5,92.71727891156463,94.52843537414967,21,50,261,2,249
1034,254,260,92.71727891156463,93.80861678004536,21,29,47,1,6
1035,254,231,92.71727891156463,94.55165532879819,21,29,82,2,23
1036,254,436,92.71727891156463,94.11047619047619,21,19,192,1,182
1037,254,573,92.71727891156463,94.80707482993198,21,19,331,2,319
1038,254,634,92.71727891156463,95.52689342403629,21,15,399,3,380
1039,260,5,93.80861678004536,95.96807256235827,29,49,271,2,255
1040,260,5,93.80861678004536,96.64145124716553,29,50,283,3,255
1041,260,284,93.80861678004536,96.26993197278912,29,24,109,2,24
1042,260,227,93.80861678004536,96.66467120181406,29,29,127,3,33
1043,260,517,93.80861678004536,96.29315192743765,29,18,278,2,257
1044,260,634,93.80861678004536,95.52689342403629,29,15,381,2,374
1045,231,5,94.55165532879819,95.96807256235827,29,49,234,1,226
1046,231,5,94.55165532879819,96.64145124716553,29,50,243,2,226
1047,231,284,94.55165532879819,96.26993197278912,29,24,91,2,53
1048,231,227,94.55165532879819,96.66467120181406,29,29,91,2,4
1049,231,517,94.55165532879819,96.29315192743765,29,18,296,2,286
1050,231,516,94.55165532879819,96.98975056689342,29,18,304,2,285
1051,284,5,96.26993197278912,98.24362811791383,24,48,292,2,279
1052,284,8,96.26993197278912,98.5687074829932,24,50,293,2,276
1053,284,231,96.26993197278912,97.54702947845806,24,29,76,1,53
1054,284,605,96.26993197278912,97.54702947845806,24,19,326,1,321
1055,284,431,96.26993197278912,99.07954648526078,24,18,190,3,147
1056,284,628,96.26993197278912,97.66312925170068,24,19,349,1,344
1057,284,627,96.26993197278912,99.05632653061225,24,17,363,3,343
1058,227,5,96.66467120181406,98.24362811791383,29,48,232,2,222
1059,227,8,96.66467120181406,98.5687074829932,29,50,234,2,219
1060,227,205,96.66467120181406,99.40462585034014,29,27,120,3,22
1061,227,431,96.66467120181406,99.07954648526078,29,18,229,2,204
1062,227,627,96.66467120181406,99.05632653061225,29,17,413,2,400
1063,231,8,97.54702947845806,98.5687074829932,29,50,227,1,223
1064,231,5,97.54702947845806,100.1708843537415,29,50,253,3,226
1065,231,205,97.54702947845806,99.40462585034014,29,27,84,2,26
1066,231,227,97.54702947845806,100.33342403628119,29,32,120,3,4
1067,231,431,97.54702947845806,99.07954648526078,29,18,211,2,200
1068,231,411,97.54702947845806,100.00834467120181,29,21,209,2,180
1069,231,627,97.54702947845806,99.05632653061225,29,17,401,2,396
1070,231,615,97.54702947845806,99.75292517006802,29,17,396,2,384
1071,205,5,99.40462585034014,100.89070294784581,27,49,210,1,200
1072,205,5,99.40462585034014,102.28390022675737,27,50,235,3,200
1073,205,260,99.40462585034014,101.26222222222222,27,31,97,2,55
1074,205,262,99.40462585034014,102.33034013605442,27,25,138,3,57
1075,205,431,99.40462585034014,101.19256235827665,27,19,239,2,226
1076,205,568,99.40462585034014,101.86594104308391,27,20,378,2,363
1077,205,665,99.40462585034014,101.98204081632653,27,19,473,3,460
1078,227,5,100.33342403628119,102.28390022675737,32,50,237,2,222
1079,227,4,100.33342403628119,103.07337868480725,32,47,252,3,223
1080,227,262,100.33342403628119,102.33034013605442,32,25,93,2,35
1081,227,259,100.33342403628119,102.51609977324263,32,30,99,2,32
1082,227,568,100.33342403628119,101.86594104308391,32,20,347,2,341
1083,227,436,100.33342403628119,102.5857596371882,32,20,230,2,209
1084,227,665,100.33342403628119,101.98204081632653,32,19,444,2,438
1085,260,5,101.26222222222222,102.28390022675737,31,50,259,1,255
1086,260,4,101.26222222222222,103.07337868480725,31,47,268,2,256
1087,260,262,101.26222222222222,102.33034013605442,31,25,46,1,2
1088,260,259,101.26222222222222,102.51609977324263,31,30,54,1,1
1089,260,206,101.26222222222222,104.04861678004535,31,34,132,3,54
1090,260,436,101.26222222222222,102.5857596371882,31,20,185,1,176
1091,260,431,101.26222222222222,104.02539682539683,31,18,208,3,171
1092,262,5,102.33034013605442,104.42013605442177,25,49,272,2,257
1093,262,5,102.33034013605442,105.13995464852609,25,49,284,3,257
1094,262,206,102.33034013605442,104.04861678004535,25,34,93,2,56
1095,262,257,102.33034013605442,105.30249433106576,25,28,128,3,5
1096,262,431,102.33034013605442,104.02539682539683,25,18,184,2,169
1097,262,411,102.33034013605442,105.30249433106576,25,23,196,3,149
1098,259,5,102.51609977324263,104.42013605442177,30,49,267,2,254
1099,259,5,102.51609977324263,105.13995464852609,30,49,278,3,254
1100,259,206,102.51609977324263,104.04861678004535,30,34,85,2,53
1101,259,257,102.51609977324263,105.30249433106576,30,28,120,3,2
1102,259,431,102.51609977324263,104.02539682539683,30,18,184,2,172
1103,259,411,102.51609977324263,105.30249433106576,30,23,194,3,152
1104,206,5,104.04861678004535,105.13995464852609,34,49,206,1,201
1105,206,5,104.04861678004535,105.83655328798186,34,50,215,2,201
1106,206,257,104.04861678004535,105.30249433106576,34,28,74,1,51
1107,206,257,104.04861678004535,106.41705215419502,34,28,114,2,51
1108,206,258,104.04861678004535,106.53315192743764,34,25,119,2,52
1109,206,411,104.04861678004535,105.30249433106576,34,23,212,1,205
1110,206,518,104.04861678004535,106.16163265306123,34,21,325,2,312
1111,206,431,104.04861678004535,106.83501133786848,34,18,255,3,225
1112,206,635,104.04861678004535,106.11519274376417,34,17,438,2,429
1113,257,5,105.30249433106576,107.25297052154195,28,49,266,2,252
1114,257,5,105.30249433106576,107.92634920634922,28,50,276,3,252
1115,257,258,105.30249433106576,106.53315192743764,28,25,53,1,1
1116,257,431,105.30249433106576,106.83501133786848,28,18,186,2,174
1117,257,431,105.30249433106576,107.53160997732427,28,19,199,2,174
1118,257,638,105.30249433106576,107.50839002267574,28,20,393,2,381
1119,257,5,106.41705215419502,107.92634920634922,28,50,260,2,252
1120,257,52,106.41705215419502,108.62294784580499,28,42,226,2,205
1121,257,234,106.41705215419502,108.43718820861679,28,24,90,2,23
1122,257,260,106.41705215419502,109.38920634920635,28,31,128,3,3
1123,257,431,106.41705215419502,107.53160997732427,28,19,180,1,174
1124,257,412,106.41705215419502,108.66938775510204,28,21,183,2,155
1125,257,638,106.41705215419502,107.50839002267574,28,20,384,1,381
1126,257,720,106.41705215419502,108.48362811791384,28,17,471,2,463
1127,258,5,106.53315192743764,107.92634920634922,25,50,260,1,253
1128,258,52,106.53315192743764,108.62294784580499,25,42,225,2,206
1129,258,234,106.53315192743764,108.43718820861679,25,24,85,2,24
1130,258,260,106.53315192743764,109.38920634920635,25,31,123,3,2
1131,258,412,106.53315192743764,108.66938775510204,25,21,179,2,154
1132,258,720,106.53315192743764,108.48362811791384,25,17,470,2,462
1133,234,5,108.43718820861679,110.06258503401361,24,47,239,2,229
1134,234,255,108.43718820861679,110.24834467120182,24,29,81,2,21
1135,234,261,108.43718820861679,111.36290249433107,24,25,129,3,27
1136,234,442,108.43718820861679,110.15546485260771,24,20,221,2,208
1137,234,555,108.43718820861679,111.06104308390023,24,18,340,3,321
1138,234,632,108.43718820861679,111.06104308390023,24,17,414,3,398
1139,260,5,109.38920634920635,111.45578231292517,31,49,270,2,255
1140,260,5,109.38920634920635,111.4790022675737,31,49,270,2,255
1141,260,261,109.38920634920635,111.36290249433107,31,25,85,2,1
1142,260,259,109.38920634920635,112.1059410430839,31,23,117,3,1
1143,260,555,109.38920634920635,111.06104308390023,31,18,304,2,295
1144,260,423,109.38920634920635,112.29170068027211,31,21,205,3,163
1145,260,632,109.38920634920635,111.06104308390023,31,17,379,2,372
1146,260,617,109.38920634920635,111.75764172335602,31,15,371,2,357
1147,255,5,110.24834467120182,111.45578231292517,29,49,255,1,250
1148,255,5,110.24834467120182,111.4790022675737,29,49,256,1,250
1149,255,5,110.24834467120182,112.89541950113379,29,50,275,3,250
1150,255,261,110.24834467120182,111.36290249433107,29,25,48,1,6
1151,255,259,110.24834467120182,112.1059410430839,29,23,80,2,4
1152,255,423,110.24834467120182,112.29170068027211,29,21,190,2,168
1153,255,431,110.24834467120182,113.19727891156462,29,20,217,3,176
1154,255,617,110.24834467120182,111.75764172335602,29,15,368,2,362
1155,255,618,110.24834467120182,113.1740589569161,29,15,384,3,363
1156,261,5,111.36290249433107,112.89541950113379,25,50,264,2,256
1157,261,5,111.36290249433107,113.59201814058957,25,49,273,2,256
1158,261,255,111.36290249433107,113.05795918367347,25,28,73,2,6
1159,261,431,111.36290249433107,113.19727891156462,25,20,187,2,170
1160,261,482,111.36290249433107,114.0564172335601,25,18,250,3,221
1161,261,618,111.36290249433107,113.1740589569161,25,15,365,2,357
1162,261,626,111.36290249433107,113.87065759637188,25,16,381,3,365
1163,259,5,112.1059410430839,113.59201814058957,23,49,262,1,254
1164,259,5,112.1059410430839,115.00843537414966,23,49,283,3,254
1165,259,270,112.1059410430839,114.42793650793651,23,27,101,2,11
1166,259,431,112.1059410430839,113.19727891156462,23,20,178,1,172
1167,259,482,112.1059410430839,114.0564172335601,23,18,238,2,223
1168,259,618,112.1059410430839,113.1740589569161,23,15,362,1,359
1169,259,626,112.1059410430839,113.87065759637188,23,16,375,2,367
1170,259,635,112.1059410430839,114.5904761904762,23,17,391,2,376
1171,255,5,113.05795918367347,115.00843537414966,28,49,264,2,250
1172,255,4,113.05795918367347,115.58893424036282,28,45,274,3,251
1173,255,270,113.05795918367347,114.42793650793651,28,27,61,1,15
1174,255,259,113.05795918367347,115.05487528344672,28,26,86,2,4
1175,255,259,113.05795918367347,115.79791383219955,28,26,118,3,4
1176,255,428,113.05795918367347,115.3102947845805,28,18,198,2,173
1177,255,635,113.05795918367347,114.5904761904762,28,17,386,2,380
1178,255,615,113.05795918367347,115.65859410430839,28,14,377,3,360
1179,270,4,114.42793650793651,115.58893424036282,27,45,271,1,266
1180,270,5,114.42793650793651,117.12145124716554,27,45,289,3,265
1181,270,259,114.42793650793651,115.79791383219955,27,26,60,1,11
1182,270,259,114.42793650793651,117.02857142857142,27,29,113,3,11
1183,270,423,114.42793650793651,116.05333333333334,27,19,168,2,153
1184,270,615,114.42793650793651,115.65859410430839,27,14,349,1,345
1185,270,616,114.42793650793651,117.16789115646259,27,14,366,3,346
1186,259,5,115.05487528344672,117.12145124716554,26,45,269,2,254
1187,259,5,115.05487528344672,118.02702947845805,26,45,284,3,254
1188,259,552,115.05487528344672,117.4465306122449,26,18,311,2,293
1189,259,421,115.05487528344672,117.8877097505669,26,18,203,3,162
1190,259,616,115.05487528344672,117.16789115646259,26,14,368,2,357
1191,259,5,115.79791383219955,117.12145124716554,26,45,260,1,254
1192,259,5,115.79791383219955,118.02702947845805,26,45,272,2,254
1193,259,258,115.79791383219955,118.46820861678005,26,26,115,3,1
1194,259,552,115.79791383219955,117.4465306122449,26,18,301,2,293
1195,259,421,115.79791383219955,117.8877097505669,26,18,185,2,162
1196,259,616,115.79791383219955,117.16789115646259,26,14,362,1,357
1197,259,699,115.79791383219955,118.28244897959183,26,11,453,2,440
1198,259,5,117.02857142857142,119.4898866213152,29,44,275,2,254
1199,259,5,117.02857142857142,119.81496598639455,29,44,281,3,254
1200,259,258,117.02857142857142,118.46820861678005,29,26,62,1,1
1201,259,227,117.02857142857142,118.93260770975057,29,34,88,2,32
1202,259,438,117.02857142857142,118.9558276643991,29,22,197,2,179
1203,259,699,117.02857142857142,118.28244897959183,29,11,443,1,440
1204,259,744,117.02857142857142,118.93260770975057,29,20,492,2,485
1205,258,5,118.46820861678005,119.4898866213152,26,44,257,1,253
1206,258,5,118.46820861678005,119.81496598639455,26,44,260,1,253
1207,258,4,118.46820861678005,121.34748299319727,26,48,283,3,254
1208,258,227,118.46820861678005,120.48834467120182,26,36,92,2,31
1209,258,227,118.46820861678005,120.51156462585034,26,33,93,2,31
1210,258,434,118.46820861678005,120.1168253968254,26,17,190,2,176
1211,258,462,118.46820861678005,120.79020408163265,26,23,227,2,204
1212,227,4,118.93260770975057,121.34748299319727,34,48,246,2,223
1213,227,387,118.93260770975057,121.51002267573696,34,26,195,3,160
1214,227,434,118.93260770975057,120.1168253968254,34,17,213,1,207
1215,227,462,118.93260770975057,120.79020408163265,34,23,248,2,235
1216,227,645,118.93260770975057,121.51002267573696,34,22,432,3,418
1217,227,49,120.48834467120182,122.39238095238096,36,44,196,2,178
1218,227,4,120.48834467120182,123.46049886621316,36,47,257,3,223
1219,227,387,120.48834467120182,121.51002267573696,36,26,166,1,160
1220,227,266,120.48834467120182,123.20507936507937,36,26,123,3,39
1221,227,412,120.48834467120182,122.50848072562358,36,31,204,2,185
1222,227,411,120.48834467120182,122.53170068027211,36,27,204,2,184
1223,227,645,120.48834467120182,121.51002267573696,36,22,420,1,418
1224,227,49,120.51156462585034,122.39238095238096,33,44,196,2,178
1225,227,4,120.51156462585034,123.46049886621316,33,47,257,3,223
1226,227,266,120.51156462585034,123.20507936507937,33,26,122,3,39
1227,227,412,120.51156462585034,122.50848072562358,33,31,204,2,185
1228,227,411,120.51156462585034,122.53170068027211,33,27,204,2,184
1229,387,4,121.51002267573696,123.46049886621316,26,47,392,2,383
1230,387,5,121.51002267573696,124.15709750566894,26,48,399,3,382
1231,387,266,121.51002267573696,123.20507936507937,26,26,141,2,121
1232,387,411,121.51002267573696,122.53170068027211,26,27,50,1,24
1233,387,592,121.51002267573696,123.762358276644,26,22,227,2,205
1234,387,783,121.51002267573696,122.67102040816327,26,20,399,1,396
1235,387,757,121.51002267573696,124.0409977324263,26,22,386,3,370
1236,387,873,121.51002267573696,124.0409977324263,26,23,498,3,486
1237,266,39,123.20507936507937,124.90013605442176,26,42,238,2,227
1238,266,387,123.20507936507937,124.36607709750567,26,29,131,1,121
1239,266,270,123.20507936507937,124.76081632653062,26,27,67,2,4
1240,266,585,123.20507936507937,125.38775510204081,26,21,333,2,319
1241,266,700,123.20507936507937,124.5750566893424,26,20,438,1,434
1242,387,4,124.36607709750567,126.29333333333334,29,49,392,2,383
1243,387,4,124.36607709750567,127.01315192743765,29,48,400,3,383
1244,387,266,124.36607709750567,125.57351473922903,29,25,132,1,121
1245,387,256,124.36607709750567,126.78095238095239,29,30,167,2,131
1246,387,585,124.36607709750567,125.38775510204081,29,21,203,1,198
1247,387,414,124.36607709750567,126.31655328798186,29,24,88,2,27
1248,387,560,124.36607709750567,127.26857142857143,29,20,213,3,173
1249,387,777,124.36607709750567,126.4326530612245,29,19,400,2,390
1250,387,796,124.36607709750567,126.73451247165534,29,24,422,2,409
1251,387,821,124.36607709750567,126.75773242630386,29,20,446,2,434
1252,270,4,124.76081632653062,126.29333333333334,27,49,274,2,266
1253,270,4,124.76081632653062,127.01315192743765,27,48,283,2,266
1254,270,256,124.76081632653062,126.78095238095239,27,30,88,2,14
1255,270,414,124.76081632653062,126.31655328798186,27,24,159,2,144
1256,270,560,124.76081632653062,127.26857142857143,27,20,309,3,290
1257,266,4,125.57351473922903,127.01315192743765,25,48,269,1,262
1258,266,4,125.57351473922903,128.4063492063492,25,47,289,3,262
1259,266,256,125.57351473922903,126.78095238095239,25,30,53,1,10
1260,266,295,125.57351473922903,128.45278911564625,25,26,127,3,29
1261,266,560,125.57351473922903,127.26857142857143,25,20,303,2,294
1262,266,590,125.57351473922903,128.45278911564625,25,22,347,3,324
1263,266,618,125.57351473922903,128.05804988662132,25,18,368,2,352
1264,256,4,126.78095238095239,128.4063492063492,30,47,262,2,252
1265,256,6,126.78095238095239,129.07972789115647,30,47,269,2,250
1266,256,295,126.78095238095239,128.45278911564625,30,26,82,2,39
1267,256,219,126.78095238095239,128.63854875283448,30,32,88,2,37
1268,256,590,126.78095238095239,128.45278911564625,30,22,342,2,334
1269,256,560,126.78095238095239,128.61532879818594,30,24,314,2,304
1270,256,618,126.78095238095239,128.05804988662132,30,18,366,1,362
1271,256,657,126.78095238095239,128.61532879818594,30,21,409,2,401
1272,295,5,128.45278911564625,129.79954648526078,26,49,296,1,290
1273,295,5,128.45278911564625,130.79800453514738,26,44,307,2,290
1274,295,258,128.45278911564625,130.0085260770975,26,29,77,2,37
1275,295,232,128.45278911564625,130.86766439909297,26,30,122,2,63
1276,295,566,128.45278911564625,130.03174603174602,26,27,279,2,271
1277,295,576,128.45278911564625,131.09986394557822,26,24,303,3,281
1278,295,617,128.45278911564625,130.03174603174602,26,23,329,2,322
1279,295,634,128.45278911564625,131.0766439909297,26,24,357,3,339
1280,219,5,128.63854875283448,129.79954648526078,32,49,220,1,214
1281,219,5,128.63854875283448,130.79800453514738,32,44,233,2,214
1282,219,258,128.63854875283448,130.0085260770975,32,29,71,1,39
1283,219,232,128.63854875283448,130.86766439909297,32,30,97,2,13
1284,219,566,128.63854875283448,130.03174603174602,32,27,352,1,347
1285,219,576,128.63854875283448,131.09986394557822,32,24,372,2,357
1286,219,617,128.63854875283448,130.03174603174602,32,23,402,1,398
1287,219,634,128.63854875283448,131.0766439909297,32,24,428,2,415
1288,258,5,130.0085260770975,131.93578231292517,29,49,266,2,253
1289,258,218,130.0085260770975,131.79646258503402,29,29,87,2,40
1290,258,206,130.0085260770975,132.77170068027212,29,24,130,3,52
1291,258,576,130.0085260770975,131.09986394557822,29,24,321,1,318
1292,258,443,130.0085260770975,131.84290249433107,29,20,201,2,185
1293,258,587,130.0085260770975,132.9342403628118,29,20,352,3,329
1294,258,634,130.0085260770975,131.0766439909297,29,24,379,1,376
1295,258,749,130.0085260770975,131.79646258503402,29,19,497,2,491
1296,258,621,130.0085260770975,132.84136054421768,29,22,383,3,363
1297,232,5,130.86766439909297,131.93578231292517,30,49,232,1,227
1298,232,9,130.86766439909297,133.2825396825397,30,49,246,2,223
1299,232,206,130.86766439909297,132.77170068027212,30,24,86,2,26
1300,232,587,130.86766439909297,132.9342403628118,30,20,366,2,355
1301,232,412,130.86766439909297,133.79337868480727,30,29,220,3,180
1302,232,621,130.86766439909297,132.84136054421768,30,22,398,2,389
1303,232,630,130.86766439909297,133.81659863945578,30,21,418,3,398
1304,218,9,131.79646258503402,133.2825396825397,29,49,219,1,209
1305,218,5,131.79646258503402,134.07201814058956,29,49,234,2,213
1306,218,5,131.79646258503402,134.76861678004536,29,49,249,3,213
1307,218,388,131.79646258503402,134.2577777777778,29,27,200,2,170
1308,218,587,131.79646258503402,132.9342403628118,29,20,372,1,369
1309,218,412,131.79646258503402,133.79337868480727,29,29,212,2,194
1310,218,621,131.79646258503402,132.84136054421768,29,22,406,1,403
1311,218,630,131.79646258503402,133.81659863945578,29,21,421,2,412
1312,206,5,132.77170068027212,134.07201814058956,24,49,209,1,201
1313,206,5,132.77170068027212,134.76861678004536,24,49,219,2,201
1314,206,388,132.77170068027212,134.2577777777778,24,27,193,1,182
1315,206,282,132.77170068027212,135.0008163265306,24,29,122,2,76
1316,206,386,132.77170068027212,135.65097505668933,24,29,219,3,180
1317,206,412,132.77170068027212,133.79337868480727,24,29,211,1,206
1318,206,414,132.77170068027212,134.9079365079365,24,25,227,2,208
1319,206,630,132.77170068027212,133.81659863945578,24,21,426,1,424
1320,206,655,132.77170068027212,135.3491156462585,24,21,463,3,449
1321,388,5,134.2577777777778,136.18503401360545,27,49,392,2,383
1322,388,386,134.2577777777778,135.65097505668933,27,29,60,1,2
1323,388,263,134.2577777777778,136.57977324263038,27,27,160,2,125
1324,388,437,134.2577777777778,136.39401360544218,27,23,104,2,49
1325,388,655,134.2577777777778,135.3491156462585,27,21,271,1,267
1326,388,700,134.2577777777778,135.85995464852607,27,21,320,2,312
1327,388,615,134.2577777777778,137.06739229024944,27,16,257,3,227
1328,388,872,134.2577777777778,135.32589569161,27,22,486,1,484
1329,388,844,134.2577777777778,135.8831746031746,27,23,461,2,456
1330,388,827,134.2577777777778,137.18349206349205,27,11,457,3,439
1331,282,5,135.0008163265306,136.18503401360545,29,49,282,1,277
1332,282,8,135.0008163265306,137.48535147392292,29,50,294,2,274
1333,282,5,135.0008163265306,137.76399092970522,29,48,301,3,277
1334,282,263,135.0008163265306,136.57977324263038,29,27,71,2,19
1335,282,437,135.0008163265306,136.39401360544218,29,23,166,1,155
1336,282,413,135.0008163265306,137.55501133786848,29,21,171,3,131
1337,282,414,135.0008163265306,137.62467120181407,29,25,174,3,132
1338,282,615,135.0008163265306,137.06739229024944,29,16,345,2,333
1339,386,8,135.65097505668933,137.48535147392292,29,50,386,2,378
1340,386,5,135.65097505668933,137.76399092970522,29,48,392,2,381
1341,386,257,135.65097505668933,138.019410430839,29,28,164,2,129
1342,386,413,135.65097505668933,137.55501133786848,29,21,86,2,27
1343,386,414,135.65097505668933,137.62467120181407,29,25,89,2,28
1344,386,615,135.65097505668933,137.06739229024944,29,16,237,1,229
1345,386,615,135.65097505668933,138.06585034013605,29,23,252,2,229
1346,386,827,135.65097505668933,137.18349206349205,29,11,446,2,441
1347,386,820,135.65097505668933,138.06585034013605,29,21,446,2,434
1348,263,5,136.57977324263038,137.76399092970522,27,48,263,1,258
1349,263,5,136.57977324263038,138.9946485260771,27,47,278,2,258
1350,263,257,136.57977324263038,138.019410430839,27,28,62,1,6
1351,263,211,136.57977324263038,139.29650793650794,27,24,128,3,52
1352,263,414,136.57977324263038,137.62467120181407,27,25,158,1,151
1353,263,430,136.57977324263038,139.29650793650794,27,20,204,3,167
1354,263,615,136.57977324263038,138.06585034013605,27,23,358,1,352
1355,257,5,138.019410430839,140.41106575963718,28,48,272,2,252
1356,257,211,138.019410430839,139.29650793650794,28,24,72,1,46
1357,257,219,138.019410430839,139.94666666666666,28,32,91,2,38
1358,257,430,138.019410430839,139.29650793650794,28,20,182,1,173
1359,257,559,138.019410430839,139.94666666666666,28,26,313,2,302
1360,257,680,138.019410430839,139.94666666666666,28,21,431,2,423
1361,211,5,139.29650793650794,140.41106575963718,24,48,212,1,206
1362,211,5,139.29650793650794,141.15410430839003,24,49,221,2,206
1363,211,5,139.29650793650794,141.8274829931973,24,49,233,3,206
1364,211,258,139.29650793650794,141.27020408163267,24,30,97,2,47
1365,211,262,139.29650793650794,142.1990022675737,24,29,135,3,51
1366,211,566,139.29650793650794,141.31664399092972,24,27,366,2,355
1367,211,695,139.29650793650794,141.33986394557823,24,24,492,2,484
1368,219,5,139.94666666666666,141.15410430839003,32,49,220,1,214
1369,219,5,139.94666666666666,141.8274829931973,32,49,229,2,214
1370,219,258,139.94666666666666,141.27020408163267,32,30,69,1,39
1371,219,262,139.94666666666666,142.1990022675737,32,29,106,2,43
1372,219,566,139.94666666666666,141.31664399092972,32,27,352,1,347
1373,219,576,139.94666666666666,142.38476190476192,32,26,372,2,357
1374,219,695,139.94666666666666,141.33986394557823,32,24,480,1,476
1375,219,691,139.94666666666666,142.38476190476192,32,24,484,2,472
1376,258,8,141.27020408163267,143.33678004535147,30,50,265,2,250
1377,258,5,141.27020408163267,143.77795918367346,30,49,275,3,253
1378,258,218,141.27020408163267,143.12780045351474,30,30,89,2,40
1379,258,206,141.27020408163267,144.12625850340137,30,31,134,3,52
1380,258,576,141.27020408163267,142.38476190476192,30,26,322,1,318
1381,258,565,141.27020408163267,143.52253968253967,30,19,322,2,307
1382,258,556,141.27020408163267,143.7082993197279,30,12,316,2,298
1383,258,691,141.27020408163267,142.38476190476192,30,24,436,1,433
1384,258,754,141.27020408163267,143.12780045351474,30,18,502,2,496
1385,262,8,142.1990022675737,143.33678004535147,29,50,259,1,254
1386,262,5,142.1990022675737,143.77795918367346,29,49,266,2,257
1387,262,26,142.1990022675737,144.9621768707483,29,40,264,3,236
1388,262,206,142.1990022675737,144.12625850340137,29,31,100,2,56
1389,262,565,142.1990022675737,143.52253968253967,29,19,308,1,303
1390,262,556,142.1990022675737,143.7082993197279,29,12,301,2,294
1391,218,26,143.12780045351474,144.9621768707483,30,40,208,2,192
1392,218,48,143.12780045351474,145.70521541950114,30,34,203,3,170
1393,206,48,144.12625850340137,145.70521541950114,31,34,172,2,158
1394,206,26,144.12625850340137,147.0984126984127,31,38,221,3,180
1395,206,213,144.12625850340137,146.40181405895692,31,13,98,2,7
1396,213,48,146.40181405895692,148.49160997732426,13,36,188,2,165
1397,213,77,146.40181405895692,149.3275283446712,13,36,185,3,136
1398,213,257,146.40181405895692,149.2346485260771,13,25,130,3,44
1399,257,29,149.2346485260771,150.95292517006803,25,37,240,2,228
1400,258,39,152.57832199546485,154.64489795918368,28,36,236,2,219
1401,258,39,152.57832199546485,154.6681179138322,28,37,237,2,219
1402,258,260,152.57832199546485,153.64643990929704,28,25,46,1,2
1403,258,268,152.57832199546485,154.6681179138322,28,16,91,2,10
1404,258,576,152.57832199546485,153.66965986394558,28,17,321,1,318
1405,258,634,152.57832199546485,153.66965986394558,28,15,379,1,376
1406,207,39,153.4374603174603,154.64489795918368,28,36,176,1,168
1407,207,39,153.4374603174603,154.6681179138322,28,37,176,1,168
1408,207,86,153.4374603174603,155.66657596371883,28,27,154,2,121
1409,207,268,153.4374603174603,154.6681179138322,28,16,81,1,61
1410,260,39,153.64643990929704,154.6681179138322,25,37,225,1,221
1411,260,86,153.64643990929704,155.66657596371883,25,27,195,2,174
1412,260,268,153.64643990929704,154.6681179138322,25,16,45,1,8
1413,268,43,154.6681179138322,156.66503401360544,16,14,241,2,225
1414,609,388,30.998639455782314,32.60081632653061,21,27,232,2,221
1415,609,413,30.998639455782314,32.113197278911564,21,26,202,1,196
1416,609,412,30.998639455782314,32.15963718820862,21,30,203,1,197
1417,609,592,30.998639455782314,33.41351473922902,21,24,105,2,17
1418,609,630,30.998639455782314,32.15963718820862,21,20,54,1,21
1419,609,637,30.998639455782314,33.69215419501134,21,21,119,3,28
1420,609,849,30.998639455782314,32.13641723356009,21,22,245,1,240
1421,609,873,30.998639455782314,33.69215419501134,21,22,288,3,264
1422,413,51,32.113197278911564,33.483174603174604,26,42,367,1,362
1423,413,73,32.113197278911564,34.13333333333333,26,41,351,2,340
1424,413,386,32.113197278911564,34.0172335600907,26,29,86,2,27
1425,413,316,32.113197278911564,35.085351473922906,26,23,161,3,97
1426,413,592,32.113197278911564,33.41351473922902,26,24,188,1,179
1427,413,450,32.113197278911564,34.78349206349206,26,21,121,3,37
1428,413,637,32.113197278911564,33.69215419501134,26,21,234,2,224
1429,413,700,32.113197278911564,34.22621315192744,26,20,301,2,287
1430,413,873,32.113197278911564,33.69215419501134,26,22,465,2,460
1431,413,843,32.113197278911564,34.22621315192744,26,20,440,2,430
1432,412,51,32.15963718820862,33.483174603174604,30,42,365,1,361
1433,412,73,32.15963718820862,34.13333333333333,30,41,349,2,339
1434,412,386,32.15963718820862,34.0172335600907,30,29,84,2,26
1435,412,316,32.15963718820862,35.085351473922906,30,23,158,3,96
1436,412,592,32.15963718820862,33.41351473922902,30,24,188,1,180
1437,412,450,32.15963718820862,34.78349206349206,30,21,119,3,38
1438,412,637,32.15963718820862,33.69215419501134,30,21,234,2,225
1439,412,700,32.15963718820862,34.22621315192744,30,20,301,2,288
1440,412,873,32.15963718820862,33.69215419501134,30,22,466,2,461
1441,412,843,32.15963718820862,34.22621315192744,30,20,440,2,431
1442,592,316,33.41351473922902,35.085351473922906,24,23,285,2,276
1443,592,267,33.41351473922902,35.92126984126984,24,27,342,3,325
1444,592,450,33.41351473922902,34.78349206349206,24,21,154,1,142
1445,592,414,33.41351473922902,35.9677097505669,24,25,209,3,178
1446,592,776,33.41351473922902,36.08380952380953,24,20,217,3,184
1447,592,796,33.41351473922902,36.385668934240364,24,25,241,3,204
1448,592,850,33.41351473922902,35.944489795918365,24,18,280,3,258
1449,450,52,34.78349206349206,36.31600907029478,21,43,403,2,398
1450,450,39,34.78349206349206,37.45378684807256,21,43,427,3,411
1451,450,267,34.78349206349206,35.92126984126984,21,27,189,1,183
1452,450,261,34.78349206349206,36.80362811791383,21,28,208,2,189
1453,450,414,34.78349206349206,35.9677097505669,21,25,62,1,36
1454,450,410,34.78349206349206,36.87328798185941,21,23,98,2,40
1455,450,776,34.78349206349206,36.08380952380953,21,20,331,1,326
1456,450,796,34.78349206349206,36.385668934240364,21,25,353,2,346
1457,450,618,34.78349206349206,37.70920634920635,21,18,210,3,168
1458,450,850,34.78349206349206,35.944489795918365,21,18,403,1,400
1459,450,821,34.78349206349206,36.40888888888889,21,20,378,2,371
1460,450,894,34.78349206349206,37.593106575963716,21,19,460,3,444
1461,414,39,35.9677097505669,37.45378684807256,25,43,380,1,375
1462,414,49,35.9677097505669,38.33614512471655,25,41,379,2,365
1463,414,244,35.9677097505669,38.01106575963719,25,24,191,2,170
1464,414,219,35.9677097505669,38.2897052154195,25,33,219,2,195
1465,414,590,35.9677097505669,38.080725623582765,25,23,198,2,176
1466,414,560,35.9677097505669,38.26648526077098,25,24,176,2,146
1467,414,618,35.9677097505669,37.70920634920635,25,18,217,2,204
1468,414,657,35.9677097505669,38.26648526077098,25,20,262,2,243
1469,414,894,35.9677097505669,37.593106575963716,25,19,485,2,480
1470,414,852,35.9677097505669,38.24326530612245,25,21,449,2,438
1471,410,49,36.87328798185941,38.33614512471655,23,41,366,1,361
1472,410,24,36.87328798185941,39.38104308390023,23,41,401,3,386
1473,410,244,36.87328798185941,38.01106575963719,23,24,173,1,166
1474,410,219,36.87328798185941,38.2897052154195,23,33,201,1,191
1475,410,259,36.87328798185941,39.14884353741497,23,29,180,2,151
1476,410,590,36.87328798185941,38.080725623582765,23,23,187,1,180
1477,410,560,36.87328798185941,38.26648526077098,23,24,162,1,150
1478,410,566,36.87328798185941,39.68290249433107,23,27,197,3,156
1479,410,657,36.87328798185941,38.26648526077098,23,20,254,1,247
1480,410,617,36.87328798185941,39.68290249433107,23,23,240,3,207
1481,410,852,36.87328798185941,38.24326530612245,23,21,446,1,442
1482,410,877,36.87328798185941,39.82222222222222,23,21,484,3,467
1483,590,259,38.080725623582765,39.14884353741497,23,29,334,1,331
1484,590,207,38.080725623582765,40.49560090702948,23,27,397,2,383
1485,590,566,38.080725623582765,39.68290249433107,23,27,73,2,24
1486,590,576,38.080725623582765,40.72780045351474,23,25,115,3,14
1487,590,617,38.080725623582765,39.68290249433107,23,23,74,2,27
1488,590,634,38.080725623582765,40.72780045351474,23,23,122,3,44
1489,590,877,38.080725623582765,39.82222222222222,23,21,297,2,287
1490,590,877,38.080725623582765,40.91356009070295,23,19,312,3,287
1491,560,207,38.26648526077098,40.49560090702948,24,27,366,2,353
1492,560,566,38.26648526077098,39.68290249433107,24,27,61,1,6
1493,560,576,38.26648526077098,40.72780045351474,24,25,107,2,16
1494,560,617,38.26648526077098,39.68290249433107,24,23,83,1,57
1495,560,634,38.26648526077098,40.72780045351474,24,23,129,2,74
1496,560,877,38.26648526077098,39.82222222222222,24,21,324,2,317
1497,560,877,38.26648526077098,40.91356009070295,24,19,337,3,317
1498,566,230,39.68290249433107,41.56371882086168,27,24,346,2,336
1499,566,576,39.68290249433107,40.72780045351474,27,25,46,1,10
1500,566,596,39.68290249433107,41.28507936507937,27,11,75,2,30
1501,566,634,39.68290249433107,40.72780045351474,27,23,82,1,68
1502,566,736,39.68290249433107,41.308299319727894,27,13,184,2,170
1503,566,877,39.68290249433107,40.91356009070295,27,19,315,1,311
1504,566,834,39.68290249433107,41.308299319727894,27,13,277,2,268
1505,576,288,40.72780045351474,42.70149659863946,25,33,300,2,288
1506,576,263,40.72780045351474,43.560634920634925,25,33,336,3,313
1507,576,548,40.72780045351474,42.840816326530614,25,19,95,2,28
1508,576,643,40.72780045351474,42.678276643990934,25,19,107,2,67
1509,576,902,40.72780045351474,42.91047619047619,25,17,339,2,326
1510,596,288,41.28507936507937,42.70149659863946,11,33,314,1,308
1511,596,263,41.28507936507937,43.560634920634925,11,33,347,2,333
1512,596,548,41.28507936507937,42.840816326530614,11,19,82,2,48
1513,596,518,41.28507936507937,44.04825396825397,11,19,142,3,78
1514,596,643,41.28507936507937,42.678276643990934,11,19,76,1,47
1515,596,622,41.28507936507937,44.00181405895692,11,16,120,3,26
1516,596,902,41.28507936507937,42.91047619047619,11,17,314,2,306
1517,596,945,41.28507936507937,43.90893424036281,11,14,367,3,349
1518,548,292,42.840816326530614,44.81451247165533,19,28,270,2,256
1519,548,229,42.840816326530614,45.51111111111111,19,32,339,3,319
1520,548,518,42.840816326530614,44.04825396825397,19,19,60,1,30
1521,548,431,42.840816326530614,44.72163265306123,19,19,142,2,117
1522,548,425,42.840816326530614,45.51111111111111,19,20,168,3,123
1523,548,622,42.840816326530614,44.00181405895692,19,16,89,1,74
1524,548,643,42.840816326530614,44.81451247165533,19,17,127,2,95
1525,548,945,42.840816326530614,43.90893424036281,19,14,400,1,397
1526,548,948,42.840816326530614,44.58231292517007,19,19,407,2,400
1527,548,868,42.840816326530614,45.72009070294785,19,15,343,3,320
1528,518,229,44.04825396825397,45.51111111111111,19,32,296,1,289
1529,518,233,44.04825396825397,46.741768707483,19,30,308,3,285
1530,518,425,44.04825396825397,45.51111111111111,19,20,112,1,93
1531,518,554,44.04825396825397,46.439909297052154,19,23,109,2,36
1532,518,632,44.04825396825397,46.11482993197279,19,17,145,2,114
1533,518,623,44.04825396825397,46.32380952380952,19,19,144,2,105
1534,518,868,44.04825396825397,45.72009070294785,19,15,357,2,350
1535,518,931,44.04825396825397,46.27736961451247,19,17,424,2,413
1536,431,6,44.72163265306123,45.81297052154195,19,50,428,1,425
1537,431,4,44.72163265306123,47.06684807256236,19,48,439,2,427
1538,431,233,44.72163265306123,46.741768707483,19,30,216,2,198
1539,431,263,44.72163265306123,47.600907029478456,19,30,209,3,168
1540,431,554,44.72163265306123,46.439909297052154,19,23,144,2,123
1541,431,632,44.72163265306123,46.11482993197279,19,17,210,1,201
1542,431,623,44.72163265306123,46.32380952380952,19,19,204,2,192
1543,431,634,44.72163265306123,47.53124716553288,19,18,236,3,203
1544,425,4,45.51111111111111,47.06684807256236,20,48,426,2,421
1545,425,5,45.51111111111111,47.94920634920635,20,49,433,2,420
1546,425,233,45.51111111111111,46.741768707483,20,30,199,1,192
1547,425,263,45.51111111111111,47.600907029478456,20,30,185,2,162
1548,425,255,45.51111111111111,48.34394557823129,20,28,209,3,170
1549,425,431,45.51111111111111,47.53124716553288,20,18,87,2,6
1550,425,606,45.51111111111111,48.34394557823129,20,19,218,3,181
1551,425,634,45.51111111111111,47.53124716553288,20,18,226,2,209
1552,425,635,45.51111111111111,48.22784580498866,20,18,240,3,210
1553,425,907,45.51111111111111,48.18140589569161,20,22,496,3,482
1554,425,906,45.51111111111111,48.204625850340136,20,20,495,3,481
1555,554,263,46.439909297052154,47.600907029478456,23,30,295,1,291
1556,554,255,46.439909297052154,48.34394557823129,23,28,310,2,299
1557,554,205,46.439909297052154,49.24952380952381,23,29,369,3,349
1558,554,431,46.439909297052154,47.53124716553288,23,18,132,1,123
1559,554,606,46.439909297052154,48.34394557823129,23,19,97,2,52
1560,554,583,46.439909297052154,49.24952380952381,23,19,124,3,29
1561,554,634,46.439909297052154,47.53124716553288,23,18,93,1,80
1562,554,635,46.439909297052154,48.22784580498866,23,18,112,2,81
1563,554,642,46.439909297052154,49.24952380952381,23,18,150,3,88
1564,554,907,46.439909297052154,48.18140589569161,23,22,361,2,353
1565,554,906,46.439909297052154,48.204625850340136,23,20,360,2,352
1566,431,5,47.53124716553288,48.66902494331066,18,49,429,1,426
1567,431,5,47.53124716553288,49.36562358276644,18,50,433,2,426
1568,431,205,47.53124716553288,49.24952380952381,18,29,238,2,226
1569,431,583,47.53124716553288,49.24952380952381,18,19,169,2,152
1570,431,642,47.53124716553288,49.24952380952381,18,18,224,2,211
1571,431,897,47.53124716553288,49.458503401360545,18,18,473,2,466
1572,606,261,48.34394557823129,51.13034013605442,19,32,365,3,345
1573,606,421,48.34394557823129,51.17678004535148,19,21,222,3,185
1574,606,757,48.34394557823129,50.85170068027211,19,21,186,3,151
1575,606,897,48.34394557823129,49.458503401360545,19,18,295,1,291
1576,606,948,48.34394557823129,50.5730612244898,19,19,355,2,342
1577,606,953,48.34394557823129,51.26965986394558,19,20,369,3,347
1578,583,261,49.24952380952381,51.13034013605442,19,32,332,2,322
1579,583,259,49.24952380952381,51.85015873015873,19,33,343,3,324
1580,583,421,49.24952380952381,51.17678004535148,19,21,182,2,162
1581,583,757,49.24952380952381,50.85170068027211,19,21,187,2,174
1582,583,615,49.24952380952381,51.89659863945578,19,23,118,3,32
1583,583,948,49.24952380952381,50.5730612244898,19,19,369,1,365
1584,583,953,49.24952380952381,51.26965986394558,19,20,380,2,370
1585,583,837,49.24952380952381,52.22167800453515,19,15,284,3,254
1586,421,4,51.17678004535148,52.7092970521542,21,47,422,2,417
1587,421,8,51.17678004535148,53.38267573696145,21,50,424,2,413
1588,421,262,51.17678004535148,52.54675736961451,21,33,170,1,159
1589,421,589,51.17678004535148,52.7092970521542,21,20,180,2,168
1590,421,615,51.17678004535148,53.173696145124715,21,17,212,2,194
1591,421,615,51.17678004535148,53.8702947845805,21,16,226,3,194
1592,421,837,51.17678004535148,52.22167800453515,21,15,418,1,416
1593,421,899,51.17678004535148,53.84707482993198,21,21,492,3,478
1594,583,232,51.89659863945578,54.19537414965986,25,30,365,2,351
1595,583,260,51.89659863945578,54.79909297052154,25,33,346,3,323
1596,583,438,51.89659863945578,54.19537414965986,25,21,176,2,145
1597,583,615,51.89659863945578,53.173696145124715,25,17,64,1,32
1598,583,615,51.89659863945578,53.8702947845805,25,16,91,2,32
1599,583,650,51.89659863945578,54.77587301587302,25,18,141,3,67
1600,583,899,51.89659863945578,53.84707482993198,25,21,327,2,316
1601,583,877,51.89659863945578,54.218594104308394,25,15,311,2,294
1602,589,232,52.7092970521542,54.19537414965986,20,30,363,1,357
1603,589,260,52.7092970521542,54.79909297052154,20,33,341,2,329
1604,589,271,52.7092970521542,55.24027210884354,20,22,336,3,318
1605,589,438,52.7092970521542,54.19537414965986,20,21,164,1,151
1606,589,453,52.7092970521542,54.89197278911565,20,24,165,2,136
1607,589,615,52.7092970521542,53.8702947845805,20,16,56,1,26
1608,589,650,52.7092970521542,54.77587301587302,20,18,108,2,61
1609,589,620,52.7092970521542,55.28671201814059,20,15,115,3,31
1610,589,899,52.7092970521542,53.84707482993198,20,21,314,1,310
1611,589,877,52.7092970521542,54.218594104308394,20,15,295,2,288
1612,438,5,54.19537414965986,55.70467120181406,21,48,438,2,433
1613,438,5,54.19537414965986,56.42448979591837,21,49,444,2,433
1614,438,271,54.19537414965986,55.24027210884354,21,22,173,1,167
1615,438,233,54.19537414965986,57.0746485260771,21,27,240,3,205
1616,438,422,54.19537414965986,55.843990929705214,21,20,73,2,16
1617,438,436,54.19537414965986,56.91210884353742,21,19,117,3,2
1618,438,620,54.19537414965986,55.28671201814059,21,15,188,1,182
1619,438,650,54.19537414965986,56.679909297052156,21,16,237,2,212
1620,438,901,54.19537414965986,56.633469387755106,21,14,475,2,463
1621,453,5,54.89197278911565,56.42448979591837,24,49,453,2,448
1622,453,5,54.89197278911565,57.84090702947846,24,47,466,3,448
1623,453,233,54.89197278911565,57.0746485260771,24,27,239,2,220
1624,453,292,54.89197278911565,57.65514739229025,24,29,200,3,161
1625,453,436,54.89197278911565,56.91210884353742,24,19,89,2,17
1626,453,421,54.89197278911565,57.67836734693878,24,25,124,3,32
1627,453,650,54.89197278911565,56.679909297052156,24,16,212,2,197
1628,453,618,54.89197278911565,57.58548752834467,24,20,202,3,165
1629,453,901,54.89197278911565,56.633469387755106,24,14,454,2,448
1630,453,845,54.89197278911565,57.608707482993196,24,13,409,3,392
1631,422,5,55.843990929705214,57.84090702947846,20,47,426,2,417
1632,422,5,55.843990929705214,58.537505668934244,20,49,433,3,417
1633,422,233,55.843990929705214,57.0746485260771,20,27,196,1,189
1634,422,292,55.843990929705214,57.65514739229025,20,29,152,2,130
1635,422,259,55.843990929705214,58.583945578231294,20,25,201,3,163
1636,422,436,55.843990929705214,56.91210884353742,20,19,48,1,14
1637,422,421,55.843990929705214,57.67836734693878,20,25,79,2,1
1638,422,618,55.843990929705214,57.58548752834467,20,20,210,2,196
1639,422,616,55.843990929705214,58.816145124716556,20,15,232,3,194
1640,422,845,55.843990929705214,57.608707482993196,20,13,430,2,423
1641,436,5,56.91210884353742,58.537505668934244,19,49,437,2,431
1642,436,259,56.91210884353742,58.583945578231294,19,25,191,2,177
1643,436,431,56.91210884353742,58.83936507936508,19,19,83,2,5
1644,436,616,56.91210884353742,58.816145124716556,19,15,198,2,180
1645,421,4,57.67836734693878,60.186122448979596,25,44,431,3,417
1646,421,5,57.67836734693878,60.65052154195011,25,46,435,3,416
1647,421,258,57.67836734693878,59.90748299319728,25,26,189,2,163
1648,421,291,57.67836734693878,60.53442176870748,25,28,179,3,130
1649,421,431,57.67836734693878,58.83936507936508,25,19,51,1,10
1650,421,517,57.67836734693878,59.97714285714286,25,21,138,2,96
1651,421,549,57.67836734693878,60.51120181405896,25,24,177,3,128
1652,421,616,57.67836734693878,58.816145124716556,25,15,201,1,195
1653,421,646,57.67836734693878,59.97714285714286,25,16,246,2,225
1654,421,619,57.67836734693878,60.395102040816326,25,21,230,3,198
1655,421,841,57.67836734693878,60.46476190476191,25,16,437,3,420
1656,431,4,58.83936507936508,60.186122448979596,19,44,431,1,427
1657,431,5,58.83936507936508,60.65052154195011,19,46,433,2,426
1658,431,258,58.83936507936508,59.90748299319728,19,26,179,1,173
1659,431,291,58.83936507936508,60.53442176870748,19,28,158,2,140
1660,431,517,58.83936507936508,59.97714285714286,19,21,99,1,86
1661,431,549,58.83936507936508,60.51120181405896,19,24,138,2,118
1662,431,646,58.83936507936508,59.97714285714286,19,16,221,1,215
1663,431,619,58.83936507936508,60.395102040816326,19,21,200,2,188
1664,431,841,58.83936507936508,60.46476190476191,19,16,416,2,410
1665,517,271,59.97714285714286,62.11337868480726,21,30,263,2,246
1666,517,261,59.97714285714286,62.415238095238095,21,33,277,2,256
1667,517,579,59.97714285714286,62.04371882086168,21,23,108,2,62
1668,517,757,59.97714285714286,62.136598639455784,21,21,257,2,240
1669,517,943,59.97714285714286,62.02049886621315,21,16,435,2,426
1670,517,953,59.97714285714286,62.577777777777776,21,20,450,3,436
1671,549,271,60.51120181405896,62.11337868480726,24,30,286,2,278
1672,549,261,60.51120181405896,62.415238095238095,24,33,299,2,288
1673,549,579,60.51120181405896,62.04371882086168,24,23,72,2,30
1674,549,551,60.51120181405896,63.181496598639455,24,25,115,3,2
1675,549,580,60.51120181405896,63.43691609977324,24,24,130,3,31
1676,549,757,60.51120181405896,62.136598639455784,24,21,219,2,208
1677,549,615,60.51120181405896,63.181496598639455,24,23,133,3,66
1678,549,943,60.51120181405896,62.02049886621315,24,16,399,2,394
1679,549,953,60.51120181405896,62.577777777777776,24,20,414,2,404
1680,579,262,62.04371882086168,63.831655328798185,23,34,326,2,317
1681,579,551,62.04371882086168,63.181496598639455,23,25,56,1,28
1682,579,580,62.04371882086168,63.43691609977324,23,24,60,1,1
1683,579,615,62.04371882086168,63.181496598639455,23,23,61,1,36
1684,579,764,62.04371882086168,63.506575963718824,23,18,195,1,185
1685,579,838,62.04371882086168,63.52979591836735,23,17,267,1,259
1686,551,387,63.181496598639455,65.03909297052154,25,26,182,2,164
1687,551,233,63.181496598639455,65.36417233560091,25,26,332,2,318
1688,551,566,63.181496598639455,65.10875283446713,25,21,84,2,15
1689,551,412,63.181496598639455,66.03755102040816,25,31,186,3,139
1690,551,621,63.181496598639455,65.06231292517008,25,23,107,2,70
1691,551,628,63.181496598639455,65.92145124716554,25,21,141,3,77
1692,551,875,63.181496598639455,65.22485260770975,25,21,336,2,324
1693,580,387,63.43691609977324,65.03909297052154,24,26,205,2,193
1694,580,233,63.43691609977324,65.36417233560091,24,26,357,2,347
1695,580,566,63.43691609977324,65.10875283446713,24,21,73,2,14
1696,580,412,63.43691609977324,66.03755102040816,24,31,202,3,168
1697,580,621,63.43691609977324,65.06231292517008,24,23,81,2,41
1698,580,628,63.43691609977324,65.92145124716554,24,21,117,2,48
1699,580,875,63.43691609977324,65.22485260770975,24,21,305,2,295
1700,580,944,63.43691609977324,66.20009070294785,24,22,383,3,364
1701,566,283,65.10875283446713,67.26820861678004,21,29,298,2,283
1702,566,386,65.10875283446713,67.89514739229026,21,30,216,3,180
1703,566,415,65.10875283446713,66.6877097505669,21,24,166,2,151
1704,566,412,65.10875283446713,67.43074829931973,21,21,184,2,154
1705,566,726,65.10875283446713,66.50195011337868,21,20,171,1,160
1706,566,757,65.10875283446713,67.57006802721088,21,22,218,2,191
1707,566,944,65.10875283446713,66.20009070294785,21,22,381,1,378
1708,566,901,65.10875283446713,67.26820861678004,21,18,348,2,335
1709,412,5,66.03755102040816,67.70938775510204,31,47,413,2,407
1710,412,5,66.03755102040816,68.40598639455783,31,49,420,2,407
1711,412,283,66.03755102040816,67.26820861678004,31,29,139,1,129
1712,412,386,66.03755102040816,67.89514739229026,31,30,84,2,26
1713,412,211,66.03755102040816,68.70784580498866,31,25,232,3,201
1714,412,436,66.03755102040816,68.63818594104309,31,23,115,3,24
1715,412,757,66.03755102040816,67.57006802721088,31,22,351,2,345
1716,412,632,66.03755102040816,68.70784580498866,31,20,248,3,220
1717,412,901,66.03755102040816,67.26820861678004,31,18,492,1,489
1718,412,843,66.03755102040816,68.10412698412699,31,22,440,2,431
1719,412,828,66.03755102040816,68.63818594104309,31,19,431,3,416
1720,415,5,66.6877097505669,67.70938775510204,24,47,412,1,410
1721,415,5,66.6877097505669,68.40598639455783,24,49,417,2,410
1722,415,386,66.6877097505669,67.89514739229026,24,30,60,1,29
1723,415,211,66.6877097505669,68.70784580498866,24,25,222,2,204
1724,415,266,66.6877097505669,69.38122448979593,24,26,189,3,149
1725,415,436,66.6877097505669,68.63818594104309,24,23,87,2,21
1726,415,632,66.6877097505669,68.70784580498866,24,20,234,2,217
1727,415,843,66.6877097505669,68.10412698412699,24,22,432,1,428
1728,415,828,66.6877097505669,68.63818594104309,24,19,421,2,413
1729,412,8,67.43074829931973,69.72952380952381,21,50,416,2,404
1730,412,211,67.43074829931973,68.70784580498866,21,25,208,1,201
1731,412,266,67.43074829931973,69.38122448979593,21,26,168,2,146
1732,412,256,67.43074829931973,70.31002267573696,21,28,199,3,156
1733,412,436,67.43074829931973,68.63818594104309,21,23,57,1,24
1734,412,414,67.43074829931973,69.84562358276644,21,25,104,2,2
1735,412,632,67.43074829931973,68.70784580498866,21,20,227,1,220
1736,412,796,67.43074829931973,70.26358276643991,21,24,403,3,384
1737,412,615,67.43074829931973,70.28680272108843,21,23,237,3,203
1738,412,828,67.43074829931973,68.63818594104309,21,19,419,1,416
1739,412,821,67.43074829931973,70.26358276643991,21,18,427,3,409
1740,412,821,67.43074829931973,70.28680272108843,21,21,427,3,409
1741,436,8,68.63818594104309,69.72952380952381,23,50,431,1,428
1742,436,5,68.63818594104309,71.23882086167801,23,48,445,3,431
1743,436,256,68.63818594104309,70.31002267573696,23,28,194,2,180
1744,436,414,68.63818594104309,69.84562358276644,23,25,56,1,22
1745,436,410,68.63818594104309,70.75120181405896,23,21,95,2,26
1746,436,796,68.63818594104309,70.26358276643991,23,24,367,2,360
1747,436,615,68.63818594104309,70.28680272108843,23,23,193,2,179
1748,436,821,68.63818594104309,70.26358276643991,23,18,391,2,385
1749,436,821,68.63818594104309,70.28680272108843,23,21,391,2,385
1750,414,5,69.84562358276644,71.23882086167801,25,48,413,1,409
1751,414,6,69.84562358276644,71.91219954648527,25,45,418,2,408
1752,414,5,69.84562358276644,72.65523809523809,25,49,427,3,409
1753,414,219,69.84562358276644,72.16761904761906,25,34,219,2,195
1754,414,363,69.84562358276644,72.79455782312925,25,29,137,3,51
1755,414,560,69.84562358276644,72.14439909297052,25,26,176,2,146
1756,414,657,69.84562358276644,72.14439909297052,25,21,262,2,243
1757,414,845,69.84562358276644,72.37659863945578,25,16,445,3,431
1758,410,6,70.75120181405896,71.91219954648527,21,45,407,1,404
1759,410,5,70.75120181405896,72.65523809523809,21,49,413,2,405
1760,410,5,70.75120181405896,73.3750566893424,21,50,420,3,405
1761,410,219,70.75120181405896,72.16761904761906,21,34,201,1,191
1762,410,363,70.75120181405896,72.79455782312925,21,29,100,2,47
1763,410,258,70.75120181405896,73.51437641723356,21,30,193,3,152
1764,410,560,70.75120181405896,72.14439909297052,21,26,162,1,150
1765,410,411,70.75120181405896,73.09641723356009,21,22,101,2,1
1766,410,566,70.75120181405896,73.56081632653061,21,28,197,3,156
1767,410,657,70.75120181405896,72.14439909297052,21,21,254,1,247
1768,410,621,70.75120181405896,72.93387755102042,21,20,231,2,211
1769,410,695,70.75120181405896,73.58403628117914,21,23,310,3,285
1770,410,845,70.75120181405896,72.37659863945578,21,16,441,2,435
1771,410,877,70.75120181405896,73.70013605442178,21,20,484,3,467
1772,560,258,72.14439909297052,73.51437641723356,26,30,308,1,302
1773,560,206,72.14439909297052,74.39673469387755,26,30,367,2,354
1774,560,566,72.14439909297052,73.56081632653061,26,28,61,1,6
1775,560,576,72.14439909297052,74.62893424036281,26,26,108,2,16
1776,560,695,72.14439909297052,73.58403628117914,26,23,149,1,135
1777,560,634,72.14439909297052,74.60571428571428,26,25,129,2,74
1778,560,877,72.14439909297052,73.70013605442178,26,20,324,2,317
1779,560,877,72.14439909297052,74.7914739229025,26,21,337,3,317
1780,411,5,73.09641723356009,74.76825396825397,22,48,412,2,406
1781,411,8,73.09641723356009,75.58095238095238,22,50,417,2,403
1782,411,206,73.09641723356009,74.39673469387755,22,30,213,1,205
1783,411,217,73.09641723356009,76.06857142857143,22,24,232,3,194
1784,411,576,73.09641723356009,74.62893424036281,22,26,178,2,165
1785,411,552,73.09641723356009,75.7667120181406,22,20,182,3,141
1786,411,634,73.09641723356009,74.60571428571428,22,25,232,2,223
1787,411,634,73.09641723356009,75.7667120181406,22,17,251,3,223
1788,411,877,73.09641723356009,74.7914739229025,22,21,472,2,466
1789,411,878,73.09641723356009,75.74349206349207,22,14,481,3,467
1790,566,217,73.56081632653061,76.06857142857143,28,24,365,3,349
1791,566,387,73.56081632653061,76.39365079365079,28,24,217,3,179
1792,566,576,73.56081632653061,74.62893424036281,28,26,47,1,10
1793,566,552,73.56081632653061,75.7667120181406,28,20,96,2,14
1794,566,634,73.56081632653061,74.60571428571428,28,25,82,1,68
1795,566,634,73.56081632653061,75.7667120181406,28,17,117,2,68
1796,566,621,73.56081632653061,76.37043083900227,28,22,133,3,55
1797,566,877,73.56081632653061,74.7914739229025,28,21,315,1,311
1798,566,878,73.56081632653061,75.74349206349207,28,14,326,2,312
1799,576,217,74.62893424036281,76.06857142857143,26,24,364,1,359
1800,576,387,74.62893424036281,76.39365079365079,26,24,204,2,189
1801,576,552,74.62893424036281,75.7667120181406,26,20,55,1,24
1802,576,413,74.62893424036281,77.29922902494332,26,27,199,3,163
1803,576,412,74.62893424036281,77.32244897959184,26,29,201,3,164
1804,576,634,74.62893424036281,75.7667120181406,26,17,76,1,58
1805,576,621,74.62893424036281,76.37043083900227,26,22,87,2,45
1806,576,630,74.62893424036281,77.34566893424036,26,21,129,3,54
1807,576,878,74.62893424036281,75.74349206349207,26,14,306,1,302
1808,576,865,74.62893424036281,76.579410430839,26,21,301,2,289
1809,576,849,74.62893424036281,77.32244897959184,26,23,297,3,273
1810,552,388,75.7667120181406,77.78684807256236,20,27,186,2,164
1811,552,413,75.7667120181406,77.29922902494332,20,27,154,2,139
1812,552,412,75.7667120181406,77.32244897959184,20,29,155,2,140
1813,552,414,75.7667120181406,78.43700680272109,20,24,180,3,138
1814,552,630,75.7667120181406,77.34566893424036,20,21,103,2,78
1815,552,849,75.7667120181406,77.32244897959184,20,23,304,2,297
1816,413,5,77.29922902494332,78.99428571428571,27,48,414,2,408
1817,413,5,77.29922902494332,79.71410430839002,27,49,421,2,408
1818,413,387,77.29922902494332,79.18004535147392,27,29,85,2,26
1819,413,316,77.29922902494332,80.27138321995464,27,24,161,3,97
1820,413,414,77.29922902494332,78.43700680272109,27,24,49,1,1
1821,413,437,77.29922902494332,79.92308390022676,27,22,116,3,24
1822,413,757,77.29922902494332,78.85496598639456,27,21,350,2,344
1823,413,633,77.29922902494332,79.99274376417233,27,19,249,3,220
1824,413,872,77.29922902494332,78.85496598639456,27,23,464,2,459
1825,413,843,77.29922902494332,79.41224489795918,27,20,440,2,430
1826,412,5,77.32244897959184,78.99428571428571,29,48,413,2,407
1827,412,5,77.32244897959184,79.71410430839002,29,49,420,2,407
1828,412,387,77.32244897959184,79.18004535147392,29,29,84,2,25
1829,412,316,77.32244897959184,80.27138321995464,29,24,159,3,96
1830,412,414,77.32244897959184,78.43700680272109,29,24,48,1,2
1831,412,437,77.32244897959184,79.92308390022676,29,22,115,3,25
1832,412,757,77.32244897959184,78.85496598639456,29,21,351,2,345
1833,412,633,77.32244897959184,79.99274376417233,29,19,249,3,221
1834,412,872,77.32244897959184,78.85496598639456,29,23,465,2,460
1835,412,843,77.32244897959184,79.41224489795918,29,20,440,2,431
1836,414,5,78.43700680272109,79.71410430839002,24,49,413,1,409
1837,414,8,78.43700680272109,81.01442176870748,24,50,421,3,406
1838,414,316,78.43700680272109,80.27138321995464,24,24,126,2,98
1839,414,388,78.43700680272109,81.24662131519274,24,24,124,3,26
1840,414,437,78.43700680272109,79.92308390022676,24,22,68,1,23
1841,414,633,78.43700680272109,79.99274376417233,24,19,229,2,219
1842,414,776,78.43700680272109,81.24662131519274,24,20,382,3,362
1843,414,851,78.43700680272109,81.13052154195012,24,18,452,3,437
1844,437,8,79.92308390022676,81.01442176870748,22,50,432,1,429
1845,437,8,79.92308390022676,81.57170068027212,22,51,435,2,429
1846,437,8,79.92308390022676,82.33795918367348,22,48,441,2,429
1847,437,388,79.92308390022676,81.24662131519274,22,24,75,1,49
1848,437,256,79.92308390022676,82.03609977324263,22,28,203,2,181
1849,437,314,79.92308390022676,82.63981859410431,22,23,170,3,123
1850,437,414,79.92308390022676,81.15374149659864,22,26,58,1,23
1851,437,410,79.92308390022676,81.61814058956917,22,19,78,2,27
1852,437,776,79.92308390022676,81.24662131519274,22,20,344,1,339
1853,437,796,79.92308390022676,81.57170068027212,22,24,366,2,359
1854,437,622,79.92308390022676,82.84879818594105,22,17,224,3,185
1855,437,851,79.92308390022676,81.13052154195012,22,18,417,1,414
1856,437,821,79.92308390022676,81.59492063492064,22,21,391,2,384
1857,437,894,79.92308390022676,82.77913832199546,22,21,473,3,457
1858,414,8,81.15374149659864,82.33795918367348,26,48,409,1,406
1859,414,5,81.15374149659864,83.94013605442177,26,48,426,3,409
1860,414,314,81.15374149659864,82.63981859410431,26,23,119,1,100
1861,414,218,81.15374149659864,83.47573696145125,26,33,220,2,196
1862,414,590,81.15374149659864,83.26675736961451,26,22,198,2,176
1863,414,558,81.15374149659864,83.47573696145125,26,25,175,2,144
1864,414,622,81.15374149659864,82.84879818594105,26,17,220,2,208
1865,414,657,81.15374149659864,83.4292970521542,26,20,262,2,243
1866,414,894,81.15374149659864,82.77913832199546,26,21,485,2,480
1867,410,5,81.61814058956917,83.94013605442177,19,48,417,2,405
1868,410,314,81.61814058956917,82.63981859410431,19,23,106,1,96
1869,410,218,81.61814058956917,83.47573696145125,19,33,208,2,192
1870,410,590,81.61814058956917,83.26675736961451,19,22,193,2,180
1871,410,558,81.61814058956917,83.47573696145125,19,25,168,2,148
1872,410,622,81.61814058956917,82.84879818594105,19,17,219,1,212
1873,410,657,81.61814058956917,83.4292970521542,19,20,259,2,247
1874,410,894,81.61814058956917,82.77913832199546,19,21,487,1,484
1875,590,258,83.26675736961451,84.82249433106576,22,29,339,2,332
1876,590,206,83.26675736961451,85.68163265306123,22,28,398,2,384
1877,590,566,83.26675736961451,84.8457142857143,22,28,72,2,24
1878,590,576,83.26675736961451,85.91383219954649,22,26,115,3,14
1879,590,617,83.26675736961451,84.8457142857143,22,23,73,2,27
1880,590,634,83.26675736961451,85.91383219954649,22,24,122,3,44
1881,590,877,83.26675736961451,85.00825396825397,22,21,297,2,287
1882,590,877,83.26675736961451,86.07637188208616,22,19,311,3,287
1883,558,258,83.47573696145125,84.82249433106576,25,29,306,1,300
1884,558,206,83.47573696145125,85.68163265306123,25,28,365,2,352
1885,558,566,83.47573696145125,84.8457142857143,25,28,60,1,8
1886,558,576,83.47573696145125,85.91383219954649,25,26,107,2,18
1887,558,429,83.47573696145125,86.35501133786848,25,19,179,3,129
1888,558,617,83.47573696145125,84.8457142857143,25,23,83,1,59
1889,558,634,83.47573696145125,85.91383219954649,25,24,130,2,76
1890,558,877,83.47573696145125,85.00825396825397,25,21,326,2,319
1891,558,877,83.47573696145125,86.07637188208616,25,19,338,3,319
1892,558,921,83.47573696145125,86.35501133786848,25,13,384,3,363
1893,566,289,84.8457142857143,86.51755102040816,28,24,286,2,277
1894,566,576,84.8457142857143,85.91383219954649,28,26,47,1,10
1895,566,429,84.8457142857143,86.35501133786848,28,19,152,2,137
1896,566,561,84.8457142857143,87.74820861678005,28,16,125,3,5
1897,566,634,84.8457142857143,85.91383219954649,28,24,82,1,68
1898,566,621,84.8457142857143,87.05160997732426,28,18,110,2,55
1899,566,877,84.8457142857143,86.07637188208616,28,19,315,1,311
1900,566,921,84.8457142857143,86.35501133786848,28,13,361,2,355
1901,576,97,85.91383219954649,88.00362811791383,26,41,487,2,479
1902,576,227,85.91383219954649,88.16616780045352,26,29,362,2,349
1903,576,333,85.91383219954649,88.51446712018141,26,20,268,3,243
1904,576,561,85.91383219954649,87.74820861678005,26,16,80,2,15
1905,576,621,85.91383219954649,87.05160997732426,26,18,67,1,45
1906,576,810,85.91383219954649,88.16616780045352,26,18,253,2,234
1907,576,844,85.91383219954649,88.16616780045352,26,21,285,2,268
1908,429,97,86.35501133786848,88.00362811791383,19,41,340,2,332
1909,429,58,86.35501133786848,89.28072562358277,19,41,392,3,371
1910,429,227,86.35501133786848,88.16616780045352,19,29,217,2,202
1911,429,333,86.35501133786848,88.51446712018141,19,20,134,2,96
1912,429,561,86.35501133786848,87.74820861678005,19,16,145,1,132
1913,429,608,86.35501133786848,89.32716553287982,19,16,220,3,179
1914,429,810,86.35501133786848,88.16616780045352,19,18,389,2,381
1915,429,844,86.35501133786848,88.16616780045352,19,21,422,2,415
1916,561,231,87.74820861678005,89.44326530612246,16,23,338,2,330
1917,561,608,87.74820861678005,89.32716553287982,16,16,83,2,47
1918,561,489,87.74820861678005,89.62902494331065,16,18,108,2,72
1919,561,438,87.74820861678005,90.58104308390023,16,20,173,3,123
1920,561,666,87.74820861678005,89.35038548752834,16,18,126,2,105
1921,561,636,87.74820861678005,89.46648526077098,16,20,105,2,75
1922,561,615,87.74820861678005,90.58104308390023,16,18,133,3,54
1923,561,930,87.74820861678005,89.11818594104308,16,16,374,1,369
1924,561,835,87.74820861678005,89.42004535147393,16,14,283,2,274
1925,608,228,89.32716553287982,91.02222222222223,16,33,387,2,380
1926,608,207,89.32716553287982,91.69560090702949,16,28,414,2,401
1927,608,438,89.32716553287982,90.58104308390023,16,20,178,1,170
1928,608,410,89.32716553287982,91.60272108843537,16,20,221,2,198
1929,608,615,89.32716553287982,90.58104308390023,16,18,54,1,7
1930,608,775,89.32716553287982,91.71882086167801,16,18,196,2,167
1931,608,874,89.32716553287982,90.97578231292518,16,16,275,2,266
1932,608,853,89.32716553287982,91.71882086167801,16,20,266,2,245
1933,489,5,89.62902494331065,90.9990022675737,18,50,488,1,484
1934,489,4,89.62902494331065,92.25287981859411,18,48,498,3,485
1935,489,228,89.62902494331065,91.02222222222223,18,33,268,1,261
1936,489,207,89.62902494331065,91.69560090702949,18,28,296,2,282
1937,489,410,89.62902494331065,91.60272108843537,18,20,116,2,79
1938,489,775,89.62902494331065,91.71882086167801,18,18,300,2,286
1939,489,874,89.62902494331065,90.97578231292518,18,16,389,1,385
1940,489,853,89.62902494331065,91.71882086167801,18,20,375,2,364
1941,438,4,90.58104308390023,92.25287981859411,20,48,440,2,434
1942,438,5,90.58104308390023,93.11201814058957,20,49,447,3,433
1943,438,207,90.58104308390023,91.69560090702949,20,28,236,1,231
1944,438,254,90.58104308390023,92.71727891156463,20,21,206,2,184
1945,438,410,90.58104308390023,91.60272108843537,20,20,52,1,28
1946,438,431,90.58104308390023,92.71727891156463,20,19,92,2,7
1947,438,775,90.58104308390023,91.71882086167801,20,18,341,1,337
1948,438,627,90.58104308390023,92.71727891156463,20,14,210,2,189
1949,438,853,90.58104308390023,91.71882086167801,20,20,418,1,415
1950,410,5,91.60272108843537,93.11201814058957,20,49,410,2,405
1951,410,5,91.60272108843537,93.83183673469388,20,49,416,2,405
1952,410,5,91.60272108843537,94.52843537414967,20,50,424,3,405
1953,410,254,91.60272108843537,92.71727891156463,20,21,163,1,156
1954,410,260,91.60272108843537,93.80861678004536,20,29,178,2,150
1955,410,231,91.60272108843537,94.55165532879819,20,29,219,3,179
1956,410,431,91.60272108843537,92.71727891156463,20,19,52,1,21
1957,410,436,91.60272108843537,94.11047619047619,20,19,111,3,26
1958,410,627,91.60272108843537,92.71727891156463,20,14,222,1,217
1959,410,811,91.60272108843537,93.83183673469388,20,19,412,2,401
1960,410,844,91.60272108843537,93.80861678004536,20,17,444,2,434
1961,431,5,92.71727891156463,93.83183673469388,19,49,429,1,426
1962,431,5,92.71727891156463,94.52843537414967,19,50,433,2,426
1963,431,260,92.71727891156463,93.80861678004536,19,29,177,1,171
1964,431,231,92.71727891156463,94.55165532879819,19,29,215,2,200
1965,431,436,92.71727891156463,94.11047619047619,19,19,60,1,5
1966,431,573,92.71727891156463,94.80707482993198,19,19,168,2,142
1967,431,811,92.71727891156463,93.83183673469388,19,19,383,1,380
1968,431,784,92.71727891156463,94.66775510204081,19,18,363,2,353
1969,431,634,92.71727891156463,95.52689342403629,19,15,236,3,203
1970,431,844,92.71727891156463,93.80861678004536,19,17,416,1,413
1971,431,842,92.71727891156463,94.66775510204081,19,19,419,2,411
1972,436,5,94.11047619047619,95.96807256235827,19,49,438,2,431
1973,436,5,94.11047619047619,96.64145124716553,19,50,445,3,431
1974,436,284,94.11047619047619,96.26993197278912,19,24,178,2,152
1975,436,227,94.11047619047619,96.66467120181406,19,29,236,3,209
1976,436,517,94.11047619047619,96.29315192743765,19,18,124,2,81
1977,436,516,94.11047619047619,96.98975056689342,19,18,148,3,80
1978,436,634,94.11047619047619,95.52689342403629,19,15,207,1,198
1979,436,811,94.11047619047619,96.68789115646258,19,18,391,3,375
1980,436,843,94.11047619047619,96.68789115646258,19,18,422,3,407
1981,573,284,94.80707482993198,96.26993197278912,19,24,296,1,289
1982,573,227,94.80707482993198,96.66467120181406,19,29,355,2,346
1983,573,231,94.80707482993198,97.54702947845806,19,29,362,3,342
1984,573,517,94.80707482993198,96.29315192743765,19,18,85,1,56
1985,573,516,94.80707482993198,96.98975056689342,19,18,110,2,57
1986,573,605,94.80707482993198,97.54702947845806,19,19,122,3,32
1987,573,811,94.80707482993198,96.68789115646258,19,18,251,2,238
1988,573,628,94.80707482993198,97.66312925170068,19,19,135,3,55
1989,573,938,94.80707482993198,96.26993197278912,19,12,370,1,365
1990,573,843,94.80707482993198,96.68789115646258,19,18,282,2,270
1991,517,231,96.29315192743765,97.54702947845806,18,29,291,1,286
1992,517,605,96.29315192743765,97.54702947845806,18,19,103,1,88
1993,517,431,96.29315192743765,99.07954648526078,18,18,148,3,86
1994,517,628,96.29315192743765,97.66312925170068,18,19,126,1,111
1995,517,627,96.29315192743765,99.05632653061225,18,17,162,3,110
1996,517,878,96.29315192743765,97.82566893424037,18,17,367,2,361
1997,516,205,96.98975056689342,99.40462585034014,18,27,328,2,311
1998,516,431,96.98975056689342,99.07954648526078,18,18,124,2,85
1999,516,627,96.98975056689342,99.05632653061225,18,17,142,2,111
2000,516,615,96.98975056689342,99.75292517006802,18,17,155,3,99
2001,516,821,96.98975056689342,99.40462585034014,18,16,322,2,305
2002,605,205,97.54702947845806,99.40462585034014,19,27,408,2,400
2003,605,227,97.54702947845806,100.33342403628119,19,32,397,3,378
2004,605,431,97.54702947845806,99.07954648526078,19,18,186,2,174
2005,605,411,97.54702947845806,100.00834467120181,19,21,221,2,194
2006,605,627,97.54702947845806,99.05632653061225,19,17,69,2,22
2007,605,615,97.54702947845806,99.75292517006802,19,17,96,2,10
2008,605,821,97.54702947845806,99.40462585034014,19,16,230,2,216
2009,605,898,97.54702947845806,99.98512471655329,19,18,311,2,293
2010,431,5,99.07954648526078,100.1708843537415,18,50,429,1,426
2011,431,5,99.07954648526078,100.89070294784581,18,49,433,2,426
2012,431,227,99.07954648526078,100.33342403628119,18,32,211,1,204
2013,431,260,99.07954648526078,101.26222222222222,18,31,195,2,171
2014,431,568,99.07954648526078,101.86594104308391,18,20,182,3,137
2015,431,807,99.07954648526078,101.37832199546486,18,20,389,2,376
2016,431,665,99.07954648526078,101.98204081632653,18,19,265,3,234
2017,431,851,99.07954648526078,101.33188208616781,18,19,431,2,420
2018,431,843,99.07954648526078,101.72662131519274,18,16,427,3,412
2019,411,5,100.00834467120181,102.28390022675737,21,50,418,2,406
2020,411,260,100.00834467120181,101.26222222222222,21,31,160,1,151
2021,411,262,100.00834467120181,102.33034013605442,21,25,179,2,149
2022,411,259,100.00834467120181,102.51609977324263,21,30,186,3,152
2023,411,431,100.00834467120181,101.19256235827665,21,19,55,1,20
2024,411,568,100.00834467120181,101.86594104308391,21,20,176,2,157
2025,411,436,100.00834467120181,102.5857596371882,21,20,114,3,25
2026,411,807,100.00834467120181,101.37832199546486,21,20,400,1,396
2027,411,665,100.00834467120181,101.98204081632653,21,19,268,2,254
2028,411,851,100.00834467120181,101.33188208616781,21,19,444,1,440
2029,411,843,100.00834467120181,101.72662131519274,21,16,438,2,432
2030,411,899,100.00834467120181,102.46965986394558,21,19,499,2,488
2031,431,5,101.19256235827665,102.28390022675737,19,50,429,1,426
2032,431,4,101.19256235827665,103.07337868480725,19,47,435,2,427
2033,431,262,101.19256235827665,102.33034013605442,19,25,176,1,169
2034,431,259,101.19256235827665,102.51609977324263,19,30,181,1,172
2035,431,206,101.19256235827665,104.04861678004535,19,34,256,3,225
2036,431,436,101.19256235827665,102.5857596371882,19,20,60,1,5
2037,431,791,101.19256235827665,103.3752380952381,19,21,372,2,360
2038,431,799,101.19256235827665,104.02539682539683,19,17,388,3,368
2039,431,899,101.19256235827665,102.46965986394558,19,19,471,1,468
2040,568,206,101.86594104308391,104.04861678004535,20,34,374,2,362
2041,568,431,101.86594104308391,104.02539682539683,20,18,166,2,137
2042,568,791,101.86594104308391,103.3752380952381,20,21,232,2,223
2043,568,799,101.86594104308391,104.02539682539683,20,17,249,2,231
2044,568,781,101.86594104308391,104.81487528344671,20,22,248,3,213
2045,568,823,101.86594104308391,104.30403628117914,20,15,276,2,255
2046,568,846,101.86594104308391,104.81487528344671,20,17,306,3,278
2047,436,5,102.5857596371882,104.42013605442177,20,49,438,2,431
2048,436,5,102.5857596371882,105.13995464852609,20,49,445,3,431
2049,436,206,102.5857596371882,104.04861678004535,20,34,238,1,230
2050,436,257,102.5857596371882,105.30249433106576,20,28,214,3,179
2051,436,431,102.5857596371882,104.02539682539683,20,18,62,1,5
2052,436,411,102.5857596371882,105.30249433106576,20,23,120,3,25
2053,436,799,102.5857596371882,104.02539682539683,20,17,368,1,363
2054,436,781,102.5857596371882,104.81487528344671,20,22,358,2,345
2055,436,823,102.5857596371882,104.30403628117914,20,15,394,2,387
2056,436,846,102.5857596371882,104.81487528344671,20,17,421,2,410
2057,431,5,104.02539682539683,105.13995464852609,18,49,429,1,426
2058,431,5,104.02539682539683,105.83655328798186,18,50,433,2,426
2059,431,257,104.02539682539683,105.30249433106576,18,28,182,1,174
2060,431,257,104.02539682539683,106.41705215419502,18,28,202,2,174
2061,431,258,104.02539682539683,106.53315192743764,18,25,204,3,173
2062,431,411,104.02539682539683,105.30249433106576,18,23,59,1,20
2063,431,518,104.02539682539683,106.16163265306123,18,21,127,2,87
2064,431,635,104.02539682539683,106.11519274376417,18,17,223,2,204
2065,431,785,104.02539682539683,106.57959183673469,18,17,371,3,354
2066,431,862,104.02539682539683,106.27773242630386,18,16,442,2,431
2067,431,838,104.02539682539683,106.858231292517,18,18,425,3,407
2068,411,5,105.30249433106576,107.25297052154195,23,49,415,2,406
2069,411,5,105.30249433106576,107.92634920634922,23,50,421,3,406
2070,411,257,105.30249433106576,106.41705215419502,23,28,161,1,154
2071,411,258,105.30249433106576,106.53315192743764,23,25,162,1,153
2072,411,431,105.30249433106576,106.83501133786848,23,18,69,2,20
2073,411,431,105.30249433106576,107.53160997732427,23,19,98,2,20
2074,411,785,105.30249433106576,106.57959183673469,23,17,378,1,374
2075,411,638,105.30249433106576,107.50839002267574,23,20,246,2,227
2076,411,838,105.30249433106576,106.858231292517,23,18,432,2,427
2077,411,863,105.30249433106576,107.99600907029479,23,14,467,3,452
2078,518,52,106.16163265306123,108.62294784580499,21,42,478,2,466
2079,518,234,106.16163265306123,108.43718820861679,21,24,300,2,284
2080,518,431,106.16163265306123,107.53160997732427,21,19,105,1,87
2081,518,412,106.16163265306123,108.66938775510204,21,21,151,3,106
2082,518,638,106.16163265306123,107.50839002267574,21,20,133,1,120
2083,518,720,106.16163265306123,108.48362811791384,21,17,225,2,202
2084,518,863,106.16163265306123,107.99600907029479,21,14,354,2,345
2085,518,900,106.16163265306123,108.50684807256236,21,16,395,2,382
2086,431,5,106.83501133786848,107.92634920634922,18,50,429,1,426
2087,431,52,106.83501133786848,108.62294784580499,18,42,387,2,379
2088,431,234,106.83501133786848,108.43718820861679,18,24,209,2,197
2089,431,260,106.83501133786848,109.38920634920635,18,31,203,3,171
2090,431,412,106.83501133786848,108.66938775510204,18,21,81,2,19
2091,431,720,106.83501133786848,108.48362811791384,18,17,298,2,289
2092,431,774,106.83501133786848,109.7839455782313,18,19,366,3,343
2093,431,863,106.83501133786848,107.99600907029479,18,14,435,1,432
2094,431,900,106.83501133786848,108.50684807256236,18,16,474,2,469
2095,431,52,107.53160997732427,108.62294784580499,19,42,382,1,379
2096,431,5,107.53160997732427,110.06258503401361,19,47,440,3,426
2097,431,260,107.53160997732427,109.38920634920635,19,31,189,2,171
2098,431,255,107.53160997732427,110.24834467120182,19,29,211,3,176
2099,431,412,107.53160997732427,108.66938775510204,19,21,53,1,19
2100,431,442,107.53160997732427,110.15546485260771,19,20,114,3,11
2101,431,774,107.53160997732427,109.7839455782313,19,19,356,2,343
2102,431,840,107.53160997732427,109.92326530612245,19,18,422,2,409
2103,412,5,108.66938775510204,110.06258503401361,21,47,411,1,407
2104,412,5,108.66938775510204,111.45578231292517,21,49,424,3,407
2105,412,5,108.66938775510204,111.4790022675737,21,49,425,3,407
2106,412,255,108.66938775510204,110.24834467120182,21,29,171,2,157
2107,412,261,108.66938775510204,111.36290249433107,21,25,190,3,151
2108,412,442,108.66938775510204,110.15546485260771,21,20,71,1,30
2109,412,555,108.66938775510204,111.06104308390023,21,18,176,2,143
2110,412,774,108.66938775510204,109.7839455782313,21,19,365,1,362
2111,412,632,108.66938775510204,111.06104308390023,21,17,243,2,220
2112,412,840,108.66938775510204,109.92326530612245,21,18,431,1,428
2113,412,882,108.66938775510204,111.38612244897959,21,15,484,3,470
2114,412,885,108.66938775510204,111.4790022675737,21,13,488,3,473
2115,442,5,110.15546485260771,111.45578231292517,20,49,441,1,437
2116,442,5,110.15546485260771,111.4790022675737,20,49,441,1,437
2117,442,5,110.15546485260771,112.89541950113379,20,50,453,3,437
2118,442,261,110.15546485260771,111.36290249433107,20,25,188,1,181
2119,442,259,110.15546485260771,112.1059410430839,20,23,201,2,183
2120,442,255,110.15546485260771,113.05795918367347,20,28,225,3,187
2121,442,423,110.15546485260771,112.29170068027211,20,21,94,2,19
2122,442,617,110.15546485260771,111.75764172335602,20,15,188,2,175
2123,442,882,110.15546485260771,111.38612244897959,20,15,443,1,440
2124,442,885,110.15546485260771,111.4790022675737,20,13,447,1,443
2125,555,259,111.06104308390023,112.1059410430839,18,23,299,1,296
2126,555,255,111.06104308390023,113.05795918367347,18,28,312,2,300
2127,555,423,111.06104308390023,112.29170068027211,18,21,142,1,132
2128,555,431,111.06104308390023,113.19727891156462,18,20,154,2,124
2129,555,618,111.06104308390023,113.1740589569161,18,15,111,2,63
2130,555,626,111.06104308390023,113.87065759637188,18,16,140,3,71
2131,555,884,111.06104308390023,113.38303854875284,18,11,344,2,329
2132,423,5,112.29170068027211,113.59201814058957,21,49,422,1,418
2133,423,5,112.29170068027211,115.00843537414966,21,49,434,3,418
2134,423,270,112.29170068027211,114.42793650793651,21,27,179,2,153
2135,423,259,112.29170068027211,115.05487528344672,21,26,203,3,164
2136,423,482,112.29170068027211,114.0564172335601,21,18,96,2,59
2137,423,626,112.29170068027211,113.87065759637188,21,16,214,2,203
2138,423,635,112.29170068027211,114.5904761904762,21,17,234,2,212
2139,423,884,112.29170068027211,113.38303854875284,21,11,463,1,461
2140,423,881,112.29170068027211,114.19573696145125,21,16,465,2,458
2141,423,868,112.29170068027211,114.49759637188208,21,11,455,2,445
2142,431,5,113.19727891156462,115.00843537414966,20,49,433,2,426
2143,431,4,113.19727891156462,115.58893424036282,20,45,439,2,427
2144,431,270,113.19727891156462,114.42793650793651,20,27,169,1,161
2145,431,259,113.19727891156462,115.05487528344672,20,26,190,2,172
2146,431,259,113.19727891156462,115.79791383219955,20,26,205,3,172
2147,431,428,113.19727891156462,115.3102947845805,20,18,91,2,3
2148,431,423,113.19727891156462,116.05333333333334,20,19,123,3,8
2149,431,635,113.19727891156462,114.5904761904762,20,17,213,1,204
2150,431,615,113.19727891156462,115.65859410430839,20,14,212,2,184
2151,431,868,113.19727891156462,114.49759637188208,20,11,441,1,437
2152,431,855,113.19727891156462,116.09977324263039,20,13,442,3,424
2153,482,4,114.0564172335601,115.58893424036282,18,45,483,2,478
2154,482,259,114.0564172335601,115.79791383219955,18,26,235,2,223
2155,482,259,114.0564172335601,117.02857142857142,18,29,257,3,223
2156,482,428,114.0564172335601,115.3102947845805,18,18,76,1,54
2157,482,423,114.0564172335601,116.05333333333334,18,19,104,2,59
2158,482,615,114.0564172335601,115.65859410430839,18,14,150,2,133
2159,482,855,114.0564172335601,116.09977324263039,18,13,383,2,373
2160,482,878,114.0564172335601,116.98213151927438,18,16,416,3,396
2161,428,5,115.3102947845805,117.12145124716554,18,45,430,2,423
2162,428,5,115.3102947845805,118.02702947845805,18,45,439,3,423
2163,428,259,115.3102947845805,117.02857142857142,18,29,184,2,169
2164,428,552,115.3102947845805,117.4465306122449,18,18,154,2,124
2165,428,421,115.3102947845805,117.8877097505669,18,18,111,3,7
2166,428,616,115.3102947845805,117.16789115646259,18,14,204,2,188
2167,428,699,115.3102947845805,118.28244897959183,18,11,300,3,271
2168,428,878,115.3102947845805,116.98213151927438,18,16,456,2,450
2169,428,842,115.3102947845805,117.84126984126985,18,11,428,3,414
2170,423,5,116.05333333333334,117.12145124716554,19,45,421,1,418
2171,423,5,116.05333333333334,118.02702947845805,19,45,427,2,418
2172,423,258,116.05333333333334,118.46820861678005,19,26,195,2,165
2173,423,227,116.05333333333334,118.93260770975057,19,34,232,3,196
2174,423,552,116.05333333333334,117.4465306122449,19,18,142,1,129
2175,423,421,116.05333333333334,117.8877097505669,19,18,79,2,2
2176,423,438,116.05333333333334,118.9558276643991,19,22,126,3,15
2177,423,616,116.05333333333334,117.16789115646259,19,14,199,1,193
2178,423,699,116.05333333333334,118.28244897959183,19,11,292,2,276
2179,423,744,116.05333333333334,118.93260770975057,19,20,344,3,321
2180,423,842,116.05333333333334,117.84126984126985,19,11,426,2,419
2181,423,848,116.05333333333334,118.88616780045352,19,17,442,3,425
2182,552,258,117.4465306122449,118.46820861678005,18,26,297,1,294
2183,552,227,117.4465306122449,118.93260770975057,18,34,331,1,325
2184,552,438,117.4465306122449,118.9558276643991,18,22,131,2,114
2185,552,434,117.4465306122449,120.1168253968254,18,17,165,3,118
2186,552,744,117.4465306122449,118.93260770975057,18,20,202,1,192
2187,552,848,117.4465306122449,118.88616780045352,18,17,302,1,296
2188,421,5,117.8877097505669,119.4898866213152,18,44,422,2,416
2189,421,5,117.8877097505669,119.81496598639455,18,44,424,2,416
2190,421,227,117.8877097505669,118.93260770975057,18,34,199,1,194
2191,421,227,117.8877097505669,120.48834467120182,18,36,224,3,194
2192,421,227,117.8877097505669,120.51156462585034,18,33,225,3,194
2193,421,438,117.8877097505669,118.9558276643991,18,22,49,1,17
2194,421,434,117.8877097505669,120.1168253968254,18,17,97,2,13
2195,421,462,117.8877097505669,120.79020408163265,18,23,132,3,41
2196,421,744,117.8877097505669,118.93260770975057,18,20,326,1,323
2197,421,811,117.8877097505669,120.48834467120182,18,21,406,3,390
2198,421,786,117.8877097505669,120.51156462585034,18,19,382,3,365
2199,421,844,117.8877097505669,120.48834467120182,18,19,438,3,423
2200,421,852,117.8877097505669,120.53478458049887,18,18,446,3,431
2201,438,4,118.9558276643991,121.34748299319727,22,48,446,2,434
2202,438,227,118.9558276643991,120.48834467120182,22,36,221,2,211
2203,438,227,118.9558276643991,120.51156462585034,22,33,221,2,211
2204,438,387,118.9558276643991,121.51002267573696,22,26,121,3,51
2205,438,434,118.9558276643991,120.1168253968254,22,17,50,1,4
2206,438,462,118.9558276643991,120.79020408163265,22,23,83,2,24
2207,438,811,118.9558276643991,120.48834467120182,22,21,379,2,373
2208,438,786,118.9558276643991,120.51156462585034,22,19,354,2,348
2209,438,645,118.9558276643991,121.51002267573696,22,22,234,3,207
2210,438,844,118.9558276643991,120.48834467120182,22,19,411,2,406
2211,438,852,118.9558276643991,120.53478458049887,22,18,420,2,414
2212,434,4,120.1168253968254,121.34748299319727,17,48,433,1,430
2213,434,49,120.1168253968254,122.39238095238096,17,44,397,2,385
2214,434,387,120.1168253968254,121.51002267573696,17,26,76,1,47
2215,434,412,120.1168253968254,122.50848072562358,17,31,105,2,22
2216,434,411,120.1168253968254,122.53170068027211,17,27,107,2,23
2217,434,645,120.1168253968254,121.51002267573696,17,22,219,1,211
2218,434,783,120.1168253968254,122.67102040816327,17,20,366,3,349
2219,434,849,120.1168253968254,122.48526077097506,17,22,427,2,415
2220,462,49,120.79020408163265,122.39238095238096,23,44,419,2,413
2221,462,4,120.79020408163265,123.46049886621316,23,47,472,3,458
2222,462,266,120.79020408163265,123.20507936507937,23,26,222,2,196
2223,462,412,120.79020408163265,122.50848072562358,23,31,89,2,50
2224,462,411,120.79020408163265,122.53170068027211,23,27,91,2,51
2225,462,592,120.79020408163265,123.762358276644,23,22,182,3,130
2226,462,783,120.79020408163265,122.67102040816327,23,20,331,2,321
2227,462,849,120.79020408163265,122.48526077097506,23,22,394,2,387
2228,462,944,120.79020408163265,122.67102040816327,23,21,489,2,482
2229,412,5,122.50848072562358,124.15709750566894,31,48,413,2,407
2230,412,39,122.50848072562358,124.90013605442176,31,42,387,2,373
2231,412,387,122.50848072562358,124.36607709750567,31,29,84,2,25
2232,412,270,122.50848072562358,124.76081632653062,31,27,172,2,142
2233,412,592,122.50848072562358,123.762358276644,31,22,188,1,180
2234,412,585,122.50848072562358,125.38775510204081,31,21,213,3,173
2235,412,757,122.50848072562358,124.0409977324263,31,22,351,2,345
2236,412,700,122.50848072562358,124.5750566893424,31,20,301,2,288
2237,412,873,122.50848072562358,124.0409977324263,31,23,466,2,461
2238,411,5,122.53170068027211,124.15709750566894,27,48,412,2,406
2239,411,39,122.53170068027211,124.90013605442176,27,42,386,2,372
2240,411,387,122.53170068027211,124.36607709750567,27,29,83,2,24
2241,411,270,122.53170068027211,124.76081632653062,27,27,171,2,141
2242,411,592,122.53170068027211,123.762358276644,27,22,189,1,181
2243,411,585,122.53170068027211,125.38775510204081,27,21,213,3,174
2244,411,757,122.53170068027211,124.0409977324263,27,22,352,2,346
2245,411,700,122.53170068027211,124.5750566893424,27,20,302,2,289
2246,411,873,122.53170068027211,124.0409977324263,27,23,467,2,462
2247,592,266,123.762358276644,125.57351473922903,22,25,335,2,326
2248,592,585,123.762358276644,125.38775510204081,22,21,70,2,7
2249,592,414,123.762358276644,126.31655328798186,22,24,209,3,178
2250,592,777,123.762358276644,126.4326530612245,22,19,218,3,185
2251,592,796,123.762358276644,126.73451247165534,22,24,241,3,204
2252,592,906,123.762358276644,126.4326530612245,22,18,334,3,314
2253,585,256,125.38775510204081,126.78095238095239,21,30,334,1,329
2254,585,560,125.38775510204081,127.26857142857143,21,20,85,2,25
2255,585,777,125.38775510204081,126.4326530612245,21,19,197,1,192
2256,585,796,125.38775510204081,126.73451247165534,21,24,219,1,211
2257,585,618,125.38775510204081,128.05804988662132,21,18,120,3,33
2258,585,906,125.38775510204081,126.4326530612245,21,18,324,1,321
2259,585,821,125.38775510204081,126.75773242630386,21,20,243,1,236
2260,585,901,125.38775510204081,127.91873015873016,21,21,334,3,316
2261,414,4,126.31655328798186,128.4063492063492,24,47,420,2,410
2262,414,6,126.31655328798186,129.07972789115647,24,47,425,3,408
2263,414,295,126.31655328798186,128.45278911564625,24,26,150,2,119
2264,414,219,126.31655328798186,128.63854875283448,24,32,219,2,195
2265,414,590,126.31655328798186,128.45278911564625,24,22,199,2,176
2266,414,560,126.31655328798186,128.61532879818594,24,24,176,2,146
2267,414,618,126.31655328798186,128.05804988662132,24,18,217,2,204
2268,414,657,126.31655328798186,128.61532879818594,24,21,262,2,243
2269,414,901,126.31655328798186,127.91873015873016,24,21,492,2,487
2270,560,295,127.26857142857143,128.45278911564625,20,26,270,1,265
2271,560,219,127.26857142857143,128.63854875283448,20,32,346,1,341
2272,560,258,127.26857142857143,130.0085260770975,20,29,324,3,302
2273,560,590,127.26857142857143,128.45278911564625,20,22,59,1,30
2274,560,566,127.26857142857143,130.03174603174602,20,27,119,3,6
2275,560,657,127.26857142857143,128.61532879818594,20,21,113,1,97
2276,560,617,127.26857142857143,130.03174603174602,20,23,132,3,57
2277,560,949,127.26857142857143,128.61532879818594,20,21,393,1,389
2278,560,877,127.26857142857143,130.1942857142857,20,20,341,3,317
2279,590,258,128.45278911564625,130.0085260770975,22,29,339,2,332
2280,590,232,128.45278911564625,130.86766439909297,22,30,373,2,358
2281,590,566,128.45278911564625,130.03174603174602,22,27,72,2,24
2282,590,576,128.45278911564625,131.09986394557822,22,24,115,3,14
2283,590,617,128.45278911564625,130.03174603174602,22,23,73,2,27
2284,590,634,128.45278911564625,131.0766439909297,22,24,121,3,44
2285,590,877,128.45278911564625,130.1942857142857,22,20,297,2,287
2286,590,877,128.45278911564625,131.2624036281179,22,21,311,3,287
2287,560,258,128.61532879818594,130.0085260770975,24,29,308,1,302
2288,560,232,128.61532879818594,130.86766439909297,24,30,342,2,328
2289,560,566,128.61532879818594,130.03174603174602,24,27,61,1,6
2290,560,576,128.61532879818594,131.09986394557822,24,24,108,2,16
2291,560,617,128.61532879818594,130.03174603174602,24,23,83,1,57
2292,560,634,128.61532879818594,131.0766439909297,24,24,129,2,74
2293,560,877,128.61532879818594,130.1942857142857,24,20,324,2,317
2294,560,877,128.61532879818594,131.2624036281179,24,21,337,3,317
2295,566,218,130.03174603174602,131.79646258503402,27,29,356,2,348
2296,566,206,130.03174603174602,132.77170068027212,27,24,379,3,360
2297,566,576,130.03174603174602,131.09986394557822,27,24,47,1,10
2298,566,443,130.03174603174602,131.84290249433107,27,20,146,2,123
2299,566,587,130.03174603174602,132.9342403628118,27,20,127,3,21
2300,566,634,130.03174603174602,131.0766439909297,27,24,82,1,68
2301,566,749,130.03174603174602,131.79646258503402,27,19,198,2,183
2302,566,621,130.03174603174602,132.84136054421768,27,22,133,3,55
2303,566,877,130.03174603174602,131.2624036281179,27,21,315,1,311
2304,566,846,130.03174603174602,131.79646258503402,27,17,290,2,280
2305,566,875,130.03174603174602,132.98068027210886,27,20,334,3,309
2306,576,206,131.09986394557822,132.77170068027212,24,24,377,2,370
2307,576,587,131.09986394557822,132.9342403628118,24,20,80,2,11
2308,576,412,131.09986394557822,133.79337868480727,24,29,201,3,164
2309,576,621,131.09986394557822,132.84136054421768,24,22,87,2,45
2310,576,630,131.09986394557822,133.81659863945578,24,21,129,3,54
2311,576,875,131.09986394557822,132.98068027210886,24,20,310,2,299
2312,576,849,131.09986394557822,133.79337868480727,24,23,297,3,273
2313,443,9,131.84290249433107,133.2825396825397,20,49,438,1,434
2314,443,5,131.84290249433107,134.07201814058956,20,49,448,2,438
2315,443,5,131.84290249433107,134.76861678004536,20,49,456,3,438
2316,443,388,131.84290249433107,134.2577777777778,20,27,118,2,55
2317,443,587,131.84290249433107,132.9342403628118,20,20,151,1,144
2318,443,412,131.84290249433107,133.79337868480727,20,29,90,2,31
2319,443,630,131.84290249433107,133.81659863945578,20,21,205,2,187
2320,443,875,131.84290249433107,132.98068027210886,20,20,435,1,432
2321,443,849,131.84290249433107,133.79337868480727,20,23,415,2,406
2322,587,388,132.9342403628118,134.2577777777778,20,27,207,1,199
2323,587,282,132.9342403628118,135.0008163265306,20,29,318,2,305
2324,587,386,132.9342403628118,135.65097505668933,20,29,233,3,201
2325,587,414,132.9342403628118,134.9079365079365,20,25,193,2,173
2326,587,655,132.9342403628118,135.3491156462585,20,21,124,2,68
2327,587,700,132.9342403628118,135.85995464852607,20,21,169,3,113
2328,587,872,132.9342403628118,135.32589569161,20,22,303,2,285
2329,587,844,132.9342403628118,135.8831746031746,20,23,287,3,257
2330,412,5,133.79337868480727,136.18503401360545,29,49,420,2,407
2331,412,282,133.79337868480727,135.0008163265306,29,29,140,1,130
2332,412,386,133.79337868480727,135.65097505668933,29,29,84,2,26
2333,412,263,133.79337868480727,136.57977324263038,29,27,191,3,149
2334,412,414,133.79337868480727,134.9079365079365,29,25,48,1,2
2335,412,437,133.79337868480727,136.39401360544218,29,23,115,3,25
2336,412,655,133.79337868480727,135.3491156462585,29,21,252,2,243
2337,412,700,133.79337868480727,135.85995464852607,29,21,301,2,288
2338,412,872,133.79337868480727,135.32589569161,29,22,465,2,460
2339,412,844,133.79337868480727,135.8831746031746,29,23,441,2,432
2340,414,5,134.9079365079365,136.18503401360545,25,49,413,1,409
2341,414,8,134.9079365079365,137.48535147392292,25,50,421,3,406
2342,414,5,134.9079365079365,137.76399092970522,25,48,427,3,409
2343,414,263,134.9079365079365,136.57977324263038,25,27,167,2,151
2344,414,437,134.9079365079365,136.39401360544218,25,23,68,1,23
2345,414,413,134.9079365079365,137.55501133786848,25,21,114,3,1
2346,414,615,134.9079365079365,137.06739229024944,25,16,221,2,201
2347,414,827,134.9079365079365,137.18349206349205,25,11,424,2,413
2348,437,8,136.39401360544218,137.48535147392292,23,50,432,1,429
2349,437,5,136.39401360544218,137.76399092970522,23,48,436,1,432
2350,437,5,136.39401360544218,138.9946485260771,23,47,446,3,432
2351,437,257,136.39401360544218,138.019410430839,23,28,193,2,180
2352,437,211,136.39401360544218,139.29650793650794,23,24,258,3,226
2353,437,413,136.39401360544218,137.55501133786848,23,21,55,1,24
2354,437,414,136.39401360544218,137.62467120181407,23,25,58,1,23
2355,437,430,136.39401360544218,139.29650793650794,23,20,125,3,7
2356,437,615,136.39401360544218,138.06585034013605,23,23,192,2,178
2357,437,790,136.39401360544218,139.22684807256235,23,17,373,3,353
2358,437,820,136.39401360544218,138.06585034013605,23,21,390,2,383
2359,437,894,136.39401360544218,139.2500680272109,23,20,473,3,457
2360,413,5,137.55501133786848,138.9946485260771,21,47,413,1,408
2361,413,5,137.55501133786848,140.41106575963718,21,48,426,3,408
2362,413,211,137.55501133786848,139.29650793650794,21,24,215,2,202
2363,413,219,137.55501133786848,139.94666666666666,21,32,220,2,194
2364,413,430,137.55501133786848,139.29650793650794,21,20,77,2,17
2365,413,559,137.55501133786848,139.94666666666666,21,26,179,2,146
2366,413,790,137.55501133786848,139.22684807256235,21,17,384,2,377
2367,413,680,137.55501133786848,139.94666666666666,21,21,286,2,267
2368,413,894,137.55501133786848,139.2500680272109,21,20,487,2,481
2369,414,5,137.62467120181407,138.9946485260771,25,47,413,1,409
2370,414,5,137.62467120181407,140.41106575963718,25,48,426,3,409
2371,414,211,137.62467120181407,139.29650793650794,25,24,215,2,203
2372,414,219,137.62467120181407,139.94666666666666,25,32,219,2,195
2373,414,430,137.62467120181407,139.29650793650794,25,20,74,2,16
2374,414,559,137.62467120181407,139.94666666666666,25,26,176,2,145
2375,414,790,137.62467120181407,139.22684807256235,25,17,382,2,376
2376,414,680,137.62467120181407,139.94666666666666,25,21,284,2,266
2377,414,894,137.62467120181407,139.2500680272109,25,20,485,2,480
2378,430,5,139.29650793650794,140.41106575963718,20,48,428,1,425
2379,430,5,139.29650793650794,141.15410430839003,20,49,432,2,425
2380,430,5,139.29650793650794,141.8274829931973,20,49,439,3,425
2381,430,258,139.29650793650794,141.27020408163267,20,30,192,2,172
2382,430,262,139.29650793650794,142.1990022675737,20,29,209,3,168
2383,430,566,139.29650793650794,141.31664399092972,20,27,161,2,136
2384,430,695,139.29650793650794,141.33986394557823,20,24,279,2,265
2385,430,877,139.29650793650794,141.47918367346938,20,22,457,2,447
2386,559,258,139.94666666666666,141.27020408163267,26,30,306,1,301
2387,559,262,139.94666666666666,142.1990022675737,26,29,312,2,297
2388,559,566,139.94666666666666,141.31664399092972,26,27,59,1,7
2389,559,576,139.94666666666666,142.38476190476192,26,26,106,2,17
2390,559,695,139.94666666666666,141.33986394557823,26,24,149,1,136
2391,559,691,139.94666666666666,142.38476190476192,26,24,169,2,132
2392,559,877,139.94666666666666,141.47918367346938,26,22,325,2,318
2393,559,876,139.94666666666666,142.5473015873016,26,19,336,3,317
2394,559,928,139.94666666666666,142.77950113378685,26,18,389,3,369
2395,566,218,141.31664399092972,143.12780045351474,27,30,357,2,348
2396,566,206,141.31664399092972,144.12625850340137,27,31,380,3,360
2397,566,576,141.31664399092972,142.38476190476192,27,26,47,1,10
2398,566,565,141.31664399092972,143.52253968253967,27,19,95,2,1
2399,566,556,141.31664399092972,143.7082993197279,27,12,103,2,10
2400,566,691,141.31664399092972,142.38476190476192,27,24,133,1,125
2401,566,754,141.31664399092972,143.12780045351474,27,18,204,2,188
2402,566,797,141.31664399092972,143.82439909297054,27,15,255,3,231
2403,566,876,141.31664399092972,142.5473015873016,27,19,314,1,310
2404,566,928,141.31664399092972,142.77950113378685,27,18,367,1,362
2405,566,860,141.31664399092972,143.68507936507936,27,15,311,2,294
2406,576,206,142.38476190476192,144.12625850340137,26,31,378,2,370
2407,576,565,142.38476190476192,143.52253968253967,26,19,50,1,11
2408,576,556,142.38476190476192,143.7082993197279,26,12,60,1,20
2409,576,797,142.38476190476192,143.82439909297054,26,15,230,1,221
2410,576,860,142.38476190476192,143.68507936507936,26,15,289,1,284
2411,565,213,143.52253968253967,146.40181405895692,19,13,373,3,352
2412,556,213,143.7082993197279,146.40181405895692,12,13,362,3,343
2413,566,260,152.6247619047619,153.64643990929704,20,25,309,1,306
2414,566,268,152.6247619047619,154.6681179138322,20,16,311,2,298
2415,566,576,152.6247619047619,153.66965986394558,20,17,46,1,10
2416,566,634,152.6247619047619,153.66965986394558,20,15,82,1,68
2417,592,268,152.64798185941044,154.6681179138322,18,16,335,2,324
2418,592,576,152.64798185941044,153.66965986394558,18,17,47,1,16
2419,592,634,152.64798185941044,153.66965986394558,18,15,61,1,42
2420,576,86,153.66965986394558,155.66657596371883,17,27,497,2,490
2421,683,388,30.998639455782314,32.60081632653061,14,27,303,2,295
2422,683,413,30.998639455782314,32.113197278911564,14,26,274,1,270
2423,683,412,30.998639455782314,32.15963718820862,14,30,276,1,271
2424,683,592,30.998639455782314,33.41351473922902,14,24,138,2,91
2425,683,630,30.998639455782314,32.15963718820862,14,20,73,1,53
2426,683,637,30.998639455782314,33.69215419501134,14,21,125,3,46
2427,683,849,30.998639455782314,32.13641723356009,14,22,173,1,166
2428,683,873,30.998639455782314,33.69215419501134,14,22,223,3,190
2429,621,388,31.184399092970523,32.60081632653061,23,27,241,1,233
2430,621,386,31.184399092970523,34.0172335600907,23,29,265,3,235
2431,621,592,31.184399092970523,33.41351473922902,23,24,100,2,29
2432,621,637,31.184399092970523,33.69215419501134,23,21,109,3,16
2433,621,873,31.184399092970523,33.69215419501134,23,22,274,3,252
2434,630,386,32.15963718820862,34.0172335600907,20,29,257,2,244
2435,630,316,32.15963718820862,35.085351473922906,20,23,338,3,314
2436,630,592,32.15963718820862,33.41351473922902,20,24,66,1,38
2437,630,450,32.15963718820862,34.78349206349206,20,21,213,3,180
2438,630,637,32.15963718820862,33.69215419501134,20,21,66,2,7
2439,630,700,32.15963718820862,34.22621315192744,20,20,113,2,70
2440,630,873,32.15963718820862,33.69215419501134,20,22,252,2,243
2441,630,843,32.15963718820862,34.22621315192744,20,20,231,2,213
2442,637,316,33.69215419501134,35.085351473922906,21,23,327,1,321
2443,637,267,33.69215419501134,35.92126984126984,21,27,382,2,370
2444,637,450,33.69215419501134,34.78349206349206,21,21,193,1,187
2445,637,414,33.69215419501134,35.9677097505669,21,25,244,2,223
2446,637,776,33.69215419501134,36.08380952380953,21,20,173,2,139
2447,637,796,33.69215419501134,36.385668934240364,21,25,197,3,159
2448,637,850,33.69215419501134,35.944489795918365,21,18,234,2,213
2449,637,821,33.69215419501134,36.40888888888889,21,20,218,3,184
2450,700,267,34.22621315192744,35.92126984126984,20,27,439,2,433
2451,700,261,34.22621315192744,36.80362811791383,20,28,453,3,439
2452,700,414,34.22621315192744,35.9677097505669,20,25,296,2,286
2453,700,410,34.22621315192744,36.87328798185941,20,23,312,3,290
2454,700,776,34.22621315192744,36.08380952380953,20,20,110,2,76
2455,700,796,34.22621315192744,36.385668934240364,20,25,134,2,96
2456,700,850,34.22621315192744,35.944489795918365,20,18,167,2,150
2457,700,821,34.22621315192744,36.40888888888889,20,20,153,2,121
2458,776,590,36.08380952380953,38.080725623582765,20,23,205,2,186
2459,776,560,36.08380952380953,38.26648526077098,20,24,236,2,216
2460,776,618,36.08380952380953,37.70920634920635,20,18,173,2,158
2461,776,657,36.08380952380953,38.26648526077098,20,20,152,2,119
2462,776,894,36.08380952380953,37.593106575963716,20,19,135,2,118
2463,776,852,36.08380952380953,38.24326530612245,20,21,120,2,76
2464,796,590,36.385668934240364,38.080725623582765,25,23,219,2,206
2465,796,560,36.385668934240364,38.26648526077098,25,24,250,2,236
2466,796,618,36.385668934240364,37.70920634920635,25,18,187,1,178
2467,796,657,36.385668934240364,38.26648526077098,25,20,161,2,139
2468,796,894,36.385668934240364,37.593106575963716,25,19,111,1,98
2469,796,852,36.385668934240364,38.24326530612245,25,21,98,2,56
2470,618,259,37.70920634920635,39.14884353741497,18,29,364,1,359
2471,618,207,37.70920634920635,40.49560090702948,18,27,428,3,411
2472,618,566,37.70920634920635,39.68290249433107,18,27,100,2,52
2473,618,617,37.70920634920635,39.68290249433107,18,23,85,2,1
2474,618,877,37.70920634920635,39.82222222222222,18,21,275,2,259
2475,657,207,38.26648526077098,40.49560090702948,20,27,460,2,450
2476,657,566,38.26648526077098,39.68290249433107,20,27,110,1,91
2477,657,576,38.26648526077098,40.72780045351474,20,25,133,2,81
2478,657,617,38.26648526077098,39.68290249433107,20,23,73,1,40
2479,657,634,38.26648526077098,40.72780045351474,20,23,108,2,23
2480,657,877,38.26648526077098,39.82222222222222,20,21,230,2,220
2481,657,877,38.26648526077098,40.91356009070295,20,19,248,3,220
2482,617,230,39.68290249433107,41.56371882086168,23,24,395,2,387
2483,617,576,39.68290249433107,40.72780045351474,23,25,61,1,41
2484,617,596,39.68290249433107,41.28507936507937,23,11,72,2,21
2485,617,634,39.68290249433107,40.72780045351474,23,23,48,1,17
2486,617,736,39.68290249433107,41.308299319727894,23,13,138,2,119
2487,617,877,39.68290249433107,40.91356009070295,23,19,265,1,260
2488,617,834,39.68290249433107,41.308299319727894,23,13,228,2,217
2489,634,288,40.72780045351474,42.70149659863946,23,33,356,2,346
2490,634,263,40.72780045351474,43.560634920634925,23,33,391,3,371
2491,634,548,40.72780045351474,42.840816326530614,23,19,125,2,86
2492,634,643,40.72780045351474,42.678276643990934,23,19,84,2,9
2493,634,902,40.72780045351474,42.91047619047619,23,17,284,2,268
2494,736,288,41.308299319727894,42.70149659863946,13,33,452,1,448
2495,736,263,41.308299319727894,43.560634920634925,13,33,483,2,473
2496,736,548,41.308299319727894,42.840816326530614,13,19,199,2,188
2497,736,518,41.308299319727894,44.04825396825397,13,19,248,3,218
2498,736,643,41.308299319727894,42.678276643990934,13,19,110,1,93
2499,736,622,41.308299319727894,44.00181405895692,13,16,163,3,114
2500,736,902,41.308299319727894,42.91047619047619,13,17,180,2,166
2501,736,945,41.308299319727894,43.90893424036281,13,14,237,3,209
2502,643,292,42.678276643990934,44.81451247165533,19,28,363,2,351
2503,643,229,42.678276643990934,45.51111111111111,19,32,432,3,414
2504,643,518,42.678276643990934,44.04825396825397,19,19,138,1,125
2505,643,431,42.678276643990934,44.72163265306123,19,19,230,2,212
2506,643,425,42.678276643990934,45.51111111111111,19,20,250,3,218
2507,643,622,42.678276643990934,44.00181405895692,19,16,61,1,21
2508,643,945,42.678276643990934,43.90893424036281,19,14,307,1,302
2509,643,948,42.678276643990934,44.58231292517007,19,19,316,2,305
2510,622,229,44.00181405895692,45.51111111111111,16,32,398,2,393
2511,622,233,44.00181405895692,46.741768707483,16,30,407,3,389
2512,622,425,44.00181405895692,45.51111111111111,16,20,207,2,197
2513,622,554,44.00181405895692,46.439909297052154,16,23,125,2,68
2514,622,632,44.00181405895692,46.11482993197279,16,17,92,2,10
2515,622,623,44.00181405895692,46.32380952380952,16,19,100,2,1
2516,622,868,44.00181405895692,45.72009070294785,16,15,257,2,246
2517,622,931,44.00181405895692,46.27736961451247,16,17,324,2,309
2518,643,233,44.81451247165533,46.741768707483,17,30,418,2,410
2519,643,263,44.81451247165533,47.600907029478456,17,30,398,3,380
2520,643,554,44.81451247165533,46.439909297052154,17,23,113,2,89
2521,643,431,44.81451247165533,47.53124716553288,17,18,242,3,212
2522,643,632,44.81451247165533,46.11482993197279,17,17,57,1,11
2523,643,623,44.81451247165533,46.32380952380952,17,19,68,2,20
2524,643,634,44.81451247165533,47.53124716553288,17,18,117,3,9
2525,643,931,44.81451247165533,46.27736961451247,17,17,295,1,288
2526,632,263,46.11482993197279,47.600907029478456,17,30,375,1,369
2527,632,255,46.11482993197279,48.34394557823129,17,28,389,2,377
2528,632,431,46.11482993197279,47.53124716553288,17,18,210,1,201
2529,632,606,46.11482993197279,48.34394557823129,17,19,99,2,26
2530,632,634,46.11482993197279,47.53124716553288,17,18,61,1,2
2531,632,635,46.11482993197279,48.22784580498866,17,18,91,2,3
2532,632,907,46.11482993197279,48.18140589569161,17,22,289,2,275
2533,632,906,46.11482993197279,48.204625850340136,17,20,288,2,274
2534,623,263,46.32380952380952,47.600907029478456,19,30,364,1,360
2535,623,255,46.32380952380952,48.34394557823129,19,28,378,2,368
2536,623,205,46.32380952380952,49.24952380952381,19,29,437,3,418
2537,623,431,46.32380952380952,47.53124716553288,19,18,199,1,192
2538,623,606,46.32380952380952,48.34394557823129,19,19,89,2,17
2539,623,583,46.32380952380952,49.24952380952381,19,19,132,3,40
2540,623,634,46.32380952380952,47.53124716553288,19,18,53,1,11
2541,623,635,46.32380952380952,48.22784580498866,19,18,83,2,12
2542,623,642,46.32380952380952,49.24952380952381,19,18,127,3,19
2543,623,907,46.32380952380952,48.18140589569161,19,22,295,2,284
2544,623,906,46.32380952380952,48.204625850340136,19,20,294,2,283
2545,634,205,47.53124716553288,49.24952380952381,18,29,435,2,429
2546,634,583,47.53124716553288,49.24952380952381,18,19,90,2,51
2547,634,642,47.53124716553288,49.24952380952381,18,18,74,2,8
2548,634,897,47.53124716553288,49.458503401360545,18,18,276,2,263
2549,635,205,48.22784580498866,49.24952380952381,18,29,432,1,430
2550,635,261,48.22784580498866,51.13034013605442,18,32,394,3,374
2551,635,583,48.22784580498866,49.24952380952381,18,19,68,1,52
2552,635,421,48.22784580498866,51.17678004535148,18,21,249,3,214
2553,635,642,48.22784580498866,49.24952380952381,18,18,45,1,7
2554,635,757,48.22784580498866,50.85170068027211,18,21,166,3,122
2555,635,897,48.22784580498866,49.458503401360545,18,18,267,1,262
2556,635,948,48.22784580498866,50.5730612244898,18,19,329,2,313
2557,642,261,49.24952380952381,51.13034013605442,18,32,390,2,381
2558,642,259,49.24952380952381,51.85015873015873,18,33,399,3,383
2559,642,421,49.24952380952381,51.17678004535148,18,21,236,2,221
2560,642,583,49.24952380952381,51.89659863945578,18,25,128,3,59
2561,642,757,49.24952380952381,50.85170068027211,18,21,134,2,115
2562,642,615,49.24952380952381,51.89659863945578,18,23,117,3,27
2563,642,948,49.24952380952381,50.5730612244898,18,19,311,1,306
2564,642,953,49.24952380952381,51.26965986394558,18,20,323,2,311
2565,642,837,49.24952380952381,52.22167800453515,18,15,233,3,195
2566,757,262,50.85170068027211,52.54675736961451,21,33,500,2,495
2567,757,583,50.85170068027211,51.89659863945578,21,25,180,1,174
2568,757,589,50.85170068027211,52.7092970521542,21,20,186,2,168
2569,757,615,50.85170068027211,51.89659863945578,21,23,149,1,142
2570,757,615,50.85170068027211,53.173696145124715,21,17,174,2,142
2571,757,837,50.85170068027211,52.22167800453515,21,15,99,1,80
2572,615,232,51.89659863945578,54.19537414965986,23,30,396,2,383
2573,615,260,51.89659863945578,54.79909297052154,23,33,376,3,355
2574,615,438,51.89659863945578,54.19537414965986,23,21,203,2,177
2575,615,650,51.89659863945578,54.77587301587302,23,18,129,3,35
2576,615,899,51.89659863945578,53.84707482993198,23,21,296,2,284
2577,615,877,51.89659863945578,54.218594104308394,23,15,280,2,262
2578,615,232,53.173696145124715,54.19537414965986,17,30,386,1,383
2579,615,260,53.173696145124715,54.79909297052154,17,33,362,2,355
2580,615,271,53.173696145124715,55.24027210884354,17,22,355,2,344
2581,615,438,53.173696145124715,54.19537414965986,17,21,182,1,177
2582,615,453,53.173696145124715,54.89197278911565,17,24,178,2,162
2583,615,422,53.173696145124715,55.843990929705214,17,20,225,3,193
2584,615,650,53.173696145124715,54.77587301587302,17,18,77,2,35
2585,615,620,53.173696145124715,55.28671201814059,17,15,91,2,5
2586,615,877,53.173696145124715,54.218594104308394,17,15,266,1,262
2587,615,271,53.8702947845805,55.24027210884354,16,22,349,1,344
2588,615,453,53.8702947845805,54.89197278911565,16,24,168,1,162
2589,615,422,53.8702947845805,55.843990929705214,16,20,211,2,193
2590,615,620,53.8702947845805,55.28671201814059,16,15,61,1,5
2591,615,650,53.8702947845805,56.679909297052156,16,16,126,3,35
2592,615,901,53.8702947845805,56.633469387755106,16,14,310,3,286
2593,650,233,54.77587301587302,57.0746485260771,18,27,429,2,417
2594,650,292,54.77587301587302,57.65514739229025,18,29,379,3,358
2595,650,422,54.77587301587302,55.843990929705214,18,20,233,1,228
2596,650,436,54.77587301587302,56.91210884353742,18,19,233,2,214
2597,650,421,54.77587301587302,57.67836734693878,18,25,261,3,229
2598,650,618,54.77587301587302,57.58548752834467,18,20,125,3,32
2599,650,901,54.77587301587302,56.633469387755106,18,14,263,2,251
2600,650,845,54.77587301587302,57.608707482993196,18,13,230,3,195
2601,620,233,55.28671201814059,57.0746485260771,15,27,395,2,387
2602,620,292,55.28671201814059,57.65514739229025,15,29,343,2,328
2603,620,436,55.28671201814059,56.91210884353742,15,19,197,2,184
2604,620,421,55.28671201814059,57.67836734693878,15,25,224,2,199
2605,620,650,55.28671201814059,56.679909297052156,15,16,67,1,30
2606,620,618,55.28671201814059,57.58548752834467,15,20,99,2,2
2607,620,901,55.28671201814059,56.633469387755106,15,14,287,1,281
2608,620,845,55.28671201814059,57.608707482993196,15,13,246,2,225
2609,650,259,56.679909297052156,58.583945578231294,16,25,400,2,391
2610,650,431,56.679909297052156,58.83936507936508,16,19,238,2,219
2611,650,616,56.679909297052156,58.816145124716556,16,15,98,2,34
2612,618,258,57.58548752834467,59.90748299319728,20,26,374,2,360
2613,618,291,57.58548752834467,60.53442176870748,20,28,351,3,327
2614,618,431,57.58548752834467,58.83936507936508,20,19,195,1,187
2615,618,517,57.58548752834467,59.97714285714286,20,21,144,2,101
2616,618,549,57.58548752834467,60.51120181405896,20,24,144,3,69
2617,618,616,57.58548752834467,58.816145124716556,20,15,53,1,2
2618,618,646,57.58548752834467,59.97714285714286,20,16,107,2,28
2619,618,619,57.58548752834467,60.395102040816326,20,21,121,3,1
2620,618,841,57.58548752834467,60.46476190476191,20,16,255,3,223
2621,616,258,58.816145124716556,59.90748299319728,15,26,361,1,358
2622,616,291,58.816145124716556,60.53442176870748,15,28,333,2,325
2623,616,517,58.816145124716556,59.97714285714286,15,21,111,1,99
2624,616,549,58.816145124716556,60.51120181405896,15,24,99,2,67
2625,616,646,58.816145124716556,59.97714285714286,15,16,58,1,30
2626,616,619,58.816145124716556,60.395102040816326,15,21,68,2,3
2627,616,841,58.816145124716556,60.46476190476191,15,16,236,2,225
2628,646,271,59.97714285714286,62.11337868480726,16,30,386,2,375
2629,646,261,59.97714285714286,62.415238095238095,16,33,399,2,385
2630,646,579,59.97714285714286,62.04371882086168,16,23,111,2,67
2631,646,757,59.97714285714286,62.136598639455784,16,21,145,2,111
2632,646,943,59.97714285714286,62.02049886621315,16,16,310,2,297
2633,646,953,59.97714285714286,62.577777777777776,16,20,327,3,307
2634,619,271,60.395102040816326,62.11337868480726,21,30,356,2,348
2635,619,261,60.395102040816326,62.415238095238095,21,33,368,2,358
2636,619,579,60.395102040816326,62.04371882086168,21,23,81,2,40
2637,619,551,60.395102040816326,63.181496598639455,21,25,138,3,68
2638,619,757,60.395102040816326,62.136598639455784,21,21,157,2,138
2639,619,615,60.395102040816326,63.181496598639455,21,23,120,3,4
2640,619,943,60.395102040816326,62.02049886621315,21,16,331,2,324
2641,619,953,60.395102040816326,62.577777777777776,21,20,347,2,334
2642,757,262,62.136598639455784,63.831655328798185,21,34,500,2,495
2643,757,387,62.136598639455784,65.03909297052154,21,26,391,3,370
2644,757,551,62.136598639455784,63.181496598639455,21,25,211,1,206
2645,757,580,62.136598639455784,63.43691609977324,21,24,186,1,177
2646,757,566,62.136598639455784,65.10875283446713,21,21,230,3,191
2647,757,615,62.136598639455784,63.181496598639455,21,23,149,1,142
2648,757,764,62.136598639455784,63.506575963718824,21,18,59,1,7
2649,757,621,62.136598639455784,65.06231292517008,21,23,185,3,136
2650,757,838,62.136598639455784,63.52979591836735,21,17,101,1,81
2651,615,387,63.181496598639455,65.03909297052154,23,26,242,2,228
2652,615,233,63.181496598639455,65.36417233560091,23,26,393,2,382
2653,615,566,63.181496598639455,65.10875283446713,23,21,96,2,49
2654,615,412,63.181496598639455,66.03755102040816,23,31,237,3,203
2655,615,621,63.181496598639455,65.06231292517008,23,23,81,2,6
2656,615,628,63.181496598639455,65.92145124716554,23,21,119,3,13
2657,615,875,63.181496598639455,65.22485260770975,23,21,274,2,260
2658,764,387,63.506575963718824,65.03909297052154,18,26,383,2,377
2659,764,566,63.506575963718824,65.10875283446713,18,21,210,2,198
2660,764,412,63.506575963718824,66.03755102040816,18,31,368,3,352
2661,764,621,63.506575963718824,65.06231292517008,18,23,158,2,143
2662,764,628,63.506575963718824,65.92145124716554,18,21,171,2,136
2663,764,875,63.506575963718824,65.22485260770975,18,21,133,2,111
2664,764,944,63.506575963718824,66.20009070294785,18,22,214,3,180
2665,621,283,65.06231292517008,67.26820861678004,23,29,351,2,338
2666,621,386,65.06231292517008,67.89514739229026,23,30,265,3,235
2667,621,415,65.06231292517008,66.6877097505669,23,24,218,2,206
2668,621,412,65.06231292517008,67.43074829931973,23,21,233,2,209
2669,621,726,65.06231292517008,66.50195011337868,23,20,122,1,105
2670,621,757,65.06231292517008,67.57006802721088,23,22,174,3,136
2671,621,944,65.06231292517008,66.20009070294785,23,22,327,1,323
2672,621,901,65.06231292517008,67.26820861678004,23,18,296,2,280
2673,628,283,65.92145124716554,67.26820861678004,21,29,350,1,345
2674,628,386,65.92145124716554,67.89514739229026,21,30,256,2,242
2675,628,211,65.92145124716554,68.70784580498866,21,25,434,3,417
2676,628,412,65.92145124716554,67.43074829931973,21,21,226,2,216
2677,628,436,65.92145124716554,68.63818594104309,21,23,225,3,192
2678,628,757,65.92145124716554,67.57006802721088,21,22,147,2,129
2679,628,632,65.92145124716554,68.70784580498866,21,20,120,3,4
2680,628,901,65.92145124716554,67.26820861678004,21,18,279,1,273
2681,628,843,65.92145124716554,68.10412698412699,21,22,235,2,215
2682,628,828,65.92145124716554,68.63818594104309,21,19,232,3,200
2683,726,386,66.50195011337868,67.89514739229026,20,30,345,1,340
2684,726,266,66.50195011337868,69.38122448979593,20,26,476,3,460
2685,726,436,66.50195011337868,68.63818594104309,20,23,304,2,290
2686,726,757,66.50195011337868,67.57006802721088,20,22,55,1,31
2687,726,632,66.50195011337868,68.70784580498866,20,20,134,2,94
2688,726,843,66.50195011337868,68.10412698412699,20,22,136,2,117
2689,726,828,66.50195011337868,68.63818594104309,20,19,137,2,102
2690,757,266,67.57006802721088,69.38122448979593,22,26,497,2,491
2691,757,436,67.57006802721088,68.63818594104309,22,23,324,1,321
2692,757,414,67.57006802721088,69.84562358276644,22,25,357,2,343
2693,757,632,67.57006802721088,68.70784580498866,22,20,134,1,125
2694,757,796,67.57006802721088,70.26358276643991,22,24,122,3,39
2695,757,615,67.57006802721088,70.28680272108843,22,23,184,3,142
2696,757,828,67.57006802721088,68.63818594104309,22,19,85,1,71
2697,757,821,67.57006802721088,70.26358276643991,22,18,132,3,64
2698,757,821,67.57006802721088,70.28680272108843,22,21,133,3,64
2699,632,256,68.70784580498866,70.31002267573696,20,28,382,2,376
2700,632,414,68.70784580498866,69.84562358276644,20,25,223,1,218
2701,632,410,68.70784580498866,70.75120181405896,20,21,239,2,222
2702,632,796,68.70784580498866,70.26358276643991,20,24,177,2,164
2703,632,615,68.70784580498866,70.28680272108843,20,23,70,2,17
2704,632,821,68.70784580498866,70.26358276643991,20,18,201,2,189
2705,632,821,68.70784580498866,70.28680272108843,20,21,201,2,189
2706,796,363,70.26358276643991,72.79455782312925,24,29,447,3,433
2707,796,560,70.26358276643991,72.14439909297052,24,26,250,2,236
2708,796,411,70.26358276643991,73.09641723356009,24,22,404,3,385
2709,796,657,70.26358276643991,72.14439909297052,24,21,161,2,139
2710,796,621,70.26358276643991,72.93387755102042,24,20,209,3,175
2711,796,949,70.26358276643991,72.14439909297052,24,23,173,2,153
2712,796,845,70.26358276643991,72.37659863945578,24,16,103,2,49
2713,615,219,70.28680272108843,72.16761904761906,23,34,404,2,396
2714,615,363,70.28680272108843,72.79455782312925,23,29,274,3,252
2715,615,560,70.28680272108843,72.14439909297052,23,26,97,2,55
2716,615,411,70.28680272108843,73.09641723356009,23,22,237,3,204
2717,615,657,70.28680272108843,72.14439909297052,23,21,90,2,42
2718,615,621,70.28680272108843,72.93387755102042,23,20,114,3,6
2719,615,949,70.28680272108843,72.14439909297052,23,23,343,2,334
2720,615,845,70.28680272108843,72.37659863945578,23,16,247,2,230
2721,657,258,72.14439909297052,73.51437641723356,21,30,403,1,399
2722,657,206,72.14439909297052,74.39673469387755,21,30,461,2,451
2723,657,566,72.14439909297052,73.56081632653061,21,28,110,1,91
2724,657,576,72.14439909297052,74.62893424036281,21,26,134,2,81
2725,657,695,72.14439909297052,73.58403628117914,21,23,73,1,38
2726,657,634,72.14439909297052,74.60571428571428,21,25,108,2,23
2727,657,877,72.14439909297052,73.70013605442178,21,20,230,2,220
2728,657,877,72.14439909297052,74.7914739229025,21,21,248,3,220
2729,621,206,72.93387755102042,74.39673469387755,20,30,420,1,415
2730,621,576,72.93387755102042,74.62893424036281,20,26,86,2,45
2731,621,552,72.93387755102042,75.7667120181406,20,20,140,3,69
2732,621,634,72.93387755102042,74.60571428571428,20,25,73,2,13
2733,621,634,72.93387755102042,75.7667120181406,20,17,123,3,13
2734,621,877,72.93387755102042,74.7914739229025,20,21,268,2,256
2735,621,878,72.93387755102042,75.74349206349207,20,14,284,3,257
2736,695,217,73.58403628117914,76.06857142857143,23,24,490,2,478
2737,695,387,73.58403628117914,76.39365079365079,23,24,331,3,308
2738,695,576,73.58403628117914,74.62893424036281,23,26,127,1,119
2739,695,552,73.58403628117914,75.7667120181406,23,20,171,2,143
2740,695,634,73.58403628117914,74.60571428571428,23,25,75,1,61
2741,695,634,73.58403628117914,75.7667120181406,23,17,112,2,61
2742,695,621,73.58403628117914,76.37043083900227,23,22,141,3,74
2743,695,877,73.58403628117914,74.7914739229025,23,21,189,1,182
2744,695,878,73.58403628117914,75.74349206349207,23,14,205,2,183
2745,634,217,74.60571428571428,76.06857142857143,25,24,422,1,417
2746,634,387,74.60571428571428,76.39365079365079,25,24,259,2,247
2747,634,552,74.60571428571428,75.7667120181406,25,20,96,1,82
2748,634,413,74.60571428571428,77.29922902494332,25,27,250,3,221
2749,634,412,74.60571428571428,77.32244897959184,25,29,251,3,222
2750,634,621,74.60571428571428,76.37043083900227,25,22,77,2,13
2751,634,630,74.60571428571428,77.34566893424036,25,21,118,3,4
2752,634,878,74.60571428571428,75.74349206349207,25,14,249,1,244
2753,634,865,74.60571428571428,76.579410430839,25,21,246,2,231
2754,634,849,74.60571428571428,77.32244897959184,25,23,245,3,215
2755,634,388,75.7667120181406,77.78684807256236,17,27,261,2,246
2756,634,413,75.7667120181406,77.29922902494332,17,27,231,2,221
2757,634,412,75.7667120181406,77.32244897959184,17,29,232,2,222
2758,634,414,75.7667120181406,78.43700680272109,17,24,248,3,220
2759,634,630,75.7667120181406,77.34566893424036,17,21,68,2,4
2760,634,849,75.7667120181406,77.32244897959184,17,23,225,2,215
2761,621,388,76.37043083900227,77.78684807256236,22,27,241,1,233
2762,621,387,76.37043083900227,79.18004535147392,22,29,263,3,234
2763,621,414,76.37043083900227,78.43700680272109,22,24,225,2,207
2764,621,757,76.37043083900227,78.85496598639456,22,21,173,2,136
2765,621,872,76.37043083900227,78.85496598639456,22,23,273,2,251
2766,630,387,77.34566893424036,79.18004535147392,21,29,256,2,243
2767,630,316,77.34566893424036,80.27138321995464,21,24,338,3,314
2768,630,414,77.34566893424036,78.43700680272109,21,24,221,1,216
2769,630,437,77.34566893424036,79.92308390022676,21,22,223,3,193
2770,630,757,77.34566893424036,78.85496598639456,21,21,143,2,127
2771,630,633,77.34566893424036,79.99274376417233,21,19,114,3,3
2772,630,872,77.34566893424036,78.85496598639456,21,23,251,2,242
2773,630,843,77.34566893424036,79.41224489795918,21,20,231,2,213
2774,757,316,78.85496598639456,80.27138321995464,21,24,445,1,441
2775,757,388,78.85496598639456,81.24662131519274,21,24,383,2,369
2776,757,437,78.85496598639456,79.92308390022676,21,22,323,1,320
2777,757,414,78.85496598639456,81.15374149659864,21,26,357,2,343
2778,757,410,78.85496598639456,81.61814058956917,21,19,367,3,347
2779,757,633,78.85496598639456,79.99274376417233,21,19,133,1,124
2780,757,776,78.85496598639456,81.24662131519274,21,20,105,2,19
2781,757,796,78.85496598639456,81.57170068027212,21,24,123,3,39
2782,757,851,78.85496598639456,81.13052154195012,21,18,136,2,94
2783,757,821,78.85496598639456,81.59492063492064,21,21,134,3,64
2784,633,388,79.99274376417233,81.24662131519274,19,24,251,1,245
2785,633,256,79.99274376417233,82.03609977324263,19,28,387,2,377
2786,633,314,79.99274376417233,82.63981859410431,19,23,339,3,319
2787,633,414,79.99274376417233,81.15374149659864,19,26,225,1,219
2788,633,410,79.99274376417233,81.61814058956917,19,19,234,2,223
2789,633,776,79.99274376417233,81.24662131519274,19,20,153,1,143
2790,633,796,79.99274376417233,81.57170068027212,19,24,177,2,163
2791,633,622,79.99274376417233,82.84879818594105,19,17,123,3,11
2792,633,851,79.99274376417233,81.13052154195012,19,18,223,1,218
2793,633,821,79.99274376417233,81.59492063492064,19,21,200,2,188
2794,633,894,79.99274376417233,82.77913832199546,19,21,287,3,261
2795,776,314,81.24662131519274,82.63981859410431,20,23,466,1,462
2796,776,590,81.24662131519274,83.26675736961451,20,22,205,2,186
2797,776,558,81.24662131519274,83.47573696145125,20,25,238,2,218
2798,776,622,81.24662131519274,82.84879818594105,20,17,169,2,154
2799,776,657,81.24662131519274,83.4292970521542,20,20,152,2,119
2800,776,894,81.24662131519274,82.77913832199546,20,21,135,2,118
2801,776,949,81.24662131519274,83.4292970521542,20,23,197,2,173
2802,796,314,81.57170068027212,82.63981859410431,24,23,484,1,482
2803,796,590,81.57170068027212,83.26675736961451,24,22,219,2,206
2804,796,558,81.57170068027212,83.47573696145125,24,25,252,2,238
2805,796,622,81.57170068027212,82.84879818594105,24,17,182,1,174
2806,796,657,81.57170068027212,83.4292970521542,24,20,160,2,139
2807,796,894,81.57170068027212,82.77913832199546,24,21,111,1,98
2808,796,949,81.57170068027212,83.4292970521542,24,23,173,2,153
2809,622,258,82.84879818594105,84.82249433106576,17,29,374,2,364
2810,622,206,82.84879818594105,85.68163265306123,17,28,434,3,416
2811,622,566,82.84879818594105,84.8457142857143,17,28,103,2,56
2812,622,617,82.84879818594105,84.8457142857143,17,23,86,2,5
2813,622,877,82.84879818594105,85.00825396825397,17,21,271,2,255
2814,657,258,83.4292970521542,84.82249433106576,20,29,403,1,399
2815,657,206,83.4292970521542,85.68163265306123,20,28,461,2,451
2816,657,566,83.4292970521542,84.8457142857143,20,28,110,1,91
2817,657,576,83.4292970521542,85.91383219954649,20,26,134,2,81
2818,657,429,83.4292970521542,86.35501133786848,20,19,260,3,228
2819,657,617,83.4292970521542,84.8457142857143,20,23,73,1,40
2820,657,634,83.4292970521542,85.91383219954649,20,24,109,2,23
2821,657,877,83.4292970521542,85.00825396825397,20,21,230,2,220
2822,657,877,83.4292970521542,86.07637188208616,20,19,248,3,220
2823,657,921,83.4292970521542,86.35501133786848,20,13,293,3,264
2824,617,289,84.8457142857143,86.51755102040816,23,24,336,2,328
2825,617,576,84.8457142857143,85.91383219954649,23,26,62,1,41
2826,617,429,84.8457142857143,86.35501133786848,23,19,199,2,188
2827,617,561,84.8457142857143,87.74820861678005,23,16,137,3,56
2828,617,634,84.8457142857143,85.91383219954649,23,24,49,1,17
2829,617,621,84.8457142857143,87.05160997732426,23,18,95,2,4
2830,617,877,84.8457142857143,86.07637188208616,23,19,265,1,260
2831,617,921,84.8457142857143,86.35501133786848,23,13,311,2,304
2832,634,227,85.91383219954649,88.16616780045352,24,29,418,2,407
2833,634,333,85.91383219954649,88.51446712018141,24,20,321,3,301
2834,634,561,85.91383219954649,87.74820861678005,24,16,108,2,73
2835,634,621,85.91383219954649,87.05160997732426,24,18,51,1,13
2836,634,810,85.91383219954649,88.16616780045352,24,18,201,2,176
2837,634,844,85.91383219954649,88.16616780045352,24,21,231,2,210
2838,621,227,87.05160997732426,88.16616780045352,18,29,397,1,394
2839,621,333,87.05160997732426,88.51446712018141,18,20,295,1,288
2840,621,231,87.05160997732426,89.44326530612246,18,23,403,2,390
2841,621,608,87.05160997732426,89.32716553287982,18,16,99,2,13
2842,621,489,87.05160997732426,89.62902494331065,18,18,172,3,132
2843,621,810,87.05160997732426,88.16616780045352,18,18,195,1,189
2844,621,666,87.05160997732426,89.35038548752834,18,18,109,2,45
2845,621,636,87.05160997732426,89.46648526077098,18,20,105,2,15
2846,621,844,87.05160997732426,88.16616780045352,18,21,228,1,223
2847,621,930,87.05160997732426,89.11818594104308,18,16,322,2,309
2848,621,835,87.05160997732426,89.42004535147393,18,14,237,2,214
2849,810,608,88.16616780045352,89.32716553287982,18,16,208,1,202
2850,810,489,88.16616780045352,89.62902494331065,18,18,327,1,321
2851,810,438,88.16616780045352,90.58104308390023,18,20,386,2,372
2852,810,666,88.16616780045352,89.35038548752834,18,18,153,1,144
2853,810,636,88.16616780045352,89.46648526077098,18,20,183,1,174
2854,810,615,88.16616780045352,90.58104308390023,18,18,221,2,195
2855,810,835,88.16616780045352,89.42004535147393,18,14,60,1,25
2856,810,874,88.16616780045352,90.97578231292518,18,16,137,3,64
2857,666,228,89.35038548752834,91.02222222222223,18,33,444,2,438
2858,666,207,89.35038548752834,91.69560090702949,18,28,470,2,459
2859,666,438,89.35038548752834,90.58104308390023,18,20,234,1,228
2860,666,410,89.35038548752834,91.60272108843537,18,20,274,2,256
2861,666,615,89.35038548752834,90.58104308390023,18,18,74,1,51
2862,666,775,89.35038548752834,91.71882086167801,18,18,149,2,109
2863,666,874,89.35038548752834,90.97578231292518,18,16,219,2,208
2864,666,853,89.35038548752834,91.71882086167801,18,20,213,2,187
2865,636,228,89.46648526077098,91.02222222222223,20,33,413,2,408
2866,636,207,89.46648526077098,91.69560090702949,20,28,440,2,429
2867,636,438,89.46648526077098,90.58104308390023,20,20,204,1,198
2868,636,410,89.46648526077098,91.60272108843537,20,20,244,2,226
2869,636,615,89.46648526077098,90.58104308390023,20,18,52,1,21
2870,636,775,89.46648526077098,91.71882086167801,20,18,169,2,139
2871,636,874,89.46648526077098,90.97578231292518,20,16,247,2,238
2872,636,853,89.46648526077098,91.71882086167801,20,20,238,2,217
2873,615,207,90.58104308390023,91.69560090702949,18,28,411,1,408
2874,615,254,90.58104308390023,92.71727891156463,18,21,373,2,361
2875,615,410,90.58104308390023,91.60272108843537,18,20,210,1,205
2876,615,431,90.58104308390023,92.71727891156463,18,19,206,2,184
2877,615,775,90.58104308390023,91.71882086167801,18,18,167,1,160
2878,615,627,90.58104308390023,92.71727891156463,18,14,93,2,12
2879,615,853,90.58104308390023,91.71882086167801,18,20,243,1,238
2880,615,947,90.58104308390023,93.25133786848073,18,12,351,3,332
2881,775,436,91.71882086167801,94.11047619047619,18,19,354,2,339
2882,775,811,91.71882086167801,93.83183673469388,18,19,98,2,36
2883,775,784,91.71882086167801,94.66775510204081,18,18,127,3,9
2884,775,947,91.71882086167801,93.25133786848073,18,12,184,2,172
2885,775,844,91.71882086167801,93.80861678004536,18,17,113,2,69
2886,775,842,91.71882086167801,94.66775510204081,18,19,144,3,67
2887,627,260,92.71727891156463,93.80861678004536,14,29,370,1,367
2888,627,231,92.71727891156463,94.55165532879819,14,29,404,2,396
2889,627,436,92.71727891156463,94.11047619047619,14,19,200,1,191
2890,627,573,92.71727891156463,94.80707482993198,14,19,105,2,54
2891,627,811,92.71727891156463,93.83183673469388,14,19,190,1,184
2892,627,784,92.71727891156463,94.66775510204081,14,18,178,2,157
2893,627,634,92.71727891156463,95.52689342403629,14,15,121,3,7
2894,627,844,92.71727891156463,93.80861678004536,14,17,222,1,217
2895,627,842,92.71727891156463,94.66775510204081,14,19,231,2,215
2896,811,517,93.83183673469388,96.29315192743765,19,18,313,2,294
2897,811,634,93.83183673469388,95.52689342403629,19,15,191,2,177
2898,811,938,93.83183673469388,96.26993197278912,19,12,165,2,127
2899,811,843,93.83183673469388,96.68789115646258,19,18,127,3,32
2900,784,517,94.66775510204081,96.29315192743765,18,18,276,2,267
2901,784,516,94.66775510204081,96.98975056689342,18,18,286,2,268
2902,784,605,94.66775510204081,97.54702947845806,18,19,218,3,179
2903,784,811,94.66775510204081,96.68789115646258,18,18,91,2,27
2904,784,938,94.66775510204081,96.26993197278912,18,12,169,2,154
2905,784,843,94.66775510204081,96.68789115646258,18,18,105,2,59
2906,634,227,95.52689342403629,96.66467120181406,15,29,410,1,407
2907,634,231,95.52689342403629,97.54702947845806,15,29,412,2,403
2908,634,516,95.52689342403629,96.98975056689342,15,18,134,1,118
2909,634,605,95.52689342403629,97.54702947845806,15,19,92,2,29
2910,634,811,95.52689342403629,96.68789115646258,15,18,184,1,177
2911,634,628,95.52689342403629,97.66312925170068,15,19,92,2,6
2912,634,843,95.52689342403629,96.68789115646258,15,18,215,1,209
2913,634,878,95.52689342403629,97.82566893424037,15,17,263,2,244
2914,811,431,96.68789115646258,99.07954648526078,18,18,394,2,380
2915,811,627,96.68789115646258,99.05632653061225,18,17,210,2,184
2916,811,878,96.68789115646258,97.82566893424037,18,17,83,1,67
2917,811,821,96.68789115646258,99.40462585034014,18,16,117,3,10
2918,628,205,97.66312925170068,99.40462585034014,19,27,430,2,423
2919,628,227,97.66312925170068,100.33342403628119,19,32,417,3,401
2920,628,431,97.66312925170068,99.07954648526078,19,18,206,1,197
2921,628,411,97.66312925170068,100.00834467120181,19,21,239,2,217
2922,628,627,97.66312925170068,99.05632653061225,19,17,60,1,1
2923,628,615,97.66312925170068,99.75292517006802,19,17,91,2,13
2924,628,821,97.66312925170068,99.40462585034014,19,16,207,2,193
2925,628,898,97.66312925170068,99.98512471655329,19,18,288,2,270
2926,627,227,99.05632653061225,100.33342403628119,17,32,404,1,400
2927,627,260,99.05632653061225,101.26222222222222,17,31,379,2,367
2928,627,431,99.05632653061225,101.19256235827665,17,19,217,2,196
2929,627,568,99.05632653061225,101.86594104308391,17,20,135,3,59
2930,627,807,99.05632653061225,101.37832199546486,17,20,206,2,180
2931,627,665,99.05632653061225,101.98204081632653,17,19,132,3,38
2932,627,851,99.05632653061225,101.33188208616781,17,19,244,2,224
2933,627,843,99.05632653061225,101.72662131519274,17,16,245,3,216
2934,615,260,99.75292517006802,101.26222222222222,17,31,361,2,355
2935,615,262,99.75292517006802,102.33034013605442,17,25,370,3,353
2936,615,259,99.75292517006802,102.51609977324263,17,30,375,3,356
2937,615,431,99.75292517006802,101.19256235827665,17,19,194,1,184
2938,615,568,99.75292517006802,101.86594104308391,17,20,102,2,47
2939,615,436,99.75292517006802,102.5857596371882,17,20,217,3,179
2940,615,807,99.75292517006802,101.37832199546486,17,20,204,2,192
2941,615,665,99.75292517006802,101.98204081632653,17,19,108,2,50
2942,615,851,99.75292517006802,101.33188208616781,17,19,246,2,236
2943,615,843,99.75292517006802,101.72662131519274,17,16,243,2,228
2944,615,899,99.75292517006802,102.46965986394558,17,19,307,3,284
2945,807,436,101.37832199546486,102.5857596371882,20,20,375,1,371
2946,807,431,101.37832199546486,104.02539682539683,20,18,393,3,376
2947,807,791,101.37832199546486,103.3752380952381,20,21,87,2,16
2948,807,799,101.37832199546486,104.02539682539683,20,17,114,3,8
2949,807,899,101.37832199546486,102.46965986394558,20,19,103,1,92
2950,807,823,101.37832199546486,104.30403628117914,20,15,127,3,16
2951,665,206,101.98204081632653,104.04861678004535,19,34,468,2,459
2952,665,431,101.98204081632653,104.02539682539683,19,18,250,2,234
2953,665,791,101.98204081632653,103.3752380952381,19,21,140,1,126
2954,665,799,101.98204081632653,104.02539682539683,19,17,160,2,134
2955,665,781,101.98204081632653,104.81487528344671,19,22,168,3,116
2956,665,823,101.98204081632653,104.30403628117914,19,15,187,2,158
2957,665,846,101.98204081632653,104.81487528344671,19,17,218,3,181
2958,791,411,103.3752380952381,105.30249433106576,21,23,389,2,380
2959,791,518,103.3752380952381,106.16163265306123,21,21,298,3,273
2960,791,781,103.3752380952381,104.81487528344671,21,22,63,1,10
2961,791,635,103.3752380952381,106.11519274376417,21,17,196,3,156
2962,791,846,103.3752380952381,104.81487528344671,21,17,83,1,55
2963,791,862,103.3752380952381,106.27773242630386,21,16,144,3,71
2964,799,411,104.02539682539683,105.30249433106576,17,23,392,1,388
2965,799,518,104.02539682539683,106.16163265306123,17,21,296,2,281
2966,799,431,104.02539682539683,106.83501133786848,17,18,387,3,368
2967,799,635,104.02539682539683,106.11519274376417,17,17,187,2,164
2968,799,785,104.02539682539683,106.57959183673469,17,17,111,3,14
2969,799,862,104.02539682539683,106.27773242630386,17,16,116,2,63
2970,799,838,104.02539682539683,106.858231292517,17,18,128,3,39
2971,781,518,104.81487528344671,106.16163265306123,22,21,269,1,263
2972,781,431,104.81487528344671,106.83501133786848,22,18,361,2,350
2973,781,431,104.81487528344671,107.53160997732427,22,19,369,3,350
2974,781,635,104.81487528344671,106.11519274376417,22,17,156,1,146
2975,781,785,104.81487528344671,106.57959183673469,22,17,76,2,4
2976,781,638,104.81487528344671,107.50839002267574,22,20,184,3,143
2977,781,862,104.81487528344671,106.27773242630386,22,16,103,1,81
2978,781,838,104.81487528344671,106.858231292517,22,18,105,2,57
2979,635,234,106.11519274376417,108.43718820861679,17,24,413,2,401
2980,635,431,106.11519274376417,107.53160997732427,17,19,213,1,204
2981,635,412,106.11519274376417,108.66938775510204,17,21,249,3,223
2982,635,638,106.11519274376417,107.50839002267574,17,20,60,1,3
2983,635,720,106.11519274376417,108.48362811791384,17,17,133,2,85
2984,635,863,106.11519274376417,107.99600907029479,17,14,242,2,228
2985,635,900,106.11519274376417,108.50684807256236,17,16,284,2,265
2986,785,412,106.57959183673469,108.66938775510204,17,21,384,2,373
2987,785,720,106.57959183673469,108.48362811791384,17,17,105,2,65
2988,785,863,106.57959183673469,107.99600907029479,17,14,99,1,78
2989,785,900,106.57959183673469,108.50684807256236,17,16,142,2,115
2990,638,260,107.50839002267574,109.38920634920635,20,31,387,2,378
2991,638,255,107.50839002267574,110.24834467120182,20,29,401,3,383
2992,638,412,107.50839002267574,108.66938775510204,20,21,231,1,226
2993,638,442,107.50839002267574,110.15546485260771,20,20,227,3,196
2994,638,774,107.50839002267574,109.7839455782313,20,19,168,2,136
2995,638,840,107.50839002267574,109.92326530612245,20,18,227,2,202
2996,720,255,108.48362811791384,110.24834467120182,17,29,471,2,465
2997,720,261,108.48362811791384,111.36290249433107,17,25,475,3,459
2998,720,442,108.48362811791384,110.15546485260771,17,20,287,2,278
2999,720,555,108.48362811791384,111.06104308390023,17,18,199,3,165
3000,720,774,108.48362811791384,109.7839455782313,17,19,78,1,54
3001,720,632,108.48362811791384,111.06104308390023,17,17,142,3,88
3002,720,840,108.48362811791384,109.92326530612245,17,18,135,1,120
3003,720,882,108.48362811791384,111.38612244897959,17,15,205,3,162
3004,774,555,109.7839455782313,111.06104308390023,19,18,226,1,219
3005,774,423,109.7839455782313,112.29170068027211,19,21,367,3,351
3006,774,632,109.7839455782313,111.06104308390023,19,17,152,1,142
3007,774,617,109.7839455782313,111.75764172335602,19,15,179,2,157
3008,774,882,109.7839455782313,111.38612244897959,19,15,128,2,108
3009,774,885,109.7839455782313,111.4790022675737,19,13,133,2,111
3010,632,259,111.06104308390023,112.1059410430839,17,23,376,1,373
3011,632,255,111.06104308390023,113.05795918367347,17,28,387,2,377
3012,632,423,111.06104308390023,112.29170068027211,17,21,216,1,209
3013,632,431,111.06104308390023,113.19727891156462,17,20,221,2,201
3014,632,618,111.06104308390023,113.1740589569161,17,15,92,2,14
3015,632,626,111.06104308390023,113.87065759637188,17,16,121,3,6
3016,632,884,111.06104308390023,113.38303854875284,17,11,271,2,252
3017,617,255,111.75764172335602,113.05795918367347,15,28,366,1,362
3018,617,270,111.75764172335602,114.42793650793651,15,27,366,3,347
3019,617,431,111.75764172335602,113.19727891156462,15,20,196,1,186
3020,617,482,111.75764172335602,114.0564172335601,15,18,167,2,135
3021,617,618,111.75764172335602,113.1740589569161,15,15,61,1,1
3022,617,626,111.75764172335602,113.87065759637188,15,16,91,2,9
3023,617,635,111.75764172335602,114.5904761904762,15,17,123,3,18
3024,617,884,111.75764172335602,113.38303854875284,15,11,276,2,267
3025,617,881,111.75764172335602,114.19573696145125,15,16,284,2,264
3026,617,868,111.75764172335602,114.49759637188208,15,11,277,3,251
3027,618,270,113.1740589569161,114.42793650793651,15,27,352,1,348
3028,618,259,113.1740589569161,115.05487528344672,15,26,368,2,359
3029,618,259,113.1740589569161,115.79791383219955,15,26,376,3,359
3030,618,428,113.1740589569161,115.3102947845805,15,18,211,2,190
3031,618,423,113.1740589569161,116.05333333333334,15,19,231,3,195
3032,618,635,113.1740589569161,114.5904761904762,15,17,63,1,17
3033,618,615,113.1740589569161,115.65859410430839,15,14,107,2,3
3034,618,881,113.1740589569161,114.19573696145125,15,16,267,1,263
3035,618,868,113.1740589569161,114.49759637188208,15,11,256,1,250
3036,618,855,113.1740589569161,116.09977324263039,15,13,268,3,237
3037,626,259,113.87065759637188,115.05487528344672,16,26,371,1,367
3038,626,259,113.87065759637188,115.79791383219955,16,26,376,2,367
3039,626,428,113.87065759637188,115.3102947845805,16,18,207,1,198
3040,626,423,113.87065759637188,116.05333333333334,16,19,224,2,203
3041,626,615,113.87065759637188,115.65859410430839,16,14,78,2,11
3042,626,855,113.87065759637188,116.09977324263039,16,13,248,2,229
3043,635,259,114.5904761904762,115.79791383219955,17,26,380,1,376
3044,635,259,114.5904761904762,117.02857142857142,17,29,390,2,376
3045,635,423,114.5904761904762,116.05333333333334,17,19,221,1,212
3046,635,552,114.5904761904762,117.4465306122449,17,18,148,3,83
3047,635,615,114.5904761904762,115.65859410430839,17,14,50,1,20
3048,635,616,114.5904761904762,117.16789115646259,17,14,113,3,19
3049,635,855,114.5904761904762,116.09977324263039,17,13,229,2,220
3050,635,878,114.5904761904762,116.98213151927438,17,16,264,2,243
3051,615,259,115.65859410430839,117.02857142857142,14,29,361,1,356
3052,615,258,115.65859410430839,118.46820861678005,14,26,377,3,357
3053,615,552,115.65859410430839,117.4465306122449,14,18,99,2,63
3054,615,421,115.65859410430839,117.8877097505669,14,18,216,2,194
3055,615,616,115.65859410430839,117.16789115646259,14,14,65,2,1
3056,615,699,115.65859410430839,118.28244897959183,14,11,141,3,84
3057,615,878,115.65859410430839,116.98213151927438,14,16,269,1,263
3058,615,842,115.65859410430839,117.84126984126985,14,11,246,2,227
3059,616,258,117.16789115646259,118.46820861678005,14,26,362,1,358
3060,616,227,117.16789115646259,118.93260770975057,14,34,396,2,389
3061,616,438,117.16789115646259,118.9558276643991,14,22,194,2,178
3062,616,434,117.16789115646259,120.1168253968254,14,17,222,3,182
3063,616,699,117.16789115646259,118.28244897959183,14,11,96,1,83
3064,616,744,117.16789115646259,118.93260770975057,14,20,149,2,128
3065,616,848,117.16789115646259,118.88616780045352,14,17,244,2,232
3066,699,227,118.28244897959183,120.48834467120182,11,36,481,2,472
3067,699,227,118.28244897959183,120.51156462585034,11,33,482,2,472
3068,699,434,118.28244897959183,120.1168253968254,11,17,277,2,265
3069,699,462,118.28244897959183,120.79020408163265,11,23,260,3,237
3070,699,811,118.28244897959183,120.48834467120182,11,21,147,2,112
3071,699,786,118.28244897959183,120.51156462585034,11,19,130,2,87
3072,699,844,118.28244897959183,120.48834467120182,11,19,173,2,145
3073,699,852,118.28244897959183,120.53478458049887,11,18,181,2,153
3074,744,387,118.93260770975057,121.51002267573696,20,26,374,3,357
3075,744,434,118.93260770975057,120.1168253968254,20,17,314,1,310
3076,744,462,118.93260770975057,120.79020408163265,20,23,293,2,282
3077,744,811,118.93260770975057,120.48834467120182,20,21,95,2,67
3078,744,786,118.93260770975057,120.51156462585034,20,19,80,2,42
3079,744,645,118.93260770975057,121.51002267573696,20,22,149,3,99
3080,744,844,118.93260770975057,120.48834467120182,20,19,120,2,100
3081,744,852,118.93260770975057,120.53478458049887,20,18,128,2,108
3082,811,387,120.48834467120182,121.51002267573696,21,26,426,1,424
3083,811,412,120.48834467120182,122.50848072562358,21,31,408,2,399
3084,811,411,120.48834467120182,122.53170068027211,21,27,410,2,400
3085,811,645,120.48834467120182,121.51002267573696,21,22,172,1,166
3086,811,783,120.48834467120182,122.67102040816327,21,20,98,2,28
3087,811,849,120.48834467120182,122.48526077097506,21,22,94,2,38
3088,811,944,120.48834467120182,122.67102040816327,21,21,163,2,133
3089,786,412,120.51156462585034,122.50848072562358,19,31,384,2,374
3090,786,411,120.51156462585034,122.53170068027211,19,27,385,2,375
3091,786,783,120.51156462585034,122.67102040816327,19,20,93,2,3
3092,786,849,120.51156462585034,122.48526077097506,19,22,106,2,63
3093,786,944,120.51156462585034,122.67102040816327,19,21,183,2,158
3094,645,266,121.51002267573696,123.20507936507937,22,26,386,2,379
3095,645,387,121.51002267573696,124.36607709750567,22,29,286,3,258
3096,645,411,121.51002267573696,122.53170068027211,22,27,238,1,234
3097,645,592,121.51002267573696,123.762358276644,22,22,111,2,53
3098,645,783,121.51002267573696,122.67102040816327,22,20,147,1,138
3099,645,757,121.51002267573696,124.0409977324263,22,22,156,3,112
3100,645,944,121.51002267573696,122.67102040816327,22,21,303,1,299
3101,645,873,121.51002267573696,124.0409977324263,22,23,253,3,228
3102,783,387,122.67102040816327,124.36607709750567,20,29,403,2,396
3103,783,592,122.67102040816327,123.762358276644,20,22,197,1,191
3104,783,585,122.67102040816327,125.38775510204081,20,21,230,3,198
3105,783,757,122.67102040816327,124.0409977324263,20,22,64,1,26
3106,783,700,122.67102040816327,124.5750566893424,20,20,117,2,83
3107,783,873,122.67102040816327,124.0409977324263,20,23,108,1,90
3108,783,918,122.67102040816327,124.5750566893424,20,20,158,2,135
3109,757,266,124.0409977324263,125.57351473922903,22,25,495,2,491
3110,757,585,124.0409977324263,125.38775510204081,22,21,182,1,172
3111,757,414,124.0409977324263,126.31655328798186,22,24,357,2,343
3112,757,777,124.0409977324263,126.4326530612245,22,19,105,2,20
3113,757,796,124.0409977324263,126.73451247165534,22,24,122,3,39
3114,757,906,124.0409977324263,126.4326530612245,22,18,181,2,149
3115,757,821,124.0409977324263,126.75773242630386,22,20,133,3,64
3116,700,256,124.5750566893424,126.78095238095239,20,30,454,2,444
3117,700,414,124.5750566893424,126.31655328798186,20,24,296,2,286
3118,700,560,124.5750566893424,127.26857142857143,20,20,182,3,140
3119,700,777,124.5750566893424,126.4326530612245,20,19,111,2,77
3120,700,796,124.5750566893424,126.73451247165534,20,24,134,2,96
3121,700,906,124.5750566893424,126.4326530612245,20,18,221,2,206
3122,700,821,124.5750566893424,126.75773242630386,20,20,153,2,121
3123,777,295,126.4326530612245,128.45278911564625,19,26,490,2,482
3124,777,590,126.4326530612245,128.45278911564625,19,22,206,2,187
3125,777,560,126.4326530612245,128.61532879818594,19,24,236,2,217
3126,777,618,126.4326530612245,128.05804988662132,19,18,174,2,159
3127,777,657,126.4326530612245,128.61532879818594,19,21,152,2,120
3128,777,901,126.4326530612245,127.91873015873016,19,21,140,1,124
3129,777,949,126.4326530612245,128.61532879818594,19,21,196,2,172
3130,796,590,126.73451247165534,128.45278911564625,24,22,219,2,206
3131,796,560,126.73451247165534,128.61532879818594,24,24,250,2,236
3132,796,618,126.73451247165534,128.05804988662132,24,18,187,1,178
3133,796,657,126.73451247165534,128.61532879818594,24,21,161,2,139
3134,796,901,126.73451247165534,127.91873015873016,24,21,117,1,105
3135,796,949,126.73451247165534,128.61532879818594,24,21,173,2,153
3136,618,258,128.05804988662132,130.0085260770975,18,29,370,2,360
3137,618,232,128.05804988662132,130.86766439909297,18,30,405,3,386
3138,618,566,128.05804988662132,130.03174603174602,18,27,100,2,52
3139,618,617,128.05804988662132,130.03174603174602,18,23,85,2,1
3140,618,877,128.05804988662132,130.1942857142857,18,20,275,2,259
3141,657,258,128.61532879818594,130.0085260770975,21,29,403,1,399
3142,657,232,128.61532879818594,130.86766439909297,21,30,436,2,425
3143,657,566,128.61532879818594,130.03174603174602,21,27,110,1,91
3144,657,576,128.61532879818594,131.09986394557822,21,24,134,2,81
3145,657,617,128.61532879818594,130.03174603174602,21,23,73,1,40
3146,657,634,128.61532879818594,131.0766439909297,21,24,108,2,23
3147,657,877,128.61532879818594,130.1942857142857,21,20,230,2,220
3148,657,877,128.61532879818594,131.2624036281179,21,21,248,3,220
3149,617,218,130.03174603174602,131.79646258503402,23,29,406,2,399
3150,617,206,130.03174603174602,132.77170068027212,23,24,428,3,411
3151,617,576,130.03174603174602,131.09986394557822,23,24,62,1,41
3152,617,443,130.03174603174602,131.84290249433107,23,20,191,2,174
3153,617,587,130.03174603174602,132.9342403628118,23,20,129,3,30
3154,617,634,130.03174603174602,131.0766439909297,23,24,48,1,17
3155,617,749,130.03174603174602,131.79646258503402,23,19,152,2,132
3156,617,621,130.03174603174602,132.84136054421768,23,22,121,3,4
3157,617,877,130.03174603174602,131.2624036281179,23,21,265,1,260
3158,617,846,130.03174603174602,131.79646258503402,23,17,241,2,229
3159,617,875,130.03174603174602,132.98068027210886,23,20,288,3,258
3160,634,206,131.0766439909297,132.77170068027212,24,24,434,2,428
3161,634,587,131.0766439909297,132.9342403628118,24,20,93,2,47
3162,634,412,131.0766439909297,133.79337868480727,24,29,251,3,222
3163,634,621,131.0766439909297,132.84136054421768,24,22,77,2,13
3164,634,630,131.0766439909297,133.81659863945578,24,21,118,3,4
3165,634,875,131.0766439909297,132.98068027210886,24,20,255,2,241
3166,634,849,131.0766439909297,133.79337868480727,24,23,245,3,215
3167,749,388,131.79646258503402,134.2577777777778,19,27,376,2,361
3168,749,587,131.79646258503402,132.9342403628118,19,20,169,1,162
3169,749,412,131.79646258503402,133.79337868480727,19,29,348,2,337
3170,749,621,131.79646258503402,132.84136054421768,19,22,136,1,128
3171,749,630,131.79646258503402,133.81659863945578,19,21,147,2,119
3172,749,875,131.79646258503402,132.98068027210886,19,20,136,1,126
3173,749,849,131.79646258503402,133.79337868480727,19,23,132,2,100
3174,621,388,132.84136054421768,134.2577777777778,22,27,241,1,233
3175,621,282,132.84136054421768,135.0008163265306,22,29,352,2,339
3176,621,386,132.84136054421768,135.65097505668933,22,29,264,3,235
3177,621,414,132.84136054421768,134.9079365079365,22,25,225,2,207
3178,621,655,132.84136054421768,135.3491156462585,22,21,113,3,34
3179,621,872,132.84136054421768,135.32589569161,22,22,273,2,251
3180,630,282,133.81659863945578,135.0008163265306,21,29,352,1,348
3181,630,386,133.81659863945578,135.65097505668933,21,29,256,2,244
3182,630,263,133.81659863945578,136.57977324263038,21,27,386,3,367
3183,630,414,133.81659863945578,134.9079365079365,21,25,221,1,216
3184,630,437,133.81659863945578,136.39401360544218,21,23,223,3,193
3185,630,655,133.81659863945578,135.3491156462585,21,21,71,2,25
3186,630,700,133.81659863945578,135.85995464852607,21,21,112,2,70
3187,630,872,133.81659863945578,135.32589569161,21,22,251,2,242
3188,630,844,133.81659863945578,135.8831746031746,21,23,232,2,214
3189,655,263,135.3491156462585,136.57977324263038,21,27,396,1,392
3190,655,257,135.3491156462585,138.019410430839,21,28,414,3,398
3191,655,437,135.3491156462585,136.39401360544218,21,23,223,1,218
3192,655,413,135.3491156462585,137.55501133786848,21,21,260,2,242
3193,655,414,135.3491156462585,137.62467120181407,21,25,260,2,241
3194,655,615,135.3491156462585,137.06739229024944,21,16,84,2,40
3195,655,615,135.3491156462585,138.06585034013605,21,23,124,3,40
3196,655,827,135.3491156462585,137.18349206349205,21,11,189,2,172
3197,655,820,135.3491156462585,138.06585034013605,21,21,202,3,165
3198,700,257,135.85995464852607,138.019410430839,21,28,453,2,443
3199,700,413,135.85995464852607,137.55501133786848,21,21,296,2,287
3200,700,414,135.85995464852607,137.62467120181407,21,25,296,2,286
3201,700,615,135.85995464852607,137.06739229024944,21,16,100,1,85
3202,700,615,135.85995464852607,138.06585034013605,21,23,127,2,85
3203,700,827,135.85995464852607,137.18349206349205,21,11,139,1,127
3204,700,820,135.85995464852607,138.06585034013605,21,21,153,2,120
3205,615,211,137.06739229024944,139.29650793650794,16,24,415,2,404
3206,615,219,137.06739229024944,139.94666666666666,16,32,415,3,396
3207,615,430,137.06739229024944,139.29650793650794,16,20,208,2,185
3208,615,559,137.06739229024944,139.94666666666666,16,26,136,3,56
3209,615,790,137.06739229024944,139.22684807256235,16,17,198,2,175
3210,615,680,137.06739229024944,139.94666666666666,16,21,140,3,65
3211,615,894,137.06739229024944,139.2500680272109,16,20,294,2,279
3212,615,949,137.06739229024944,139.9002267573696,16,22,356,3,334
3213,615,211,138.06585034013605,139.29650793650794,23,24,407,1,404
3214,615,219,138.06585034013605,139.94666666666666,23,32,404,2,396
3215,615,430,138.06585034013605,139.29650793650794,23,20,192,1,185
3216,615,559,138.06585034013605,139.94666666666666,23,26,98,2,56
3217,615,790,138.06585034013605,139.22684807256235,23,17,182,1,175
3218,615,680,138.06585034013605,139.94666666666666,23,21,104,2,65
3219,615,894,138.06585034013605,139.2500680272109,23,20,284,1,279
3220,615,949,138.06585034013605,139.9002267573696,23,22,343,2,334
3221,790,566,139.22684807256235,141.31664399092972,17,27,241,2,224
3222,790,695,139.22684807256235,141.33986394557823,17,24,132,2,95
3223,790,877,139.22684807256235,141.47918367346938,17,22,130,2,87
3224,680,258,139.94666666666666,141.27020408163267,21,30,426,1,422
3225,680,262,139.94666666666666,142.1990022675737,21,29,429,2,418
3226,680,566,139.94666666666666,141.31664399092972,21,27,128,1,114
3227,680,576,139.94666666666666,142.38476190476192,21,26,148,2,104
3228,680,695,139.94666666666666,141.33986394557823,21,24,62,1,15
3229,680,691,139.94666666666666,142.38476190476192,21,24,106,2,11
3230,680,877,139.94666666666666,141.47918367346938,21,22,208,2,197
3231,680,876,139.94666666666666,142.5473015873016,21,19,226,3,196
3232,680,928,139.94666666666666,142.77950113378685,21,18,276,3,248
3233,695,218,141.33986394557823,143.12780045351474,24,30,483,2,477
3234,695,206,141.33986394557823,144.12625850340137,24,31,504,3,489
3235,695,576,141.33986394557823,142.38476190476192,24,26,127,1,119
3236,695,565,141.33986394557823,143.52253968253967,24,19,160,2,130
3237,695,556,141.33986394557823,143.7082993197279,24,12,172,2,139
3238,695,691,141.33986394557823,142.38476190476192,24,24,45,1,4
3239,695,754,141.33986394557823,143.12780045351474,24,18,97,2,59
3240,695,797,141.33986394557823,143.82439909297054,24,15,148,2,102
3241,695,876,141.33986394557823,142.5473015873016,24,19,188,1,181
3242,695,928,141.33986394557823,142.77950113378685,24,18,241,1,233
3243,695,860,141.33986394557823,143.68507936507936,24,15,193,2,165
3244,691,206,142.38476190476192,144.12625850340137,24,31,491,2,485
3245,691,565,142.38476190476192,143.52253968253967,24,19,135,1,126
3246,691,556,142.38476190476192,143.7082993197279,24,12,147,1,135
3247,691,797,142.38476190476192,143.82439909297054,24,15,123,1,106
3248,691,860,142.38476190476192,143.68507936507936,24,15,178,1,169
3249,617,260,152.6247619047619,153.64643990929704,14,25,360,1,357
3250,617,268,152.6247619047619,154.6681179138322,14,16,360,2,349
3251,617,576,152.6247619047619,153.66965986394558,14,17,61,1,41
3252,617,634,152.6247619047619,153.66965986394558,14,15,48,1,17
3253,635,268,152.78730158730158,154.6681179138322,13,16,376,2,367
3254,875,388,31.346938775510203,32.60081632653061,21,27,490,1,487
3255,875,386,31.346938775510203,34.0172335600907,21,29,502,3,489
3256,875,592,31.346938775510203,33.41351473922902,21,24,297,2,283
3257,875,637,31.346938775510203,33.69215419501134,21,21,259,2,238
3258,875,700,31.346938775510203,34.22621315192744,21,20,214,3,175
3259,875,873,31.346938775510203,33.69215419501134,21,22,101,2,2
3260,875,843,31.346938775510203,34.22621315192744,21,20,128,3,32
3261,849,386,32.13641723356009,34.0172335600907,22,29,470,2,463
3262,849,592,32.13641723356009,33.41351473922902,22,24,263,1,257
3263,849,450,32.13641723356009,34.78349206349206,22,21,415,3,399
3264,849,637,32.13641723356009,33.69215419501134,22,21,222,2,212
3265,849,700,32.13641723356009,34.22621315192744,22,20,174,2,149
3266,849,873,32.13641723356009,33.69215419501134,22,22,71,2,24
3267,849,843,32.13641723356009,34.22621315192744,22,20,90,2,6
3268,873,450,33.69215419501134,34.78349206349206,22,21,426,1,423
3269,873,414,33.69215419501134,35.9677097505669,22,25,469,2,459
3270,873,776,33.69215419501134,36.08380952380953,22,20,141,2,97
3271,873,796,33.69215419501134,36.385668934240364,22,25,139,3,77
3272,873,850,33.69215419501134,35.944489795918365,22,18,100,2,23
3273,873,821,33.69215419501134,36.40888888888889,22,20,128,3,52
3274,843,414,34.22621315192744,35.9677097505669,20,25,436,2,429
3275,843,410,34.22621315192744,36.87328798185941,20,23,448,3,433
3276,843,776,34.22621315192744,36.08380952380953,20,20,104,2,67
3277,843,796,34.22621315192744,36.385668934240364,20,25,104,2,47
3278,843,850,34.22621315192744,35.944489795918365,20,18,74,2,7
3279,843,821,34.22621315192744,36.40888888888889,20,20,97,2,22
3280,850,590,35.944489795918365,38.080725623582765,18,23,276,2,260
3281,850,560,35.944489795918365,38.26648526077098,18,24,307,2,290
3282,850,618,35.944489795918365,37.70920634920635,18,18,244,2,232
3283,850,657,35.944489795918365,38.26648526077098,18,20,217,2,193
3284,850,894,35.944489795918365,37.593106575963716,18,19,84,2,44
3285,850,852,35.944489795918365,38.24326530612245,18,21,99,2,2
3286,821,590,36.40888888888889,38.080725623582765,20,23,242,2,231
3287,821,560,36.40888888888889,38.26648526077098,20,24,273,2,261
3288,821,618,36.40888888888889,37.70920634920635,20,18,211,1,203
3289,821,657,36.40888888888889,38.26648526077098,20,20,182,2,164
3290,821,894,36.40888888888889,37.593106575963716,20,19,89,1,73
3291,821,852,36.40888888888889,38.24326530612245,20,21,85,2,31
3292,894,566,37.593106575963716,39.68290249433107,19,27,340,2,328
3293,894,617,37.593106575963716,39.68290249433107,19,23,291,2,277
3294,894,877,37.593106575963716,39.82222222222222,19,21,97,2,17
3295,852,566,38.24326530612245,39.68290249433107,21,27,293,1,286
3296,852,576,38.24326530612245,40.72780045351474,21,25,296,2,276
3297,852,617,38.24326530612245,39.68290249433107,21,23,243,1,235
3298,852,634,38.24326530612245,40.72780045351474,21,23,243,2,218
3299,852,877,38.24326530612245,39.82222222222222,21,21,72,2,25
3300,852,877,38.24326530612245,40.91356009070295,21,19,118,3,25
3301,877,596,39.82222222222222,41.28507936507937,21,11,288,1,281
3302,877,736,39.82222222222222,41.308299319727894,21,13,155,1,141
3303,877,643,39.82222222222222,42.678276643990934,21,19,264,3,234
3304,877,834,39.82222222222222,41.308299319727894,21,13,77,1,43
3305,877,548,40.91356009070295,42.840816326530614,19,19,339,2,329
3306,877,643,40.91356009070295,42.678276643990934,19,19,246,2,234
3307,877,902,40.91356009070295,42.91047619047619,19,17,90,2,25
3308,834,548,41.308299319727894,42.840816326530614,13,19,294,2,286
3309,834,518,41.308299319727894,44.04825396825397,13,19,337,3,316
3310,834,643,41.308299319727894,42.678276643990934,13,19,200,1,191
3311,834,622,41.308299319727894,44.00181405895692,13,16,242,3,212
3312,834,902,41.308299319727894,42.91047619047619,13,17,97,2,68
3313,834,945,41.308299319727894,43.90893424036281,13,14,158,3,111
3314,902,518,42.91047619047619,44.04825396825397,17,19,387,1,384
3315,902,431,42.91047619047619,44.72163265306123,17,19,477,2,471
3316,902,425,42.91047619047619,45.51111111111111,17,20,490,3,477
3317,902,622,42.91047619047619,44.00181405895692,17,16,284,1,280
3318,902,643,42.91047619047619,44.81451247165533,17,17,272,2,259
3319,902,948,42.91047619047619,44.58231292517007,17,19,85,2,46
3320,902,868,42.91047619047619,45.72009070294785,17,15,126,3,34
3321,945,554,43.90893424036281,46.439909297052154,14,23,406,3,391
3322,945,632,43.90893424036281,46.11482993197279,14,17,327,2,313
3323,945,623,43.90893424036281,46.32380952380952,14,19,338,2,322
3324,945,868,43.90893424036281,45.72009070294785,14,15,110,2,77
3325,945,931,43.90893424036281,46.27736961451247,14,17,103,2,14
3326,948,554,44.58231292517007,46.439909297052154,19,23,402,2,394
3327,948,632,44.58231292517007,46.11482993197279,19,17,323,2,316
3328,948,623,44.58231292517007,46.32380952380952,19,19,334,2,325
3329,948,634,44.58231292517007,47.53124716553288,19,18,339,3,314
3330,948,868,44.58231292517007,45.72009070294785,19,15,94,1,80
3331,948,931,44.58231292517007,46.27736961451247,19,17,75,2,17
3332,868,431,45.72009070294785,47.53124716553288,15,18,444,2,437
3333,868,606,45.72009070294785,48.34394557823129,15,19,285,3,262
3334,868,634,45.72009070294785,47.53124716553288,15,18,247,2,234
3335,868,635,45.72009070294785,48.22784580498866,15,18,257,3,233
3336,868,907,45.72009070294785,48.18140589569161,15,22,113,2,39
3337,868,906,45.72009070294785,48.204625850340136,15,20,114,2,38
3338,931,606,46.27736961451247,48.34394557823129,17,19,337,2,325
3339,931,583,46.27736961451247,49.24952380952381,17,19,371,3,348
3340,931,634,46.27736961451247,47.53124716553288,17,18,302,1,297
3341,931,635,46.27736961451247,48.22784580498866,17,18,308,2,296
3342,931,642,46.27736961451247,49.24952380952381,17,18,316,3,289
3343,931,907,46.27736961451247,48.18140589569161,17,22,85,2,24
3344,931,906,46.27736961451247,48.204625850340136,17,20,87,2,25
3345,907,583,48.18140589569161,49.24952380952381,22,19,327,1,324
3346,907,642,48.18140589569161,49.24952380952381,22,18,269,1,265
3347,907,757,48.18140589569161,50.85170068027211,22,21,189,3,150
3348,907,897,48.18140589569161,49.458503401360545,22,18,56,1,10
3349,907,948,48.18140589569161,50.5730612244898,22,19,111,2,41
3350,906,583,48.204625850340136,49.24952380952381,20,19,326,1,323
3351,906,421,48.204625850340136,51.17678004535148,20,21,502,3,485
3352,906,642,48.204625850340136,49.24952380952381,20,18,268,1,264
3353,906,757,48.204625850340136,50.85170068027211,20,21,188,3,149
3354,906,897,48.204625850340136,49.458503401360545,20,18,55,1,9
3355,906,948,48.204625850340136,50.5730612244898,20,19,110,2,42
3356,897,421,49.458503401360545,51.17678004535148,18,21,482,2,476
3357,897,583,49.458503401360545,51.89659863945578,18,25,331,2,314
3358,897,757,49.458503401360545,50.85170068027211,18,21,152,1,140
3359,897,615,49.458503401360545,51.89659863945578,18,23,301,2,282
3360,897,948,49.458503401360545,50.5730612244898,18,19,70,1,51
3361,897,953,49.458503401360545,51.26965986394558,18,20,96,2,56
3362,897,837,49.458503401360545,52.22167800453515,18,15,133,3,60
3363,948,583,50.5730612244898,51.89659863945578,19,25,369,1,365
3364,948,589,50.5730612244898,52.7092970521542,19,20,371,2,359
3365,948,615,50.5730612244898,51.89659863945578,19,23,338,1,333
3366,948,615,50.5730612244898,53.173696145124715,19,17,351,3,333
3367,948,837,50.5730612244898,52.22167800453515,19,15,132,2,111
3368,953,589,51.26965986394558,52.7092970521542,20,20,369,1,364
3369,953,615,51.26965986394558,53.173696145124715,20,17,348,2,338
3370,953,615,51.26965986394558,53.8702947845805,20,16,356,3,338
3371,953,899,51.26965986394558,53.84707482993198,20,21,123,3,54
3372,953,877,51.26965986394558,54.218594104308394,20,15,148,3,76
3373,837,438,52.22167800453515,54.19537414965986,15,21,408,2,399
3374,837,453,52.22167800453515,54.89197278911565,15,24,401,3,384
3375,837,615,52.22167800453515,53.8702947845805,15,16,233,2,222
3376,837,650,52.22167800453515,54.77587301587302,15,18,217,3,187
3377,837,899,52.22167800453515,53.84707482993198,15,21,94,2,62
3378,837,877,52.22167800453515,54.218594104308394,15,15,95,2,40
3379,899,453,53.84707482993198,54.89197278911565,21,24,448,1,446
3380,899,422,53.84707482993198,55.843990929705214,21,20,485,2,477
3381,899,620,53.84707482993198,55.28671201814059,21,15,286,1,279
3382,899,650,53.84707482993198,56.679909297052156,21,16,277,3,249
3383,899,901,53.84707482993198,56.633469387755106,21,14,120,3,2
3384,877,422,54.218594104308394,55.843990929705214,15,20,460,2,455
3385,877,436,54.218594104308394,56.91210884353742,15,19,456,3,441
3386,877,620,54.218594104308394,55.28671201814059,15,15,261,1,257
3387,877,650,54.218594104308394,56.679909297052156,15,16,251,2,227
3388,877,901,54.218594104308394,56.633469387755106,15,14,107,2,24
3389,901,421,56.633469387755106,57.67836734693878,14,25,482,1,480
3390,901,431,56.633469387755106,58.83936507936508,14,19,480,2,470
3391,901,616,56.633469387755106,58.816145124716556,14,15,300,2,285
3392,845,431,57.608707482993196,58.83936507936508,13,19,417,1,414
3393,845,517,57.608707482993196,59.97714285714286,13,21,343,2,328
3394,845,549,57.608707482993196,60.51120181405896,13,24,321,3,296
3395,845,616,57.608707482993196,58.816145124716556,13,15,235,1,229
3396,845,646,57.608707482993196,59.97714285714286,13,16,224,2,199
3397,845,619,57.608707482993196,60.395102040816326,13,21,256,3,226
3398,845,841,57.608707482993196,60.46476190476191,13,16,123,3,4
3399,841,579,60.46476190476191,62.04371882086168,16,23,271,2,262
3400,841,551,60.46476190476191,63.181496598639455,16,25,313,3,290
3401,841,580,60.46476190476191,63.43691609977324,16,24,291,3,261
3402,841,757,60.46476190476191,62.136598639455784,16,21,111,2,84
3403,841,615,60.46476190476191,63.181496598639455,16,23,254,3,226
3404,841,943,60.46476190476191,62.02049886621315,16,16,122,2,102
3405,841,953,60.46476190476191,62.577777777777776,16,20,144,2,112
3406,943,551,62.02049886621315,63.181496598639455,16,25,395,1,392
3407,943,580,62.02049886621315,63.43691609977324,16,24,368,1,363
3408,943,615,62.02049886621315,63.181496598639455,16,23,332,1,328
3409,943,764,62.02049886621315,63.506575963718824,16,18,190,1,179
3410,943,838,62.02049886621315,63.52979591836735,16,17,123,2,105
3411,953,566,62.577777777777776,65.10875283446713,20,21,402,3,387
3412,953,621,62.577777777777776,65.06231292517008,20,23,349,2,332
3413,953,875,62.577777777777776,65.22485260770975,20,21,138,3,78
3414,838,387,63.52979591836735,65.03909297052154,17,26,456,2,451
3415,838,566,63.52979591836735,65.10875283446713,17,21,280,2,272
3416,838,412,63.52979591836735,66.03755102040816,17,31,439,3,426
3417,838,621,63.52979591836735,65.06231292517008,17,23,227,2,217
3418,838,628,63.52979591836735,65.92145124716554,17,21,234,2,210
3419,838,726,63.52979591836735,66.50195011337868,17,20,170,3,112
3420,838,875,63.52979591836735,65.22485260770975,17,21,82,2,37
3421,838,944,63.52979591836735,66.20009070294785,17,22,156,3,106
3422,875,386,65.22485260770975,67.89514739229026,21,30,502,3,489
3423,875,415,65.22485260770975,66.6877097505669,21,24,464,1,460
3424,875,412,65.22485260770975,67.43074829931973,21,21,473,2,463
3425,875,726,65.22485260770975,66.50195011337868,21,20,159,1,149
3426,875,757,65.22485260770975,67.57006802721088,21,22,155,2,118
3427,875,901,65.22485260770975,67.26820861678004,21,18,92,2,26
3428,875,843,65.22485260770975,68.10412698412699,21,22,128,3,32
3429,944,757,66.20009070294785,67.57006802721088,22,22,196,1,187
3430,944,632,66.20009070294785,68.70784580498866,22,20,330,3,312
3431,944,901,66.20009070294785,67.26820861678004,22,18,63,1,43
3432,944,843,66.20009070294785,68.10412698412699,22,22,130,2,101
3433,944,828,66.20009070294785,68.63818594104309,22,19,156,2,116
3434,901,436,67.26820861678004,68.63818594104309,18,23,469,1,465
3435,901,414,67.26820861678004,69.84562358276644,18,25,499,3,487
3436,901,632,67.26820861678004,68.70784580498866,18,20,276,1,269
3437,901,828,67.26820861678004,68.63818594104309,18,19,94,1,73
3438,843,414,68.10412698412699,69.84562358276644,22,25,436,2,429
3439,843,410,68.10412698412699,70.75120181405896,22,21,448,3,433
3440,843,796,68.10412698412699,70.26358276643991,22,24,104,2,47
3441,843,615,68.10412698412699,70.28680272108843,22,23,247,2,228
3442,843,821,68.10412698412699,70.26358276643991,22,18,96,2,22
3443,843,821,68.10412698412699,70.28680272108843,22,21,97,2,22
3444,828,414,68.63818594104309,69.84562358276644,19,25,417,1,414
3445,828,410,68.63818594104309,70.75120181405896,19,21,428,2,418
3446,828,796,68.63818594104309,70.26358276643991,19,24,77,2,32
3447,828,615,68.63818594104309,70.28680272108843,19,23,225,2,213
3448,828,821,68.63818594104309,70.26358276643991,19,18,70,2,7
3449,828,821,68.63818594104309,70.28680272108843,19,21,71,2,7
3450,821,363,70.26358276643991,72.79455782312925,18,29,471,3,458
3451,821,560,70.26358276643991,72.14439909297052,18,26,273,2,261
3452,821,411,70.26358276643991,73.09641723356009,18,22,428,3,410
3453,821,657,70.26358276643991,72.14439909297052,18,21,183,2,164
3454,821,621,70.26358276643991,72.93387755102042,18,20,231,3,200
3455,821,949,70.26358276643991,72.14439909297052,18,23,151,2,128
3456,821,845,70.26358276643991,72.37659863945578,18,16,94,2,24
3457,821,363,70.28680272108843,72.79455782312925,21,29,471,3,458
3458,821,560,70.28680272108843,72.14439909297052,21,26,273,2,261
3459,821,411,70.28680272108843,73.09641723356009,21,22,427,3,410
3460,821,657,70.28680272108843,72.14439909297052,21,21,182,2,164
3461,821,621,70.28680272108843,72.93387755102042,21,20,230,3,200
3462,821,949,70.28680272108843,72.14439909297052,21,23,151,2,128
3463,821,845,70.28680272108843,72.37659863945578,21,16,93,2,24
3464,949,566,72.14439909297052,73.56081632653061,23,28,388,1,383
3465,949,576,72.14439909297052,74.62893424036281,23,26,388,2,373
3466,949,695,72.14439909297052,73.58403628117914,23,23,261,1,254
3467,949,634,72.14439909297052,74.60571428571428,23,25,332,2,315
3468,949,877,72.14439909297052,73.70013605442178,23,20,98,2,72
3469,949,877,72.14439909297052,74.7914739229025,23,21,135,3,72
3470,845,566,72.37659863945578,73.56081632653061,16,28,284,1,279
3471,845,576,72.37659863945578,74.62893424036281,16,26,286,2,269
3472,845,695,72.37659863945578,73.58403628117914,16,23,159,1,150
3473,845,634,72.37659863945578,74.60571428571428,16,25,232,2,211
3474,845,877,72.37659863945578,73.70013605442178,16,20,65,1,32
3475,845,877,72.37659863945578,74.7914739229025,16,21,109,2,32
3476,877,387,73.70013605442178,76.39365079365079,20,24,504,3,490
3477,877,552,73.70013605442178,75.7667120181406,20,20,337,2,325
3478,877,634,73.70013605442178,75.7667120181406,20,17,259,2,243
3479,877,621,73.70013605442178,76.37043083900227,20,22,281,3,256
3480,877,878,73.70013605442178,75.74349206349207,20,14,88,2,1
3481,877,865,73.70013605442178,76.579410430839,20,21,125,3,12
3482,877,387,74.7914739229025,76.39365079365079,21,24,495,2,490
3483,877,413,74.7914739229025,77.29922902494332,21,27,476,3,464
3484,877,412,74.7914739229025,77.32244897959184,21,29,478,3,465
3485,877,621,74.7914739229025,76.37043083900227,21,22,265,2,256
3486,877,630,74.7914739229025,77.34566893424036,21,21,270,3,247
3487,877,865,74.7914739229025,76.579410430839,21,21,78,2,12
3488,877,849,74.7914739229025,77.32244897959184,21,23,113,3,28
3489,878,388,75.74349206349207,77.78684807256236,14,27,498,2,490
3490,878,413,75.74349206349207,77.29922902494332,14,27,470,2,465
3491,878,412,75.74349206349207,77.32244897959184,14,29,471,2,466
3492,878,414,75.74349206349207,78.43700680272109,14,24,478,3,464
3493,878,630,75.74349206349207,77.34566893424036,14,21,257,2,248
3494,878,849,75.74349206349207,77.32244897959184,14,23,74,2,29
3495,865,388,76.579410430839,77.78684807256236,21,27,480,1,477
3496,865,387,76.579410430839,79.18004535147392,21,29,491,3,478
3497,865,414,76.579410430839,78.43700680272109,21,24,458,2,451
3498,865,757,76.579410430839,78.85496598639456,21,21,146,2,108
3499,865,872,76.579410430839,78.85496598639456,21,23,98,2,7
3500,865,843,76.579410430839,79.41224489795918,21,20,124,3,22
3501,849,387,77.32244897959184,79.18004535147392,23,29,469,2,462
3502,849,414,77.32244897959184,78.43700680272109,23,24,438,1,435
3503,849,437,77.32244897959184,79.92308390022676,23,22,427,3,412
3504,849,757,77.32244897959184,78.85496598639456,23,21,113,2,92
3505,849,633,77.32244897959184,79.99274376417233,23,19,245,3,216
3506,849,872,77.32244897959184,78.85496598639456,23,23,70,2,23
3507,849,843,77.32244897959184,79.41224489795918,23,20,90,2,6
3508,872,388,78.85496598639456,81.24662131519274,23,24,495,2,484
3509,872,437,78.85496598639456,79.92308390022676,23,22,437,1,435
3510,872,414,78.85496598639456,81.15374149659864,23,26,469,2,458
3511,872,410,78.85496598639456,81.61814058956917,23,19,477,3,462
3512,872,633,78.85496598639456,79.99274376417233,23,19,244,1,239
3513,872,776,78.85496598639456,81.24662131519274,23,20,141,2,96
3514,872,796,78.85496598639456,81.57170068027212,23,24,140,3,76
3515,872,851,78.85496598639456,81.13052154195012,23,18,100,2,21
3516,872,821,78.85496598639456,81.59492063492064,23,21,129,3,51
3517,843,388,79.41224489795918,81.24662131519274,20,24,462,2,455
3518,843,414,79.41224489795918,81.15374149659864,20,26,436,2,429
3519,843,410,79.41224489795918,81.61814058956917,20,19,443,2,433
3520,843,776,79.41224489795918,81.24662131519274,20,20,104,2,67
3521,843,796,79.41224489795918,81.57170068027212,20,24,104,2,47
3522,843,851,79.41224489795918,81.13052154195012,20,18,74,2,8
3523,843,821,79.41224489795918,81.59492063492064,20,21,97,2,22
3524,851,590,81.13052154195012,83.26675736961451,18,22,277,2,261
3525,851,558,81.13052154195012,83.47573696145125,18,25,310,2,293
3526,851,622,81.13052154195012,82.84879818594105,18,17,241,2,229
3527,851,657,81.13052154195012,83.4292970521542,18,20,218,2,194
3528,851,894,81.13052154195012,82.77913832199546,18,21,83,2,43
3529,851,949,81.13052154195012,83.4292970521542,18,23,139,2,98
3530,821,590,81.59492063492064,83.26675736961451,21,22,242,2,231
3531,821,558,81.59492063492064,83.47573696145125,21,25,275,2,263
3532,821,622,81.59492063492064,82.84879818594105,21,17,206,1,199
3533,821,657,81.59492063492064,83.4292970521542,21,20,182,2,164
3534,821,894,81.59492063492064,82.77913832199546,21,21,89,1,73
3535,821,949,81.59492063492064,83.4292970521542,21,23,150,2,128
3536,894,566,82.77913832199546,84.8457142857143,21,28,340,2,328
3537,894,617,82.77913832199546,84.8457142857143,21,23,291,2,277
3538,894,877,82.77913832199546,85.00825396825397,21,21,97,2,17
3539,949,566,83.4292970521542,84.8457142857143,23,28,388,1,383
3540,949,576,83.4292970521542,85.91383219954649,23,26,388,2,373
3541,949,617,83.4292970521542,84.8457142857143,23,23,338,1,332
3542,949,634,83.4292970521542,85.91383219954649,23,24,333,2,315
3543,949,877,83.4292970521542,85.00825396825397,23,21,99,2,72
3544,949,877,83.4292970521542,86.07637188208616,23,19,135,3,72
3545,949,921,83.4292970521542,86.35501133786848,23,13,129,3,28
3546,877,429,85.00825396825397,86.35501133786848,21,19,452,1,448
3547,877,561,85.00825396825397,87.74820861678005,21,16,337,3,316
3548,877,621,85.00825396825397,87.05160997732426,21,18,271,2,256
3549,877,921,85.00825396825397,86.35501133786848,21,13,73,1,44
3550,877,561,86.07637188208616,87.74820861678005,19,16,324,2,316
3551,877,810,86.07637188208616,88.16616780045352,19,18,112,2,67
3552,877,844,86.07637188208616,88.16616780045352,19,21,96,2,33
3553,921,561,86.35501133786848,87.74820861678005,13,16,365,1,360
3554,921,608,86.35501133786848,89.32716553287982,13,16,338,3,313
3555,921,810,86.35501133786848,88.16616780045352,13,18,136,2,111
3556,921,844,86.35501133786848,88.16616780045352,13,21,110,2,77
3557,921,930,86.35501133786848,89.11818594104308,13,16,119,3,9
3558,844,608,88.16616780045352,89.32716553287982,21,16,241,1,236
3559,844,489,88.16616780045352,89.62902494331065,21,18,361,1,355
3560,844,438,88.16616780045352,90.58104308390023,21,20,419,2,406
3561,844,666,88.16616780045352,89.35038548752834,21,18,185,1,178
3562,844,636,88.16616780045352,89.46648526077098,21,20,215,1,208
3563,844,615,88.16616780045352,90.58104308390023,21,18,252,2,229
3564,844,835,88.16616780045352,89.42004535147393,21,14,55,1,9
3565,844,874,88.16616780045352,90.97578231292518,21,16,125,3,30
3566,930,438,89.11818594104308,90.58104308390023,16,20,496,1,492
3567,930,615,89.11818594104308,90.58104308390023,16,18,321,1,315
3568,930,775,89.11818594104308,91.71882086167801,16,18,191,3,155
3569,930,874,89.11818594104308,90.97578231292518,16,16,98,2,56
3570,930,853,89.11818594104308,91.71882086167801,16,20,136,3,77
3571,835,438,89.42004535147393,90.58104308390023,14,20,400,1,397
3572,835,410,89.42004535147393,91.60272108843537,14,20,435,2,425
3573,835,615,89.42004535147393,90.58104308390023,14,18,226,1,220
3574,835,775,89.42004535147393,91.71882086167801,14,18,116,2,60
3575,835,874,89.42004535147393,90.97578231292518,14,16,78,2,39
3576,835,853,89.42004535147393,91.71882086167801,14,20,101,2,18
3577,874,431,90.97578231292518,92.71727891156463,16,19,449,2,443
3578,874,627,90.97578231292518,92.71727891156463,16,14,258,2,247
3579,874,811,90.97578231292518,93.83183673469388,16,19,138,3,63
3580,874,947,90.97578231292518,93.25133786848073,16,12,122,2,73
3581,874,844,90.97578231292518,93.80861678004536,16,17,126,3,30
3582,853,436,91.71882086167801,94.11047619047619,20,19,430,2,417
3583,853,811,91.71882086167801,93.83183673469388,20,19,100,2,42
3584,853,784,91.71882086167801,94.66775510204081,20,18,145,3,69
3585,853,947,91.71882086167801,93.25133786848073,20,12,115,2,94
3586,853,844,91.71882086167801,93.80861678004536,20,17,90,2,9
3587,853,842,91.71882086167801,94.66775510204081,20,19,127,3,11
3588,947,573,93.25133786848073,94.80707482993198,12,19,380,2,374
3589,947,784,93.25133786848073,94.66775510204081,12,18,174,1,163
3590,947,634,93.25133786848073,95.52689342403629,12,15,328,2,313
3591,947,842,93.25133786848073,94.66775510204081,12,19,121,1,105
3592,844,517,93.80861678004536,96.29315192743765,17,18,344,2,327
3593,844,634,93.80861678004536,95.52689342403629,17,15,223,2,210
3594,844,811,93.80861678004536,96.68789115646258,17,18,128,3,33
3595,844,938,93.80861678004536,96.26993197278912,17,12,142,2,94
3596,844,843,93.80861678004536,96.68789115646258,17,18,124,3,1
3597,842,517,94.66775510204081,96.29315192743765,19,18,332,2,325
3598,842,516,94.66775510204081,96.98975056689342,19,18,341,2,326
3599,842,605,94.66775510204081,97.54702947845806,19,19,267,3,237
3600,842,811,94.66775510204081,96.68789115646258,19,18,92,2,31
3601,842,938,94.66775510204081,96.26993197278912,19,12,118,2,96
3602,842,843,94.66775510204081,96.68789115646258,19,18,87,2,1
3603,938,605,96.26993197278912,97.54702947845806,12,19,338,1,333
3604,938,628,96.26993197278912,97.66312925170068,12,19,316,1,310
3605,938,627,96.26993197278912,99.05632653061225,12,17,333,3,311
3606,938,878,96.26993197278912,97.82566893424037,12,17,90,2,60
3607,843,431,96.68789115646258,99.07954648526078,18,18,425,2,412
3608,843,627,96.68789115646258,99.05632653061225,18,17,239,2,216
3609,843,878,96.68789115646258,97.82566893424037,18,17,60,1,35
3610,843,821,96.68789115646258,99.40462585034014,18,16,119,3,22
3611,878,431,97.82566893424037,99.07954648526078,17,18,450,1,447
3612,878,411,97.82566893424037,100.00834467120181,17,21,476,2,467
3613,878,627,97.82566893424037,99.05632653061225,17,17,257,1,251
3614,878,615,97.82566893424037,99.75292517006802,17,17,276,2,263
3615,878,821,97.82566893424037,99.40462585034014,17,16,89,2,57
3616,878,898,97.82566893424037,99.98512471655329,17,18,95,2,20
3617,821,431,99.40462585034014,101.19256235827665,16,19,398,2,390
3618,821,568,99.40462585034014,101.86594104308391,16,20,274,2,253
3619,821,807,99.40462585034014,101.37832199546486,16,20,86,2,14
3620,821,665,99.40462585034014,101.98204081632653,16,19,191,3,156
3621,821,851,99.40462585034014,101.33188208616781,16,19,88,2,30
3622,821,843,99.40462585034014,101.72662131519274,16,16,102,2,22
3623,898,431,99.98512471655329,101.19256235827665,18,19,470,1,467
3624,898,568,99.98512471655329,101.86594104308391,18,20,340,2,330
3625,898,436,99.98512471655329,102.5857596371882,18,20,475,3,462
3626,898,807,99.98512471655329,101.37832199546486,18,20,109,1,91
3627,898,665,99.98512471655329,101.98204081632653,18,19,248,2,233
3628,898,851,99.98512471655329,101.33188208616781,18,19,75,1,47
3629,898,843,99.98512471655329,101.72662131519274,18,16,93,2,55
3630,898,899,99.98512471655329,102.46965986394558,18,19,107,2,1
3631,851,436,101.33188208616781,102.5857596371882,19,20,418,1,415
3632,851,431,101.33188208616781,104.02539682539683,19,18,436,3,420
3633,851,791,101.33188208616781,103.3752380952381,19,21,107,2,60
3634,851,799,101.33188208616781,104.02539682539683,19,17,127,3,52
3635,851,899,101.33188208616781,102.46965986394558,19,19,69,1,48
3636,851,823,101.33188208616781,104.30403628117914,19,15,131,3,28
3637,843,431,101.72662131519274,104.02539682539683,16,18,424,2,412
3638,843,791,101.72662131519274,103.3752380952381,16,21,88,2,52
3639,843,799,101.72662131519274,104.02539682539683,16,17,108,2,44
3640,843,823,101.72662131519274,104.30403628117914,16,15,113,3,20
3641,899,431,102.46965986394558,104.02539682539683,19,18,473,2,468
3642,899,411,102.46965986394558,105.30249433106576,19,23,503,3,488
3643,899,799,102.46965986394558,104.02539682539683,19,17,120,2,100
3644,899,781,102.46965986394558,104.81487528344671,19,22,155,2,118
3645,899,823,102.46965986394558,104.30403628117914,19,15,110,2,76
3646,899,846,102.46965986394558,104.81487528344671,19,17,114,2,53
3647,823,518,104.30403628117914,106.16163265306123,15,21,315,2,305
3648,823,431,104.30403628117914,106.83501133786848,15,18,407,3,392
3649,823,635,104.30403628117914,106.11519274376417,15,17,204,2,188
3650,823,785,104.30403628117914,106.57959183673469,15,17,105,2,38
3651,823,862,104.30403628117914,106.27773242630386,15,16,94,2,39
3652,823,838,104.30403628117914,106.858231292517,15,18,111,3,15
3653,846,518,104.81487528344671,106.16163265306123,17,21,333,1,328
3654,846,431,104.81487528344671,106.83501133786848,17,18,424,2,415
3655,846,431,104.81487528344671,107.53160997732427,17,19,431,3,415
3656,846,635,104.81487528344671,106.11519274376417,17,17,218,1,211
3657,846,785,104.81487528344671,106.57959183673469,17,17,97,2,61
3658,846,638,104.81487528344671,107.50839002267574,17,20,238,3,208
3659,846,862,104.81487528344671,106.27773242630386,17,16,65,1,16
3660,846,838,104.81487528344671,106.858231292517,17,18,88,2,8
3661,862,431,106.27773242630386,107.53160997732427,16,19,434,1,431
3662,862,412,106.27773242630386,108.66938775510204,16,21,462,2,450
3663,862,638,106.27773242630386,107.50839002267574,16,20,230,1,224
3664,862,720,106.27773242630386,108.48362811791384,16,17,171,2,142
3665,862,863,106.27773242630386,107.99600907029479,16,14,74,2,1
3666,862,900,106.27773242630386,108.50684807256236,16,16,103,2,38
3667,838,412,106.858231292517,108.66938775510204,18,21,433,2,426
3668,838,720,106.858231292517,108.48362811791384,18,17,137,2,118
3669,838,774,106.858231292517,109.7839455782313,18,19,141,3,64
3670,838,863,106.858231292517,107.99600907029479,18,14,55,1,25
3671,838,900,106.858231292517,108.50684807256236,18,16,94,2,62
3672,863,442,107.99600907029479,110.15546485260771,14,20,431,2,421
3673,863,774,107.99600907029479,109.7839455782313,14,19,118,2,89
3674,863,840,107.99600907029479,109.92326530612245,14,18,86,2,23
3675,900,442,108.50684807256236,110.15546485260771,16,20,463,2,458
3676,900,555,108.50684807256236,111.06104308390023,16,18,362,3,345
3677,900,774,108.50684807256236,109.7839455782313,16,19,137,1,126
3678,900,632,108.50684807256236,111.06104308390023,16,17,290,3,268
3679,900,840,108.50684807256236,109.92326530612245,16,18,86,1,60
3680,900,882,108.50684807256236,111.38612244897959,16,15,125,3,18
3681,900,885,108.50684807256236,111.4790022675737,16,13,129,3,15
3682,840,555,109.92326530612245,111.06104308390023,18,18,289,1,285
3683,840,423,109.92326530612245,112.29170068027211,18,21,429,2,417
3684,840,632,109.92326530612245,111.06104308390023,18,17,214,1,208
3685,840,617,109.92326530612245,111.75764172335602,18,15,237,2,223
3686,840,882,109.92326530612245,111.38612244897959,18,15,76,1,42
3687,840,885,109.92326530612245,111.4790022675737,18,13,81,2,45
3688,882,431,111.38612244897959,113.19727891156462,15,20,458,2,451
3689,882,482,111.38612244897959,114.0564172335601,15,18,416,3,400
3690,882,618,111.38612244897959,113.1740589569161,15,15,275,2,264
3691,882,626,111.38612244897959,113.87065759637188,15,16,277,2,256
3692,882,884,111.38612244897959,113.38303854875284,15,11,86,2,2
3693,882,881,111.38612244897959,114.19573696145125,15,16,121,3,1
3694,885,431,111.4790022675737,113.19727891156462,13,20,460,2,454
3695,885,482,111.4790022675737,114.0564172335601,13,18,418,3,403
3696,885,618,111.4790022675737,113.1740589569161,13,15,277,2,267
3697,885,626,111.4790022675737,113.87065759637188,13,16,279,2,259
3698,885,884,111.4790022675737,113.38303854875284,13,11,82,2,1
3699,885,881,111.4790022675737,114.19573696145125,13,16,117,3,4
3700,884,428,113.38303854875284,115.3102947845805,11,18,463,2,456
3701,884,423,113.38303854875284,116.05333333333334,11,19,475,3,461
3702,884,635,113.38303854875284,114.5904761904762,11,17,254,1,249
3703,884,615,113.38303854875284,115.65859410430839,11,14,286,2,269
3704,884,868,113.38303854875284,114.49759637188208,11,11,51,1,16
3705,884,855,113.38303854875284,116.09977324263039,11,13,121,3,29
3706,881,428,114.19573696145125,115.3102947845805,16,18,456,1,453
3707,881,423,114.19573696145125,116.05333333333334,16,19,465,2,458
3708,881,615,114.19573696145125,115.65859410430839,16,14,273,1,266
3709,881,616,114.19573696145125,117.16789115646259,16,14,294,3,265
3710,881,855,114.19573696145125,116.09977324263039,16,13,86,2,26
3711,881,878,114.19573696145125,116.98213151927438,16,16,120,3,3
3712,868,423,114.49759637188208,116.05333333333334,11,19,450,2,445
3713,868,552,114.49759637188208,117.4465306122449,11,18,341,3,316
3714,868,615,114.49759637188208,115.65859410430839,11,14,258,1,253
3715,868,616,114.49759637188208,117.16789115646259,11,14,277,3,252
3716,868,855,114.49759637188208,116.09977324263039,11,13,70,2,13
3717,868,878,114.49759637188208,116.98213151927438,11,16,107,2,10
3718,855,552,116.09977324263039,117.4465306122449,13,18,309,1,303
3719,855,421,116.09977324263039,117.8877097505669,13,18,441,2,434
3720,855,438,116.09977324263039,118.9558276643991,13,22,435,3,417
3721,855,616,116.09977324263039,117.16789115646259,13,14,243,1,239
3722,855,699,116.09977324263039,118.28244897959183,13,11,182,2,156
3723,855,744,116.09977324263039,118.93260770975057,13,20,165,3,111
3724,855,842,116.09977324263039,117.84126984126985,13,11,76,2,13
3725,855,848,116.09977324263039,118.88616780045352,13,17,120,3,7
3726,878,438,116.98213151927438,118.9558276643991,16,22,448,2,440
3727,878,699,116.98213151927438,118.28244897959183,16,11,188,1,179
3728,878,744,116.98213151927438,118.93260770975057,16,20,158,2,134
3729,878,848,116.98213151927438,118.88616780045352,16,17,87,2,30
3730,842,438,117.84126984126985,118.9558276643991,11,22,407,1,404
3731,842,434,117.84126984126985,120.1168253968254,11,17,420,2,408
3732,842,462,117.84126984126985,120.79020408163265,11,23,401,3,380
3733,842,744,117.84126984126985,118.93260770975057,11,20,109,1,98
3734,842,811,117.84126984126985,120.48834467120182,11,21,118,3,31
3735,842,786,117.84126984126985,120.51156462585034,11,19,128,3,56
3736,842,848,117.84126984126985,118.88616780045352,11,17,45,1,6
3737,842,844,117.84126984126985,120.48834467120182,11,19,114,3,2
3738,842,852,117.84126984126985,120.53478458049887,11,18,116,3,10
3739,848,387,118.88616780045352,121.51002267573696,17,26,475,3,461
3740,848,434,118.88616780045352,120.1168253968254,17,17,417,1,414
3741,848,462,118.88616780045352,120.79020408163265,17,23,395,2,386
3742,848,811,118.88616780045352,120.48834467120182,17,21,78,2,37
3743,848,786,118.88616780045352,120.51156462585034,17,19,94,2,62
3744,848,645,118.88616780045352,121.51002267573696,17,22,232,3,203
3745,848,844,118.88616780045352,120.48834467120182,17,19,69,2,4
3746,848,852,118.88616780045352,120.53478458049887,17,18,71,2,4
3747,844,387,120.48834467120182,121.51002267573696,19,26,459,1,457
3748,844,412,120.48834467120182,122.50848072562358,19,31,441,2,432
3749,844,411,120.48834467120182,122.53170068027211,19,27,442,2,433
3750,844,645,120.48834467120182,121.51002267573696,19,22,204,1,199
3751,844,783,120.48834467120182,122.67102040816327,19,20,112,2,61
3752,844,849,120.48834467120182,122.48526077097506,19,22,86,2,5
3753,844,944,120.48834467120182,122.67102040816327,19,21,137,2,100
3754,852,412,120.53478458049887,122.50848072562358,18,31,448,2,440
3755,852,411,120.53478458049887,122.53170068027211,18,27,449,2,441
3756,852,783,120.53478458049887,122.67102040816327,18,20,115,2,69
3757,852,849,120.53478458049887,122.48526077097506,18,22,84,2,3
3758,852,944,120.53478458049887,122.67102040816327,18,21,130,2,92
3759,849,387,122.48526077097506,124.36607709750567,22,29,469,2,462
3760,849,592,122.48526077097506,123.762358276644,22,22,263,1,257
3761,849,585,122.48526077097506,125.38775510204081,22,21,292,3,264
3762,849,757,122.48526077097506,124.0409977324263,22,22,114,2,92
3763,849,700,122.48526077097506,124.5750566893424,22,20,174,2,149
3764,849,873,122.48526077097506,124.0409977324263,22,23,71,2,24
3765,849,918,122.48526077097506,124.5750566893424,22,20,113,2,69
3766,944,592,122.67102040816327,123.762358276644,21,22,355,1,352
3767,944,585,122.67102040816327,125.38775510204081,21,21,378,3,359
3768,944,757,122.67102040816327,124.0409977324263,21,22,196,1,187
3769,944,700,122.67102040816327,124.5750566893424,21,20,257,2,244
3770,944,873,122.67102040816327,124.0409977324263,21,23,92,1,71
3771,944,918,122.67102040816327,124.5750566893424,21,20,86,2,26
3772,873,585,124.0409977324263,125.38775510204081,23,21,294,1,288
3773,873,414,124.0409977324263,126.31655328798186,23,24,469,2,459
3774,873,777,124.0409977324263,126.4326530612245,23,19,141,2,96
3775,873,796,124.0409977324263,126.73451247165534,23,24,139,3,77
3776,873,906,124.0409977324263,126.4326530612245,23,18,108,2,33
3777,873,821,124.0409977324263,126.75773242630386,23,20,128,3,52
3778,918,560,124.5750566893424,127.26857142857143,20,20,376,3,358
3779,918,777,124.5750566893424,126.4326530612245,20,19,162,2,141
3780,918,796,124.5750566893424,126.73451247165534,20,24,153,2,122
3781,918,906,124.5750566893424,126.4326530612245,20,18,81,2,12
3782,918,821,124.5750566893424,126.75773242630386,20,20,135,2,97
3783,906,590,126.4326530612245,128.45278911564625,18,22,328,2,316
3784,906,560,126.4326530612245,128.61532879818594,18,24,359,2,346
3785,906,618,126.4326530612245,128.05804988662132,18,18,296,2,288
3786,906,657,126.4326530612245,128.61532879818594,18,21,266,2,249
3787,906,901,126.4326530612245,127.91873015873016,18,21,64,1,5
3788,906,949,126.4326530612245,128.61532879818594,18,21,103,2,43
3789,821,590,126.75773242630386,128.45278911564625,20,22,242,2,231
3790,821,560,126.75773242630386,128.61532879818594,20,24,273,2,261
3791,821,618,126.75773242630386,128.05804988662132,20,18,211,1,203
3792,821,657,126.75773242630386,128.61532879818594,20,21,182,2,164
3793,821,901,126.75773242630386,127.91873015873016,20,21,94,1,80
3794,821,949,126.75773242630386,128.61532879818594,20,21,151,2,128
3795,901,566,127.91873015873016,130.03174603174602,21,27,347,2,335
3796,901,617,127.91873015873016,130.03174603174602,21,23,298,2,284
3797,901,877,127.91873015873016,130.1942857142857,21,20,101,2,24
3798,949,566,128.61532879818594,130.03174603174602,21,27,388,1,383
3799,949,576,128.61532879818594,131.09986394557822,21,24,388,2,373
3800,949,617,128.61532879818594,130.03174603174602,21,23,338,1,332
3801,949,634,128.61532879818594,131.0766439909297,21,24,332,2,315
3802,949,877,128.61532879818594,130.1942857142857,21,20,99,2,72
3803,949,877,128.61532879818594,131.2624036281179,21,21,135,3,72
3804,877,443,130.1942857142857,131.84290249433107,20,20,440,2,434
3805,877,587,130.1942857142857,132.9342403628118,20,20,313,3,290
3806,877,749,130.1942857142857,131.79646258503402,20,19,145,2,128
3807,877,621,130.1942857142857,132.84136054421768,20,22,280,3,256
3808,877,846,130.1942857142857,131.79646258503402,20,17,76,2,31
3809,877,875,130.1942857142857,132.98068027210886,20,20,120,3,2
3810,877,587,131.2624036281179,132.9342403628118,21,20,299,2,290
3811,877,412,131.2624036281179,133.79337868480727,21,29,478,3,465
3812,877,621,131.2624036281179,132.84136054421768,21,22,265,2,256
3813,877,630,131.2624036281179,133.81659863945578,21,21,270,3,247
3814,877,875,131.2624036281179,132.98068027210886,21,20,74,2,2
3815,877,849,131.2624036281179,133.79337868480727,21,23,113,3,28
3816,846,388,131.79646258503402,134.2577777777778,17,27,470,2,458
3817,846,587,131.79646258503402,132.9342403628118,17,20,264,1,259
3818,846,412,131.79646258503402,133.79337868480727,17,29,442,2,434
3819,846,621,131.79646258503402,132.84136054421768,17,22,229,1,225
3820,846,630,131.79646258503402,133.81659863945578,17,21,233,2,216
3821,846,875,131.79646258503402,132.98068027210886,17,20,59,1,29
3822,846,849,131.79646258503402,133.79337868480727,17,23,86,2,3
3823,875,388,132.98068027210886,134.2577777777778,20,27,490,1,487
3824,875,386,132.98068027210886,135.65097505668933,20,29,502,3,489
3825,875,414,132.98068027210886,134.9079365079365,20,25,468,2,461
3826,875,655,132.98068027210886,135.3491156462585,20,21,242,2,220
3827,875,700,132.98068027210886,135.85995464852607,20,21,214,3,175
3828,875,872,132.98068027210886,135.32589569161,20,22,101,2,3
3829,875,844,132.98068027210886,135.8831746031746,20,23,129,3,31
3830,849,386,133.79337868480727,135.65097505668933,23,29,470,2,463
3831,849,414,133.79337868480727,134.9079365079365,23,25,438,1,435
3832,849,437,133.79337868480727,136.39401360544218,23,23,427,3,412
3833,849,655,133.79337868480727,135.3491156462585,23,21,205,2,194
3834,849,700,133.79337868480727,135.85995464852607,23,21,174,2,149
3835,849,872,133.79337868480727,135.32589569161,23,22,70,2,23
3836,849,844,133.79337868480727,135.8831746031746,23,23,90,2,5
3837,872,437,135.32589569161,136.39401360544218,22,23,437,1,435
3838,872,413,135.32589569161,137.55501133786848,22,21,469,2,459
3839,872,414,135.32589569161,137.62467120181407,22,25,469,2,458
3840,872,615,135.32589569161,137.06739229024944,22,16,268,2,257
3841,872,615,135.32589569161,138.06585034013605,22,23,283,3,257
3842,872,827,135.32589569161,137.18349206349205,22,11,92,2,45
3843,872,820,135.32589569161,138.06585034013605,22,21,129,3,52
3844,844,413,135.8831746031746,137.55501133786848,23,21,437,2,431
3845,844,414,135.8831746031746,137.62467120181407,23,25,436,2,430
3846,844,615,135.8831746031746,137.06739229024944,23,16,235,1,229
3847,844,615,135.8831746031746,138.06585034013605,23,23,248,2,229
3848,844,827,135.8831746031746,137.18349206349205,23,11,59,1,17
3849,844,820,135.8831746031746,138.06585034013605,23,21,97,2,24
3850,827,430,137.18349206349205,139.29650793650794,11,20,407,2,397
3851,827,559,137.18349206349205,139.94666666666666,11,26,293,3,268
3852,827,790,137.18349206349205,139.22684807256235,11,17,95,2,37
3853,827,680,137.18349206349205,139.94666666666666,11,21,189,3,147
3854,827,894,137.18349206349205,139.2500680272109,11,20,111,2,67
3855,827,949,137.18349206349205,139.9002267573696,11,22,169,3,122
3856,820,430,138.06585034013605,139.29650793650794,21,20,394,1,390
3857,820,559,138.06585034013605,139.94666666666666,21,26,273,2,261
3858,820,790,138.06585034013605,139.22684807256235,21,17,58,1,30
3859,820,680,138.06585034013605,139.94666666666666,21,21,162,2,140
3860,820,894,138.06585034013605,139.2500680272109,21,20,90,1,74
3861,820,949,138.06585034013605,139.9002267573696,21,22,151,2,129
3862,894,566,139.2500680272109,141.31664399092972,20,27,340,2,328
3863,894,695,139.2500680272109,141.33986394557823,20,24,218,2,199
3864,894,877,139.2500680272109,141.47918367346938,20,22,97,2,17
3865,949,566,139.9002267573696,141.31664399092972,22,27,388,1,383
3866,949,576,139.9002267573696,142.38476190476192,22,26,388,2,373
3867,949,695,139.9002267573696,141.33986394557823,22,24,261,1,254
3868,949,691,139.9002267573696,142.38476190476192,22,24,279,2,258
3869,949,877,139.9002267573696,141.47918367346938,22,22,99,2,72
3870,949,876,139.9002267573696,142.5473015873016,22,19,135,3,73
3871,949,928,139.9002267573696,142.77950113378685,22,18,126,3,21
3872,877,565,141.47918367346938,143.52253968253967,22,19,324,2,312
3873,877,556,141.47918367346938,143.7082993197279,22,12,335,2,321
3874,877,754,141.47918367346938,143.12780045351474,22,18,142,2,123
3875,877,797,141.47918367346938,143.82439909297054,22,15,129,2,80
3876,877,876,141.47918367346938,142.5473015873016,22,19,46,1,1
3877,877,928,141.47918367346938,142.77950113378685,22,18,76,1,51
3878,877,860,141.47918367346938,143.68507936507936,22,15,97,2,17
3879,876,556,142.5473015873016,143.7082993197279,19,12,324,1,320
3880,876,797,142.5473015873016,143.82439909297054,19,15,96,1,79
3881,876,860,142.5473015873016,143.68507936507936,19,15,52,1,16
3882,928,797,142.77950113378685,143.82439909297054,18,15,139,1,131
