,f0,f1,t0,t1,dB0,dB1,dist,utime,ufreq
0,4,19,1.207437641723356,2.36843537414966,39,19,52,1,15
1,4,34,1.207437641723356,3.6687528344671203,39,19,110,2,30
2,19,34,2.36843537414966,3.6687528344671203,19,19,58,1,15
3,19,6,2.36843537414966,4.667210884353741,19,39,100,2,13
4,19,14,2.36843537414966,5.038730158730159,19,32,115,3,5
5,19,397,2.36843537414966,4.760090702947846,19,12,392,2,378
6,19,497,2.36843537414966,4.690430839002268,19,11,488,2,478
7,34,14,3.6687528344671203,5.038730158730159,19,32,62,1,20
8,34,14,3.6687528344671203,6.060408163265306,19,30,105,2,20
9,34,397,3.6687528344671203,4.760090702947846,19,12,366,1,363
10,34,497,3.6687528344671203,4.690430839002268,19,11,465,1,463
11,6,14,4.667210884353741,6.060408163265306,39,30,61,1,8
12,14,6,5.038730158730159,7.964444444444444,32,38,126,3,8
13,14,6,6.060408163265306,7.964444444444444,30,38,82,2,8
14,14,5,6.060408163265306,8.266303854875284,30,41,95,2,9
15,14,403,6.060408163265306,8.219863945578231,30,20,400,2,389
16,6,9,7.964444444444444,9.961360544217687,38,38,86,2,3
17,6,211,7.964444444444444,9.961360544217687,38,17,222,2,205
18,6,211,7.964444444444444,10.193560090702949,38,16,226,2,205
19,5,9,8.266303854875284,9.961360544217687,41,38,73,2,4
20,5,6,8.266303854875284,10.402539682539683,41,38,92,2,1
21,5,211,8.266303854875284,9.961360544217687,41,17,219,2,206
22,5,211,8.266303854875284,10.193560090702949,41,16,222,2,206
23,9,7,9.961360544217687,11.72607709750567,38,38,76,2,2
24,9,6,9.961360544217687,12.60843537414966,38,39,114,3,3
25,9,266,9.961360544217687,11.54031746031746,38,17,266,2,257
26,9,237,9.961360544217687,12.631655328798185,38,16,255,3,228
27,6,7,10.402539682539683,11.72607709750567,38,38,57,1,1
28,6,266,10.402539682539683,11.54031746031746,38,17,265,1,260
29,6,237,10.402539682539683,12.631655328798185,38,16,250,2,231
30,7,10,11.72607709750567,14.349931972789117,38,38,113,3,3
31,7,211,11.72607709750567,13.722993197278912,38,17,221,2,204
32,7,235,11.72607709750567,14.210612244897959,38,16,252,2,228
33,6,10,12.60843537414966,14.349931972789117,39,38,75,2,4
34,6,4,12.60843537414966,15.32517006802721,39,40,117,3,2
35,6,211,12.60843537414966,13.722993197278912,39,17,211,1,205
36,6,235,12.60843537414966,14.210612244897959,39,16,239,2,229
37,6,211,12.60843537414966,15.464489795918368,39,16,239,3,205
38,7,4,13.490793650793652,15.32517006802721,38,40,79,2,3
39,7,10,13.490793650793652,16.114648526077097,38,39,113,3,3
40,7,211,13.490793650793652,15.464489795918368,38,16,221,2,204
41,7,211,13.490793650793652,16.23074829931973,38,17,236,3,204
42,7,425,13.490793650793652,15.603809523809524,38,13,428,2,418
43,10,211,14.349931972789117,15.464489795918368,38,16,207,1,201
44,10,211,14.349931972789117,16.23074829931973,38,17,217,2,201
45,10,425,14.349931972789117,15.603809523809524,38,13,418,1,415
46,4,271,15.32517006802721,17.949024943310658,40,18,290,3,267
47,4,424,15.32517006802721,17.34530612244898,40,13,429,2,420
48,10,4,16.114648526077097,17.972244897959182,39,38,80,2,6
49,10,4,16.114648526077097,18.854603174603174,39,39,118,3,6
50,10,271,16.114648526077097,17.949024943310658,39,18,273,2,261
51,10,299,16.114648526077097,19.040362811791383,39,17,315,3,289
52,10,424,16.114648526077097,17.34530612244898,39,13,417,1,414
53,4,7,17.972244897959182,19.667301587301587,38,38,73,2,3
54,4,299,17.972244897959182,19.040362811791383,38,17,299,1,295
55,4,213,17.972244897959182,19.89950113378685,38,17,225,2,209
56,4,403,17.972244897959182,20.54965986394558,38,20,414,3,399
57,4,473,17.972244897959182,19.99238095238095,38,15,477,2,469
58,4,213,18.854603174603174,19.89950113378685,39,17,214,1,209
59,4,403,18.854603174603174,20.54965986394558,39,20,406,2,399
60,4,401,18.854603174603174,21.106938775510205,39,14,409,2,397
61,4,473,18.854603174603174,19.99238095238095,39,15,472,1,469
62,7,6,19.667301587301587,21.873197278911565,38,38,95,2,1
63,7,6,19.667301587301587,22.31437641723356,38,39,114,3,1
64,7,401,19.667301587301587,21.106938775510205,38,14,399,1,394
65,7,249,19.667301587301587,22.128616780045352,38,17,264,2,242
66,4,6,20.59609977324263,21.873197278911565,40,38,55,1,2
67,4,6,20.59609977324263,22.31437641723356,40,39,74,2,2
68,4,51,20.59609977324263,23.45215419501134,40,38,132,3,47
69,4,249,20.59609977324263,22.128616780045352,40,17,254,2,245
70,6,51,21.873197278911565,23.45215419501134,38,38,82,2,45
71,6,342,21.873197278911565,23.91655328798186,38,20,347,2,336
72,6,51,22.31437641723356,23.45215419501134,39,38,67,1,45
73,6,342,22.31437641723356,23.91655328798186,39,20,343,2,336
74,6,387,22.31437641723356,25.031111111111112,39,23,399,3,381
75,6,410,22.31437641723356,25.031111111111112,39,15,421,3,404
76,51,6,23.45215419501134,24.961451247165535,38,39,79,2,45
77,51,10,23.45215419501134,25.820589569160997,38,38,110,2,41
78,51,387,23.45215419501134,25.031111111111112,38,23,343,2,336
79,51,214,23.45215419501134,25.611609977324264,38,25,188,2,163
80,51,410,23.45215419501134,25.031111111111112,38,15,365,2,359
81,51,539,23.45215419501134,26.261768707482993,38,14,503,3,488
82,6,10,24.961451247165535,26.70294784580499,39,38,75,2,4
83,6,4,24.961451247165535,27.678185941043086,39,37,117,3,2
84,6,227,24.961451247165535,26.795827664399095,39,23,235,2,221
85,6,206,24.961451247165535,27.23700680272109,39,28,223,2,200
86,10,4,25.820589569160997,27.678185941043086,38,37,80,2,6
87,10,206,25.820589569160997,27.23700680272109,38,28,205,1,196
88,10,389,25.820589569160997,28.23546485260771,38,19,393,2,379
89,10,415,25.820589569160997,28.0497052154195,38,15,416,2,405
90,10,4,26.70294784580499,29.442902494331065,38,38,118,3,6
91,10,389,26.70294784580499,28.23546485260771,38,19,385,2,379
92,10,415,26.70294784580499,28.0497052154195,38,15,409,1,405
93,10,412,26.70294784580499,28.908843537414967,38,15,413,2,402
94,4,10,27.678185941043086,28.908843537414967,37,39,53,1,6
95,4,7,27.678185941043086,30.25560090702948,37,39,111,3,3
96,4,384,27.678185941043086,29.860861678004536,37,26,391,2,380
97,4,211,27.678185941043086,30.464580498866212,37,17,239,3,207
98,4,412,27.678185941043086,28.908843537414967,37,15,411,1,408
99,4,410,27.678185941043086,29.860861678004536,37,21,417,2,406
100,10,7,28.908843537414967,30.25560090702948,39,39,58,1,3
101,10,211,28.908843537414967,30.464580498866212,39,17,212,2,201
102,4,23,29.442902494331065,31.90421768707483,38,38,108,2,19
103,4,211,29.442902494331065,30.464580498866212,38,17,212,1,207
104,4,268,29.442902494331065,32.066757369614514,38,21,287,3,264
105,7,23,30.25560090702948,31.90421768707483,39,38,73,2,16
106,7,4,30.25560090702948,32.949115646258505,39,38,116,3,3
107,7,268,30.25560090702948,32.066757369614514,39,21,272,2,261
108,7,239,30.25560090702948,32.949115646258505,39,25,259,3,232
109,23,4,31.90421768707483,32.949115646258505,38,38,49,1,19
110,23,4,31.90421768707483,33.8314739229025,38,38,85,2,19
111,23,4,31.90421768707483,34.73705215419501,38,40,123,3,19
112,23,239,31.90421768707483,32.949115646258505,38,25,221,1,216
113,23,209,31.90421768707483,33.99401360544218,38,26,207,2,186
114,4,209,32.949115646258505,33.99401360544218,38,26,210,1,205
115,4,210,32.949115646258505,35.10857142857143,38,22,226,2,206
116,4,331,32.949115646258505,35.80517006802721,38,22,349,3,327
117,4,18,33.8314739229025,35.9677097505669,38,39,93,2,14
118,4,210,33.8314739229025,35.10857142857143,38,22,213,1,206
119,4,331,33.8314739229025,35.80517006802721,38,22,338,2,327
120,4,491,33.8314739229025,36.80362811791383,38,22,504,3,487
121,4,18,34.73705215419501,35.9677097505669,40,39,55,1,14
122,4,10,34.73705215419501,36.85006802721089,40,37,91,2,6
123,4,331,34.73705215419501,35.80517006802721,40,22,330,1,327
124,4,228,34.73705215419501,36.91972789115646,40,27,243,2,224
125,4,225,34.73705215419501,37.45378684807256,40,26,250,3,221
126,4,491,34.73705215419501,36.80362811791383,40,22,495,2,487
127,4,454,34.73705215419501,37.221587301587306,40,19,463,2,450
128,18,10,35.9677097505669,37.73242630385488,39,37,76,2,8
129,18,225,35.9677097505669,37.45378684807256,39,26,217,1,207
130,18,383,35.9677097505669,38.638004535147395,39,24,383,3,365
131,18,454,35.9677097505669,37.221587301587306,39,19,439,1,436
132,10,383,36.85006802721089,38.638004535147395,37,24,381,2,373
133,10,227,36.85006802721089,39.14884353741497,37,20,239,2,217
134,10,227,37.73242630385488,39.14884353741497,37,20,225,1,217
135,10,6,39.05596371882086,40.84390022675737,39,39,77,2,4
136,10,4,39.05596371882086,41.79591836734694,39,38,118,3,6
137,10,227,39.05596371882086,40.91356009070295,39,25,231,2,217
138,10,255,39.05596371882086,41.33151927437642,39,25,264,2,245
139,10,508,39.05596371882086,41.84235827664399,39,17,512,3,498
140,10,4,39.938321995464854,41.79591836734694,39,38,80,2,6
141,10,255,39.938321995464854,41.33151927437642,39,25,252,1,245
142,10,382,39.938321995464854,42.399637188208615,39,21,387,2,372
143,10,508,39.938321995464854,41.84235827664399,39,17,505,2,498
144,6,10,40.84390022675737,42.58539682539683,39,39,75,2,4
145,6,7,40.84390022675737,43.46775510204082,39,39,113,3,1
146,6,382,40.84390022675737,42.399637188208615,39,21,382,2,376
147,6,238,40.84390022675737,43.490975056689344,39,26,258,3,232
148,4,7,41.79591836734694,43.46775510204082,38,39,72,2,3
149,4,7,41.79591836734694,44.373333333333335,38,40,111,3,3
150,4,238,41.79591836734694,43.490975056689344,38,26,245,2,234
151,4,421,41.79591836734694,43.97859410430839,38,23,427,2,417
152,10,7,42.58539682539683,44.373333333333335,39,40,77,2,3
153,10,7,42.58539682539683,45.2324716553288,39,39,114,3,3
154,10,212,42.58539682539683,44.83773242630386,39,28,224,2,202
155,10,254,42.58539682539683,45.51111111111111,39,23,275,3,244
156,10,421,42.58539682539683,43.97859410430839,39,23,415,1,411
157,7,4,43.46775510204082,46.18448979591837,39,39,117,3,3
158,7,212,43.46775510204082,44.83773242630386,39,28,213,1,205
159,7,254,43.46775510204082,45.51111111111111,39,23,262,2,247
160,7,4,44.373333333333335,46.18448979591837,40,39,78,2,3
161,7,254,44.373333333333335,45.51111111111111,40,23,252,1,247
162,7,218,44.373333333333335,47.04362811791383,40,26,240,3,211
163,7,218,45.2324716553288,47.04362811791383,39,26,225,2,211
164,7,231,45.2324716553288,47.763446712018144,39,27,249,3,224
165,4,7,46.18448979591837,47.879546485260775,39,39,73,2,3
166,4,10,46.18448979591837,49.08698412698413,39,39,125,3,6
167,4,231,46.18448979591837,47.763446712018144,39,27,237,2,227
168,4,228,46.18448979591837,48.4368253968254,39,30,244,2,224
169,7,10,47.879546485260775,49.08698412698413,39,39,52,1,3
170,7,5,47.879546485260775,49.71392290249433,39,41,79,2,2
171,7,6,47.879546485260775,50.549841269841274,39,39,115,3,1
172,7,261,47.879546485260775,49.946122448979594,39,27,269,2,254
173,7,341,47.879546485260775,50.29442176870749,39,26,350,2,334
174,10,6,49.08698412698413,50.549841269841274,39,39,63,1,4
175,10,341,49.08698412698413,50.29442176870749,39,26,335,1,331
176,5,10,49.71392290249433,51.85015873015873,41,37,92,2,5
177,5,256,49.71392290249433,52.082358276643994,41,25,271,2,251
178,5,229,49.71392290249433,52.38421768707483,41,20,252,3,224
179,6,10,50.549841269841274,51.85015873015873,39,37,56,1,4
180,6,256,50.549841269841274,52.082358276643994,39,25,259,2,250
181,6,229,50.549841269841274,52.38421768707483,39,20,237,2,223
182,10,6,51.85015873015873,53.614875283446715,37,39,76,2,4
183,10,226,51.85015873015873,54.10249433106576,37,26,237,2,216
184,10,231,51.85015873015873,54.75265306122449,37,25,254,3,221
185,10,425,51.85015873015873,54.14893424036281,37,21,427,2,415
186,6,10,52.75573696145125,54.9384126984127,39,39,94,2,4
187,6,226,52.75573696145125,54.10249433106576,39,26,228,1,220
188,6,231,52.75573696145125,54.75265306122449,39,25,241,2,225
189,6,425,52.75573696145125,54.14893424036281,39,21,423,1,419
190,6,410,52.75573696145125,54.984852607709755,39,17,415,2,404
191,6,10,53.614875283446715,54.9384126984127,39,39,57,1,4
192,6,4,53.614875283446715,55.913650793650795,39,39,99,2,2
193,6,231,53.614875283446715,54.75265306122449,39,25,230,1,225
194,6,247,53.614875283446715,55.89043083900227,39,25,260,2,241
195,6,410,53.614875283446715,54.984852607709755,39,17,408,1,404
196,6,410,53.614875283446715,55.98331065759637,39,18,417,2,404
197,10,225,54.9384126984127,56.91210884353742,39,24,231,2,215
198,10,241,54.9384126984127,57.72480725623583,39,28,260,3,231
199,10,410,54.9384126984127,55.98331065759637,39,18,403,1,400
200,4,7,55.913650793650795,58.46784580498866,39,39,110,3,3
201,4,241,55.913650793650795,57.72480725623583,39,28,250,2,237
202,10,4,56.70312925170068,58.096326530612245,39,39,60,1,6
203,10,7,56.70312925170068,58.46784580498866,39,39,76,2,3
204,10,4,56.70312925170068,59.419863945578236,39,39,117,3,6
205,10,241,56.70312925170068,57.72480725623583,39,28,235,1,231
206,10,212,56.70312925170068,59.187664399092974,39,22,229,2,202
207,10,439,56.70312925170068,58.90902494331066,39,13,439,2,429
208,4,212,58.096326530612245,59.187664399092974,39,22,213,1,208
209,4,212,58.096326530612245,60.09324263038549,39,32,225,2,208
210,7,212,58.46784580498866,60.09324263038549,39,32,217,2,205
211,7,225,58.46784580498866,61.18458049886621,39,28,247,3,218
212,7,214,58.46784580498866,61.41678004535147,39,30,243,3,207
213,7,424,58.46784580498866,61.161360544217686,39,22,433,3,417
214,7,430,58.46784580498866,61.23102040816327,39,20,439,3,423
215,4,7,59.419863945578236,61.11492063492064,39,39,73,2,3
216,4,6,59.419863945578236,61.99727891156463,39,39,111,3,2
217,4,225,59.419863945578236,61.18458049886621,39,28,234,2,221
218,4,214,59.419863945578236,61.41678004535147,39,30,227,2,210
219,4,209,59.419863945578236,62.32235827664399,39,31,240,3,205
220,4,424,59.419863945578236,61.161360544217686,39,22,427,2,420
221,4,430,59.419863945578236,61.23102040816327,39,20,433,2,426
222,7,4,61.11492063492064,62.972517006802725,39,38,80,2,3
223,7,209,61.11492063492064,62.32235827664399,39,31,209,1,202
224,7,402,61.11492063492064,64.04063492063493,39,25,415,3,395
225,6,14,61.99727891156463,64.22639455782313,39,39,96,2,8
226,6,5,61.99727891156463,64.71401360544218,39,41,117,3,1
227,6,402,61.99727891156463,64.04063492063493,39,25,406,2,396
228,6,253,61.99727891156463,64.76045351473923,39,24,274,3,247
229,6,411,61.99727891156463,64.69079365079365,39,20,421,3,405
230,4,14,62.972517006802725,64.22639455782313,38,39,55,1,10
231,4,5,62.972517006802725,64.71401360544218,38,41,75,2,1
232,4,6,62.972517006802725,65.52671201814059,38,40,110,3,2
233,4,402,62.972517006802725,64.04063492063493,38,25,401,1,398
234,4,253,62.972517006802725,64.76045351473923,38,24,261,2,249
235,4,258,62.972517006802725,65.75891156462585,38,26,281,3,254
236,4,411,62.972517006802725,64.69079365079365,38,20,414,2,407
237,4,422,62.972517006802725,65.38739229024944,38,17,431,2,418
238,14,6,64.22639455782313,65.52671201814059,39,40,57,1,8
239,14,6,64.22639455782313,66.40907029478458,39,39,94,2,8
240,14,258,64.22639455782313,65.75891156462585,39,26,253,2,244
241,14,226,64.22639455782313,67.10566893424037,39,24,246,3,212
242,14,422,64.22639455782313,65.38739229024944,39,17,411,1,408
243,14,430,64.22639455782313,66.26975056689342,39,15,425,2,416
244,5,6,64.71401360544218,66.40907029478458,41,39,73,2,1
245,5,258,64.71401360544218,65.75891156462585,41,26,257,1,253
246,5,226,64.71401360544218,67.10566893424037,41,24,244,2,221
247,5,430,64.71401360544218,66.26975056689342,41,15,430,2,425
248,6,226,65.52671201814059,67.10566893424037,40,24,230,2,220
249,6,259,65.52671201814059,68.01124716553288,40,23,275,2,253
250,6,422,65.52671201814059,68.08090702947845,40,16,430,3,416
251,6,4,66.40907029478458,69.12580498866214,39,39,117,3,2
252,6,259,66.40907029478458,68.01124716553288,39,23,262,2,253
253,6,231,66.40907029478458,68.87038548752835,39,24,249,2,225
254,6,422,66.40907029478458,68.08090702947845,39,16,422,2,416
255,6,4,67.75582766439909,69.12580498866214,42,39,59,1,2
256,6,8,67.75582766439909,69.47410430839003,42,40,74,2,2
257,6,231,67.75582766439909,68.87038548752835,42,24,230,1,225
258,6,252,67.75582766439909,69.75274376417234,42,24,261,2,246
259,6,410,67.75582766439909,69.5437641723356,42,15,411,2,404
260,4,10,69.12580498866214,71.26204081632653,39,39,92,2,6
261,4,10,69.12580498866214,71.51746031746032,39,40,103,2,6
262,4,219,69.12580498866214,71.00662131519275,39,25,230,2,215
263,4,342,69.12580498866214,71.61034013605442,39,27,355,2,338
264,8,10,69.47410430839003,71.26204081632653,40,39,77,2,2
265,8,10,69.47410430839003,71.51746031746032,40,40,88,2,2
266,8,219,69.47410430839003,71.00662131519275,40,25,221,2,211
267,8,342,69.47410430839003,71.61034013605442,40,27,346,2,334
268,10,7,71.26204081632653,73.02675736961451,39,41,76,2,3
269,10,7,71.26204081632653,73.9091156462585,39,41,114,3,3
270,10,210,71.26204081632653,73.25895691609978,39,20,218,2,200
271,10,212,71.26204081632653,74.18775510204082,39,31,238,3,202
272,10,7,71.51746031746032,73.02675736961451,40,41,65,2,3
273,10,7,71.51746031746032,73.9091156462585,40,41,103,2,3
274,10,210,71.51746031746032,73.25895691609978,40,20,214,2,200
275,10,212,71.51746031746032,74.18775510204082,40,31,232,3,202
276,10,211,71.51746031746032,74.28063492063492,40,29,234,3,201
277,7,10,73.02675736961451,75.2326530612245,41,38,95,2,3
278,7,212,73.02675736961451,74.18775510204082,41,31,211,1,205
279,7,211,73.02675736961451,74.28063492063492,41,29,211,1,204
280,7,229,73.02675736961451,75.4184126984127,41,31,245,2,222
281,7,416,73.02675736961451,75.25587301587302,41,22,420,2,409
282,7,423,73.02675736961451,75.27909297052155,41,23,427,2,416
283,7,10,73.9091156462585,75.2326530612245,41,38,57,1,3
284,7,229,73.9091156462585,75.4184126984127,41,31,231,2,222
285,7,210,73.9091156462585,76.41687074829932,41,32,230,3,203
286,7,416,73.9091156462585,75.25587301587302,41,22,413,1,409
287,7,423,73.9091156462585,75.27909297052155,41,23,420,1,416
288,10,5,75.2326530612245,77.06702947845805,38,40,79,2,5
289,10,5,75.2326530612245,77.50820861678005,38,40,98,2,5
290,10,210,75.2326530612245,76.41687074829932,38,32,206,1,200
291,10,419,75.2326530612245,76.97414965986394,38,20,416,2,409
292,7,5,76.11501133786848,77.50820861678005,39,40,60,1,2
293,7,39,76.11501133786848,78.73886621315192,39,38,117,3,32
294,7,408,76.11501133786848,78.25124716553289,39,20,411,2,401
295,7,403,76.11501133786848,78.85496598639456,39,19,413,3,396
296,7,444,76.11501133786848,78.22802721088435,39,15,446,2,437
297,5,39,77.06702947845805,78.73886621315192,40,38,80,2,34
298,5,19,77.06702947845805,80.01596371882086,40,36,128,3,14
299,5,408,77.06702947845805,78.25124716553289,40,20,406,1,403
300,5,403,77.06702947845805,78.85496598639456,40,19,405,2,398
301,5,211,77.06702947845805,79.87664399092971,40,17,239,3,206
302,5,444,77.06702947845805,78.22802721088435,40,15,442,1,439
303,5,39,77.50820861678005,78.73886621315192,40,38,63,1,34
304,5,19,77.50820861678005,80.01596371882086,40,36,109,3,14
305,5,403,77.50820861678005,78.85496598639456,40,19,402,1,398
306,5,211,77.50820861678005,79.87664399092971,40,17,230,2,206
307,39,19,78.73886621315192,80.01596371882086,38,36,59,1,20
308,39,19,78.73886621315192,80.96798185941043,38,36,98,2,20
309,39,211,78.73886621315192,79.87664399092971,38,17,179,1,172
310,39,211,78.73886621315192,80.75900226757369,38,16,193,2,172
311,19,24,80.01596371882086,82.17541950113379,36,36,93,2,5
312,19,23,80.01596371882086,82.52371882086167,36,38,108,3,4
313,19,244,80.01596371882086,81.92,36,23,239,2,225
314,19,442,80.01596371882086,81.89678004535148,36,13,431,2,423
315,19,24,80.96798185941043,82.17541950113379,36,36,52,1,5
316,19,23,80.96798185941043,82.52371882086167,36,38,67,2,4
317,19,23,80.96798185941043,83.84725623582767,36,40,124,3,4
318,19,401,80.96798185941043,83.15065759637189,36,26,393,2,382
319,19,412,80.96798185941043,83.15065759637189,36,20,404,2,393
320,24,23,82.17541950113379,83.84725623582767,36,40,72,2,1
321,24,45,82.17541950113379,84.98503401360544,36,39,123,3,21
322,24,320,82.17541950113379,84.07945578231293,36,22,307,2,296
323,24,205,82.17541950113379,84.89215419501134,36,27,216,3,181
324,23,45,82.52371882086167,84.98503401360544,38,39,108,2,22
325,23,320,82.52371882086167,84.07945578231293,38,22,304,2,297
326,23,205,82.52371882086167,84.89215419501134,38,27,209,2,182
327,23,228,82.52371882086167,85.40299319727892,38,26,240,3,205
328,23,45,83.84725623582767,84.98503401360544,40,39,54,1,22
329,23,5,83.84725623582767,85.89061224489797,40,39,90,2,18
330,23,7,83.84725623582767,86.7265306122449,40,38,125,3,16
331,23,205,83.84725623582767,84.89215419501134,40,27,187,1,182
332,23,228,83.84725623582767,85.40299319727892,40,26,216,2,205
333,23,515,83.84725623582767,86.12281179138323,40,19,502,2,492
334,23,515,83.84725623582767,86.6336507936508,40,14,506,3,492
335,45,7,84.98503401360544,86.7265306122449,39,38,84,2,38
336,45,6,84.98503401360544,87.58566893424036,39,39,119,3,39
337,45,231,84.98503401360544,87.05160997732426,39,26,206,2,186
338,45,227,84.98503401360544,87.60888888888888,39,26,214,3,182
339,45,515,84.98503401360544,86.12281179138323,39,19,473,1,470
340,45,515,84.98503401360544,86.6336507936508,39,14,475,2,470
341,45,424,84.98503401360544,87.81786848072562,39,15,398,3,379
342,5,6,85.89061224489797,87.58566893424036,39,39,73,2,1
343,5,231,85.89061224489797,87.05160997732426,39,26,231,1,226
344,5,227,85.89061224489797,87.60888888888888,39,26,234,2,222
345,5,208,85.89061224489797,88.72344671201814,39,25,237,3,203
346,5,424,85.89061224489797,87.81786848072562,39,15,427,2,419
347,5,416,85.89061224489797,88.72344671201814,39,18,429,3,411
348,7,10,86.7265306122449,88.90920634920636,38,38,94,2,3
349,7,208,86.7265306122449,88.72344671201814,38,25,219,2,201
350,7,424,86.7265306122449,87.81786848072562,38,15,420,1,417
351,7,416,86.7265306122449,88.72344671201814,38,18,418,2,409
352,7,413,86.7265306122449,89.65224489795918,38,18,425,3,406
353,6,10,87.58566893424036,88.90920634920636,39,38,57,1,4
354,6,25,87.58566893424036,90.20952380952382,39,39,115,3,19
355,6,208,87.58566893424036,88.72344671201814,39,25,208,1,202
356,6,232,87.58566893424036,89.83800453514739,39,28,246,2,226
357,6,416,87.58566893424036,88.72344671201814,39,18,413,1,410
358,6,413,87.58566893424036,89.65224489795918,39,18,417,2,407
359,10,25,88.90920634920636,90.20952380952382,38,39,58,1,15
360,10,31,88.90920634920636,90.92934240362813,38,40,89,2,21
361,10,211,88.90920634920636,91.16154195011337,38,28,223,2,201
362,25,7,90.20952380952382,91.99746031746032,39,39,79,2,18
363,25,18,90.20952380952382,92.43863945578231,39,40,96,2,7
364,25,272,90.20952380952382,92.16,39,25,261,2,247
365,25,215,90.20952380952382,92.64761904761905,39,27,217,2,190
366,25,418,90.20952380952382,92.67083900226757,39,20,407,2,393
367,31,7,90.92934240362813,91.99746031746032,40,39,52,1,24
368,31,18,90.92934240362813,92.43863945578231,40,40,66,2,13
369,31,6,90.92934240362813,93.7621768707483,40,39,125,3,25
370,31,272,90.92934240362813,92.16,40,25,247,1,241
371,31,215,90.92934240362813,92.64761904761905,40,27,198,2,184
372,31,230,90.92934240362813,93.55319727891157,40,21,229,3,199
373,31,418,90.92934240362813,92.67083900226757,40,20,394,2,387
374,7,6,91.99746031746032,93.7621768707483,39,39,76,2,1
375,7,230,91.99746031746032,93.55319727891157,39,21,233,2,223
376,18,6,92.43863945578231,93.7621768707483,40,39,58,1,12
377,18,7,92.43863945578231,94.64453514739229,40,38,96,2,11
378,18,230,92.43863945578231,93.55319727891157,40,21,217,1,212
379,18,232,92.43863945578231,95.15537414965986,40,25,244,3,214
380,6,10,93.7621768707483,95.52689342403629,39,39,76,2,4
381,6,232,93.7621768707483,95.15537414965986,39,25,234,1,226
382,6,222,93.7621768707483,96.17705215419501,39,22,240,2,216
383,6,230,93.7621768707483,96.4324716553288,39,23,252,3,224
384,7,6,94.64453514739229,97.29160997732427,38,39,114,3,1
385,7,222,94.64453514739229,96.17705215419501,38,22,225,2,215
386,7,230,94.64453514739229,96.4324716553288,38,23,236,2,223
387,10,6,95.52689342403629,97.29160997732427,39,39,76,2,4
388,10,4,95.52689342403629,98.24362811791383,39,39,117,3,6
389,10,256,95.52689342403629,98.10430839002268,39,25,270,3,246
390,10,217,95.52689342403629,98.40616780045352,39,25,241,3,207
391,6,217,97.29160997732427,98.40616780045352,39,25,216,1,211
392,6,207,97.29160997732427,99.96190476190476,39,30,232,3,201
393,6,433,97.29160997732427,98.63836734693878,39,17,431,1,427
394,4,6,98.24362811791383,99.49750566893424,39,39,54,1,2
395,4,207,98.24362811791383,99.96190476190476,39,30,216,2,203
396,6,4,98.61514739229025,100.89070294784581,37,38,98,2,2
397,6,207,98.61514739229025,99.96190476190476,37,30,209,1,201
398,6,227,98.61514739229025,101.28544217687075,37,25,249,3,221
399,6,4,99.49750566893424,100.89070294784581,39,38,60,1,2
400,6,227,99.49750566893424,101.28544217687075,39,25,234,2,221
401,6,256,99.49750566893424,101.63374149659865,39,26,266,2,250
402,4,6,100.89070294784581,102.14458049886622,38,38,54,1,2
403,4,6,100.89070294784581,102.5857596371882,38,40,73,2,2
404,4,7,100.89070294784581,103.4681179138322,38,38,111,3,3
405,4,234,100.89070294784581,103.23591836734694,38,23,251,2,230
406,4,415,100.89070294784581,103.4681179138322,38,18,426,3,411
407,6,7,102.14458049886622,103.4681179138322,38,38,57,1,1
408,6,234,102.14458049886622,103.23591836734694,38,23,233,1,228
409,6,236,102.14458049886622,104.14149659863946,38,29,246,2,230
410,6,375,102.14458049886622,104.69877551020409,38,27,385,3,369
411,6,415,102.14458049886622,103.4681179138322,38,18,413,1,409
412,6,410,102.14458049886622,104.79165532879819,38,21,420,3,404
413,6,7,102.5857596371882,105.23283446712018,40,38,114,3,1
414,6,236,102.5857596371882,104.14149659863946,40,29,240,2,230
415,6,375,102.5857596371882,104.69877551020409,40,27,380,2,369
416,6,410,102.5857596371882,104.79165532879819,40,21,415,2,404
417,7,5,103.4681179138322,106.18485260770976,38,39,117,3,2
418,7,375,103.4681179138322,104.69877551020409,38,27,372,1,368
419,7,247,103.4681179138322,106.27773242630386,38,24,269,3,240
420,7,410,103.4681179138322,104.79165532879819,38,21,407,1,403
421,7,4,105.23283446712018,107.06721088435374,38,39,79,2,3
422,7,10,105.23283446712018,107.87990929705215,38,38,114,3,3
423,7,247,105.23283446712018,106.27773242630386,38,24,244,1,240
424,7,343,105.23283446712018,106.81179138321995,38,27,343,2,336
425,7,461,105.23283446712018,106.64925170068028,38,19,458,1,454
426,5,10,106.18485260770976,107.87990929705215,39,38,73,2,5
427,5,254,106.18485260770976,108.2746485260771,39,26,265,2,249
428,5,256,106.18485260770976,108.55328798185941,39,26,271,2,251
429,4,6,107.06721088435374,109.20344671201815,39,40,92,2,2
430,4,5,107.06721088435374,109.69106575963718,39,36,113,3,1
431,4,254,107.06721088435374,108.2746485260771,39,26,255,1,250
432,4,256,107.06721088435374,108.55328798185941,39,26,260,1,252
433,10,6,107.87990929705215,109.20344671201815,38,40,57,1,4
434,10,5,107.87990929705215,109.69106575963718,38,36,78,2,5
435,10,254,107.87990929705215,110.38766439909297,38,25,267,3,244
436,10,227,107.87990929705215,110.5966439909297,38,26,247,3,217
437,10,465,107.87990929705215,110.06258503401361,38,14,465,2,455
438,10,425,107.87990929705215,110.5966439909297,38,19,431,3,415
439,6,7,109.20344671201815,111.40934240362812,40,38,95,2,1
440,6,254,109.20344671201815,110.38766439909297,40,25,253,1,248
441,6,227,109.20344671201815,110.5966439909297,40,26,229,1,221
442,6,425,109.20344671201815,110.5966439909297,40,19,423,1,419
443,5,7,109.69106575963718,111.40934240362812,36,38,74,2,2
444,5,4,109.69106575963718,112.36136054421769,36,38,115,3,1
445,5,405,109.69106575963718,112.36136054421769,36,26,416,3,400
446,5,410,109.69106575963718,112.40780045351474,36,19,422,3,405
447,5,410,109.69106575963718,112.43102040816326,36,19,422,3,405
448,7,4,111.40934240362812,112.80253968253969,38,39,60,1,3
449,7,4,111.40934240362812,114.12607709750567,38,38,117,3,3
450,7,253,111.40934240362812,113.38303854875284,38,24,260,2,246
451,7,211,111.40934240362812,114.19573696145125,38,27,237,3,204
452,7,410,111.40934240362812,112.43102040816326,38,19,405,1,403
453,4,6,112.36136054421769,114.93877551020408,38,39,111,3,2
454,4,253,112.36136054421769,113.38303854875284,38,24,253,1,249
455,4,211,112.36136054421769,114.19573696145125,38,27,222,2,207
456,4,6,112.80253968253969,114.93877551020408,39,39,92,2,2
457,4,211,112.80253968253969,114.19573696145125,39,27,216,1,207
458,4,249,112.80253968253969,115.4031746031746,39,18,269,3,245
459,4,7,114.12607709750567,116.70349206349206,38,39,111,3,3
460,4,249,114.12607709750567,115.4031746031746,38,18,251,1,245
461,4,363,114.12607709750567,116.26231292517006,38,21,371,2,359
462,4,211,114.12607709750567,116.58739229024944,38,32,233,2,207
463,6,4,114.93877551020408,116.33197278911565,39,38,60,1,2
464,6,7,114.93877551020408,116.70349206349206,39,39,76,2,1
465,6,10,114.93877551020408,117.58585034013606,39,38,114,3,4
466,6,363,114.93877551020408,116.26231292517006,39,21,362,1,357
467,6,211,114.93877551020408,116.58739229024944,39,32,217,2,205
468,6,216,114.93877551020408,117.84126984126985,39,29,244,3,210
469,6,423,114.93877551020408,117.63229024943311,39,23,433,3,417
470,4,10,116.33197278911565,117.58585034013606,38,38,54,1,6
471,4,216,116.33197278911565,117.84126984126985,38,29,222,2,212
472,4,209,116.33197278911565,118.79328798185941,38,32,231,2,205
473,4,423,116.33197278911565,117.63229024943311,38,23,423,1,419
474,7,4,116.70349206349206,119.42022675736962,39,39,117,3,3
475,7,216,116.70349206349206,117.84126984126985,39,29,215,1,209
476,7,209,116.70349206349206,118.79328798185941,39,32,221,2,202
477,10,4,117.58585034013606,119.42022675736962,38,39,79,2,6
478,10,4,117.58585034013606,119.8381859410431,38,38,97,2,6
479,10,209,117.58585034013606,118.79328798185941,38,32,206,1,199
480,10,249,117.58585034013606,120.44190476190477,38,26,269,3,239
481,10,258,117.58585034013606,120.51156462585034,38,26,278,3,248
482,4,10,119.42022675736962,120.67410430839003,39,39,54,1,6
483,4,6,119.42022675736962,121.99764172335601,39,40,111,3,2
484,4,249,119.42022675736962,120.44190476190477,39,26,249,1,245
485,4,258,119.42022675736962,120.51156462585034,39,26,258,1,254
486,4,253,119.42022675736962,122.06730158730159,39,25,274,3,249
487,4,410,119.42022675736962,121.16172335600908,39,19,413,2,406
488,4,6,119.8381859410431,121.99764172335601,38,40,93,2,2
489,4,253,119.8381859410431,122.06730158730159,38,25,267,2,249
490,4,410,119.8381859410431,121.16172335600908,38,19,410,1,406
491,4,426,119.8381859410431,122.76390022675737,38,15,440,3,422
492,10,6,120.67410430839003,121.99764172335601,39,40,57,1,4
493,10,51,120.67410430839003,122.99609977324263,39,38,108,2,41
494,10,253,120.67410430839003,122.06730158730159,39,25,250,1,243
495,10,228,120.67410430839003,122.97287981859411,39,22,239,2,218
496,10,226,120.67410430839003,123.57659863945578,39,23,250,3,216
497,10,426,120.67410430839003,122.76390022675737,39,15,426,2,416
498,6,5,121.99764172335601,123.80879818594104,40,37,78,2,1
499,6,226,121.99764172335601,123.57659863945578,40,23,230,2,220
500,6,425,121.99764172335601,124.71437641723357,40,19,435,3,419
501,51,6,122.99609977324263,125.08589569160998,38,38,101,2,45
502,51,7,122.99609977324263,125.52707482993198,38,39,118,3,44
503,51,228,122.99609977324263,125.17877551020409,38,24,200,2,177
504,51,425,122.99609977324263,124.71437641723357,38,19,381,2,374
505,51,422,122.99609977324263,125.5502947845805,38,17,387,3,371
506,5,6,123.80879818594104,125.08589569160998,37,38,55,1,1
507,5,7,123.80879818594104,125.52707482993198,37,39,74,2,2
508,5,228,123.80879818594104,125.17877551020409,37,24,231,1,223
509,5,406,123.80879818594104,126.20045351473924,37,23,414,2,401
510,5,422,123.80879818594104,125.5502947845805,37,17,424,2,417
511,5,412,123.80879818594104,126.57197278911565,37,16,424,3,407
512,6,4,125.08589569160998,126.92027210884353,38,39,79,2,2
513,6,406,125.08589569160998,126.20045351473924,38,23,403,1,400
514,6,218,125.08589569160998,127.47755102040817,38,21,236,2,212
515,6,412,125.08589569160998,126.57197278911565,38,16,411,1,406
516,7,4,125.52707482993198,126.92027210884353,39,39,60,1,3
517,7,218,125.52707482993198,127.47755102040817,39,21,227,2,211
518,7,215,125.52707482993198,128.220589569161,39,27,238,3,208
519,7,412,125.52707482993198,126.57197278911565,39,16,407,1,405
520,4,7,126.92027210884353,128.17414965986396,39,39,54,1,3
521,4,7,126.92027210884353,128.61532879818594,39,38,73,2,3
522,4,215,126.92027210884353,128.220589569161,39,27,218,1,211
523,4,385,126.92027210884353,128.52244897959184,39,23,387,2,381
524,4,228,126.92027210884353,129.75310657596373,39,24,255,3,224
525,7,4,128.17414965986396,130.0085260770975,39,39,79,2,3
526,7,228,128.17414965986396,129.75310657596373,39,24,231,2,221
527,7,211,128.17414965986396,130.70512471655329,39,28,231,3,204
528,7,422,128.17414965986396,130.65868480725624,39,21,429,2,415
529,7,4,128.61532879818594,130.0085260770975,38,39,60,1,3
530,7,228,128.61532879818594,129.75310657596373,38,24,226,1,221
531,7,211,128.61532879818594,130.70512471655329,38,28,223,2,204
532,7,422,128.61532879818594,130.65868480725624,38,21,424,2,415
533,4,10,130.0085260770975,131.70358276643992,39,38,73,2,6
534,4,230,130.0085260770975,131.79646258503402,39,30,239,2,226
535,4,214,130.0085260770975,132.81814058956917,39,33,242,3,210
536,4,431,130.0085260770975,131.79646258503402,39,19,434,2,427
537,7,6,130.82122448979592,133.0271201814059,40,38,95,2,1
538,7,214,130.82122448979592,132.81814058956917,40,33,224,2,207
539,7,227,130.82122448979592,133.51473922902494,40,25,249,3,220
540,7,419,130.82122448979592,133.44507936507938,40,15,427,3,412
541,10,6,131.70358276643992,133.0271201814059,38,38,57,1,4
542,10,5,131.70358276643992,134.42031746031745,38,40,117,3,5
543,10,214,131.70358276643992,132.81814058956917,38,33,210,1,204
544,10,227,131.70358276643992,133.51473922902494,38,25,231,2,217
545,10,419,131.70358276643992,133.44507936507938,38,15,416,2,409
546,6,5,133.0271201814059,134.42031746031745,38,40,60,1,1
547,6,5,133.0271201814059,135.0704761904762,38,40,88,2,1
548,6,407,133.0271201814059,135.27945578231294,38,21,413,2,401
549,6,214,133.0271201814059,135.58131519274377,38,23,235,3,208
550,5,7,134.42031746031745,136.11537414965986,40,39,73,2,2
551,5,4,134.42031746031745,137.06739229024944,40,39,114,3,1
552,5,214,134.42031746031745,135.58131519274377,40,23,215,1,209
553,5,345,134.42031746031745,137.0209523809524,40,24,358,3,340
554,5,478,134.42031746031745,136.78875283446712,40,19,484,2,473
555,5,7,135.0704761904762,136.11537414965986,40,39,45,1,2
556,5,4,135.0704761904762,137.06739229024944,40,39,86,2,1
557,5,6,135.0704761904762,137.88009070294785,40,39,121,3,1
558,5,345,135.0704761904762,137.0209523809524,40,24,350,2,340
559,5,230,135.0704761904762,137.60145124716553,40,26,250,3,225
560,5,478,135.0704761904762,136.78875283446712,40,19,479,2,473
561,7,6,136.11537414965986,137.88009070294785,39,39,76,2,1
562,7,4,136.11537414965986,138.8321088435374,39,39,117,3,3
563,7,230,136.11537414965986,137.60145124716553,39,26,232,1,223
564,7,410,136.11537414965986,138.32126984126984,39,22,414,2,403
565,4,7,137.06739229024944,139.64480725623582,39,39,111,3,3
566,4,229,137.06739229024944,139.43582766439908,39,23,247,2,225
567,4,410,137.06739229024944,138.32126984126984,39,22,410,1,406
568,4,424,137.06739229024944,139.2500680272109,39,20,430,2,420
569,6,7,137.88009070294785,139.64480725623582,39,39,76,2,1
570,6,4,137.88009070294785,140.5968253968254,39,39,117,3,2
571,6,229,137.88009070294785,139.43582766439908,39,23,233,2,223
572,6,230,137.88009070294785,140.13242630385488,39,26,244,2,224
573,6,424,137.88009070294785,139.2500680272109,39,20,422,1,418
574,6,461,137.88009070294785,140.10920634920635,39,16,465,2,455
575,4,230,138.8321088435374,140.13242630385488,39,26,233,1,226
576,4,300,138.8321088435374,140.99156462585034,39,23,310,2,296
577,4,461,138.8321088435374,140.10920634920635,39,16,460,1,457
578,4,428,138.8321088435374,141.17732426303854,39,14,436,2,424
579,7,23,139.64480725623582,141.96680272108844,39,39,101,2,16
580,7,300,139.64480725623582,140.99156462585034,39,23,299,1,293
581,7,351,139.64480725623582,141.8274829931973,39,22,357,2,344
582,7,428,139.64480725623582,141.17732426303854,39,14,426,2,421
583,7,465,139.64480725623582,141.8274829931973,39,15,468,2,458
584,4,23,140.5968253968254,141.96680272108844,39,39,62,1,19
585,4,22,140.5968253968254,143.15102040816328,39,37,111,3,18
586,4,351,140.5968253968254,141.8274829931973,39,22,351,1,347
587,4,205,140.5968253968254,143.19746031746033,39,17,230,3,201
588,4,465,140.5968253968254,141.8274829931973,39,15,464,1,461
589,23,22,141.96680272108844,143.15102040816328,39,37,51,1,1
590,23,205,141.96680272108844,143.19746031746033,39,17,190,1,182
591,23,223,141.96680272108844,144.10303854875283,39,22,220,2,200
592,22,23,143.15102040816328,144.47455782312926,37,37,57,1,1
593,22,23,143.15102040816328,145.10149659863947,37,37,84,2,1
594,22,222,143.15102040816328,145.0550566893424,37,20,216,2,200
595,22,211,143.15102040816328,146.0302947845805,37,16,226,3,189
596,23,43,144.47455782312926,146.51791383219955,37,35,90,2,20
597,23,45,144.47455782312926,147.4467120181406,37,36,130,3,22
598,23,211,144.47455782312926,146.0302947845805,37,16,200,2,188
599,23,205,144.47455782312926,147.42349206349206,37,22,222,3,182
600,23,43,145.10149659863947,146.51791383219955,37,35,64,1,20
601,23,45,145.10149659863947,147.4467120181406,37,36,103,2,22
602,23,45,145.10149659863947,147.65569160997734,37,38,112,3,22
603,23,205,145.10149659863947,147.42349206349206,37,22,208,2,182
604,23,428,145.10149659863947,147.49315192743765,37,15,418,2,405
605,43,45,146.51791383219955,147.65569160997734,35,38,49,1,2
606,43,52,146.51791383219955,148.83990929705215,35,39,100,2,9
607,43,224,146.51791383219955,148.5380498866213,35,26,201,2,181
608,43,229,146.51791383219955,148.6077097505669,35,30,207,2,186
609,43,481,146.51791383219955,148.09687074829932,35,14,443,2,438
610,45,52,147.4467120181406,148.83990929705215,36,39,60,1,7
611,45,6,147.4467120181406,150.23310657596372,36,39,126,3,39
612,45,224,147.4467120181406,148.5380498866213,36,26,185,1,179
613,45,229,147.4467120181406,148.6077097505669,36,30,191,1,184
614,45,252,147.4467120181406,150.02412698412698,36,19,235,3,207
615,45,515,147.4467120181406,149.65260770975058,36,18,480,2,470
616,45,52,147.65569160997734,148.83990929705215,38,39,51,1,7
617,45,6,147.65569160997734,150.23310657596372,38,39,118,3,39
618,45,252,147.65569160997734,150.02412698412698,38,19,231,2,207
619,45,515,147.65569160997734,149.65260770975058,38,18,478,2,470
620,52,6,148.83990929705215,150.23310657596372,39,39,76,1,46
621,52,6,148.83990929705215,151.11546485260772,39,39,108,2,46
622,52,252,148.83990929705215,150.02412698412698,39,19,206,1,200
623,52,205,148.83990929705215,150.90648526077098,39,24,177,2,153
624,52,472,148.83990929705215,151.11546485260772,39,14,431,2,420
625,6,60,150.23310657596372,152.92662131519273,39,38,128,3,54
626,6,229,150.23310657596372,151.9049433106576,39,22,234,2,223
627,6,336,150.23310657596372,152.69442176870749,39,28,347,2,330
628,6,483,150.23310657596372,152.41578231292516,39,14,486,2,477
629,6,60,151.11546485260772,152.92662131519273,39,38,95,2,54
630,6,336,151.11546485260772,152.69442176870749,39,28,337,2,330
631,6,351,151.11546485260772,153.99473922902496,39,26,367,3,345
632,6,483,151.11546485260772,152.41578231292516,39,14,480,1,477
633,6,351,151.9978231292517,153.99473922902496,38,26,356,2,345
634,60,6,152.92662131519273,154.2037188208617,38,38,77,1,54
635,60,4,152.92662131519273,155.364716553288,38,41,119,2,56
636,60,351,152.92662131519273,153.99473922902496,38,26,295,1,291
637,60,354,152.92662131519273,155.57369614512473,38,27,315,3,294
638,60,250,152.92662131519273,155.73623582766442,38,26,225,3,190
639,60,541,152.92662131519273,154.18049886621316,38,14,484,1,481
640,60,432,152.92662131519273,155.06285714285715,38,22,383,2,372
641,6,4,154.2037188208617,155.364716553288,38,41,50,1,2
642,6,4,154.2037188208617,156.47927437641724,38,41,98,2,2
643,6,58,154.2037188208617,156.64181405895692,38,38,117,2,52
644,6,354,154.2037188208617,155.57369614512473,38,27,353,1,348
645,6,250,154.2037188208617,155.73623582766442,38,26,253,2,244
646,6,223,154.2037188208617,156.64181405895692,38,22,241,2,217
647,6,461,154.2037188208617,156.06131519274376,38,19,462,2,455
648,4,58,155.364716553288,156.64181405895692,41,38,77,1,54
649,4,5,155.364716553288,158.2439909297052,41,38,124,3,1
650,4,223,155.364716553288,156.64181405895692,41,22,226,1,219
651,4,229,155.364716553288,158.2439909297052,41,29,257,3,225
652,4,427,155.364716553288,158.0350113378685,41,20,438,3,423
653,4,5,156.47927437641724,158.2439909297052,41,38,76,2,1
654,4,17,156.47927437641724,159.26566893424035,41,34,121,3,13
655,4,229,156.47927437641724,158.2439909297052,41,29,237,2,225
656,4,427,156.47927437641724,158.0350113378685,41,20,428,2,423
657,58,5,156.64181405895692,158.2439909297052,38,38,87,2,53
658,58,17,156.64181405895692,159.26566893424035,38,34,120,3,41
659,58,229,156.64181405895692,158.2439909297052,38,29,184,2,171
660,58,299,156.64181405895692,159.54430839002268,38,24,271,3,241
661,58,427,156.64181405895692,158.0350113378685,38,20,374,1,369
662,58,483,156.64181405895692,159.4746485260771,38,18,442,3,425
663,5,17,158.2439909297052,159.26566893424035,38,34,46,1,12
664,5,4,158.2439909297052,160.0087074829932,38,40,76,2,1
665,5,299,158.2439909297052,159.54430839002268,38,24,299,1,294
666,5,208,158.2439909297052,160.58920634920636,38,30,227,2,203
667,5,483,158.2439909297052,159.4746485260771,38,18,481,1,478
668,5,411,158.2439909297052,160.61242630385487,38,25,419,2,406
669,5,411,158.2439909297052,160.6356462585034,38,22,419,2,406
670,17,4,159.26566893424035,161.6108843537415,34,37,102,2,13
671,17,54,159.26566893424035,161.93596371882086,34,37,121,3,37
672,17,208,159.26566893424035,160.58920634920636,34,30,199,1,191
673,17,299,159.26566893424035,161.58766439909297,34,24,299,2,282
674,17,411,159.26566893424035,160.61242630385487,34,25,398,1,394
675,17,411,159.26566893424035,160.6356462585034,34,22,398,1,394
676,17,415,159.26566893424035,161.7037641723356,34,22,412,2,398
677,4,54,160.0087074829932,161.93596371882086,40,37,97,2,50
678,4,299,160.0087074829932,161.58766439909297,40,24,303,2,295
679,4,278,160.0087074829932,162.44680272108843,40,22,293,2,274
680,4,415,160.0087074829932,161.7037641723356,40,22,417,2,411
681,4,244,161.6108843537415,163.49170068027212,37,31,253,2,240
682,4,381,161.6108843537415,164.0954195011338,37,26,392,2,377
683,4,419,161.6108843537415,164.11863945578233,37,24,429,3,415
684,54,4,161.93596371882086,163.53814058956917,37,38,85,2,50
685,54,4,161.93596371882086,163.6542403628118,37,35,89,2,50
686,54,244,161.93596371882086,163.49170068027212,37,31,201,2,190
687,54,381,161.93596371882086,164.0954195011338,37,26,340,2,327
688,54,535,161.93596371882086,163.32916099773243,37,25,485,1,481
689,54,419,161.93596371882086,164.11863945578233,37,24,377,2,365
690,4,62,163.53814058956917,165.2564172335601,38,39,94,2,58
691,4,61,163.53814058956917,165.65115646258505,38,36,107,2,57
692,4,240,163.53814058956917,165.34929705215418,38,24,249,2,236
693,4,256,163.53814058956917,165.99945578231294,38,26,273,2,252
694,4,422,163.53814058956917,165.92979591836735,38,20,431,2,418
695,4,62,163.6542403628118,165.2564172335601,35,39,90,2,58
696,4,61,163.6542403628118,165.65115646258505,35,36,103,2,57
697,4,240,163.6542403628118,165.34929705215418,35,24,247,2,236
698,4,256,163.6542403628118,165.99945578231294,35,26,271,2,252
699,4,422,163.6542403628118,165.92979591836735,35,20,429,2,418
700,62,5,165.2564172335601,167.06757369614513,39,39,97,2,57
701,62,210,165.2564172335601,167.5784126984127,39,34,179,2,148
702,62,212,165.2564172335601,168.18213151927438,39,32,196,3,150
703,62,423,165.2564172335601,167.06757369614513,39,22,369,2,361
704,61,5,165.65115646258505,167.06757369614513,36,39,83,1,56
705,61,5,165.65115646258505,168.36789115646258,36,39,130,3,56
706,61,210,165.65115646258505,167.5784126984127,36,34,171,2,149
707,61,212,165.65115646258505,168.18213151927438,36,32,186,3,151
708,61,423,165.65115646258505,167.06757369614513,36,22,367,1,362
709,61,470,165.65115646258505,168.29823129251702,36,17,425,3,409
710,5,212,167.06757369614513,168.18213151927438,39,32,212,1,207
711,5,218,167.06757369614513,168.7161904761905,39,25,225,2,213
712,5,248,167.06757369614513,169.76108843537415,39,20,269,3,243
713,5,470,167.06757369614513,168.29823129251702,39,17,468,1,465
714,5,248,168.36789115646258,169.76108843537415,39,20,250,1,243
715,5,342,168.36789115646258,171.13106575963718,39,26,357,3,337
716,5,58,169.48244897959185,171.64190476190475,40,40,107,2,53
717,5,4,169.48244897959185,172.36172335600907,40,38,124,3,1
718,5,342,169.48244897959185,171.13106575963718,40,26,344,2,337
719,5,439,169.48244897959185,171.82766439909298,40,16,446,2,434
720,5,58,170.5970068027211,171.64190476190475,39,40,70,1,53
721,5,4,170.5970068027211,172.36172335600907,39,38,76,2,1
722,5,6,170.5970068027211,172.7332426303855,39,37,92,2,1
723,5,211,170.5970068027211,172.52426303854875,39,18,222,2,206
724,5,230,170.5970068027211,173.22086167800452,39,22,252,3,225
725,5,439,170.5970068027211,171.82766439909298,39,16,437,1,434
726,5,458,170.5970068027211,172.80290249433108,39,20,463,2,453
727,58,6,171.64190476190475,172.7332426303855,40,37,70,1,52
728,58,4,171.64190476190475,174.12643990929706,40,37,120,2,54
729,58,230,171.64190476190475,173.22086167800452,40,22,185,2,172
730,58,228,171.64190476190475,174.56761904761905,40,23,212,3,170
731,58,458,171.64190476190475,172.80290249433108,40,20,403,1,400
732,4,228,172.36172335600907,174.56761904761905,38,23,243,2,224
733,6,4,172.7332426303855,174.12643990929706,37,37,60,1,2
734,6,228,172.7332426303855,174.56761904761905,37,23,236,2,222
735,6,252,172.7332426303855,175.61251700680273,37,24,275,3,246
736,6,410,172.7332426303855,175.403537414966,37,19,420,3,404
737,4,6,174.12643990929706,175.38031746031746,37,37,54,1,2
738,4,252,174.12643990929706,175.61251700680273,37,24,256,1,248
739,4,214,174.12643990929706,175.86793650793652,37,24,223,2,210
740,4,219,174.12643990929706,176.88961451247167,37,23,246,3,215
741,4,410,174.12643990929706,175.403537414966,37,19,410,1,406
742,4,410,174.12643990929706,175.96081632653062,37,19,414,2,406
743,6,4,175.38031746031746,177.65587301587303,37,37,98,2,2
744,6,219,175.38031746031746,176.88961451247167,37,23,223,2,213
745,4,6,175.89115646258503,178.02739229024942,37,37,92,2,2
746,4,241,175.89115646258503,178.60789115646259,37,27,264,3,237
747,4,61,177.65587301587303,179.60634920634922,37,38,102,2,57
748,4,6,177.65587301587303,179.79210884353742,37,37,92,2,2
749,4,354,177.65587301587303,179.420589569161,37,28,358,2,350
750,4,211,177.65587301587303,180.1171882086168,37,31,233,2,207
751,4,422,177.65587301587303,180.07074829931972,37,21,431,2,418
752,6,61,178.02739229024942,179.60634920634922,37,38,87,2,55
753,6,354,178.02739229024942,179.420589569161,37,28,353,1,348
754,6,211,178.02739229024942,180.1171882086168,37,31,224,2,205
755,6,422,178.02739229024942,180.07074829931972,37,21,425,2,416
756,61,4,179.60634920634922,181.185306122449,38,41,89,2,57
757,61,4,179.60634920634922,181.8354648526077,38,40,112,2,57
758,61,214,179.60634920634922,181.39428571428573,38,31,171,2,153
759,61,209,179.60634920634922,182.29986394557824,38,31,188,3,148
760,61,552,179.60634920634922,181.53360544217688,38,16,498,2,491
761,61,524,179.60634920634922,182.41596371882088,38,16,479,3,463
762,6,4,179.79210884353742,181.185306122449,37,41,60,1,2
763,6,4,179.79210884353742,181.8354648526077,37,40,88,2,2
764,6,214,179.79210884353742,181.39428571428573,37,31,219,2,208
765,6,209,179.79210884353742,182.29986394557824,37,31,230,3,203
766,4,6,181.185306122449,182.95002267573696,41,41,76,2,2
767,4,209,181.185306122449,182.29986394557824,41,31,211,1,205
768,4,227,181.185306122449,182.9035827664399,41,27,235,2,223
769,4,247,181.185306122449,183.83238095238096,41,24,268,3,243
770,4,459,181.185306122449,183.20544217687075,41,19,463,2,455
771,4,6,181.8354648526077,182.95002267573696,40,41,48,1,2
772,4,5,181.8354648526077,184.69151927437642,40,40,123,3,1
773,4,227,181.8354648526077,182.9035827664399,40,27,228,1,223
774,4,247,181.8354648526077,183.83238095238096,40,24,258,2,243
775,4,459,181.8354648526077,183.20544217687075,40,19,459,1,455
776,6,5,182.95002267573696,184.69151927437642,41,40,75,2,1
777,6,401,182.95002267573696,185.71319727891157,41,26,413,3,395
778,6,230,182.95002267573696,185.80607709750566,41,26,256,3,224
779,6,458,182.95002267573696,185.71319727891157,41,20,467,3,452
780,6,459,182.95002267573696,185.78285714285715,41,20,469,3,453
781,5,6,184.69151927437642,185.94539682539684,40,39,54,1,1
782,5,10,184.69151927437642,187.26893424036282,40,39,111,3,5
783,5,401,184.69151927437642,185.71319727891157,40,26,398,1,396
784,5,230,184.69151927437642,185.80607709750566,40,26,230,1,225
785,5,228,184.69151927437642,187.5243537414966,40,24,254,3,223
786,5,458,184.69151927437642,185.71319727891157,40,20,455,1,453
787,5,459,184.69151927437642,185.78285714285715,40,20,456,1,454
788,5,461,184.69151927437642,187.33859410430838,40,18,470,3,456
789,6,10,185.52743764172337,187.26893424036282,39,39,75,2,4
790,6,228,185.52743764172337,187.5243537414966,39,24,238,2,222
791,6,461,185.52743764172337,187.33859410430838,39,18,462,2,455
792,6,425,185.52743764172337,188.24417233560092,39,21,435,3,419
793,6,10,185.94539682539684,187.26893424036282,39,39,57,1,4
794,6,228,185.94539682539684,187.5243537414966,39,24,232,2,222
795,6,270,185.94539682539684,188.66213151927437,39,25,289,3,264
796,6,232,185.94539682539684,188.82467120181406,39,26,258,3,226
797,6,461,185.94539682539684,187.33859410430838,39,18,459,1,455
798,6,425,185.94539682539684,188.24417233560092,39,21,431,2,419
799,10,4,187.26893424036282,190.0088888888889,39,39,118,3,6
800,10,270,187.26893424036282,188.66213151927437,39,25,267,1,260
801,10,232,187.26893424036282,188.82467120181406,39,26,232,2,222
802,10,247,187.26893424036282,189.98566893424038,39,24,264,3,237
803,10,410,187.26893424036282,189.19619047619048,39,20,409,2,400
804,6,10,187.73333333333335,189.0336507936508,38,38,56,1,4
805,6,4,187.73333333333335,190.0088888888889,38,39,98,2,2
806,6,232,187.73333333333335,188.82467120181406,38,26,231,1,226
807,6,247,187.73333333333335,189.98566893424038,38,24,260,2,241
808,6,410,187.73333333333335,189.19619047619048,38,20,409,1,404
809,6,470,187.73333333333335,190.61260770975056,38,20,480,3,464
810,10,4,189.0336507936508,191.30920634920636,38,38,98,2,6
811,10,4,189.0336507936508,191.75038548752835,38,38,117,3,6
812,10,246,189.0336507936508,191.7271655328798,38,28,263,3,236
813,10,240,189.0336507936508,191.7968253968254,38,27,259,3,230
814,10,470,189.0336507936508,190.61260770975056,38,20,465,2,460
815,10,423,189.0336507936508,191.3556462585034,38,21,425,2,413
816,10,425,189.0336507936508,191.7968253968254,38,20,432,3,415
817,4,246,190.0088888888889,191.7271655328798,39,28,253,2,242
818,4,240,190.0088888888889,191.7968253968254,39,27,248,2,236
819,4,423,190.0088888888889,191.3556462585034,39,21,423,1,419
820,4,425,190.0088888888889,191.7968253968254,39,20,428,2,421
821,4,227,191.30920634920636,193.02748299319728,38,24,235,2,223
822,4,212,191.30920634920636,194.18848072562358,38,32,242,3,208
823,4,10,191.75038548752835,194.32780045351475,38,38,111,3,6
824,4,227,191.75038548752835,193.02748299319728,38,24,230,1,223
825,4,212,191.75038548752835,194.18848072562358,38,32,233,2,208
826,4,453,191.75038548752835,194.4903401360544,38,17,464,3,449
827,4,7,193.53832199546486,196.11573696145126,38,38,111,3,3
828,4,215,193.53832199546486,195.48879818594105,38,29,227,2,211
829,4,209,193.53832199546486,196.4175963718821,38,30,240,3,205
830,4,464,193.53832199546486,195.30303854875285,38,18,466,2,460
831,4,417,193.53832199546486,195.95319727891157,38,20,426,2,413
832,10,7,194.32780045351475,196.11573696145126,38,38,77,2,3
833,10,215,194.32780045351475,195.48879818594105,38,29,211,1,205
834,10,209,194.32780045351475,196.4175963718821,38,30,218,2,199
835,10,227,194.32780045351475,196.7891156462585,38,28,242,2,217
836,10,417,194.32780045351475,195.95319727891157,38,20,413,2,407
837,4,6,195.30303854875285,197.3928344671202,39,39,90,2,2
838,4,209,195.30303854875285,196.4175963718821,39,30,211,1,205
839,4,227,195.30303854875285,196.7891156462585,39,28,232,1,223
840,4,413,195.30303854875285,197.4857142857143,39,17,420,2,409
841,7,6,196.11573696145126,197.3928344671202,38,39,55,1,1
842,7,14,196.11573696145126,198.34485260770975,38,40,96,2,7
843,7,343,196.11573696145126,198.5538321995465,38,26,352,2,336
844,7,228,196.11573696145126,198.85569160997733,38,26,251,3,221
845,7,413,196.11573696145126,197.4857142857143,38,17,410,1,406
846,7,498,196.11573696145126,198.76281179138323,38,17,504,3,491
847,7,496,196.11573696145126,198.97179138321997,38,19,504,3,489
848,6,343,197.3928344671202,198.5538321995465,39,26,341,1,337
849,6,228,197.3928344671202,198.85569160997733,39,26,231,1,222
850,6,230,197.3928344671202,200.1792290249433,39,27,254,3,224
851,6,498,197.3928344671202,198.76281179138323,39,17,496,1,492
852,6,496,197.3928344671202,198.97179138321997,39,19,495,2,490
853,14,6,198.34485260770975,199.64517006802723,40,40,57,1,8
854,14,6,198.34485260770975,200.0863492063492,40,39,75,2,8
855,14,5,198.34485260770975,201.01514739229026,40,38,115,3,9
856,14,230,198.34485260770975,200.1792290249433,40,27,230,2,216
857,14,226,198.34485260770975,201.20090702947846,40,25,245,3,212
858,14,492,198.34485260770975,200.75972789115647,40,20,489,2,478
859,14,492,198.34485260770975,200.78294784580498,40,19,489,2,478
860,6,5,199.64517006802723,201.01514739229026,40,38,59,1,1
861,6,10,199.64517006802723,202.26902494331065,40,37,113,3,4
862,6,226,199.64517006802723,201.20090702947846,40,25,230,2,220
863,6,227,199.64517006802723,202.33868480725624,40,27,250,3,221
864,6,492,199.64517006802723,200.75972789115647,40,20,488,1,486
865,6,492,199.64517006802723,200.78294784580498,40,19,488,1,486
866,6,10,200.0863492063492,202.26902494331065,39,37,94,2,4
867,6,226,200.0863492063492,201.20090702947846,39,25,225,1,220
868,6,227,200.0863492063492,202.33868480725624,39,27,241,2,221
869,6,270,200.0863492063492,202.87274376417233,39,25,290,3,264
870,6,474,200.0863492063492,202.73342403628118,39,17,482,3,468
871,5,10,201.01514739229026,202.26902494331065,38,37,54,1,5
872,5,4,201.01514739229026,203.66222222222223,38,37,114,3,1
873,5,227,201.01514739229026,202.33868480725624,38,27,229,1,222
874,5,270,201.01514739229026,202.87274376417233,38,25,277,2,265
875,5,474,201.01514739229026,202.73342403628118,38,17,475,2,469
876,5,410,201.01514739229026,203.31392290249434,38,20,417,2,405
877,10,4,202.26902494331065,203.66222222222223,37,37,60,1,6
878,10,4,202.26902494331065,204.54458049886622,37,38,98,2,6
879,10,271,202.26902494331065,204.61424036281178,37,24,280,2,261
880,10,410,202.26902494331065,203.31392290249434,37,20,403,1,400
881,10,429,202.26902494331065,204.12662131519275,37,18,427,2,419
882,4,57,203.66222222222223,205.68235827664398,37,39,102,2,53
883,4,342,203.66222222222223,205.70557823129252,37,26,349,2,338
884,4,363,203.66222222222223,206.1467573696145,37,27,375,2,359
885,4,423,203.66222222222223,205.35727891156463,37,21,425,2,419
886,4,414,203.66222222222223,205.84489795918367,37,19,421,2,410
887,4,57,204.54458049886622,205.68235827664398,38,39,72,1,53
888,4,342,204.54458049886622,205.70557823129252,38,26,342,1,338
889,4,363,204.54458049886622,206.1467573696145,38,27,366,2,359
890,4,228,204.54458049886622,207.40063492063493,38,26,256,3,224
891,4,414,204.54458049886622,205.84489795918367,38,19,414,1,410
892,4,410,204.54458049886622,206.8433560090703,38,20,418,2,406
893,57,4,205.68235827664398,207.63283446712018,39,38,99,2,53
894,57,4,205.68235827664398,208.51519274376417,39,38,133,3,53
895,57,228,205.68235827664398,207.40063492063493,39,26,186,2,171
896,57,211,205.68235827664398,208.3526530612245,39,33,192,3,154
897,57,410,205.68235827664398,206.8433560090703,39,20,357,1,353
898,57,422,205.68235827664398,208.28299319727893,39,20,382,3,365
899,4,228,205.89133786848072,207.40063492063493,39,26,233,2,224
900,4,211,205.89133786848072,208.3526530612245,39,33,233,2,207
901,4,422,205.89133786848072,208.28299319727893,39,20,431,2,418
902,4,7,207.63283446712018,209.7690702947846,38,38,92,2,3
903,4,229,207.63283446712018,209.49043083900227,38,32,239,2,225
904,4,214,207.63283446712018,210.44244897959183,38,33,242,3,210
905,4,428,207.63283446712018,209.39755102040817,38,23,431,2,424
906,4,7,208.51519274376417,209.7690702947846,38,38,54,1,3
907,4,214,208.51519274376417,210.44244897959183,38,33,226,2,210
908,4,227,208.51519274376417,211.13904761904763,38,26,250,3,223
909,4,419,208.51519274376417,211.06938775510204,38,18,429,3,415
910,7,86,209.7690702947846,211.60344671201815,38,39,112,2,79
911,7,10,209.7690702947846,212.41614512471656,38,39,114,3,3
912,7,227,209.7690702947846,211.13904761904763,38,26,228,1,220
913,7,258,209.7690702947846,212.2768253968254,38,23,273,3,251
914,7,419,209.7690702947846,211.06938775510204,38,18,416,1,412
915,4,86,209.83873015873016,211.60344671201815,38,39,112,2,82
916,4,10,209.83873015873016,212.41614512471656,38,39,111,3,6
917,4,227,209.83873015873016,211.13904761904763,38,26,230,1,223
918,4,258,209.83873015873016,212.2768253968254,38,23,275,2,254
919,4,419,209.83873015873016,211.06938775510204,38,18,418,1,415
920,86,5,211.60344671201815,212.92698412698414,39,41,99,1,81
921,86,256,211.60344671201815,212.9037641723356,39,22,179,1,170
922,86,222,211.60344671201815,214.11120181405897,39,13,174,3,136
923,86,515,211.60344671201815,213.20562358276644,39,19,435,2,429
924,86,515,211.60344671201815,213.8557823129252,39,12,440,2,429
925,10,222,212.41614512471656,214.11120181405897,39,13,224,2,212
926,10,298,212.41614512471656,215.3882993197279,39,12,315,3,288
927,5,10,212.92698412698414,214.7845804988662,41,38,80,2,5
928,5,10,212.92698412698414,214.92390022675738,41,38,86,2,5
929,5,222,212.92698412698414,214.11120181405897,41,13,223,1,217
930,5,298,212.92698412698414,215.3882993197279,41,12,312,2,293
931,10,21,214.7845804988662,216.17777777777778,38,39,61,1,11
932,10,6,214.7845804988662,217.57097505668935,38,38,120,3,4
933,10,243,214.7845804988662,216.38675736961451,38,15,243,2,233
934,10,220,214.7845804988662,217.50131519274376,38,14,240,3,210
935,10,21,214.92390022675738,216.17777777777778,38,39,55,1,11
936,10,6,214.92390022675738,217.57097505668935,38,38,114,3,4
937,10,243,214.92390022675738,216.38675736961451,38,15,241,1,233
938,10,220,214.92390022675738,217.50131519274376,38,14,238,3,210
939,21,6,216.17777777777778,217.57097505668935,39,38,62,1,15
940,21,10,216.17777777777778,218.5926530612245,39,43,105,2,11
941,21,220,216.17777777777778,217.50131519274376,39,14,207,1,199
942,21,267,216.17777777777778,218.12825396825397,39,14,260,2,246
943,21,221,216.17777777777778,219.01061224489797,39,17,234,3,200
944,6,10,217.57097505668935,218.5926530612245,38,43,44,1,4
945,6,31,217.57097505668935,219.77687074829933,38,40,98,2,25
946,6,9,217.57097505668935,220.24126984126985,38,40,115,3,3
947,6,221,217.57097505668935,219.01061224489797,38,17,224,1,215
948,6,221,217.57097505668935,220.07873015873017,38,17,241,3,215
949,10,31,218.5926530612245,219.77687074829933,43,40,55,1,21
950,10,9,218.5926530612245,220.24126984126985,43,40,71,2,1
951,10,221,218.5926530612245,220.07873015873017,43,17,220,1,211
952,10,221,218.5926530612245,220.86820861678004,43,11,233,2,211
953,31,10,219.77687074829933,220.86820861678004,40,34,51,1,21
954,31,221,219.77687074829933,220.86820861678004,40,11,196,1,190
955,403,19,1.18421768707483,2.36843537414966,21,19,387,1,384
956,403,34,1.18421768707483,3.6687528344671203,21,19,384,2,369
957,397,14,4.760090702947846,6.060408163265306,12,30,387,1,383
958,403,9,8.219863945578231,9.961360544217687,20,38,401,2,394
959,403,6,8.219863945578231,10.402539682539683,20,38,408,2,397
960,403,211,8.219863945578231,9.961360544217687,20,17,206,2,192
961,403,211,8.219863945578231,10.193560090702949,20,16,210,2,192
962,403,541,8.219863945578231,9.496961451247167,20,15,149,1,138
963,403,538,8.219863945578231,10.379319727891156,20,14,164,2,135
964,403,641,8.219863945578231,9.729160997732427,20,16,247,2,238
965,403,642,8.219863945578231,10.170340136054422,20,14,253,2,239
966,403,825,8.219863945578231,9.752380952380953,20,10,427,2,422
967,211,7,9.961360544217687,11.72607709750567,17,38,218,2,204
968,211,6,9.961360544217687,12.60843537414966,17,39,235,3,205
969,211,266,9.961360544217687,11.54031746031746,17,17,87,2,55
970,211,237,9.961360544217687,12.631655328798185,17,16,118,3,26
971,211,524,9.961360544217687,11.261678004535147,17,15,318,1,313
972,211,638,9.961360544217687,11.49387755102041,17,14,432,2,427
973,211,680,9.961360544217687,12.376235827664399,17,14,480,2,469
974,211,7,10.193560090702949,11.72607709750567,16,38,214,2,204
975,211,6,10.193560090702949,12.60843537414966,16,39,230,2,205
976,211,266,10.193560090702949,11.54031746031746,16,17,80,1,55
977,211,237,10.193560090702949,12.631655328798185,16,16,108,2,26
978,211,524,10.193560090702949,11.261678004535147,16,15,316,1,313
979,211,524,10.193560090702949,13.02639455782313,16,16,336,3,313
980,211,638,10.193560090702949,11.49387755102041,16,14,431,1,427
981,211,680,10.193560090702949,12.376235827664399,16,14,478,2,469
982,266,6,11.54031746031746,12.60843537414966,17,39,264,1,260
983,266,7,11.54031746031746,13.490793650793652,17,38,272,2,259
984,266,10,11.54031746031746,14.349931972789117,17,38,283,3,256
985,266,237,11.54031746031746,12.631655328798185,17,16,55,1,29
986,266,211,11.54031746031746,13.722993197278912,17,17,109,2,55
987,266,235,11.54031746031746,14.210612244897959,17,16,119,3,31
988,266,524,11.54031746031746,13.02639455782313,17,16,266,1,258
989,266,529,11.54031746031746,13.908752834467121,17,14,282,2,263
990,266,689,11.54031746031746,13.25859410430839,17,14,429,2,423
991,237,10,12.631655328798185,14.349931972789117,16,38,239,2,227
992,237,4,12.631655328798185,15.32517006802721,16,40,260,3,233
993,237,211,12.631655328798185,13.722993197278912,16,17,54,1,26
994,237,235,12.631655328798185,14.210612244897959,16,16,68,2,2
995,237,211,12.631655328798185,15.464489795918368,16,16,125,3,26
996,237,529,12.631655328798185,13.908752834467121,16,14,297,1,292
997,237,524,12.631655328798185,14.791111111111112,16,15,302,2,287
998,237,425,12.631655328798185,15.603809523809524,16,13,227,3,188
999,237,641,12.631655328798185,14.582131519274377,16,14,413,2,404
1000,237,641,12.631655328798185,15.464489795918368,16,15,422,3,404
1001,211,4,13.722993197278912,15.32517006802721,17,40,218,2,207
1002,211,10,13.722993197278912,16.114648526077097,17,39,226,2,201
1003,211,524,13.722993197278912,14.791111111111112,17,15,316,1,313
1004,211,425,13.722993197278912,15.603809523809524,17,13,229,2,214
1005,211,523,13.722993197278912,16.555827664399093,17,15,335,3,312
1006,211,641,13.722993197278912,15.464489795918368,17,15,436,2,430
1007,211,641,13.722993197278912,16.34684807256236,17,15,445,3,430
1008,235,4,14.210612244897959,15.32517006802721,16,40,236,1,231
1009,235,10,14.210612244897959,16.114648526077097,16,39,239,2,225
1010,235,211,14.210612244897959,15.464489795918368,16,16,59,1,24
1011,235,211,14.210612244897959,16.23074829931973,16,17,90,2,24
1012,235,425,14.210612244897959,15.603809523809524,16,13,199,1,190
1013,235,523,14.210612244897959,16.555827664399093,16,15,305,2,288
1014,235,641,14.210612244897959,15.464489795918368,16,15,410,1,406
1015,235,641,14.210612244897959,16.34684807256236,16,15,416,2,406
1016,211,4,15.464489795918368,17.972244897959182,16,38,233,3,207
1017,211,271,15.464489795918368,17.949024943310658,16,18,123,2,60
1018,211,523,15.464489795918368,16.555827664399093,16,15,316,1,312
1019,211,424,15.464489795918368,17.34530612244898,16,13,228,2,213
1020,211,524,15.464489795918368,18.320544217687075,16,16,336,3,313
1021,211,640,15.464489795918368,17.670385487528346,16,14,439,2,429
1022,211,4,16.23074829931973,17.972244897959182,17,38,220,2,207
1023,211,4,16.23074829931973,18.854603174603174,17,39,236,3,207
1024,211,271,16.23074829931973,17.949024943310658,17,18,95,2,60
1025,211,299,16.23074829931973,19.040362811791383,17,17,150,3,88
1026,211,424,16.23074829931973,17.34530612244898,17,13,218,1,213
1027,211,524,16.23074829931973,18.320544217687075,17,16,326,2,313
1028,211,640,16.23074829931973,17.670385487528346,17,14,433,1,429
1029,211,641,16.23074829931973,18.993922902494333,17,15,446,3,430
1030,271,7,17.949024943310658,19.667301587301587,18,38,274,2,264
1031,271,4,17.949024943310658,20.59609977324263,18,40,290,3,267
1032,271,299,17.949024943310658,19.040362811791383,18,17,55,1,28
1033,271,213,17.949024943310658,19.89950113378685,18,17,102,2,58
1034,271,403,17.949024943310658,20.54965986394558,18,20,173,3,132
1035,271,473,17.949024943310658,19.99238095238095,18,15,220,2,202
1036,271,515,17.949024943310658,20.82829931972789,18,19,274,3,244
1037,271,641,17.949024943310658,18.993922902494333,18,15,373,1,370
1038,271,641,17.949024943310658,19.87628117913832,18,14,379,2,370
1039,299,4,19.040362811791383,20.59609977324263,17,40,303,2,295
1040,299,6,19.040362811791383,21.873197278911565,17,38,317,3,293
1041,299,403,19.040362811791383,20.54965986394558,17,20,123,2,104
1042,299,401,19.040362811791383,21.106938775510205,17,14,135,2,102
1043,299,515,19.040362811791383,20.82829931972789,17,19,229,2,216
1044,299,515,19.040362811791383,21.339138321995467,17,14,238,2,216
1045,213,6,19.89950113378685,21.873197278911565,17,38,224,2,207
1046,213,6,19.89950113378685,22.31437641723356,17,39,232,2,207
1047,213,401,19.89950113378685,21.106938775510205,17,14,195,1,188
1048,213,249,19.89950113378685,22.128616780045352,17,17,103,2,36
1049,213,515,19.89950113378685,21.339138321995467,17,14,308,1,302
1050,213,539,19.89950113378685,22.73233560090703,17,14,348,3,326
1051,213,659,19.89950113378685,22.639455782312925,17,18,461,3,446
1052,403,6,20.54965986394558,21.873197278911565,20,38,401,1,397
1053,403,6,20.54965986394558,22.31437641723356,20,39,404,2,397
1054,403,51,20.54965986394558,23.45215419501134,20,38,374,3,352
1055,403,249,20.54965986394558,22.128616780045352,20,17,168,2,154
1056,403,539,20.54965986394558,22.73233560090703,20,14,165,2,136
1057,403,659,20.54965986394558,22.639455782312925,20,18,271,2,256
1058,403,824,20.54965986394558,22.96453514739229,20,13,434,2,421
1059,401,6,21.106938775510205,22.31437641723356,14,39,398,1,395
1060,401,51,21.106938775510205,23.45215419501134,14,38,364,2,350
1061,401,249,21.106938775510205,22.128616780045352,14,17,158,1,152
1062,401,342,21.106938775510205,23.91655328798186,14,20,135,3,59
1063,401,539,21.106938775510205,22.73233560090703,14,14,155,2,138
1064,401,605,21.106938775510205,23.6843537414966,14,16,232,3,204
1065,401,659,21.106938775510205,22.639455782312925,14,18,266,2,258
1066,401,617,21.106938775510205,23.6843537414966,14,12,243,3,216
1067,401,824,21.106938775510205,22.96453514739229,14,13,430,2,423
1068,249,51,22.128616780045352,23.45215419501134,17,38,206,1,198
1069,249,6,22.128616780045352,24.961451247165535,17,39,272,3,243
1070,249,342,22.128616780045352,23.91655328798186,17,20,121,2,93
1071,249,387,22.128616780045352,25.031111111111112,17,23,186,3,138
1072,249,605,22.128616780045352,23.6843537414966,17,16,362,2,356
1073,249,410,22.128616780045352,25.031111111111112,17,15,204,3,161
1074,249,617,22.128616780045352,23.6843537414966,17,12,374,2,368
1075,249,641,22.128616780045352,24.729251700680273,17,14,408,3,392
1076,342,6,23.91655328798186,24.961451247165535,20,39,339,1,336
1077,342,10,23.91655328798186,25.820589569160997,20,38,342,2,332
1078,342,10,23.91655328798186,26.70294784580499,20,38,353,3,332
1079,342,387,23.91655328798186,25.031111111111112,20,23,66,1,45
1080,342,214,23.91655328798186,25.611609977324264,20,25,147,2,128
1081,342,227,23.91655328798186,26.795827664399095,20,23,169,3,115
1082,342,410,23.91655328798186,25.031111111111112,20,15,83,1,68
1083,342,613,23.91655328798186,25.843809523809526,20,16,283,2,271
1084,342,539,23.91655328798186,26.261768707482993,20,14,221,2,197
1085,342,646,23.91655328798186,25.98312925170068,20,15,317,2,304
1086,342,720,23.91655328798186,26.493968253968255,20,14,394,3,378
1087,387,10,25.031111111111112,26.70294784580499,23,38,384,2,377
1088,387,4,25.031111111111112,27.678185941043086,23,37,400,3,383
1089,387,227,25.031111111111112,26.795827664399095,23,23,177,2,160
1090,387,206,25.031111111111112,27.23700680272109,23,28,204,2,181
1091,387,539,25.031111111111112,26.261768707482993,23,14,161,1,152
1092,387,720,25.031111111111112,26.493968253968255,23,14,339,1,333
1093,387,662,25.031111111111112,27.376326530612246,23,18,293,2,275
1094,214,10,25.611609977324264,26.70294784580499,25,38,209,1,204
1095,214,4,25.611609977324264,27.678185941043086,25,37,228,2,210
1096,214,227,25.611609977324264,26.795827664399095,25,23,53,1,13
1097,214,206,25.611609977324264,27.23700680272109,25,28,70,2,8
1098,214,389,25.611609977324264,28.23546485260771,25,19,208,3,175
1099,214,415,25.611609977324264,28.0497052154195,25,15,227,2,201
1100,214,662,25.611609977324264,27.376326530612246,25,18,454,2,448
1101,214,640,25.611609977324264,28.258684807256238,25,14,441,3,426
1102,227,10,26.795827664399095,28.908843537414967,23,39,235,2,217
1103,227,4,26.795827664399095,29.442902494331065,23,38,250,3,223
1104,227,389,26.795827664399095,28.23546485260771,23,19,173,1,162
1105,227,415,26.795827664399095,28.0497052154195,23,15,196,1,188
1106,227,412,26.795827664399095,28.908843537414967,23,15,206,2,185
1107,227,640,26.795827664399095,28.258684807256238,23,14,418,1,413
1108,206,10,27.23700680272109,28.908843537414967,28,39,209,2,196
1109,206,4,27.23700680272109,29.442902494331065,28,38,223,2,202
1110,206,384,27.23700680272109,29.860861678004536,28,26,211,3,178
1111,206,412,27.23700680272109,28.908843537414967,28,15,218,2,206
1112,206,410,27.23700680272109,29.860861678004536,28,21,233,3,204
1113,206,640,27.23700680272109,28.258684807256238,28,14,436,1,434
1114,206,625,27.23700680272109,30.02340136054422,28,15,436,3,419
1115,389,4,28.23546485260771,29.442902494331065,19,38,388,1,385
1116,389,7,28.23546485260771,30.25560090702948,19,39,392,2,382
1117,389,384,28.23546485260771,29.860861678004536,19,26,70,2,5
1118,389,211,28.23546485260771,30.464580498866212,19,17,202,2,178
1119,389,410,28.23546485260771,29.860861678004536,19,21,73,2,21
1120,389,566,28.23546485260771,31.068299319727892,19,19,215,3,177
1121,389,625,28.23546485260771,30.02340136054422,19,15,248,2,236
1122,389,656,28.23546485260771,30.464580498866212,19,14,284,2,267
1123,389,886,28.23546485260771,29.257142857142856,19,14,499,1,497
1124,389,826,28.23546485260771,30.928979591836736,19,11,452,3,437
1125,384,23,29.860861678004536,31.90421768707483,26,38,372,2,361
1126,384,268,29.860861678004536,32.066757369614514,26,21,150,2,116
1127,384,566,29.860861678004536,31.068299319727892,26,19,189,1,182
1128,384,554,29.860861678004536,31.55591836734694,26,15,185,2,170
1129,384,642,29.860861678004536,31.346938775510203,26,14,266,1,258
1130,384,665,29.860861678004536,32.670476190476194,26,15,306,3,281
1131,384,826,29.860861678004536,30.928979591836736,26,11,444,1,442
1132,384,826,29.860861678004536,31.811337868480727,26,12,450,2,442
1133,211,23,30.464580498866212,31.90421768707483,17,38,198,1,188
1134,211,4,30.464580498866212,32.949115646258505,17,38,233,2,207
1135,211,268,30.464580498866212,32.066757369614514,17,21,89,2,57
1136,211,239,30.464580498866212,32.949115646258505,17,25,111,2,28
1137,211,554,30.464580498866212,31.55591836734694,17,15,346,1,343
1138,211,538,30.464580498866212,32.949115646258505,17,14,344,2,327
1139,211,539,30.464580498866212,33.32063492063492,17,15,350,3,328
1140,211,665,30.464580498866212,32.670476190476194,17,15,464,2,454
1141,268,4,32.066757369614514,33.8314739229025,21,38,275,2,264
1142,268,4,32.066757369614514,34.73705215419501,21,40,288,3,264
1143,268,209,32.066757369614514,33.99401360544218,21,26,102,2,59
1144,268,539,32.066757369614514,33.32063492063492,21,15,276,1,271
1145,268,569,32.066757369614514,34.481632653061226,21,22,318,2,301
1146,268,726,32.066757369614514,33.552834467120185,21,14,462,1,458
1147,268,618,32.066757369614514,34.17977324263039,21,14,362,2,350
1148,239,4,32.949115646258505,34.73705215419501,25,40,247,2,235
1149,239,209,32.949115646258505,33.99401360544218,25,26,54,1,30
1150,239,210,32.949115646258505,35.10857142857143,25,22,97,2,29
1151,239,331,32.949115646258505,35.80517006802721,25,22,154,3,92
1152,239,569,32.949115646258505,34.481632653061226,25,22,337,2,330
1153,239,561,32.949115646258505,35.75873015873016,25,18,344,3,322
1154,239,618,32.949115646258505,34.17977324263039,25,14,383,1,379
1155,239,638,32.949115646258505,35.735510204081635,25,16,417,3,399
1156,209,18,33.99401360544218,35.9677097505669,26,39,209,2,191
1157,209,10,33.99401360544218,36.85006802721089,26,37,234,3,199
1158,209,210,33.99401360544218,35.10857142857143,26,22,48,1,1
1159,209,331,33.99401360544218,35.80517006802721,26,22,145,2,122
1160,209,228,33.99401360544218,36.91972789115646,26,27,127,3,19
1161,209,561,33.99401360544218,35.75873015873016,26,18,360,2,352
1162,209,491,33.99401360544218,36.80362811791383,26,22,307,3,282
1163,209,638,33.99401360544218,35.735510204081635,26,16,436,2,429
1164,209,654,33.99401360544218,36.24634920634921,26,20,455,2,445
1165,210,10,35.10857142857143,36.85006802721089,22,37,214,2,200
1166,210,10,35.10857142857143,37.73242630385488,22,37,230,3,200
1167,210,228,35.10857142857143,36.91972789115646,22,27,80,2,18
1168,210,225,35.10857142857143,37.45378684807256,22,26,102,2,15
1169,210,491,35.10857142857143,36.80362811791383,22,22,290,2,281
1170,210,454,35.10857142857143,37.221587301587306,22,19,260,2,244
1171,210,654,35.10857142857143,36.24634920634921,22,20,447,1,444
1172,210,680,35.10857142857143,37.17514739229025,22,16,478,2,470
1173,331,10,35.80517006802721,36.85006802721089,22,37,324,1,321
1174,331,10,35.80517006802721,37.73242630385488,22,37,332,2,321
1175,331,228,35.80517006802721,36.91972789115646,22,27,114,1,103
1176,331,225,35.80517006802721,37.45378684807256,22,26,128,2,106
1177,331,383,35.80517006802721,38.638004535147395,22,24,133,3,52
1178,331,454,35.80517006802721,37.221587301587306,22,19,137,1,123
1179,331,540,35.80517006802721,38.59156462585034,22,15,241,3,209
1180,331,680,35.80517006802721,37.17514739229025,22,16,354,1,349
1181,331,619,35.80517006802721,38.49868480725624,22,15,310,3,288
1182,228,10,36.91972789115646,39.05596371882086,27,39,237,2,218
1183,228,383,36.91972789115646,38.638004535147395,27,24,172,2,155
1184,228,227,36.91972789115646,39.14884353741497,27,20,96,2,1
1185,228,540,36.91972789115646,38.59156462585034,27,15,320,2,312
1186,228,545,36.91972789115646,39.14884353741497,27,14,331,2,317
1187,228,619,36.91972789115646,38.49868480725624,27,15,397,2,391
1188,228,716,36.91972789115646,39.288163265306125,27,13,499,2,488
1189,225,10,37.45378684807256,39.05596371882086,26,39,226,2,215
1190,225,10,37.45378684807256,39.938321995464854,26,39,240,2,215
1191,225,383,37.45378684807256,38.638004535147395,26,24,166,1,158
1192,225,227,37.45378684807256,39.14884353741497,26,20,73,2,2
1193,225,540,37.45378684807256,38.59156462585034,26,15,319,1,315
1194,225,545,37.45378684807256,39.14884353741497,26,14,328,2,320
1195,225,533,37.45378684807256,40.19374149659864,26,15,330,3,308
1196,225,619,37.45378684807256,38.49868480725624,26,15,397,1,394
1197,225,716,37.45378684807256,39.288163265306125,26,13,497,2,491
1198,383,10,38.638004535147395,39.938321995464854,24,39,377,1,373
1199,383,6,38.638004535147395,40.84390022675737,24,39,389,2,377
1200,383,227,38.638004535147395,40.91356009070295,24,25,184,2,156
1201,383,255,38.638004535147395,41.33151927437642,24,25,173,3,128
1202,383,533,38.638004535147395,40.19374149659864,24,15,164,2,150
1203,383,642,38.638004535147395,40.61170068027211,24,16,273,2,259
1204,227,6,39.14884353741497,40.84390022675737,20,39,233,2,221
1205,227,4,39.14884353741497,41.79591836734694,20,38,250,3,223
1206,227,255,39.14884353741497,41.33151927437642,20,25,98,2,28
1207,227,533,39.14884353741497,40.19374149659864,20,15,309,1,306
1208,227,508,39.14884353741497,41.84235827664399,20,17,304,3,281
1209,227,642,39.14884353741497,40.61170068027211,20,16,420,1,415
1210,227,659,39.14884353741497,41.84235827664399,20,16,447,3,432
1211,227,10,40.91356009070295,42.58539682539683,25,39,229,2,217
1212,227,7,40.91356009070295,43.46775510204082,25,39,246,3,220
1213,227,382,40.91356009070295,42.399637188208615,25,21,168,1,155
1214,227,238,40.91356009070295,43.490975056689344,25,26,112,3,11
1215,227,537,40.91356009070295,42.98013605442177,25,17,323,2,310
1216,227,664,40.91356009070295,42.81759637188209,25,14,445,2,437
1217,227,641,40.91356009070295,43.69995464852608,25,18,431,3,414
1218,255,10,41.33151927437642,42.58539682539683,25,39,251,1,245
1219,255,7,41.33151927437642,43.46775510204082,25,39,265,2,248
1220,255,382,41.33151927437642,42.399637188208615,25,21,135,1,127
1221,255,238,41.33151927437642,43.490975056689344,25,26,95,2,17
1222,255,537,41.33151927437642,42.98013605442177,25,17,291,2,282
1223,255,421,41.33151927437642,43.97859410430839,25,23,201,3,166
1224,255,664,41.33151927437642,42.81759637188209,25,14,414,1,409
1225,255,641,41.33151927437642,43.69995464852608,25,18,399,2,386
1226,255,618,41.33151927437642,44.1643537414966,25,15,383,3,363
1227,382,7,42.399637188208615,43.46775510204082,21,39,378,1,375
1228,382,7,42.399637188208615,44.373333333333335,21,40,385,2,375
1229,382,7,42.399637188208615,45.2324716553288,21,39,394,3,375
1230,382,238,42.399637188208615,43.490975056689344,21,26,151,1,144
1231,382,212,42.399637188208615,44.83773242630386,21,28,200,2,170
1232,382,421,42.399637188208615,43.97859410430839,21,23,78,2,39
1233,382,520,42.399637188208615,45.023492063492064,21,14,178,3,138
1234,382,641,42.399637188208615,43.69995464852608,21,18,265,1,259
1235,382,618,42.399637188208615,44.1643537414966,21,15,248,2,236
1236,382,855,42.399637188208615,43.67673469387755,21,12,476,1,473
1237,382,873,42.399637188208615,45.023492063492064,21,11,504,3,491
1238,238,7,43.490975056689344,45.2324716553288,26,39,243,2,231
1239,238,4,43.490975056689344,46.18448979591837,26,39,261,3,234
1240,238,212,43.490975056689344,44.83773242630386,26,28,64,1,26
1241,238,254,43.490975056689344,45.51111111111111,26,23,88,2,16
1242,238,520,43.490975056689344,45.023492063492064,26,14,290,2,282
1243,238,542,43.490975056689344,45.67365079365079,26,13,318,2,304
1244,238,642,43.490975056689344,45.46467120181406,26,13,413,2,404
1245,212,4,44.83773242630386,46.18448979591837,28,39,216,1,208
1246,212,218,44.83773242630386,47.04362811791383,28,26,95,2,6
1247,212,231,44.83773242630386,47.763446712018144,28,27,127,3,19
1248,212,568,44.83773242630386,46.78820861678005,28,15,366,2,356
1249,212,625,44.83773242630386,46.78820861678005,28,14,421,2,413
1250,254,7,45.51111111111111,47.879546485260775,23,39,267,2,247
1251,254,218,45.51111111111111,47.04362811791383,23,26,75,2,36
1252,254,231,45.51111111111111,47.763446712018144,23,27,100,2,23
1253,254,228,45.51111111111111,48.4368253968254,23,30,129,3,26
1254,254,568,45.51111111111111,46.78820861678005,23,15,319,1,314
1255,254,594,45.51111111111111,48.15818594104309,23,13,359,3,340
1256,254,625,45.51111111111111,46.78820861678005,23,14,375,1,371
1257,254,726,45.51111111111111,47.67056689342404,23,14,481,2,472
1258,218,10,47.04362811791383,49.08698412698413,26,39,226,2,208
1259,218,5,47.04362811791383,49.71392290249433,26,41,242,3,213
1260,218,228,47.04362811791383,48.4368253968254,26,30,61,1,10
1261,218,261,47.04362811791383,49.946122448979594,26,27,132,3,43
1262,218,594,47.04362811791383,48.15818594104309,26,13,379,1,376
1263,218,554,47.04362811791383,48.529705215419504,26,18,342,1,336
1264,218,699,47.04362811791383,49.15664399092971,26,19,490,2,481
1265,231,10,47.763446712018144,49.08698412698413,27,39,228,1,221
1266,231,5,47.763446712018144,49.71392290249433,27,41,241,2,226
1267,231,6,47.763446712018144,50.549841269841274,27,39,255,3,225
1268,231,261,47.763446712018144,49.946122448979594,27,27,99,2,30
1269,231,341,47.763446712018144,50.29442176870749,27,26,155,3,110
1270,231,515,47.763446712018144,50.08544217687075,27,17,301,2,284
1271,231,699,47.763446712018144,49.15664399092971,27,19,472,1,468
1272,231,679,47.763446712018144,50.73560090702948,27,16,466,3,448
1273,228,5,48.4368253968254,49.71392290249433,30,41,230,1,223
1274,228,6,48.4368253968254,50.549841269841274,30,39,240,2,222
1275,228,261,48.4368253968254,49.946122448979594,30,27,73,2,33
1276,228,341,48.4368253968254,50.29442176870749,30,26,138,2,113
1277,228,515,48.4368253968254,50.08544217687075,30,17,296,2,287
1278,228,515,48.4368253968254,50.874920634920635,30,20,306,2,287
1279,228,679,48.4368253968254,50.73560090702948,30,16,462,2,451
1280,261,10,49.946122448979594,51.85015873015873,27,37,264,2,251
1281,261,6,49.946122448979594,52.75573696145125,27,39,282,3,255
1282,261,256,49.946122448979594,52.082358276643994,27,25,92,2,5
1283,261,229,49.946122448979594,52.38421768707483,27,20,110,2,32
1284,261,578,49.946122448979594,51.432199546485265,27,14,323,1,317
1285,261,618,49.946122448979594,52.082358276643994,27,16,369,2,357
1286,261,631,49.946122448979594,52.523537414965986,27,16,386,3,370
1287,341,10,50.29442176870749,51.85015873015873,26,37,338,2,331
1288,341,6,50.29442176870749,52.75573696145125,26,39,351,2,335
1289,341,256,50.29442176870749,52.082358276643994,26,25,115,2,85
1290,341,229,50.29442176870749,52.38421768707483,26,20,144,2,112
1291,341,578,50.29442176870749,51.432199546485265,26,14,242,1,237
1292,341,519,50.29442176870749,52.964716553287985,26,15,212,3,178
1293,341,618,50.29442176870749,52.082358276643994,26,16,288,2,277
1294,341,631,50.29442176870749,52.523537414965986,26,16,305,2,290
1295,256,6,52.082358276643994,53.614875283446715,25,39,259,2,250
1296,256,10,52.082358276643994,54.9384126984127,25,39,275,3,246
1297,256,226,52.082358276643994,54.10249433106576,25,26,92,2,30
1298,256,231,52.082358276643994,54.75265306122449,25,25,118,3,25
1299,256,425,52.082358276643994,54.14893424036281,25,21,191,2,169
1300,256,410,52.082358276643994,54.984852607709755,25,17,198,3,154
1301,256,728,52.082358276643994,53.823854875283445,25,23,478,2,472
1302,256,709,52.082358276643994,54.868752834467124,25,20,469,3,453
1303,229,6,52.38421768707483,53.614875283446715,20,39,229,1,223
1304,229,10,52.38421768707483,54.9384126984127,20,39,245,3,219
1305,229,226,52.38421768707483,54.10249433106576,20,26,74,2,3
1306,229,231,52.38421768707483,54.75265306122449,20,25,102,2,2
1307,229,425,52.38421768707483,54.14893424036281,20,21,210,2,196
1308,229,410,52.38421768707483,54.984852607709755,20,17,213,3,181
1309,229,728,52.38421768707483,53.823854875283445,20,23,503,1,499
1310,229,709,52.38421768707483,54.868752834467124,20,20,492,2,480
1311,226,4,54.10249433106576,55.913650793650795,26,39,235,2,222
1312,226,10,54.10249433106576,56.70312925170068,26,39,243,3,216
1313,226,247,54.10249433106576,55.89043083900227,26,25,80,2,21
1314,226,225,54.10249433106576,56.91210884353742,26,24,121,3,1
1315,226,410,54.10249433106576,55.98331065759637,26,18,201,2,184
1316,226,552,54.10249433106576,56.26195011337869,26,15,339,2,326
1317,226,675,54.10249433106576,56.47092970521542,26,14,460,2,449
1318,231,4,54.75265306122449,55.913650793650795,25,39,232,1,227
1319,231,10,54.75265306122449,56.70312925170068,25,39,236,2,221
1320,231,247,54.75265306122449,55.89043083900227,25,25,52,1,16
1321,231,225,54.75265306122449,56.91210884353742,25,24,93,2,6
1322,231,241,54.75265306122449,57.72480725623583,25,28,128,3,10
1323,231,410,54.75265306122449,55.98331065759637,25,18,187,1,179
1324,231,552,54.75265306122449,56.26195011337869,25,15,328,2,321
1325,231,569,54.75265306122449,57.5158276643991,25,17,358,3,338
1326,231,675,54.75265306122449,56.47092970521542,25,14,450,2,444
1327,247,4,55.89043083900227,58.096326530612245,25,39,261,2,243
1328,247,7,55.89043083900227,58.46784580498866,25,39,264,3,240
1329,247,225,55.89043083900227,56.91210884353742,25,24,49,1,22
1330,247,241,55.89043083900227,57.72480725623583,25,28,79,2,6
1331,247,569,55.89043083900227,57.5158276643991,25,17,330,2,322
1332,247,655,55.89043083900227,57.817687074829934,25,15,416,2,408
1333,225,4,56.91210884353742,58.096326530612245,24,39,227,1,221
1334,225,7,56.91210884353742,58.46784580498866,24,39,228,2,218
1335,225,4,56.91210884353742,59.419863945578236,24,39,246,3,221
1336,225,212,56.91210884353742,59.187664399092974,24,22,99,2,13
1337,225,439,56.91210884353742,58.90902494331066,24,13,231,2,214
1338,225,602,56.91210884353742,59.60562358276644,24,20,394,3,377
1339,225,719,56.91210884353742,59.14122448979592,24,14,503,2,494
1340,225,617,56.91210884353742,59.582403628117916,24,17,409,3,392
1341,241,4,57.72480725623583,59.419863945578236,28,39,248,2,237
1342,241,212,57.72480725623583,59.187664399092974,28,22,69,1,29
1343,241,212,57.72480725623583,60.09324263038549,28,32,106,2,29
1344,241,439,57.72480725623583,58.90902494331066,28,13,204,1,198
1345,241,602,57.72480725623583,59.60562358276644,28,20,370,2,361
1346,241,719,57.72480725623583,59.14122448979592,28,14,482,1,478
1347,241,617,57.72480725623583,59.582403628117916,28,17,384,2,376
1348,212,7,59.187664399092974,61.11492063492064,22,39,221,2,205
1349,212,6,59.187664399092974,61.99727891156463,22,39,239,3,206
1350,212,225,59.187664399092974,61.18458049886621,22,28,87,2,13
1351,212,214,59.187664399092974,61.41678004535147,22,30,96,2,2
1352,212,424,59.187664399092974,61.161360544217686,22,22,228,2,212
1353,212,430,59.187664399092974,61.23102040816327,22,20,235,2,218
1354,212,627,59.187664399092974,61.602539682539685,22,16,428,2,415
1355,212,7,60.09324263038549,61.11492063492064,32,39,210,1,205
1356,212,6,60.09324263038549,61.99727891156463,32,39,222,2,206
1357,212,4,60.09324263038549,62.972517006802725,32,38,242,3,208
1358,212,225,60.09324263038549,61.18458049886621,32,28,49,1,13
1359,212,214,60.09324263038549,61.41678004535147,32,30,57,1,2
1360,212,209,60.09324263038549,62.32235827664399,32,31,96,2,3
1361,212,424,60.09324263038549,61.161360544217686,32,22,217,1,212
1362,212,430,60.09324263038549,61.23102040816327,32,20,223,1,218
1363,212,627,60.09324263038549,61.602539682539685,32,16,420,2,415
1364,225,4,61.18458049886621,62.972517006802725,28,38,234,2,221
1365,225,209,61.18458049886621,62.32235827664399,28,31,52,1,16
1366,225,402,61.18458049886621,64.04063492063493,28,25,216,3,177
1367,225,596,61.18458049886621,63.22793650793651,28,16,381,2,371
1368,225,582,61.18458049886621,63.27437641723356,28,20,368,2,357
1369,225,630,61.18458049886621,63.11183673469388,28,15,413,2,405
1370,214,4,61.41678004535147,62.972517006802725,30,38,220,2,210
1371,214,14,61.41678004535147,64.22639455782313,30,39,234,3,200
1372,214,402,61.41678004535147,64.04063492063493,30,25,219,3,188
1373,214,596,61.41678004535147,63.22793650793651,30,16,390,2,382
1374,214,582,61.41678004535147,63.27437641723356,30,20,377,2,368
1375,214,630,61.41678004535147,63.11183673469388,30,15,422,2,416
1376,209,14,62.32235827664399,64.22639455782313,31,39,212,2,195
1377,209,5,62.32235827664399,64.71401360544218,31,41,229,2,204
1378,209,402,62.32235827664399,64.04063492063493,31,25,207,2,193
1379,209,253,62.32235827664399,64.76045351473923,31,24,114,2,44
1380,209,411,62.32235827664399,64.69079365079365,31,20,226,2,202
1381,402,6,64.04063492063493,65.52671201814059,25,40,401,1,396
1382,402,6,64.04063492063493,66.40907029478458,25,39,409,2,396
1383,402,258,64.04063492063493,65.75891156462585,25,26,162,2,144
1384,402,422,64.04063492063493,65.38739229024944,25,17,61,1,20
1385,402,430,64.04063492063493,66.26975056689342,25,15,100,2,28
1386,402,640,64.04063492063493,65.31773242630386,25,16,244,1,238
1387,402,641,64.04063492063493,66.64126984126985,25,16,264,3,239
1388,402,826,64.04063492063493,66.20009070294785,25,14,434,2,424
1389,402,869,64.04063492063493,66.64126984126985,25,11,480,3,467
1390,253,6,64.76045351473923,66.40907029478458,24,39,257,2,247
1391,253,226,64.76045351473923,67.10566893424037,24,24,105,2,27
1392,253,430,64.76045351473923,66.26975056689342,24,15,189,2,177
1393,253,641,64.76045351473923,66.64126984126985,24,16,396,2,388
1394,258,6,65.75891156462585,67.75582766439909,26,42,266,2,252
1395,258,226,65.75891156462585,67.10566893424037,26,24,66,1,32
1396,258,259,65.75891156462585,68.01124716553288,26,23,97,2,1
1397,258,422,65.75891156462585,68.08090702947845,26,16,192,2,164
1398,258,723,65.75891156462585,67.9415873015873,26,20,474,2,465
1399,226,4,67.10566893424037,69.12580498866214,24,39,238,2,222
1400,226,8,67.10566893424037,69.47410430839003,24,40,241,2,218
1401,226,231,67.10566893424037,68.87038548752835,24,24,76,2,5
1402,226,252,67.10566893424037,69.75274376417234,24,24,117,3,26
1403,226,595,67.10566893424037,69.0097052154195,24,18,378,2,369
1404,226,410,67.10566893424037,69.5437641723356,24,15,212,2,184
1405,226,698,67.10566893424037,69.40444444444445,24,15,482,2,472
1406,259,4,68.01124716553288,69.12580498866214,23,39,259,1,255
1407,259,8,68.01124716553288,69.47410430839003,23,40,259,1,251
1408,259,252,68.01124716553288,69.75274376417234,23,24,75,2,7
1409,259,410,68.01124716553288,69.5437641723356,23,15,165,2,151
1410,259,520,68.01124716553288,70.6118820861678,23,14,284,3,261
1411,259,733,68.01124716553288,69.03292517006803,23,21,476,1,474
1412,259,698,68.01124716553288,69.40444444444445,23,15,443,1,439
1413,259,641,68.01124716553288,70.6118820861678,23,14,398,3,382
1414,231,10,68.87038548752835,71.26204081632653,24,39,244,2,221
1415,231,10,68.87038548752835,71.51746031746032,24,40,249,3,221
1416,231,219,68.87038548752835,71.00662131519275,24,25,93,2,12
1417,231,342,68.87038548752835,71.61034013605442,24,27,162,3,111
1418,231,520,68.87038548752835,70.6118820861678,24,14,299,2,289
1419,231,599,68.87038548752835,71.5871201814059,24,18,386,3,368
1420,231,641,68.87038548752835,70.6118820861678,24,14,417,2,410
1421,252,10,69.75274376417234,71.26204081632653,24,39,251,2,242
1422,252,10,69.75274376417234,71.51746031746032,24,40,254,2,242
1423,252,219,69.75274376417234,71.00662131519275,24,25,63,1,33
1424,252,342,69.75274376417234,71.61034013605442,24,27,120,2,90
1425,252,599,69.75274376417234,71.5871201814059,24,18,356,2,347
1426,252,569,69.75274376417234,72.49269841269842,24,15,338,3,317
1427,252,641,69.75274376417234,71.9354195011338,24,16,400,2,389
1428,252,640,69.75274376417234,72.37659863945578,24,14,404,3,388
1429,219,7,71.00662131519275,73.02675736961451,25,41,229,2,212
1430,219,7,71.00662131519275,73.9091156462585,25,41,246,3,212
1431,219,210,71.00662131519275,73.25895691609978,25,20,97,2,9
1432,219,569,71.00662131519275,72.49269841269842,25,15,356,1,350
1433,219,605,71.00662131519275,73.76979591836735,25,19,404,3,386
1434,219,640,71.00662131519275,72.37659863945578,25,14,425,1,421
1435,219,641,71.00662131519275,73.70013605442178,25,14,438,3,422
1436,342,7,71.61034013605442,73.02675736961451,27,41,341,1,335
1437,342,7,71.61034013605442,73.9091156462585,27,41,349,2,335
1438,342,210,71.61034013605442,73.25895691609978,27,20,150,2,132
1439,342,212,71.61034013605442,74.18775510204082,27,31,171,3,130
1440,342,211,71.61034013605442,74.28063492063492,27,29,174,3,131
1441,342,605,71.61034013605442,73.76979591836735,27,19,279,2,263
1442,342,641,71.61034013605442,73.70013605442178,27,14,312,2,299
1443,342,720,71.61034013605442,74.58249433106576,27,13,399,3,378
1444,342,826,71.61034013605442,74.58249433106576,27,10,501,3,484
1445,210,10,73.25895691609978,75.2326530612245,20,38,217,2,200
1446,210,7,73.25895691609978,76.11501133786848,20,39,237,3,203
1447,210,211,73.25895691609978,74.28063492063492,20,29,44,1,1
1448,210,229,73.25895691609978,75.4184126984127,20,31,95,2,19
1449,210,416,73.25895691609978,75.25587301587302,20,22,223,2,206
1450,210,423,73.25895691609978,75.27909297052155,20,23,230,2,213
1451,210,640,73.25895691609978,75.90603174603174,20,16,445,3,430
1452,212,10,74.18775510204082,75.2326530612245,31,38,207,1,202
1453,212,7,74.18775510204082,76.11501133786848,31,39,221,2,205
1454,212,5,74.18775510204082,77.06702947845805,31,40,241,3,207
1455,212,229,74.18775510204082,75.4184126984127,31,31,56,1,17
1456,212,210,74.18775510204082,76.41687074829932,31,32,96,2,2
1457,212,416,74.18775510204082,75.25587301587302,31,22,209,1,204
1458,212,423,74.18775510204082,75.27909297052155,31,23,216,1,211
1459,212,419,74.18775510204082,76.97414965986394,31,20,239,3,207
1460,212,640,74.18775510204082,75.90603174603174,31,16,434,2,428
1461,212,641,74.18775510204082,76.34721088435374,31,16,439,2,429
1462,211,7,74.28063492063492,76.11501133786848,29,39,219,2,204
1463,211,5,74.28063492063492,77.06702947845805,29,40,238,3,206
1464,211,229,74.28063492063492,75.4184126984127,29,31,52,1,18
1465,211,210,74.28063492063492,76.41687074829932,29,32,92,2,1
1466,211,419,74.28063492063492,76.97414965986394,29,20,238,3,208
1467,211,640,74.28063492063492,75.90603174603174,29,16,435,2,429
1468,211,641,74.28063492063492,76.34721088435374,29,16,439,2,430
1469,229,5,75.4184126984127,77.06702947845805,31,40,235,2,224
1470,229,5,75.4184126984127,77.50820861678005,31,40,241,2,224
1471,229,408,75.4184126984127,78.25124716553289,31,20,217,3,179
1472,229,419,75.4184126984127,76.97414965986394,31,20,201,2,190
1473,229,444,75.4184126984127,78.22802721088435,31,15,247,3,215
1474,229,626,75.4184126984127,78.20480725623582,31,14,415,3,397
1475,210,5,76.41687074829932,77.50820861678005,32,40,210,1,205
1476,210,39,76.41687074829932,78.73886621315192,32,38,198,2,171
1477,210,408,76.41687074829932,78.25124716553289,32,20,213,2,198
1478,210,403,76.41687074829932,78.85496598639456,32,19,220,2,193
1479,210,444,76.41687074829932,78.22802721088435,32,15,247,2,234
1480,210,515,76.41687074829932,78.57632653061225,32,17,319,2,305
1481,210,626,76.41687074829932,78.20480725623582,32,14,423,2,416
1482,408,19,78.25124716553289,80.01596371882086,20,36,396,2,389
1483,408,19,78.25124716553289,80.96798185941043,20,36,406,3,389
1484,408,211,78.25124716553289,79.87664399092971,20,17,209,2,197
1485,408,211,78.25124716553289,80.75900226757369,20,16,225,3,197
1486,408,589,78.25124716553289,80.17850340136054,20,14,199,2,181
1487,408,552,78.25124716553289,80.96798185941043,20,12,186,3,144
1488,408,717,78.25124716553289,80.15528344671202,20,15,320,2,309
1489,408,641,78.25124716553289,80.96798185941043,20,20,261,3,233
1490,403,19,78.85496598639456,80.01596371882086,19,36,387,1,384
1491,403,19,78.85496598639456,80.96798185941043,19,36,395,2,384
1492,403,211,78.85496598639456,79.87664399092971,19,17,197,1,192
1493,403,211,78.85496598639456,80.75900226757369,19,16,209,2,192
1494,403,589,78.85496598639456,80.17850340136054,19,14,195,1,186
1495,403,552,78.85496598639456,80.96798185941043,19,12,175,2,149
1496,403,717,78.85496598639456,80.15528344671202,19,15,319,1,314
1497,403,641,78.85496598639456,80.96798185941043,19,20,255,2,238
1498,211,19,79.87664399092971,80.96798185941043,17,36,198,1,192
1499,211,24,79.87664399092971,82.17541950113379,17,36,212,2,187
1500,211,23,79.87664399092971,82.52371882086167,17,38,220,3,188
1501,211,244,79.87664399092971,81.92,17,23,94,2,33
1502,211,552,79.87664399092971,80.96798185941043,17,12,344,1,341
1503,211,442,79.87664399092971,81.89678004535148,17,13,247,2,231
1504,211,641,79.87664399092971,80.96798185941043,17,20,433,1,430
1505,211,649,79.87664399092971,81.89678004535148,17,16,447,2,438
1506,211,682,79.87664399092971,82.84879818594105,17,16,488,3,471
1507,211,24,80.75900226757369,82.17541950113379,16,36,197,1,187
1508,211,23,80.75900226757369,82.52371882086167,16,38,203,2,188
1509,211,244,80.75900226757369,81.92,16,23,60,1,33
1510,211,401,80.75900226757369,83.15065759637189,16,26,216,2,190
1511,211,442,80.75900226757369,81.89678004535148,16,13,236,1,231
1512,211,412,80.75900226757369,83.15065759637189,16,20,226,2,201
1513,211,553,80.75900226757369,83.40607709750567,16,11,360,3,342
1514,211,649,80.75900226757369,81.89678004535148,16,16,441,1,438
1515,211,682,80.75900226757369,82.84879818594105,16,16,480,2,471
1516,211,636,80.75900226757369,83.31319727891156,16,12,439,3,425
1517,244,23,81.92,83.84725623582767,23,40,236,2,221
1518,244,401,81.92,83.15065759637189,23,26,166,1,157
1519,244,320,81.92,84.07945578231293,23,22,120,2,76
1520,244,205,81.92,84.89215419501134,23,27,134,3,39
1521,244,412,81.92,83.15065759637189,23,20,176,1,168
1522,244,553,81.92,83.40607709750567,23,11,316,1,309
1523,244,636,81.92,83.31319727891156,23,12,397,1,392
1524,401,45,83.15065759637189,84.98503401360544,26,39,365,2,356
1525,401,5,83.15065759637189,85.89061224489797,26,39,413,3,396
1526,401,205,83.15065759637189,84.89215419501134,26,27,210,2,196
1527,401,228,83.15065759637189,85.40299319727892,26,26,198,2,173
1528,401,554,83.15065759637189,85.14757369614513,26,17,176,2,153
1529,401,515,83.15065759637189,86.12281179138323,26,19,171,3,114
1530,401,680,83.15065759637189,85.14757369614513,26,12,292,2,279
1531,401,819,83.15065759637189,86.05315192743764,26,16,436,3,418
1532,401,896,83.15065759637189,86.02993197278911,26,15,510,3,495
1533,320,5,84.07945578231293,85.89061224489797,22,39,325,2,315
1534,320,7,84.07945578231293,86.7265306122449,22,38,333,3,313
1535,320,228,84.07945578231293,85.40299319727892,22,26,108,1,92
1536,320,231,84.07945578231293,87.05160997732426,22,26,156,3,89
1537,320,554,84.07945578231293,85.14757369614513,22,17,238,1,234
1538,320,515,84.07945578231293,86.12281179138323,22,19,214,2,195
1539,320,515,84.07945578231293,86.6336507936508,22,14,224,3,195
1540,320,680,84.07945578231293,85.14757369614513,22,12,363,1,360
1541,320,819,84.07945578231293,86.05315192743764,22,16,506,2,499
1542,320,743,84.07945578231293,86.93551020408164,22,13,441,3,423
1543,205,7,84.89215419501134,86.7265306122449,27,38,213,2,198
1544,205,6,84.89215419501134,87.58566893424036,27,39,230,3,199
1545,205,231,84.89215419501134,87.05160997732426,27,26,97,2,26
1546,205,227,84.89215419501134,87.60888888888888,27,26,119,3,22
1547,205,515,84.89215419501134,86.12281179138323,27,19,314,1,310
1548,205,515,84.89215419501134,86.6336507936508,27,14,319,2,310
1549,205,424,84.89215419501134,87.81786848072562,27,15,253,3,219
1550,205,640,84.89215419501134,87.37668934240364,27,16,448,2,435
1551,228,7,85.40299319727892,86.7265306122449,26,38,228,1,221
1552,228,6,85.40299319727892,87.58566893424036,26,39,241,2,222
1553,228,231,85.40299319727892,87.05160997732426,26,26,71,2,3
1554,228,227,85.40299319727892,87.60888888888888,26,26,95,2,1
1555,228,515,85.40299319727892,86.6336507936508,26,14,292,1,287
1556,228,424,85.40299319727892,87.81786848072562,26,15,222,2,196
1557,228,640,85.40299319727892,87.37668934240364,26,16,421,2,412
1558,231,10,87.05160997732426,88.90920634920636,26,38,235,2,221
1559,231,208,87.05160997732426,88.72344671201814,26,25,76,2,23
1560,231,232,87.05160997732426,89.83800453514739,26,28,120,3,1
1561,231,416,87.05160997732426,88.72344671201814,26,18,199,2,185
1562,231,413,87.05160997732426,89.65224489795918,26,18,214,3,182
1563,231,720,87.05160997732426,89.1414058956916,26,17,497,2,489
1564,231,630,87.05160997732426,89.5825850340136,26,14,414,3,399
1565,227,10,87.60888888888888,88.90920634920636,26,38,224,1,217
1566,227,25,87.60888888888888,90.20952380952382,26,39,231,3,202
1567,227,208,87.60888888888888,88.72344671201814,26,25,52,1,19
1568,227,232,87.60888888888888,89.83800453514739,26,28,96,2,5
1569,227,416,87.60888888888888,88.72344671201814,26,18,195,1,189
1570,227,413,87.60888888888888,89.65224489795918,26,18,206,2,186
1571,227,546,87.60888888888888,90.4649433106576,26,14,342,3,319
1572,227,720,87.60888888888888,89.1414058956916,26,17,497,2,493
1573,227,630,87.60888888888888,89.5825850340136,26,14,412,2,403
1574,227,617,87.60888888888888,90.4649433106576,26,14,409,3,390
1575,208,25,88.72344671201814,90.20952380952382,25,39,194,1,183
1576,208,31,88.72344671201814,90.92934240362813,25,40,201,2,177
1577,208,232,88.72344671201814,89.83800453514739,25,28,54,1,24
1578,208,211,88.72344671201814,91.16154195011337,25,28,105,2,3
1579,208,546,88.72344671201814,90.4649433106576,25,14,346,2,338
1580,208,617,88.72344671201814,90.4649433106576,25,14,416,2,409
1581,208,641,88.72344671201814,91.34730158730159,25,15,448,3,433
1582,232,31,89.83800453514739,90.92934240362813,28,40,206,1,201
1583,232,7,89.83800453514739,91.99746031746032,28,39,243,2,225
1584,232,18,89.83800453514739,92.43863945578231,28,40,242,3,214
1585,232,211,89.83800453514739,91.16154195011337,28,28,61,1,21
1586,232,272,89.83800453514739,92.16,28,25,108,2,40
1587,232,215,89.83800453514739,92.64761904761905,28,27,122,3,17
1588,232,571,89.83800453514739,92.22965986394559,28,15,354,2,339
1589,232,418,89.83800453514739,92.67083900226757,28,20,222,3,186
1590,232,641,89.83800453514739,91.34730158730159,28,15,414,2,409
1591,232,665,89.83800453514739,92.67083900226757,28,16,450,3,433
1592,211,18,91.16154195011337,92.43863945578231,28,40,201,1,193
1593,211,6,91.16154195011337,93.7621768707483,28,39,234,3,205
1594,211,215,91.16154195011337,92.64761904761905,28,27,64,1,4
1595,211,230,91.16154195011337,93.55319727891157,28,21,105,2,19
1596,211,571,91.16154195011337,92.22965986394559,28,15,363,1,360
1597,211,418,91.16154195011337,92.67083900226757,28,20,217,2,207
1598,211,539,91.16154195011337,93.71573696145126,28,18,346,3,328
1599,211,665,91.16154195011337,92.67083900226757,28,16,459,2,454
1600,211,641,91.16154195011337,93.52997732426304,28,15,442,2,430
1601,272,6,92.16,93.7621768707483,25,39,275,2,266
1602,272,7,92.16,94.64453514739229,25,38,286,2,265
1603,272,230,92.16,93.55319727891157,25,21,73,1,42
1604,272,539,92.16,93.71573696145126,25,18,275,2,267
1605,272,573,92.16,94.52843537414967,25,18,318,2,301
1606,272,641,92.16,93.52997732426304,25,15,374,1,369
1607,272,634,92.16,94.43555555555555,25,13,375,2,362
1608,215,6,92.64761904761905,93.7621768707483,27,39,214,1,209
1609,215,7,92.64761904761905,94.64453514739229,27,38,225,2,208
1610,215,10,92.64761904761905,95.52689342403629,27,39,240,3,205
1611,215,232,92.64761904761905,95.15537414965986,27,25,109,3,17
1612,215,539,92.64761904761905,93.71573696145126,27,18,327,1,324
1613,215,573,92.64761904761905,94.52843537414967,27,18,367,2,358
1614,215,634,92.64761904761905,94.43555555555555,27,13,426,2,419
1615,230,7,93.55319727891157,94.64453514739229,21,38,228,1,223
1616,230,10,93.55319727891157,95.52689342403629,21,39,236,2,220
1617,230,232,93.55319727891157,95.15537414965986,21,25,69,2,2
1618,230,222,93.55319727891157,96.17705215419501,21,22,113,3,8
1619,230,562,93.55319727891157,96.36281179138322,21,25,353,3,332
1620,230,561,93.55319727891157,96.38603174603175,21,23,353,3,331
1621,232,6,95.15537414965986,97.29160997732427,25,39,244,2,226
1622,232,222,95.15537414965986,96.17705215419501,25,22,45,1,10
1623,232,230,95.15537414965986,96.4324716553288,25,23,55,1,2
1624,232,256,95.15537414965986,98.10430839002268,25,25,129,3,24
1625,232,562,95.15537414965986,96.36281179138322,25,25,334,1,330
1626,232,561,95.15537414965986,96.38603174603175,25,23,333,1,329
1627,232,609,95.15537414965986,97.61668934240363,25,21,392,2,377
1628,232,633,95.15537414965986,97.12907029478458,25,19,410,2,401
1629,232,668,95.15537414965986,97.6863492063492,25,17,449,3,436
1630,222,6,96.17705215419501,97.29160997732427,22,39,221,1,216
1631,222,4,96.17705215419501,98.24362811791383,22,39,235,2,218
1632,222,6,96.17705215419501,98.61514739229025,22,37,240,2,216
1633,222,256,96.17705215419501,98.10430839002268,22,25,90,2,34
1634,222,217,96.17705215419501,98.40616780045352,22,25,96,2,5
1635,222,609,96.17705215419501,97.61668934240363,22,21,392,1,387
1636,222,433,96.17705215419501,98.63836734693878,22,17,236,2,211
1637,222,668,96.17705215419501,97.6863492063492,22,17,451,2,446
1638,222,637,96.17705215419501,98.91700680272109,22,17,431,3,415
1639,230,4,96.4324716553288,98.24362811791383,23,39,239,2,226
1640,230,6,96.4324716553288,98.61514739229025,23,37,243,2,224
1641,230,256,96.4324716553288,98.10430839002268,23,25,77,2,26
1642,230,217,96.4324716553288,98.40616780045352,23,25,86,2,13
1643,230,609,96.4324716553288,97.61668934240363,23,21,382,1,379
1644,230,433,96.4324716553288,98.63836734693878,23,17,224,2,203
1645,230,668,96.4324716553288,97.6863492063492,23,17,441,1,438
1646,230,637,96.4324716553288,98.91700680272109,23,17,421,2,407
1647,256,6,98.10430839002268,99.49750566893424,25,39,257,1,250
1648,256,4,98.10430839002268,100.89070294784581,25,38,279,3,252
1649,256,207,98.10430839002268,99.96190476190476,25,30,94,2,49
1650,256,555,98.10430839002268,100.0780045351474,25,23,311,2,299
1651,256,585,98.10430839002268,100.47274376417234,25,18,344,2,329
1652,256,641,98.10430839002268,100.14766439909297,25,17,395,2,385
1653,256,623,98.10430839002268,100.40308390022676,25,17,380,2,367
1654,217,6,98.40616780045352,99.49750566893424,25,39,216,1,211
1655,217,4,98.40616780045352,100.89070294784581,25,38,238,2,213
1656,217,207,98.40616780045352,99.96190476190476,25,30,68,2,10
1657,217,227,98.40616780045352,101.28544217687075,25,25,124,3,10
1658,217,555,98.40616780045352,100.0780045351474,25,23,346,2,338
1659,217,585,98.40616780045352,100.47274376417234,25,18,379,2,368
1660,217,641,98.40616780045352,100.14766439909297,25,17,431,2,424
1661,217,623,98.40616780045352,100.40308390022676,25,17,415,2,406
1662,207,6,99.96190476190476,102.14458049886622,30,38,222,2,201
1663,207,6,99.96190476190476,102.5857596371882,30,40,231,3,201
1664,207,227,99.96190476190476,101.28544217687075,30,25,60,1,20
1665,207,256,99.96190476190476,101.63374149659865,30,26,87,2,49
1666,207,596,99.96190476190476,101.65696145124717,30,16,396,2,389
1667,207,622,99.96190476190476,101.56408163265306,30,18,421,2,415
1668,227,6,101.28544217687075,102.5857596371882,25,40,228,1,221
1669,227,7,101.28544217687075,103.4681179138322,25,38,239,2,220
1670,227,234,101.28544217687075,103.23591836734694,25,23,84,2,7
1671,227,236,101.28544217687075,104.14149659863946,25,29,123,3,9
1672,227,584,101.28544217687075,103.25913832199547,25,16,367,2,357
1673,227,415,101.28544217687075,103.4681179138322,25,18,210,2,188
1674,227,643,101.28544217687075,103.23591836734694,25,13,424,2,416
1675,227,650,101.28544217687075,103.79319727891156,25,13,437,3,423
1676,256,7,101.63374149659865,103.4681179138322,26,38,261,2,249
1677,256,234,101.63374149659865,103.23591836734694,26,23,72,2,22
1678,256,236,101.63374149659865,104.14149659863946,26,29,110,3,20
1679,256,584,101.63374149659865,103.25913832199547,26,16,335,2,328
1680,256,415,101.63374149659865,103.4681179138322,26,18,178,2,159
1681,256,643,101.63374149659865,103.23591836734694,26,13,393,2,387
1682,256,650,101.63374149659865,103.79319727891156,26,13,405,2,394
1683,234,7,103.23591836734694,105.23283446712018,23,38,243,2,227
1684,234,5,103.23591836734694,106.18485260770976,23,39,262,3,229
1685,234,375,103.23591836734694,104.69877551020409,23,27,154,1,141
1686,234,410,103.23591836734694,104.79165532879819,23,21,188,2,176
1687,234,530,103.23591836734694,106.09197278911564,23,19,321,3,296
1688,234,683,103.23591836734694,105.00063492063492,23,15,455,2,449
1689,236,7,104.14149659863946,105.23283446712018,29,38,234,1,229
1690,236,5,104.14149659863946,106.18485260770976,29,39,247,2,231
1691,236,4,104.14149659863946,107.06721088435374,29,39,264,3,232
1692,236,247,104.14149659863946,106.27773242630386,29,24,93,2,11
1693,236,343,104.14149659863946,106.81179138321995,29,27,157,3,107
1694,236,530,104.14149659863946,106.09197278911564,29,19,306,2,294
1695,236,461,104.14149659863946,106.64925170068028,29,19,250,3,225
1696,375,5,104.69877551020409,106.18485260770976,27,39,375,1,370
1697,375,4,104.69877551020409,107.06721088435374,27,39,385,2,371
1698,375,247,104.69877551020409,106.27773242630386,27,24,145,2,128
1699,375,343,104.69877551020409,106.81179138321995,27,27,96,2,32
1700,375,530,104.69877551020409,106.09197278911564,27,19,166,1,155
1701,375,461,104.69877551020409,106.64925170068028,27,19,120,2,86
1702,375,538,104.69877551020409,107.43873015873017,27,16,201,3,163
1703,375,743,104.69877551020409,106.02231292517007,27,24,372,1,368
1704,375,647,104.69877551020409,107.16009070294785,27,18,292,2,272
1705,375,873,104.69877551020409,107.64770975056689,27,11,514,3,498
1706,247,10,106.27773242630386,107.87990929705215,24,38,247,2,237
1707,247,6,106.27773242630386,109.20344671201815,24,40,272,3,241
1708,247,254,106.27773242630386,108.2746485260771,24,26,86,2,7
1709,247,256,106.27773242630386,108.55328798185941,24,26,98,2,9
1710,247,538,106.27773242630386,107.43873015873017,24,16,295,1,291
1711,247,558,106.27773242630386,108.99446712018141,24,16,332,3,311
1712,247,718,106.27773242630386,108.08888888888889,24,15,477,2,471
1713,247,625,106.27773242630386,108.99446712018141,24,14,396,3,378
1714,343,10,106.81179138321995,107.87990929705215,27,38,336,1,333
1715,343,6,106.81179138321995,109.20344671201815,27,40,352,2,337
1716,343,5,106.81179138321995,109.69106575963718,27,36,360,3,338
1717,343,254,106.81179138321995,108.2746485260771,27,26,109,1,89
1718,343,256,106.81179138321995,108.55328798185941,27,26,115,2,87
1719,343,558,106.81179138321995,108.99446712018141,27,16,235,2,215
1720,343,718,106.81179138321995,108.08888888888889,27,15,379,1,375
1721,343,625,106.81179138321995,108.99446712018141,27,14,297,2,282
1722,254,5,108.2746485260771,109.69106575963718,26,36,256,1,249
1723,254,227,108.2746485260771,110.5966439909297,26,26,104,2,27
1724,254,465,108.2746485260771,110.06258503401361,26,14,225,2,211
1725,254,425,108.2746485260771,110.5966439909297,26,19,198,2,171
1726,254,743,108.2746485260771,110.27156462585035,26,20,497,2,489
1727,256,5,108.55328798185941,109.69106575963718,26,36,256,1,251
1728,256,7,108.55328798185941,111.40934240362812,26,38,278,3,249
1729,256,254,108.55328798185941,110.38766439909297,26,25,79,2,2
1730,256,227,108.55328798185941,110.5966439909297,26,26,93,2,29
1731,256,465,108.55328798185941,110.06258503401361,26,14,219,2,209
1732,256,425,108.55328798185941,110.5966439909297,26,19,191,2,169
1733,256,743,108.55328798185941,110.27156462585035,26,20,493,2,487
1734,256,717,108.55328798185941,111.33968253968254,26,22,476,3,461
1735,254,7,110.38766439909297,111.40934240362812,25,38,251,1,247
1736,254,4,110.38766439909297,112.36136054421769,25,38,264,2,250
1737,254,4,110.38766439909297,112.80253968253969,25,39,271,2,250
1738,254,405,110.38766439909297,112.36136054421769,25,26,173,2,151
1739,254,410,110.38766439909297,112.40780045351474,25,19,179,2,156
1740,254,410,110.38766439909297,112.43102040816326,25,19,179,2,156
1741,254,641,110.38766439909297,112.52390022675738,25,16,398,2,387
1742,227,4,110.5966439909297,112.36136054421769,26,38,236,2,223
1743,227,4,110.5966439909297,112.80253968253969,26,39,242,2,223
1744,227,405,110.5966439909297,112.36136054421769,26,26,194,2,178
1745,227,253,110.5966439909297,113.38303854875284,26,24,123,3,26
1746,227,410,110.5966439909297,112.40780045351474,26,19,199,2,183
1747,227,410,110.5966439909297,112.43102040816326,26,19,199,2,183
1748,227,641,110.5966439909297,112.52390022675738,26,16,422,2,414
1749,405,4,112.36136054421769,114.12607709750567,26,38,408,2,401
1750,405,6,112.36136054421769,114.93877551020408,26,39,414,3,399
1751,405,253,112.36136054421769,113.38303854875284,26,24,158,1,152
1752,405,211,112.36136054421769,114.19573696145125,26,27,209,2,194
1753,405,564,112.36136054421769,113.91709750566893,26,18,173,2,159
1754,405,537,112.36136054421769,114.47437641723356,26,14,160,2,132
1755,405,745,112.36136054421769,114.28861678004536,26,14,350,2,340
1756,405,720,112.36136054421769,115.17097505668934,26,12,337,3,315
1757,405,825,112.36136054421769,114.72979591836734,26,10,432,2,420
1758,253,6,113.38303854875284,114.93877551020408,24,39,256,2,247
1759,253,4,113.38303854875284,116.33197278911565,24,38,280,3,249
1760,253,249,113.38303854875284,115.4031746031746,24,18,87,2,4
1761,253,363,113.38303854875284,116.26231292517006,24,21,166,3,110
1762,253,537,113.38303854875284,114.47437641723356,24,14,288,1,284
1763,253,602,113.38303854875284,116.05333333333334,24,19,367,3,349
1764,253,720,113.38303854875284,115.17097505668934,24,12,473,2,467
1765,253,633,113.38303854875284,116.05333333333334,24,16,397,3,380
1766,211,4,114.19573696145125,116.33197278911565,27,38,227,2,207
1767,211,7,114.19573696145125,116.70349206349206,27,39,231,3,204
1768,211,249,114.19573696145125,115.4031746031746,27,18,64,1,38
1769,211,363,114.19573696145125,116.26231292517006,27,21,176,2,152
1770,211,602,114.19573696145125,116.05333333333334,27,19,399,2,391
1771,211,633,114.19573696145125,116.05333333333334,27,16,430,2,422
1772,211,690,114.19573696145125,116.49451247165533,27,14,489,2,479
1773,249,7,115.4031746031746,116.70349206349206,18,39,248,1,242
1774,249,10,115.4031746031746,117.58585034013606,18,38,257,2,239
1775,249,211,115.4031746031746,116.58739229024944,18,32,64,1,38
1776,249,216,115.4031746031746,117.84126984126985,18,29,110,2,33
1777,249,539,115.4031746031746,117.37687074829932,18,17,302,2,290
1778,249,423,115.4031746031746,117.63229024943311,18,23,199,2,174
1779,249,690,115.4031746031746,116.49451247165533,18,14,443,1,441
1780,249,642,115.4031746031746,117.81804988662132,18,16,407,2,393
1781,363,10,116.26231292517006,117.58585034013606,21,38,358,1,353
1782,363,216,116.26231292517006,117.84126984126985,21,29,162,2,147
1783,363,209,116.26231292517006,118.79328798185941,21,32,189,3,154
1784,363,539,116.26231292517006,117.37687074829932,21,17,182,1,176
1785,363,423,116.26231292517006,117.63229024943311,21,23,84,1,60
1786,363,551,116.26231292517006,118.88616780045352,21,14,219,3,188
1787,363,642,116.26231292517006,117.81804988662132,21,16,287,2,279
1788,363,633,116.26231292517006,118.90938775510205,21,13,293,3,270
1789,363,848,116.26231292517006,117.79482993197279,21,11,489,2,485
1790,363,826,116.26231292517006,119.14158730158731,21,10,479,3,463
1791,211,4,116.58739229024944,119.42022675736962,32,39,240,3,207
1792,211,216,116.58739229024944,117.84126984126985,32,29,54,1,5
1793,211,209,116.58739229024944,118.79328798185941,32,32,95,2,2
1794,211,423,116.58739229024944,117.63229024943311,32,23,217,1,212
1795,211,551,116.58739229024944,118.88616780045352,32,14,354,2,340
1796,211,642,116.58739229024944,117.81804988662132,32,16,434,1,431
1797,211,633,116.58739229024944,118.90938775510205,32,13,434,2,422
1798,216,4,117.84126984126985,119.42022675736962,29,39,223,2,212
1799,216,4,117.84126984126985,119.8381859410431,29,38,229,2,212
1800,216,10,117.84126984126985,120.67410430839003,29,39,239,3,206
1801,216,249,117.84126984126985,120.44190476190477,29,26,117,3,33
1802,216,258,117.84126984126985,120.51156462585034,29,26,122,3,42
1803,216,551,117.84126984126985,118.88616780045352,29,14,338,1,335
1804,216,542,117.84126984126985,119.74530612244898,29,18,336,2,326
1805,216,633,117.84126984126985,118.90938775510205,29,13,420,1,417
1806,209,4,118.79328798185941,119.8381859410431,32,38,210,1,205
1807,209,10,118.79328798185941,120.67410430839003,32,39,215,2,199
1808,209,249,118.79328798185941,120.44190476190477,32,26,81,2,40
1809,209,258,118.79328798185941,120.51156462585034,32,26,89,2,49
1810,209,410,118.79328798185941,121.16172335600908,32,19,225,2,201
1811,209,538,118.79328798185941,121.53324263038549,32,16,350,3,329
1812,249,6,120.44190476190477,121.99764172335601,26,40,252,2,243
1813,249,51,120.44190476190477,122.99609977324263,26,38,227,3,198
1814,249,253,120.44190476190477,122.06730158730159,26,25,70,2,4
1815,249,228,120.44190476190477,122.97287981859411,26,22,111,3,21
1816,249,538,120.44190476190477,121.53324263038549,26,16,293,1,289
1817,249,426,120.44190476190477,122.76390022675737,26,15,203,2,177
1818,249,640,120.44190476190477,121.78866213151927,26,14,395,1,391
1819,249,640,120.44190476190477,123.11219954648526,26,13,408,3,391
1820,258,6,120.51156462585034,121.99764172335601,26,40,260,1,252
1821,258,51,120.51156462585034,122.99609977324263,26,38,233,2,207
1822,258,253,120.51156462585034,122.06730158730159,26,25,67,2,5
1823,258,228,120.51156462585034,122.97287981859411,26,22,110,2,30
1824,258,538,120.51156462585034,121.53324263038549,26,16,283,1,280
1825,258,426,120.51156462585034,122.76390022675737,26,15,194,2,168
1826,258,640,120.51156462585034,121.78866213151927,26,14,386,1,382
1827,258,640,120.51156462585034,123.11219954648526,26,13,398,3,382
1828,253,5,122.06730158730159,123.80879818594104,25,37,259,2,248
1829,253,226,122.06730158730159,123.57659863945578,25,23,70,2,27
1830,253,590,122.06730158730159,124.36607709750567,25,15,351,2,337
1831,253,425,122.06730158730159,124.71437641723357,25,19,206,3,172
1832,253,640,122.06730158730159,123.11219954648526,25,13,390,1,387
1833,253,671,122.06730158730159,124.38929705215419,25,22,430,2,418
1834,228,6,122.97287981859411,125.08589569160998,22,38,240,2,222
1835,228,7,122.97287981859411,125.52707482993198,22,39,247,3,221
1836,228,590,122.97287981859411,124.36607709750567,22,15,367,1,362
1837,228,425,122.97287981859411,124.71437641723357,22,19,211,2,197
1838,228,422,122.97287981859411,125.5502947845805,22,17,224,3,194
1839,228,671,122.97287981859411,124.38929705215419,22,22,447,1,443
1840,228,664,122.97287981859411,125.4574149659864,22,18,449,2,436
1841,228,726,122.97287981859411,125.48063492063493,22,19,510,3,498
1842,226,6,123.57659863945578,125.08589569160998,23,38,229,2,220
1843,226,7,123.57659863945578,125.52707482993198,23,39,235,2,219
1844,226,228,123.57659863945578,125.17877551020409,23,24,69,2,2
1845,226,406,123.57659863945578,126.20045351473924,23,23,213,3,180
1846,226,425,123.57659863945578,124.71437641723357,23,19,205,1,199
1847,226,422,123.57659863945578,125.5502947845805,23,17,214,2,196
1848,226,664,123.57659863945578,125.4574149659864,23,18,445,2,438
1849,228,4,125.17877551020409,126.92027210884353,24,39,236,2,224
1850,228,406,125.17877551020409,126.20045351473924,24,23,183,1,178
1851,228,218,125.17877551020409,127.47755102040817,24,21,100,2,10
1852,228,412,125.17877551020409,126.57197278911565,24,16,194,1,184
1853,228,599,125.17877551020409,128.05804988662132,24,20,391,3,371
1854,228,615,125.17877551020409,126.64163265306122,24,13,392,1,387
1855,406,7,126.20045351473924,128.17414965986396,23,39,408,2,399
1856,406,7,126.20045351473924,128.61532879818594,23,38,412,2,399
1857,406,218,126.20045351473924,127.47755102040817,23,21,196,1,188
1858,406,215,126.20045351473924,128.220589569161,23,27,210,2,191
1859,406,385,126.20045351473924,128.52244897959184,23,23,102,2,21
1860,406,599,126.20045351473924,128.05804988662132,23,20,209,2,193
1861,406,538,126.20045351473924,128.59210884353743,23,15,167,2,132
1862,406,641,126.20045351473924,128.4063492063492,23,16,253,2,235
1863,406,638,126.20045351473924,128.82430839002268,23,13,258,3,232
1864,406,896,126.20045351473924,127.94195011337868,23,11,496,2,490
1865,218,7,127.47755102040817,128.61532879818594,21,38,217,1,211
1866,218,4,127.47755102040817,130.0085260770975,21,39,240,3,214
1867,218,385,127.47755102040817,128.52244897959184,21,23,173,1,167
1868,218,228,127.47755102040817,129.75310657596373,21,24,99,2,10
1869,218,538,127.47755102040817,128.59210884353743,21,15,324,1,320
1870,218,574,127.47755102040817,130.24072562358276,21,17,375,3,356
1871,218,638,127.47755102040817,128.82430839002268,21,13,424,1,420
1872,218,631,127.47755102040817,129.7298866213152,21,14,424,2,413
1873,215,4,128.220589569161,130.0085260770975,27,39,225,2,211
1874,215,7,128.220589569161,130.82122448979592,27,40,236,3,208
1875,215,228,128.220589569161,129.75310657596373,27,24,67,2,13
1876,215,211,128.220589569161,130.70512471655329,27,28,107,2,4
1877,215,574,128.220589569161,130.24072562358276,27,17,369,2,359
1878,215,422,128.220589569161,130.65868480725624,27,21,232,2,207
1879,215,631,128.220589569161,129.7298866213152,27,14,421,2,416
1880,385,4,128.52244897959184,130.0085260770975,23,39,386,1,381
1881,385,7,128.52244897959184,130.82122448979592,23,40,391,2,378
1882,385,228,128.52244897959184,129.75310657596373,23,24,166,1,157
1883,385,211,128.52244897959184,130.70512471655329,23,28,198,2,174
1884,385,574,128.52244897959184,130.24072562358276,23,17,203,2,189
1885,385,422,128.52244897959184,130.65868480725624,23,21,99,2,37
1886,385,631,128.52244897959184,129.7298866213152,23,14,251,1,246
1887,385,641,128.52244897959184,131.49460317460318,23,13,286,3,256
1888,385,825,128.52244897959184,131.49460317460318,23,12,458,3,440
1889,228,7,129.75310657596373,130.82122448979592,24,40,226,1,221
1890,228,10,129.75310657596373,131.70358276643992,24,38,234,2,218
1891,228,230,129.75310657596373,131.79646258503402,24,30,88,2,2
1892,228,431,129.75310657596373,131.79646258503402,24,19,221,2,203
1893,228,641,129.75310657596373,131.49460317460318,24,13,420,2,413
1894,228,640,129.75310657596373,132.35374149659864,24,14,427,3,412
1895,211,6,130.70512471655329,133.0271201814059,28,38,228,2,205
1896,211,230,130.70512471655329,131.79646258503402,28,30,51,1,19
1897,211,214,130.70512471655329,132.81814058956917,28,33,91,2,3
1898,211,227,130.70512471655329,133.51473922902494,28,25,122,3,16
1899,211,431,130.70512471655329,131.79646258503402,28,19,225,1,220
1900,211,419,130.70512471655329,133.44507936507938,28,15,239,3,208
1901,211,640,130.70512471655329,132.35374149659864,28,14,435,2,429
1902,211,632,130.70512471655329,133.23609977324264,28,14,435,3,421
1903,211,630,130.70512471655329,133.67727891156463,28,14,438,3,419
1904,230,6,131.79646258503402,133.0271201814059,30,38,230,1,224
1905,230,5,131.79646258503402,134.42031746031745,30,40,252,3,225
1906,230,214,131.79646258503402,132.81814058956917,30,33,47,1,16
1907,230,227,131.79646258503402,133.51473922902494,30,25,74,2,3
1908,230,419,131.79646258503402,133.44507936507938,30,15,202,2,189
1909,230,551,131.79646258503402,134.1881179138322,30,14,337,2,321
1910,230,632,131.79646258503402,133.23609977324264,30,14,407,1,402
1911,230,630,131.79646258503402,133.67727891156463,30,14,408,2,400
1912,214,5,132.81814058956917,134.42031746031745,33,40,220,2,209
1913,214,5,132.81814058956917,135.0704761904762,33,40,230,2,209
1914,214,407,132.81814058956917,135.27945578231294,33,21,220,2,193
1915,214,551,132.81814058956917,134.1881179138322,33,14,342,1,337
1916,214,604,132.81814058956917,135.2562358276644,33,17,404,2,390
1917,214,515,132.81814058956917,135.67419501133787,33,18,325,3,301
1918,214,626,132.81814058956917,135.32589569161,33,16,426,3,412
1919,227,5,133.51473922902494,135.0704761904762,25,40,232,2,222
1920,227,7,133.51473922902494,136.11537414965986,25,39,247,3,220
1921,227,407,133.51473922902494,135.27945578231294,25,21,195,2,180
1922,227,214,133.51473922902494,135.58131519274377,25,23,90,2,13
1923,227,604,133.51473922902494,135.2562358276644,25,17,384,2,377
1924,227,515,133.51473922902494,135.67419501133787,25,18,303,2,288
1925,227,626,133.51473922902494,135.32589569161,25,16,407,2,399
1926,227,629,133.51473922902494,135.8831746031746,25,17,415,2,402
1927,407,4,135.27945578231294,137.06739229024944,21,39,410,2,403
1928,407,6,135.27945578231294,137.88009070294785,21,39,416,3,401
1929,407,345,135.27945578231294,137.0209523809524,21,24,97,2,62
1930,407,230,135.27945578231294,137.60145124716553,21,26,203,2,177
1931,407,478,135.27945578231294,136.78875283446712,21,19,96,2,71
1932,407,631,135.27945578231294,137.0209523809524,21,16,236,2,224
1933,407,905,135.27945578231294,136.3243537414966,21,10,500,1,498
1934,407,821,135.27945578231294,136.78875283446712,21,12,419,2,414
1935,214,4,135.58131519274377,137.06739229024944,23,39,220,1,210
1936,214,6,135.58131519274377,137.88009070294785,23,39,230,2,208
1937,214,345,135.58131519274377,137.0209523809524,23,24,145,1,131
1938,214,230,135.58131519274377,137.60145124716553,23,26,88,2,16
1939,214,478,135.58131519274377,136.78875283446712,23,19,269,1,264
1940,214,410,135.58131519274377,138.32126984126984,23,22,229,3,196
1941,214,631,135.58131519274377,137.0209523809524,23,16,422,1,417
1942,214,615,135.58131519274377,138.32126984126984,23,16,418,3,401
1943,214,658,135.58131519274377,138.55346938775511,23,17,462,3,444
1944,345,4,137.0209523809524,138.8321088435374,24,39,350,2,341
1945,345,7,137.0209523809524,139.64480725623582,24,39,356,3,338
1946,345,229,137.0209523809524,139.43582766439908,24,23,156,2,116
1947,345,410,137.0209523809524,138.32126984126984,24,22,86,1,65
1948,345,424,137.0209523809524,139.2500680272109,24,20,124,2,79
1949,345,615,137.0209523809524,138.32126984126984,24,16,276,1,270
1950,345,658,137.0209523809524,138.55346938775511,24,17,320,2,313
1951,345,826,137.0209523809524,138.55346938775511,24,13,486,2,481
1952,230,4,137.60145124716553,138.8321088435374,26,39,232,1,226
1953,230,7,137.60145124716553,139.64480725623582,26,39,240,2,223
1954,230,229,137.60145124716553,139.43582766439908,26,23,79,2,1
1955,230,424,137.60145124716553,139.2500680272109,26,20,207,2,194
1956,230,461,137.60145124716553,140.10920634920635,26,16,255,3,231
1957,230,724,137.60145124716553,140.29496598639457,26,12,507,3,494
1958,229,4,139.43582766439908,140.5968253968254,23,39,230,1,225
1959,229,23,139.43582766439908,141.96680272108844,23,39,233,3,206
1960,229,300,139.43582766439908,140.99156462585034,23,23,98,2,71
1961,229,351,139.43582766439908,141.8274829931973,23,22,160,2,122
1962,229,428,139.43582766439908,141.17732426303854,23,14,213,2,199
1963,229,465,139.43582766439908,141.8274829931973,23,15,257,2,236
1964,229,690,139.43582766439908,141.17732426303854,23,14,467,2,461
1965,229,720,139.43582766439908,141.64172335600907,23,12,500,2,491
1966,230,23,140.13242630385488,141.96680272108844,26,39,222,2,207
1967,230,351,140.13242630385488,141.8274829931973,26,22,141,2,121
1968,230,428,140.13242630385488,141.17732426303854,26,14,203,1,198
1969,230,465,140.13242630385488,141.8274829931973,26,15,246,2,235
1970,230,600,140.13242630385488,142.84916099773244,26,19,388,3,370
1971,230,690,140.13242630385488,141.17732426303854,26,14,462,1,460
1972,230,720,140.13242630385488,141.64172335600907,26,12,494,2,490
1973,230,624,140.13242630385488,142.8259410430839,26,17,411,3,394
1974,300,22,140.99156462585034,143.15102040816328,23,37,293,2,278
1975,300,205,140.99156462585034,143.19746031746033,23,17,134,2,95
1976,300,600,140.99156462585034,142.84916099773244,23,19,310,2,300
1977,300,577,140.99156462585034,143.75473922902495,23,21,301,3,277
1978,300,624,140.99156462585034,142.8259410430839,23,17,333,2,324
1979,300,625,140.99156462585034,143.801179138322,23,19,347,3,325
1980,351,22,141.8274829931973,143.15102040816328,22,37,334,1,329
1981,351,23,141.8274829931973,144.47455782312926,22,37,347,3,328
1982,351,205,141.8274829931973,143.19746031746033,22,17,157,1,146
1983,351,223,141.8274829931973,144.10303854875283,22,22,161,2,128
1984,351,600,141.8274829931973,142.84916099773244,22,19,253,1,249
1985,351,577,141.8274829931973,143.75473922902495,22,21,241,2,226
1986,351,582,141.8274829931973,144.7764172335601,22,17,264,3,231
1987,351,625,141.8274829931973,143.801179138322,22,19,287,2,274
1988,205,23,143.19746031746033,144.47455782312926,17,37,190,1,182
1989,205,23,143.19746031746033,145.10149659863947,17,37,200,2,182
1990,205,222,143.19746031746033,145.0550566893424,17,20,82,2,17
1991,205,211,143.19746031746033,146.0302947845805,17,16,122,3,6
1992,205,582,143.19746031746033,144.7764172335601,17,17,383,2,377
1993,205,624,143.19746031746033,145.4033560090703,17,18,430,2,419
1994,205,631,143.19746031746033,146.0302947845805,17,10,443,3,426
1995,223,43,144.10303854875283,146.51791383219955,22,35,208,2,180
1996,223,211,144.10303854875283,146.0302947845805,22,16,84,2,12
1997,223,573,144.10303854875283,146.49469387755101,22,13,365,2,350
1998,223,624,144.10303854875283,145.4033560090703,22,18,405,1,401
1999,223,631,144.10303854875283,146.0302947845805,22,10,416,2,408
2000,223,627,144.10303854875283,146.68045351473924,22,11,419,3,404
2001,222,43,145.0550566893424,146.51791383219955,20,35,190,1,179
2002,222,45,145.0550566893424,147.4467120181406,20,36,205,2,177
2003,222,45,145.0550566893424,147.65569160997734,20,38,209,3,177
2004,222,205,145.0550566893424,147.42349206349206,20,22,103,2,17
2005,222,573,145.0550566893424,146.49469387755101,20,13,356,1,351
2006,222,428,145.0550566893424,147.49315192743765,20,15,231,2,206
2007,222,627,145.0550566893424,146.68045351473924,20,11,411,2,405
2008,222,667,145.0550566893424,147.8878911564626,20,14,461,3,445
2009,211,45,146.0302947845805,147.4467120181406,16,36,177,1,166
2010,211,45,146.0302947845805,147.65569160997734,16,38,180,2,166
2011,211,52,146.0302947845805,148.83990929705215,16,39,200,3,159
2012,211,205,146.0302947845805,147.42349206349206,16,22,60,1,6
2013,211,224,146.0302947845805,148.5380498866213,16,26,109,3,13
2014,211,229,146.0302947845805,148.6077097505669,16,30,112,3,18
2015,211,428,146.0302947845805,147.49315192743765,16,15,226,1,217
2016,211,481,146.0302947845805,148.09687074829932,16,14,284,2,270
2017,211,549,146.0302947845805,148.65414965986395,16,17,356,3,338
2018,211,667,146.0302947845805,147.8878911564626,16,14,463,2,456
2019,205,52,147.42349206349206,148.83990929705215,22,39,165,1,153
2020,205,6,147.42349206349206,150.23310657596372,22,39,233,3,199
2021,205,224,147.42349206349206,148.5380498866213,22,26,52,1,19
2022,205,229,147.42349206349206,148.6077097505669,22,30,56,1,24
2023,205,252,147.42349206349206,150.02412698412698,22,19,121,3,47
2024,205,549,147.42349206349206,148.65414965986395,22,17,348,1,344
2025,205,515,147.42349206349206,149.65260770975058,22,18,325,2,310
2026,205,633,147.42349206349206,149.35074829931972,22,16,436,2,428
2027,205,625,147.42349206349206,150.00090702947847,22,16,434,3,420
2028,224,6,148.5380498866213,150.23310657596372,26,39,230,2,218
2029,224,6,148.5380498866213,151.11546485260772,26,39,245,3,218
2030,224,252,148.5380498866213,150.02412698412698,26,19,70,1,28
2031,224,205,148.5380498866213,150.90648526077098,26,24,104,2,19
2032,224,515,148.5380498866213,149.65260770975058,26,18,295,1,291
2033,224,472,148.5380498866213,151.11546485260772,26,14,272,3,248
2034,224,625,148.5380498866213,150.00090702947847,26,16,406,1,401
2035,224,653,148.5380498866213,151.04580498866213,26,15,442,3,429
2036,229,6,148.6077097505669,150.23310657596372,30,39,234,2,223
2037,229,6,148.6077097505669,151.11546485260772,30,39,248,3,223
2038,229,252,148.6077097505669,150.02412698412698,30,19,65,1,23
2039,229,205,148.6077097505669,150.90648526077098,30,24,102,2,24
2040,229,515,148.6077097505669,149.65260770975058,30,18,290,1,286
2041,229,472,148.6077097505669,151.11546485260772,30,14,266,3,243
2042,229,625,148.6077097505669,150.00090702947847,30,16,401,1,396
2043,229,653,148.6077097505669,151.04580498866213,30,15,437,2,424
2044,252,6,150.02412698412698,151.11546485260772,19,39,250,1,246
2045,252,6,150.02412698412698,151.9978231292517,19,38,260,2,246
2046,252,60,150.02412698412698,152.92662131519273,19,38,229,3,192
2047,252,229,150.02412698412698,151.9049433106576,19,22,84,2,23
2048,252,336,150.02412698412698,152.69442176870749,19,28,142,3,84
2049,252,472,150.02412698412698,151.11546485260772,19,14,225,1,220
2050,252,483,150.02412698412698,152.41578231292516,19,14,253,2,231
2051,252,653,150.02412698412698,151.04580498866213,19,15,403,1,401
2052,252,676,150.02412698412698,151.76562358276644,19,16,431,2,424
2053,205,6,150.90648526077098,151.9978231292517,24,38,204,1,199
2054,205,60,150.90648526077098,152.92662131519273,24,38,169,2,145
2055,205,336,150.90648526077098,152.69442176870749,24,28,152,2,131
2056,205,483,150.90648526077098,152.41578231292516,24,14,285,2,278
2057,205,544,150.90648526077098,153.04272108843537,24,17,351,2,339
2058,205,617,150.90648526077098,153.53034013605443,24,15,427,3,412
2059,229,60,151.9049433106576,152.92662131519273,22,38,175,1,169
2060,229,6,151.9049433106576,154.2037188208617,22,38,244,2,223
2061,229,351,151.9049433106576,153.99473922902496,22,26,152,2,122
2062,229,544,151.9049433106576,153.04272108843537,22,17,319,1,315
2063,229,541,151.9049433106576,154.18049886621316,22,14,327,2,312
2064,229,617,151.9049433106576,153.53034013605443,22,15,394,2,388
2065,229,719,151.9049433106576,154.55201814058958,22,18,503,3,490
2066,229,720,151.9049433106576,154.85387755102042,22,21,507,3,491
2067,336,6,152.69442176870749,154.2037188208617,28,38,336,2,330
2068,336,4,152.69442176870749,155.364716553288,28,41,351,3,332
2069,336,351,152.69442176870749,153.99473922902496,28,26,58,1,15
2070,336,354,152.69442176870749,155.57369614512473,28,27,125,3,18
2071,336,541,152.69442176870749,154.18049886621316,28,14,215,1,205
2072,336,432,152.69442176870749,155.06285714285715,28,22,140,2,96
2073,336,719,152.69442176870749,154.55201814058958,28,18,391,2,383
2074,336,720,152.69442176870749,154.85387755102042,28,21,395,2,384
2075,336,825,152.69442176870749,153.99473922902496,28,12,492,1,489
2076,351,4,153.99473922902496,155.364716553288,26,41,352,1,347
2077,351,4,153.99473922902496,156.47927437641724,26,41,363,2,347
2078,351,58,153.99473922902496,156.64181405895692,26,38,314,3,293
2079,351,354,153.99473922902496,155.57369614512473,26,27,68,2,3
2080,351,250,153.99473922902496,155.73623582766442,26,26,126,2,101
2081,351,223,153.99473922902496,156.64181405895692,26,22,171,3,128
2082,351,432,153.99473922902496,155.06285714285715,26,22,93,1,81
2083,351,461,153.99473922902496,156.06131519274376,26,19,141,2,110
2084,351,515,153.99473922902496,156.82757369614512,26,18,204,3,164
2085,351,619,153.99473922902496,156.1774149659864,26,18,284,2,268
2086,351,655,153.99473922902496,156.6185941043084,26,16,324,3,304
2087,354,58,155.57369614512473,156.64181405895692,27,38,300,1,296
2088,354,5,155.57369614512473,158.2439909297052,27,38,367,3,349
2089,354,223,155.57369614512473,156.64181405895692,27,22,139,1,131
2090,354,229,155.57369614512473,158.2439909297052,27,29,170,3,125
2091,354,515,155.57369614512473,156.82757369614512,27,18,170,1,161
2092,354,427,155.57369614512473,158.0350113378685,27,20,129,2,73
2093,354,655,155.57369614512473,156.6185941043084,27,16,304,1,301
2094,354,617,155.57369614512473,158.4065306122449,27,17,290,3,263
2095,354,825,155.57369614512473,157.9653514739229,27,12,482,2,471
2096,250,5,155.73623582766442,158.2439909297052,26,38,268,3,245
2097,250,229,155.73623582766442,158.2439909297052,26,29,110,3,21
2098,250,515,155.73623582766442,156.82757369614512,26,18,269,1,265
2099,250,427,155.73623582766442,158.0350113378685,26,20,203,2,177
2100,250,617,155.73623582766442,158.4065306122449,26,17,385,3,367
2101,223,5,156.64181405895692,158.2439909297052,22,38,229,2,218
2102,223,17,156.64181405895692,159.26566893424035,22,34,235,3,206
2103,223,229,156.64181405895692,158.2439909297052,22,29,69,2,6
2104,223,299,156.64181405895692,159.54430839002268,22,24,146,3,76
2105,223,427,156.64181405895692,158.0350113378685,22,20,213,1,204
2106,223,483,156.64181405895692,159.4746485260771,22,18,287,3,260
2107,223,617,156.64181405895692,158.4065306122449,22,17,401,2,394
2108,223,681,156.64181405895692,158.82448979591837,22,15,468,2,458
2109,229,17,158.2439909297052,159.26566893424035,29,34,217,1,212
2110,229,4,158.2439909297052,160.0087074829932,29,40,237,2,225
2111,229,299,158.2439909297052,159.54430839002268,29,24,90,1,70
2112,229,208,158.2439909297052,160.58920634920636,29,30,103,2,21
2113,229,483,158.2439909297052,159.4746485260771,29,18,259,1,254
2114,229,411,158.2439909297052,160.61242630385487,29,25,209,2,182
2115,229,411,158.2439909297052,160.6356462585034,29,22,209,2,182
2116,299,4,159.54430839002268,161.6108843537415,24,37,308,2,295
2117,299,54,159.54430839002268,161.93596371882086,24,37,266,2,245
2118,299,208,159.54430839002268,160.58920634920636,24,30,102,1,91
2119,299,278,159.54430839002268,162.44680272108843,24,22,127,3,21
2120,299,411,159.54430839002268,160.61242630385487,24,25,121,1,112
2121,299,411,159.54430839002268,160.6356462585034,24,22,121,1,112
2122,299,415,159.54430839002268,161.7037641723356,24,22,149,2,116
2123,299,642,159.54430839002268,162.35392290249433,24,15,364,3,343
2124,208,4,160.58920634920636,161.6108843537415,30,37,209,1,204
2125,208,54,160.58920634920636,161.93596371882086,30,37,165,1,154
2126,208,4,160.58920634920636,163.53814058956917,30,38,240,3,204
2127,208,278,160.58920634920636,162.44680272108843,30,22,106,2,70
2128,208,244,160.58920634920636,163.49170068027212,30,31,130,3,36
2129,208,415,160.58920634920636,161.7037641723356,30,22,212,1,207
2130,208,535,160.58920634920636,163.32916099773243,30,25,348,3,327
2131,208,642,160.58920634920636,162.35392290249433,30,15,441,2,434
2132,208,620,160.58920634920636,163.32916099773243,30,20,429,3,412
2133,299,4,161.58766439909297,163.53814058956917,24,38,307,2,295
2134,299,4,161.58766439909297,163.6542403628118,24,35,308,2,295
2135,299,244,161.58766439909297,163.49170068027212,24,31,99,2,55
2136,299,381,161.58766439909297,164.0954195011338,24,26,136,3,82
2137,299,535,161.58766439909297,163.32916099773243,24,25,248,2,236
2138,299,419,161.58766439909297,164.11863945578233,24,24,162,3,120
2139,299,620,161.58766439909297,163.32916099773243,24,20,330,2,321
2140,299,701,161.58766439909297,164.0954195011338,24,17,416,3,402
2141,278,4,162.44680272108843,163.53814058956917,22,38,278,1,274
2142,278,4,162.44680272108843,163.6542403628118,22,35,279,1,274
2143,278,62,162.44680272108843,165.2564172335601,22,39,248,3,216
2144,278,244,162.44680272108843,163.49170068027212,22,31,56,1,34
2145,278,381,162.44680272108843,164.0954195011338,22,26,125,2,103
2146,278,240,162.44680272108843,165.34929705215418,22,24,131,3,38
2147,278,419,162.44680272108843,164.11863945578233,22,24,158,2,141
2148,278,701,162.44680272108843,164.0954195011338,22,17,429,2,423
2149,244,62,163.49170068027212,165.2564172335601,31,39,197,2,182
2150,244,61,163.49170068027212,165.65115646258505,31,36,205,2,183
2151,244,240,163.49170068027212,165.34929705215418,31,24,80,2,4
2152,244,256,163.49170068027212,165.99945578231294,31,26,109,3,12
2153,244,569,163.49170068027212,165.46539682539682,31,17,336,2,325
2154,244,422,163.49170068027212,165.92979591836735,31,20,207,2,178
2155,244,633,163.49170068027212,165.5350566893424,31,15,399,2,389
2156,244,619,163.49170068027212,165.9762358276644,31,15,390,2,375
2157,381,62,164.0954195011338,165.2564172335601,26,39,323,1,319
2158,381,61,164.0954195011338,165.65115646258505,26,36,327,2,320
2159,381,5,164.0954195011338,167.06757369614513,26,39,397,3,376
2160,381,240,164.0954195011338,165.34929705215418,26,24,151,1,141
2161,381,256,164.0954195011338,165.99945578231294,26,26,149,2,125
2162,381,569,164.0954195011338,165.46539682539682,26,17,197,1,188
2163,381,422,164.0954195011338,165.92979591836735,26,20,89,2,41
2164,381,423,164.0954195011338,167.06757369614513,26,22,135,3,42
2165,381,633,164.0954195011338,165.5350566893424,26,15,260,1,252
2166,381,619,164.0954195011338,165.9762358276644,26,15,251,2,238
2167,240,5,165.34929705215418,167.06757369614513,24,39,246,2,235
2168,240,210,165.34929705215418,167.5784126984127,24,34,101,2,30
2169,240,212,165.34929705215418,168.18213151927438,24,32,125,3,28
2170,240,423,165.34929705215418,167.06757369614513,24,22,197,2,183
2171,240,470,165.34929705215418,168.29823129251702,24,17,263,3,230
2172,256,5,165.99945578231294,167.06757369614513,26,39,255,1,251
2173,256,5,165.99945578231294,168.36789115646258,26,39,271,2,251
2174,256,210,165.99945578231294,167.5784126984127,26,34,82,2,46
2175,256,212,165.99945578231294,168.18213151927438,26,32,104,2,44
2176,256,218,165.99945578231294,168.7161904761905,26,25,123,3,38
2177,256,423,165.99945578231294,167.06757369614513,26,22,173,1,167
2178,256,470,165.99945578231294,168.29823129251702,26,17,236,2,214
2179,210,5,167.5784126984127,169.48244897959185,34,40,221,2,205
2180,210,218,167.5784126984127,168.7161904761905,34,25,50,1,8
2181,210,248,167.5784126984127,169.76108843537415,34,20,101,2,38
2182,210,580,167.5784126984127,169.13414965986394,34,19,376,2,370
2183,210,515,167.5784126984127,170.20226757369616,34,20,325,3,305
2184,210,691,167.5784126984127,169.59854875283446,34,25,489,2,481
2185,212,5,168.18213151927438,169.48244897959185,32,40,214,1,207
2186,212,5,168.18213151927438,170.5970068027211,32,39,232,2,207
2187,212,248,168.18213151927438,169.76108843537415,32,20,77,2,36
2188,212,342,168.18213151927438,171.13106575963718,32,26,182,3,130
2189,212,515,168.18213151927438,170.20226757369616,32,20,315,2,303
2190,212,515,168.18213151927438,170.82920634920634,32,17,324,3,303
2191,212,691,168.18213151927438,169.59854875283446,32,25,483,1,479
2192,218,5,168.7161904761905,170.5970068027211,25,39,228,2,213
2193,218,58,168.7161904761905,171.64190476190475,25,40,204,3,160
2194,218,248,168.7161904761905,169.76108843537415,25,20,54,1,30
2195,218,342,168.7161904761905,171.13106575963718,25,26,162,2,124
2196,218,515,168.7161904761905,170.20226757369616,25,20,304,1,297
2197,218,515,168.7161904761905,170.82920634920634,25,17,311,2,297
2198,248,58,169.76108843537415,171.64190476190475,20,40,207,2,190
2199,248,4,169.76108843537415,172.36172335600907,20,38,268,3,244
2200,248,6,169.76108843537415,172.7332426303855,20,37,274,3,242
2201,248,342,169.76108843537415,171.13106575963718,20,26,111,1,94
2202,248,211,169.76108843537415,172.52426303854875,20,18,125,3,37
2203,248,515,169.76108843537415,170.82920634920634,20,17,271,1,267
2204,248,439,169.76108843537415,171.82766439909298,20,16,211,2,191
2205,248,637,169.76108843537415,172.2920634920635,20,17,404,3,389
2206,342,4,171.13106575963718,172.36172335600907,26,38,342,1,338
2207,342,6,171.13106575963718,172.7332426303855,26,37,343,2,336
2208,342,211,171.13106575963718,172.52426303854875,26,18,144,1,131
2209,342,230,171.13106575963718,173.22086167800452,26,22,144,2,112
2210,342,458,171.13106575963718,172.80290249433108,26,20,137,2,116
2211,342,585,171.13106575963718,173.8013605442177,26,16,269,3,243
2212,342,637,171.13106575963718,172.2920634920635,26,17,299,1,295
2213,342,751,171.13106575963718,172.94222222222223,26,16,416,2,409
2214,342,737,171.13106575963718,173.8013605442177,26,20,411,3,395
2215,342,840,171.13106575963718,173.75492063492064,26,15,511,3,498
2216,211,4,172.52426303854875,174.12643990929706,18,37,218,2,207
2217,211,6,172.52426303854875,175.38031746031746,18,37,239,3,205
2218,211,228,172.52426303854875,174.56761904761905,18,23,90,2,17
2219,211,585,172.52426303854875,173.8013605442177,18,16,378,1,374
2220,211,410,172.52426303854875,175.403537414966,18,19,234,3,199
2221,211,710,172.52426303854875,174.84625850340137,18,21,509,2,499
2222,230,6,173.22086167800452,175.38031746031746,22,37,243,2,224
2223,230,4,173.22086167800452,175.89115646258503,22,37,254,3,226
2224,230,228,173.22086167800452,174.56761904761905,22,23,58,1,2
2225,230,252,173.22086167800452,175.61251700680273,22,24,105,2,22
2226,230,214,173.22086167800452,175.86793650793652,22,24,115,3,16
2227,230,410,173.22086167800452,175.403537414966,22,19,203,2,180
2228,230,410,173.22086167800452,175.96081632653062,22,19,215,3,180
2229,230,710,173.22086167800452,174.84625850340137,22,21,485,2,480
2230,230,666,173.22086167800452,176.0304761904762,22,14,452,3,436
2231,228,4,174.56761904761905,175.89115646258503,23,37,231,1,224
2232,228,252,174.56761904761905,175.61251700680273,23,24,51,1,24
2233,228,214,174.56761904761905,175.86793650793652,23,24,58,1,14
2234,228,219,174.56761904761905,176.88961451247167,23,23,100,2,9
2235,228,410,174.56761904761905,175.96081632653062,23,19,192,1,182
2236,228,666,174.56761904761905,176.0304761904762,23,14,443,1,438
2237,228,650,174.56761904761905,176.91283446712018,23,15,434,2,422
2238,252,4,175.61251700680273,177.65587301587303,24,37,263,2,248
2239,252,6,175.61251700680273,178.02739229024942,24,37,267,2,246
2240,252,219,175.61251700680273,176.88961451247167,24,23,64,1,33
2241,252,507,175.61251700680273,177.67909297052154,24,17,270,2,255
2242,252,566,175.61251700680273,178.30603174603175,24,20,335,3,314
2243,252,650,175.61251700680273,176.91283446712018,24,15,402,1,398
2244,252,621,175.61251700680273,178.3292517006803,24,18,387,3,369
2245,214,4,175.86793650793652,177.65587301587303,24,37,224,2,210
2246,214,6,175.86793650793652,178.02739229024942,24,37,228,2,208
2247,214,219,175.86793650793652,176.88961451247167,24,23,44,1,5
2248,214,241,175.86793650793652,178.60789115646259,24,27,121,3,27
2249,214,507,175.86793650793652,177.67909297052154,24,17,303,2,293
2250,214,566,175.86793650793652,178.30603174603175,24,20,367,2,352
2251,214,650,175.86793650793652,176.91283446712018,24,15,438,1,436
2252,214,621,175.86793650793652,178.3292517006803,24,18,421,2,407
2253,219,6,176.88961451247167,178.02739229024942,23,37,219,1,213
2254,219,61,176.88961451247167,179.60634920634922,23,38,197,3,158
2255,219,6,176.88961451247167,179.79210884353742,23,37,247,3,213
2256,219,241,176.88961451247167,178.60789115646259,23,27,77,2,22
2257,219,354,176.88961451247167,179.420589569161,23,28,174,3,135
2258,219,566,176.88961451247167,178.30603174603175,23,20,352,1,347
2259,219,575,176.88961451247167,179.5134693877551,23,17,374,3,356
2260,219,621,176.88961451247167,178.3292517006803,23,18,407,1,402
2261,219,656,176.88961451247167,179.55990929705214,23,16,452,3,437
2262,241,6,178.60789115646259,179.79210884353742,27,37,240,1,235
2263,241,4,178.60789115646259,181.185306122449,27,41,262,3,237
2264,241,211,178.60789115646259,180.1171882086168,27,31,72,2,30
2265,241,214,178.60789115646259,181.39428571428573,27,31,123,3,27
2266,241,422,178.60789115646259,180.07074829931972,27,21,192,1,181
2267,241,552,178.60789115646259,181.53360544217688,27,16,336,3,311
2268,241,685,178.60789115646259,180.44226757369614,27,13,451,2,444
2269,241,630,178.60789115646259,181.32462585034014,27,16,406,3,389
2270,354,4,179.420589569161,181.185306122449,28,41,358,2,350
2271,354,4,179.420589569161,181.8354648526077,28,40,365,2,350
2272,354,214,179.420589569161,181.39428571428573,28,31,164,2,140
2273,354,209,179.420589569161,182.29986394557824,28,31,191,3,145
2274,354,552,179.420589569161,181.53360544217688,28,16,218,2,198
2275,354,685,179.420589569161,180.44226757369614,28,13,334,1,331
2276,354,630,179.420589569161,181.32462585034014,28,16,288,2,276
2277,354,649,179.420589569161,182.20698412698414,28,15,318,3,295
2278,354,848,179.420589569161,180.44226757369614,28,12,496,1,494
2279,211,4,180.1171882086168,181.185306122449,31,41,212,1,207
2280,211,4,180.1171882086168,181.8354648526077,31,40,220,2,207
2281,211,6,180.1171882086168,182.95002267573696,31,41,239,3,205
2282,211,214,180.1171882086168,181.39428571428573,31,31,55,1,3
2283,211,209,180.1171882086168,182.29986394557824,31,31,94,2,2
2284,211,227,180.1171882086168,182.9035827664399,31,27,121,3,16
2285,211,552,180.1171882086168,181.53360544217688,31,16,346,1,341
2286,211,524,180.1171882086168,182.41596371882088,31,16,328,2,313
2287,211,630,180.1171882086168,181.32462585034014,31,16,422,1,419
2288,211,649,180.1171882086168,182.20698412698414,31,15,447,2,438
2289,214,6,181.39428571428573,182.95002267573696,31,41,219,2,208
2290,214,227,181.39428571428573,182.9035827664399,31,27,66,2,13
2291,214,247,181.39428571428573,183.83238095238096,31,24,110,2,33
2292,214,524,181.39428571428573,182.41596371882088,31,16,313,1,310
2293,214,459,181.39428571428573,183.20544217687075,31,19,257,2,245
2294,214,515,181.39428571428573,184.29678004535148,31,19,326,3,301
2295,214,672,181.39428571428573,183.71628117913832,31,21,469,2,458
2296,209,5,182.29986394557824,184.69151927437642,31,40,229,2,204
2297,209,247,182.29986394557824,183.83238095238096,31,24,76,2,38
2298,209,515,182.29986394557824,184.29678004535148,31,19,318,2,306
2299,209,672,182.29986394557824,183.71628117913832,31,21,467,1,463
2300,209,671,182.29986394557824,184.97015873015874,31,17,476,3,462
2301,227,5,182.9035827664399,184.69151927437642,27,40,235,2,222
2302,227,6,182.9035827664399,185.52743764172337,27,39,248,3,221
2303,227,401,182.9035827664399,185.71319727891157,27,26,212,3,174
2304,227,230,182.9035827664399,185.80607709750566,27,26,125,3,3
2305,227,515,182.9035827664399,184.29678004535148,27,19,294,1,288
2306,227,458,182.9035827664399,185.71319727891157,27,20,261,3,231
2307,227,459,182.9035827664399,185.78285714285715,27,20,263,3,232
2308,227,671,182.9035827664399,184.97015873015874,27,17,453,2,444
2309,227,689,182.9035827664399,185.78285714285715,27,17,478,3,462
2310,247,6,183.83238095238096,185.52743764172337,24,39,252,2,241
2311,247,6,183.83238095238096,185.94539682539684,24,39,258,2,241
2312,247,401,183.83238095238096,185.71319727891157,24,26,174,2,154
2313,247,230,183.83238095238096,185.80607709750566,24,26,87,2,17
2314,247,458,183.83238095238096,185.71319727891157,24,20,226,2,211
2315,247,459,183.83238095238096,185.78285714285715,24,20,228,2,212
2316,247,671,183.83238095238096,184.97015873015874,24,17,427,1,424
2317,247,689,183.83238095238096,185.78285714285715,24,17,450,2,442
2318,401,10,185.71319727891157,187.26893424036282,26,39,397,2,391
2319,401,6,185.71319727891157,187.73333333333335,26,38,404,2,395
2320,401,228,185.71319727891157,187.5243537414966,26,24,190,2,173
2321,401,270,185.71319727891157,188.66213151927437,26,25,182,3,131
2322,401,461,185.71319727891157,187.33859410430838,26,18,92,2,60
2323,401,425,185.71319727891157,188.24417233560092,26,21,112,3,24
2324,401,633,185.71319727891157,187.36181405895692,26,18,243,2,232
2325,401,753,185.71319727891157,187.895873015873,26,21,364,2,352
2326,401,896,185.71319727891157,187.0831746031746,26,12,499,1,495
2327,401,847,185.71319727891157,187.895873015873,26,17,456,2,446
2328,230,10,185.80607709750566,187.26893424036282,26,39,229,1,220
2329,230,6,185.80607709750566,187.73333333333335,26,38,239,2,224
2330,230,228,185.80607709750566,187.5243537414966,26,24,74,2,2
2331,230,270,185.80607709750566,188.66213151927437,26,25,129,3,40
2332,230,461,185.80607709750566,187.33859410430838,26,18,240,2,231
2333,230,425,185.80607709750566,188.24417233560092,26,21,221,2,195
2334,230,633,185.80607709750566,187.36181405895692,26,18,409,2,403
2335,228,10,187.5243537414966,189.0336507936508,24,38,227,2,218
2336,228,4,187.5243537414966,190.0088888888889,24,39,248,2,224
2337,228,270,187.5243537414966,188.66213151927437,24,25,65,1,42
2338,228,232,187.5243537414966,188.82467120181406,24,26,56,1,4
2339,228,247,187.5243537414966,189.98566893424038,24,24,108,2,19
2340,228,410,187.5243537414966,189.19619047619048,24,20,196,2,182
2341,228,617,187.5243537414966,189.14975056689343,24,20,395,2,389
2342,270,4,188.66213151927437,190.0088888888889,25,39,272,1,266
2343,270,4,188.66213151927437,191.30920634920636,25,38,289,3,266
2344,270,247,188.66213151927437,189.98566893424038,25,24,61,1,23
2345,270,470,188.66213151927437,190.61260770975056,25,20,217,2,200
2346,270,423,188.66213151927437,191.3556462585034,25,21,192,3,153
2347,270,641,188.66213151927437,191.03056689342404,25,15,385,2,371
2348,232,4,188.82467120181406,190.0088888888889,26,39,234,1,228
2349,232,4,188.82467120181406,191.30920634920636,26,38,252,2,228
2350,232,4,188.82467120181406,191.75038548752835,26,38,260,3,228
2351,232,247,188.82467120181406,189.98566893424038,26,24,52,1,15
2352,232,246,188.82467120181406,191.7271655328798,26,28,126,3,14
2353,232,240,188.82467120181406,191.7968253968254,26,27,128,3,8
2354,232,470,188.82467120181406,190.61260770975056,26,20,250,2,238
2355,232,423,188.82467120181406,191.3556462585034,26,21,220,3,191
2356,232,425,188.82467120181406,191.7968253968254,26,20,232,3,193
2357,232,641,188.82467120181406,191.03056689342404,26,15,420,2,409
2358,232,616,188.82467120181406,191.7736054421769,26,17,404,3,384
2359,247,4,189.98566893424038,191.30920634920636,24,38,250,1,243
2360,247,4,189.98566893424038,191.75038548752835,24,38,255,2,243
2361,247,246,189.98566893424038,191.7271655328798,24,28,75,2,1
2362,247,240,189.98566893424038,191.7968253968254,24,27,78,2,7
2363,247,423,189.98566893424038,191.3556462585034,24,21,186,1,176
2364,247,425,189.98566893424038,191.7968253968254,24,20,194,2,178
2365,247,641,189.98566893424038,191.03056689342404,24,15,397,1,394
2366,247,616,189.98566893424038,191.7736054421769,24,17,377,2,369
2367,246,4,191.7271655328798,193.53832199546486,28,38,254,2,242
2368,246,10,191.7271655328798,194.32780045351475,28,38,261,3,236
2369,246,227,191.7271655328798,193.02748299319728,28,24,59,1,19
2370,246,212,191.7271655328798,194.18848072562358,28,32,111,2,34
2371,246,600,191.7271655328798,193.7473015873016,28,17,365,2,354
2372,246,453,191.7271655328798,194.4903401360544,28,17,239,3,207
2373,246,630,191.7271655328798,193.7473015873016,28,16,394,2,384
2374,246,633,191.7271655328798,194.44390022675736,28,14,404,3,387
2375,240,4,191.7968253968254,193.53832199546486,27,38,248,2,236
2376,240,10,191.7968253968254,194.32780045351475,27,38,255,3,230
2377,240,227,191.7968253968254,193.02748299319728,27,24,55,1,13
2378,240,212,191.7968253968254,194.18848072562358,27,32,107,2,28
2379,240,600,191.7968253968254,193.7473015873016,27,17,370,2,360
2380,240,453,191.7968253968254,194.4903401360544,27,17,243,3,213
2381,240,630,191.7968253968254,193.7473015873016,27,16,399,2,390
2382,240,633,191.7968253968254,194.44390022675736,27,14,409,3,393
2383,227,10,193.02748299319728,194.32780045351475,24,38,224,1,217
2384,227,4,193.02748299319728,195.30303854875285,24,39,244,2,223
2385,227,212,193.02748299319728,194.18848072562358,24,32,52,1,15
2386,227,215,193.02748299319728,195.48879818594105,24,29,107,2,12
2387,227,453,193.02748299319728,194.4903401360544,24,17,235,1,226
2388,227,464,193.02748299319728,195.30303854875285,24,18,256,2,237
2389,227,417,193.02748299319728,195.95319727891157,24,20,228,3,190
2390,227,633,193.02748299319728,194.44390022675736,24,14,411,1,406
2391,227,638,193.02748299319728,195.2798185941043,24,19,422,2,411
2392,212,4,194.18848072562358,195.30303854875285,32,39,213,1,208
2393,212,7,194.18848072562358,196.11573696145126,32,38,221,2,205
2394,212,215,194.18848072562358,195.48879818594105,32,29,56,1,3
2395,212,209,194.18848072562358,196.4175963718821,32,30,96,2,3
2396,212,227,194.18848072562358,196.7891156462585,32,28,113,3,15
2397,212,464,194.18848072562358,195.30303854875285,32,18,257,1,252
2398,212,417,194.18848072562358,195.95319727891157,32,20,219,2,205
2399,212,638,194.18848072562358,195.2798185941043,32,19,429,1,426
2400,212,633,194.18848072562358,196.76589569160998,32,16,435,3,421
2401,215,6,195.48879818594105,197.3928344671202,29,39,225,2,209
2402,215,14,195.48879818594105,198.34485260770975,29,40,236,3,201
2403,215,227,195.48879818594105,196.7891156462585,29,28,57,1,12
2404,215,413,195.48879818594105,197.4857142857143,29,17,216,2,198
2405,215,633,195.48879818594105,196.76589569160998,29,16,422,1,418
2406,209,14,196.4175963718821,198.34485260770975,30,40,212,2,195
2407,209,343,196.4175963718821,198.5538321995465,30,26,163,2,134
2408,209,228,196.4175963718821,198.85569160997733,30,26,107,2,19
2409,209,413,196.4175963718821,197.4857142857143,30,17,209,1,204
2410,209,498,196.4175963718821,198.76281179138323,30,17,306,2,289
2411,209,496,196.4175963718821,198.97179138321997,30,19,307,3,287
2412,227,14,196.7891156462585,198.34485260770975,28,40,223,2,213
2413,227,6,196.7891156462585,199.64517006802723,28,40,253,3,221
2414,227,343,196.7891156462585,198.5538321995465,28,26,139,2,116
2415,227,228,196.7891156462585,198.85569160997733,28,26,89,2,1
2416,227,498,196.7891156462585,198.76281179138323,28,17,284,2,271
2417,227,496,196.7891156462585,198.97179138321997,28,19,285,2,269
2418,227,634,196.7891156462585,199.76126984126984,28,18,427,3,407
2419,343,6,198.5538321995465,199.64517006802723,26,40,340,1,337
2420,343,6,198.5538321995465,200.0863492063492,26,39,343,2,337
2421,343,5,198.5538321995465,201.01514739229026,26,38,354,2,338
2422,343,230,198.5538321995465,200.1792290249433,26,27,133,2,113
2423,343,226,198.5538321995465,201.20090702947846,26,25,163,3,117
2424,343,492,198.5538321995465,200.75972789115647,26,20,177,2,149
2425,343,492,198.5538321995465,200.78294784580498,26,19,177,2,149
2426,343,634,198.5538321995465,199.76126984126984,26,18,296,1,291
2427,343,802,198.5538321995465,199.83092970521542,26,17,462,1,459
2428,343,634,198.5538321995465,201.47954648526078,26,17,317,3,291
2429,343,823,198.5538321995465,200.73650793650793,26,15,489,2,480
2430,228,6,198.85569160997733,200.0863492063492,26,39,228,1,222
2431,228,5,198.85569160997733,201.01514739229026,26,38,242,2,223
2432,228,230,198.85569160997733,200.1792290249433,26,27,57,1,2
2433,228,226,198.85569160997733,201.20090702947846,26,25,101,2,2
2434,228,492,198.85569160997733,200.75972789115647,26,20,276,2,264
2435,228,492,198.85569160997733,200.78294784580498,26,19,277,2,264
2436,228,634,198.85569160997733,201.47954648526078,26,17,421,3,406
2437,230,10,200.1792290249433,202.26902494331065,27,37,238,2,220
2438,230,226,200.1792290249433,201.20090702947846,27,25,44,1,4
2439,230,227,200.1792290249433,202.33868480725624,27,27,93,2,3
2440,230,270,200.1792290249433,202.87274376417233,27,25,123,3,40
2441,230,474,200.1792290249433,202.73342403628118,27,17,268,3,244
2442,230,634,200.1792290249433,201.47954648526078,27,17,408,1,404
2443,230,717,200.1792290249433,202.0368253968254,27,22,494,2,487
2444,230,644,200.1792290249433,203.1281632653061,27,20,433,3,414
2445,226,10,201.20090702947846,202.26902494331065,25,37,221,1,216
2446,226,4,201.20090702947846,203.66222222222223,25,37,246,2,222
2447,226,227,201.20090702947846,202.33868480725624,25,27,49,1,1
2448,226,270,201.20090702947846,202.87274376417233,25,25,84,2,44
2449,226,474,201.20090702947846,202.73342403628118,25,17,257,2,248
2450,226,410,201.20090702947846,203.31392290249434,25,20,205,2,184
2451,226,429,201.20090702947846,204.12662131519275,25,18,239,3,203
2452,226,644,201.20090702947846,203.1281632653061,25,20,426,2,418
2453,227,4,202.33868480725624,203.66222222222223,27,37,230,1,223
2454,227,4,202.33868480725624,204.54458049886622,27,38,242,2,223
2455,227,271,202.33868480725624,204.61424036281178,27,24,107,2,44
2456,227,429,202.33868480725624,204.12662131519275,27,18,216,2,202
2457,270,4,202.87274376417233,204.54458049886622,25,38,276,2,266
2458,270,57,202.87274376417233,205.68235827664398,25,39,245,3,213
2459,270,271,202.87274376417233,204.61424036281178,25,24,75,2,1
2460,270,342,202.87274376417233,205.70557823129252,25,26,142,3,72
2461,270,429,202.87274376417233,204.12662131519275,25,18,168,1,159
2462,270,423,202.87274376417233,205.35727891156463,25,21,187,2,153
2463,270,414,202.87274376417233,205.84489795918367,25,19,193,3,144
2464,270,738,202.87274376417233,204.8,25,15,475,2,468
2465,271,57,204.61424036281178,205.68235827664398,24,39,219,1,214
2466,271,4,204.61424036281178,205.89133786848072,24,39,273,1,267
2467,271,342,204.61424036281178,205.70557823129252,24,26,85,1,71
2468,271,363,204.61424036281178,206.1467573696145,24,27,113,2,92
2469,271,228,204.61424036281178,207.40063492063493,24,26,127,3,43
2470,271,414,204.61424036281178,205.84489795918367,24,19,153,1,143
2471,271,410,204.61424036281178,206.8433560090703,24,20,169,2,139
2472,271,616,204.61424036281178,205.89133786848072,24,16,349,1,345
2473,271,632,204.61424036281178,207.00589569161,24,15,375,2,361
2474,342,4,205.70557823129252,207.63283446712018,26,38,348,2,338
2475,342,4,205.70557823129252,208.51519274376417,26,38,359,3,338
2476,342,228,205.70557823129252,207.40063492063493,26,26,135,2,114
2477,342,211,205.70557823129252,208.3526530612245,26,33,174,3,131
2478,342,410,205.70557823129252,206.8433560090703,26,20,84,1,68
2479,342,422,205.70557823129252,208.28299319727893,26,20,137,3,80
2480,342,632,205.70557823129252,207.00589569161,26,15,295,1,290
2481,342,631,205.70557823129252,208.67773242630386,26,18,316,3,289
2482,363,4,206.1467573696145,207.63283446712018,27,38,365,1,359
2483,363,4,206.1467573696145,208.51519274376417,27,38,373,2,359
2484,363,228,206.1467573696145,207.40063492063493,27,26,145,1,135
2485,363,211,206.1467573696145,208.3526530612245,27,33,179,2,152
2486,363,422,206.1467573696145,208.28299319727893,27,20,109,2,59
2487,363,631,206.1467573696145,208.67773242630386,27,18,289,3,268
2488,228,4,207.40063492063493,208.51519274376417,26,38,229,1,224
2489,228,7,207.40063492063493,209.7690702947846,26,38,243,2,221
2490,228,4,207.40063492063493,209.83873015873016,26,38,247,2,224
2491,228,229,207.40063492063493,209.49043083900227,26,32,90,2,1
2492,228,428,207.40063492063493,209.39755102040817,26,23,218,2,200
2493,228,572,207.40063492063493,210.32634920634922,26,19,366,3,344
2494,228,631,207.40063492063493,208.67773242630386,26,18,407,1,403
2495,228,634,207.40063492063493,209.49043083900227,26,18,416,2,406
2496,211,7,208.3526530612245,209.7690702947846,33,38,213,1,204
2497,211,4,208.3526530612245,209.83873015873016,33,38,217,1,207
2498,211,229,208.3526530612245,209.49043083900227,33,32,52,1,18
2499,211,214,208.3526530612245,210.44244897959183,33,33,90,2,3
2500,211,227,208.3526530612245,211.13904761904763,33,26,121,3,16
2501,211,428,208.3526530612245,209.39755102040817,33,23,222,1,217
2502,211,572,208.3526530612245,210.32634920634922,33,19,371,2,361
2503,211,419,208.3526530612245,211.06938775510204,33,18,239,3,208
2504,211,634,208.3526530612245,209.49043083900227,33,18,426,1,423
2505,211,663,208.3526530612245,210.44244897959183,33,16,461,2,452
2506,229,86,209.49043083900227,211.60344671201815,32,39,169,2,143
2507,229,10,209.49043083900227,212.41614512471656,32,39,253,3,219
2508,229,227,209.49043083900227,211.13904761904763,32,26,71,2,2
2509,229,258,209.49043083900227,212.2768253968254,32,23,123,3,29
2510,229,419,209.49043083900227,211.06938775510204,32,18,202,2,190
2511,229,590,209.49043083900227,211.9285260770975,32,18,376,2,361
2512,229,699,209.49043083900227,211.48734693877552,32,18,478,2,470
2513,214,86,210.44244897959183,211.60344671201815,33,39,137,1,128
2514,214,10,210.44244897959183,212.41614512471656,33,39,221,2,204
2515,214,5,210.44244897959183,212.92698412698414,33,41,235,2,209
2516,214,258,210.44244897959183,212.2768253968254,33,23,90,2,44
2517,214,256,210.44244897959183,212.9037641723356,33,22,114,2,42
2518,214,590,210.44244897959183,211.9285260770975,33,18,381,1,376
2519,214,515,210.44244897959183,213.20562358276644,33,19,324,3,301
2520,214,699,210.44244897959183,211.48734693877552,33,18,487,1,485
2521,214,626,210.44244897959183,212.95020408163265,33,17,426,3,412
2522,227,10,211.13904761904763,212.41614512471656,26,39,224,1,217
2523,227,5,211.13904761904763,212.92698412698414,26,41,235,2,222
2524,227,258,211.13904761904763,212.2768253968254,26,23,58,1,31
2525,227,256,211.13904761904763,212.9037641723356,26,22,81,2,29
2526,227,222,211.13904761904763,214.11120181405897,26,13,128,3,5
2527,227,515,211.13904761904763,213.20562358276644,26,19,301,2,288
2528,227,515,211.13904761904763,213.8557823129252,26,12,311,3,288
2529,227,626,211.13904761904763,212.95020408163265,26,17,407,2,399
2530,258,10,212.2768253968254,214.7845804988662,23,38,270,3,248
2531,258,10,212.2768253968254,214.92390022675738,23,38,273,3,248
2532,258,222,212.2768253968254,214.11120181405897,23,13,87,2,36
2533,258,515,212.2768253968254,213.8557823129252,23,12,266,2,257
2534,256,10,212.9037641723356,214.7845804988662,22,38,259,2,246
2535,256,10,212.9037641723356,214.92390022675738,22,38,261,2,246
2536,256,222,212.9037641723356,214.11120181405897,22,13,62,1,34
2537,256,298,212.9037641723356,215.3882993197279,22,12,115,2,42
2538,222,21,214.11120181405897,216.17777777777778,13,39,220,2,201
2539,222,298,214.11120181405897,215.3882993197279,13,12,94,1,76
2540,222,243,214.11120181405897,216.38675736961451,13,15,100,2,21
2541,298,6,215.3882993197279,217.57097505668935,12,38,307,2,292
2542,298,220,215.3882993197279,217.50131519274376,12,14,120,2,78
2543,298,267,215.3882993197279,218.12825396825397,12,14,122,3,31
2544,243,6,216.38675736961451,217.57097505668935,15,38,242,1,237
2545,243,10,216.38675736961451,218.5926530612245,15,43,252,2,233
2546,243,220,216.38675736961451,217.50131519274376,15,14,53,1,23
2547,243,267,216.38675736961451,218.12825396825397,15,14,79,2,24
2548,243,221,216.38675736961451,219.01061224489797,15,17,115,3,22
2549,220,10,217.50131519274376,218.5926530612245,14,43,215,1,210
2550,220,31,217.50131519274376,219.77687074829933,14,40,213,2,189
2551,220,9,217.50131519274376,220.24126984126985,14,40,242,3,211
2552,220,221,217.50131519274376,219.01061224489797,14,17,65,2,1
2553,220,221,217.50131519274376,220.07873015873017,14,17,111,3,1
2554,267,31,218.12825396825397,219.77687074829933,14,40,246,2,236
2555,267,9,218.12825396825397,220.24126984126985,14,40,274,2,258
2556,267,10,218.12825396825397,220.86820861678004,14,34,283,3,257
2557,267,221,218.12825396825397,220.07873015873017,14,17,96,2,46
2558,267,221,218.12825396825397,220.86820861678004,14,11,127,3,46
2559,221,9,219.01061224489797,220.24126984126985,17,40,219,1,212
2560,221,10,219.01061224489797,220.86820861678004,17,34,226,2,211
2561,515,34,1.4628571428571429,3.6687528344671203,20,19,490,2,481
2562,515,34,1.9969160997732427,3.6687528344671203,12,19,486,2,481
2563,515,397,1.9969160997732427,4.760090702947846,12,12,168,3,118
2564,515,497,1.9969160997732427,4.690430839002268,12,11,117,3,18
2565,515,819,1.9969160997732427,4.876190476190477,12,15,328,3,304
2566,515,902,1.9969160997732427,4.783310657596372,12,13,405,3,387
2567,497,14,4.690430839002268,6.060408163265306,11,30,487,1,483
2568,524,211,7.987664399092971,9.961360544217687,10,17,324,2,313
2569,524,211,7.987664399092971,10.193560090702949,10,16,327,2,313
2570,524,541,7.987664399092971,9.496961451247167,10,15,67,2,17
2571,524,538,7.987664399092971,10.379319727891156,10,14,104,2,14
2572,524,641,7.987664399092971,9.729160997732427,10,16,139,2,117
2573,524,642,7.987664399092971,10.170340136054422,10,14,151,2,118
2574,524,825,7.987664399092971,9.752380952380953,10,10,310,2,301
2575,524,931,7.987664399092971,10.286439909297052,10,13,419,2,407
2576,515,211,8.498503401360544,9.961360544217687,17,17,310,1,304
2577,515,211,8.498503401360544,10.193560090702949,17,16,313,2,304
2578,515,538,8.498503401360544,10.379319727891156,17,14,84,2,23
2579,515,524,8.498503401360544,11.261678004535147,17,15,119,3,9
2580,515,641,8.498503401360544,9.729160997732427,17,16,137,1,126
2581,515,642,8.498503401360544,10.170340136054422,17,14,146,2,127
2582,515,825,8.498503401360544,9.752380952380953,17,10,315,1,310
2583,515,931,8.498503401360544,10.286439909297052,17,13,423,2,416
2584,541,266,9.496961451247167,11.54031746031746,15,17,289,2,275
2585,541,524,9.496961451247167,11.261678004535147,15,15,78,2,17
2586,541,638,9.496961451247167,11.49387755102041,15,14,130,2,97
2587,541,680,9.496961451247167,12.376235827664399,15,14,186,3,139
2588,541,896,9.496961451247167,11.935056689342403,15,11,370,2,355
2589,541,849,9.496961451247167,12.376235827664399,15,12,332,3,308
2590,538,266,10.379319727891156,11.54031746031746,14,17,277,1,272
2591,538,237,10.379319727891156,12.631655328798185,14,16,316,2,301
2592,538,524,10.379319727891156,13.02639455782313,14,16,115,3,14
2593,538,638,10.379319727891156,11.49387755102041,14,14,111,1,100
2594,538,680,10.379319727891156,12.376235827664399,14,14,166,2,142
2595,538,689,10.379319727891156,13.25859410430839,14,14,195,3,151
2596,538,896,10.379319727891156,11.935056689342403,14,11,364,2,358
2597,538,849,10.379319727891156,12.376235827664399,14,12,323,2,311
2598,524,237,11.261678004535147,12.631655328798185,15,16,293,1,287
2599,524,211,11.261678004535147,13.722993197278912,15,17,330,2,313
2600,524,235,11.261678004535147,14.210612244897959,15,16,316,3,289
2601,524,529,11.261678004535147,13.908752834467121,15,14,114,3,5
2602,524,680,11.261678004535147,12.376235827664399,15,14,163,1,156
2603,524,689,11.261678004535147,13.25859410430839,15,14,186,2,165
2604,524,849,11.261678004535147,12.376235827664399,15,12,329,1,325
2605,524,825,11.261678004535147,13.722993197278912,15,11,319,2,301
2606,524,235,13.02639455782313,14.210612244897959,16,16,293,1,289
2607,524,211,13.02639455782313,15.464489795918368,16,16,330,2,313
2608,524,425,13.02639455782313,15.603809523809524,16,13,149,3,99
2609,524,641,13.02639455782313,14.582131519274377,16,14,135,2,117
2610,524,641,13.02639455782313,15.464489795918368,16,15,157,2,117
2611,524,905,13.02639455782313,15.023310657596372,16,13,391,2,381
2612,524,873,13.02639455782313,15.905668934240364,16,12,370,3,349
2613,529,211,13.908752834467121,15.464489795918368,14,16,325,2,318
2614,529,211,13.908752834467121,16.23074829931973,14,17,333,2,318
2615,529,425,13.908752834467121,15.603809523809524,14,13,127,2,104
2616,529,523,13.908752834467121,16.555827664399093,14,15,114,3,6
2617,529,641,13.908752834467121,15.464489795918368,14,15,131,2,112
2618,529,641,13.908752834467121,16.34684807256236,14,15,154,2,112
2619,529,905,13.908752834467121,15.023310657596372,14,13,379,1,376
2620,529,873,13.908752834467121,15.905668934240364,14,12,355,2,344
2621,529,847,13.908752834467121,16.34684807256236,14,11,335,2,318
2622,524,211,14.791111111111112,16.23074829931973,15,17,319,1,313
2623,524,523,14.791111111111112,16.555827664399093,15,15,76,2,1
2624,524,424,14.791111111111112,17.34530612244898,15,13,149,3,100
2625,524,641,14.791111111111112,16.34684807256236,15,15,135,2,117
2626,524,640,14.791111111111112,17.670385487528346,15,14,170,3,116
2627,524,873,14.791111111111112,15.905668934240364,15,12,352,1,349
2628,524,847,14.791111111111112,16.34684807256236,15,11,330,2,323
2629,524,841,14.791111111111112,17.22920634920635,15,11,334,2,317
2630,425,4,15.603809523809524,17.972244897959182,13,38,433,2,421
2631,425,271,15.603809523809524,17.949024943310658,13,18,184,2,154
2632,425,424,15.603809523809524,17.34530612244898,13,13,75,2,1
2633,425,524,15.603809523809524,18.320544217687075,13,16,153,3,99
2634,425,640,15.603809523809524,17.670385487528346,13,14,233,2,215
2635,425,841,15.603809523809524,17.22920634920635,13,11,422,2,416
2636,523,271,16.555827664399093,17.949024943310658,15,18,259,1,252
2637,523,299,16.555827664399093,19.040362811791383,15,17,248,2,224
2638,523,524,16.555827664399093,18.320544217687075,15,16,76,2,1
2639,523,640,16.555827664399093,17.670385487528346,15,14,126,1,117
2640,523,641,16.555827664399093,18.993922902494333,15,15,158,2,118
2641,523,955,16.555827664399093,18.22766439909297,15,11,438,2,432
2642,523,956,16.555827664399093,19.11002267573696,15,14,447,3,433
2643,424,4,17.34530612244898,18.854603174603174,13,39,425,2,420
2644,424,7,17.34530612244898,19.667301587301587,13,38,429,2,417
2645,424,299,17.34530612244898,19.040362811791383,13,17,145,2,125
2646,424,213,17.34530612244898,19.89950113378685,13,17,238,3,211
2647,424,473,17.34530612244898,19.99238095238095,13,15,124,3,49
2648,424,641,17.34530612244898,18.993922902494333,13,15,228,2,217
2649,424,641,17.34530612244898,19.87628117913832,13,14,243,3,217
2650,524,213,18.320544217687075,19.89950113378685,16,17,318,2,311
2651,524,403,18.320544217687075,20.54965986394558,16,20,154,2,121
2652,524,401,18.320544217687075,21.106938775510205,16,14,172,3,123
2653,524,473,18.320544217687075,19.99238095238095,16,15,88,2,51
2654,524,515,18.320544217687075,20.82829931972789,16,19,108,3,9
2655,524,641,18.320544217687075,19.87628117913832,16,14,135,2,117
2656,524,819,18.320544217687075,20.758639455782312,16,16,313,2,295
2657,524,902,18.320544217687075,20.66575963718821,16,15,391,2,378
2658,473,6,19.99238095238095,21.873197278911565,15,38,474,2,467
2659,473,6,19.99238095238095,22.31437641723356,15,39,478,2,467
2660,473,401,19.99238095238095,21.106938775510205,15,14,87,1,72
2661,473,249,19.99238095238095,22.128616780045352,15,17,242,2,224
2662,473,515,19.99238095238095,21.339138321995467,15,14,72,1,42
2663,473,539,19.99238095238095,22.73233560090703,15,14,135,3,66
2664,473,659,19.99238095238095,22.639455782312925,15,18,218,3,186
2665,473,824,19.99238095238095,22.96453514739229,15,13,374,3,351
2666,515,51,20.82829931972789,23.45215419501134,19,38,478,3,464
2667,515,249,20.82829931972789,22.128616780045352,19,17,272,1,266
2668,515,539,20.82829931972789,22.73233560090703,19,14,85,2,24
2669,515,605,20.82829931972789,23.6843537414966,19,16,152,3,90
2670,515,659,20.82829931972789,22.639455782312925,19,18,164,2,144
2671,515,617,20.82829931972789,23.6843537414966,19,12,160,3,102
2672,515,824,20.82829931972789,22.96453514739229,19,13,322,2,309
2673,515,954,20.82829931972789,23.405714285714286,19,11,453,3,439
2674,515,51,21.339138321995467,23.45215419501134,14,38,473,2,464
2675,515,342,21.339138321995467,23.91655328798186,14,20,206,3,173
2676,515,539,21.339138321995467,22.73233560090703,14,14,65,1,24
2677,515,605,21.339138321995467,23.6843537414966,14,16,135,2,90
2678,515,659,21.339138321995467,22.639455782312925,14,18,155,1,144
2679,515,617,21.339138321995467,23.6843537414966,14,12,144,2,102
2680,515,824,21.339138321995467,22.96453514739229,14,13,317,2,309
2681,515,954,21.339138321995467,23.405714285714286,14,11,448,2,439
2682,539,342,22.73233560090703,23.91655328798186,14,20,203,1,197
2683,539,387,22.73233560090703,25.031111111111112,14,23,181,2,152
2684,539,214,22.73233560090703,25.611609977324264,14,25,348,3,325
2685,539,410,22.73233560090703,25.031111111111112,14,15,163,2,129
2686,539,641,22.73233560090703,24.729251700680273,14,14,133,2,102
2687,539,885,22.73233560090703,24.729251700680273,14,12,357,2,346
2688,605,387,23.6843537414966,25.031111111111112,16,23,226,1,218
2689,605,214,23.6843537414966,25.611609977324264,16,25,400,2,391
2690,605,410,23.6843537414966,25.031111111111112,16,15,203,1,195
2691,605,613,23.6843537414966,25.843809523809526,16,16,93,2,8
2692,605,539,23.6843537414966,26.261768707482993,16,14,129,3,66
2693,605,641,23.6843537414966,24.729251700680273,16,14,58,1,36
2694,605,646,23.6843537414966,25.98312925170068,16,15,107,2,41
2695,605,720,23.6843537414966,26.493968253968255,16,14,167,3,115
2696,605,885,23.6843537414966,24.729251700680273,16,12,284,1,280
2697,605,965,23.6843537414966,26.21532879818594,16,11,376,3,360
2698,410,10,25.031111111111112,26.70294784580499,15,38,406,2,400
2699,410,4,25.031111111111112,27.678185941043086,15,37,422,3,406
2700,410,227,25.031111111111112,26.795827664399095,15,23,198,2,183
2701,410,206,25.031111111111112,27.23700680272109,15,28,225,2,204
2702,410,539,25.031111111111112,26.261768707482993,15,14,139,1,129
2703,410,720,25.031111111111112,26.493968253968255,15,14,316,1,310
2704,410,662,25.031111111111112,27.376326530612246,15,18,271,2,252
2705,613,206,25.843809523809526,27.23700680272109,16,28,411,1,407
2706,613,389,25.843809523809526,28.23546485260771,16,19,247,2,224
2707,613,415,25.843809523809526,28.0497052154195,16,15,220,2,198
2708,613,662,25.843809523809526,27.376326530612246,16,18,82,2,49
2709,613,640,25.843809523809526,28.258684807256238,16,14,107,2,27
2710,613,923,25.843809523809526,27.376326530612246,16,11,317,2,310
2711,539,389,26.261768707482993,28.23546485260771,14,19,172,2,150
2712,539,415,26.261768707482993,28.0497052154195,14,15,146,2,124
2713,539,412,26.261768707482993,28.908843537414967,14,15,171,3,127
2714,539,662,26.261768707482993,27.376326530612246,14,18,132,1,123
2715,539,640,26.261768707482993,28.258684807256238,14,14,133,2,101
2716,539,923,26.261768707482993,27.376326530612246,14,11,387,1,384
2717,415,4,28.0497052154195,29.442902494331065,15,38,415,1,411
2718,415,7,28.0497052154195,30.25560090702948,15,39,419,2,408
2719,415,384,28.0497052154195,29.860861678004536,15,26,84,2,31
2720,415,211,28.0497052154195,30.464580498866212,15,17,229,2,204
2721,415,410,28.0497052154195,29.860861678004536,15,21,78,2,5
2722,415,625,28.0497052154195,30.02340136054422,15,15,227,2,210
2723,415,656,28.0497052154195,30.464580498866212,15,14,262,2,241
2724,415,886,28.0497052154195,29.257142857142856,15,14,474,1,471
2725,415,826,28.0497052154195,30.928979591836736,15,11,429,3,411
2726,412,7,28.908843537414967,30.25560090702948,15,39,409,1,405
2727,412,211,28.908843537414967,30.464580498866212,15,17,212,2,201
2728,412,566,28.908843537414967,31.068299319727892,15,19,180,2,154
2729,412,554,28.908843537414967,31.55591836734694,15,15,182,3,142
2730,412,625,28.908843537414967,30.02340136054422,15,15,218,1,213
2731,412,656,28.908843537414967,30.464580498866212,15,14,253,2,244
2732,412,642,28.908843537414967,31.346938775510203,15,14,253,2,230
2733,412,826,28.908843537414967,30.928979591836736,15,11,423,2,414
2734,412,826,28.908843537414967,31.811337868480727,15,12,432,3,414
2735,410,23,29.860861678004536,31.90421768707483,21,38,397,2,387
2736,410,268,29.860861678004536,32.066757369614514,21,21,171,2,142
2737,410,566,29.860861678004536,31.068299319727892,21,19,164,1,156
2738,410,554,29.860861678004536,31.55591836734694,21,15,161,2,144
2739,410,642,29.860861678004536,31.346938775510203,21,14,241,1,232
2740,410,665,29.860861678004536,32.670476190476194,21,15,282,3,255
2741,410,826,29.860861678004536,30.928979591836736,21,11,419,1,416
2742,410,826,29.860861678004536,31.811337868480727,21,12,424,2,416
2743,566,239,31.068299319727892,32.949115646258505,19,25,337,2,327
2744,566,209,31.068299319727892,33.99401360544218,19,26,379,3,357
2745,566,538,31.068299319727892,32.949115646258505,19,14,86,2,28
2746,566,539,31.068299319727892,33.32063492063492,19,15,101,2,27
2747,566,665,31.068299319727892,32.670476190476194,19,15,121,2,99
2748,566,726,31.068299319727892,33.552834467120185,19,14,192,2,160
2749,554,239,31.55591836734694,32.949115646258505,15,25,321,1,315
2750,554,209,31.55591836734694,33.99401360544218,15,26,361,2,345
2751,554,538,31.55591836734694,32.949115646258505,15,14,62,1,16
2752,554,539,31.55591836734694,33.32063492063492,15,15,77,2,15
2753,554,569,31.55591836734694,34.481632653061226,15,22,127,3,15
2754,554,665,31.55591836734694,32.670476190476194,15,15,121,1,111
2755,554,726,31.55591836734694,33.552834467120185,15,14,192,2,172
2756,554,618,31.55591836734694,34.17977324263039,15,14,130,3,64
2757,538,209,32.949115646258505,33.99401360544218,14,26,332,1,329
2758,538,210,32.949115646258505,35.10857142857143,14,22,341,2,328
2759,538,331,32.949115646258505,35.80517006802721,14,22,241,3,207
2760,538,569,32.949115646258505,34.481632653061226,14,22,73,2,31
2761,538,561,32.949115646258505,35.75873015873016,14,18,123,3,23
2762,538,618,32.949115646258505,34.17977324263039,14,14,96,1,80
2763,538,638,32.949115646258505,35.735510204081635,14,16,156,3,100
2764,538,896,32.949115646258505,34.87637188208617,14,10,367,2,358
2765,538,826,32.949115646258505,35.75873015873016,14,10,312,3,288
2766,539,210,33.32063492063492,35.10857142857143,15,22,338,2,329
2767,539,331,33.32063492063492,35.80517006802721,15,22,234,2,208
2768,539,569,33.32063492063492,34.481632653061226,15,22,58,1,30
2769,539,561,33.32063492063492,35.75873015873016,15,18,107,2,22
2770,539,638,33.32063492063492,35.735510204081635,15,16,144,2,99
2771,539,654,33.32063492063492,36.24634920634921,15,20,171,3,115
2772,539,896,33.32063492063492,34.87637188208617,15,10,363,2,357
2773,539,826,33.32063492063492,35.75873015873016,15,10,306,2,287
2774,539,934,33.32063492063492,36.29278911564626,15,14,415,3,395
2775,569,331,34.481632653061226,35.80517006802721,22,22,245,1,238
2776,569,228,34.481632653061226,36.91972789115646,22,27,357,2,341
2777,569,225,34.481632653061226,37.45378684807256,22,26,367,3,344
2778,569,561,34.481632653061226,35.75873015873016,22,18,56,1,8
2779,569,491,34.481632653061226,36.80362811791383,22,22,127,2,78
2780,569,454,34.481632653061226,37.221587301587306,22,19,165,3,115
2781,569,638,34.481632653061226,35.735510204081635,22,16,88,1,69
2782,569,654,34.481632653061226,36.24634920634921,22,20,114,2,85
2783,569,680,34.481632653061226,37.17514739229025,22,16,161,3,111
2784,569,826,34.481632653061226,35.75873015873016,22,10,263,1,257
2785,569,934,34.481632653061226,36.29278911564626,22,14,373,2,365
2786,561,228,35.75873015873016,36.91972789115646,18,27,337,1,333
2787,561,225,35.75873015873016,37.45378684807256,18,26,344,2,336
2788,561,383,35.75873015873016,38.638004535147395,18,24,217,3,178
2789,561,491,35.75873015873016,36.80362811791383,18,22,83,1,70
2790,561,454,35.75873015873016,37.221587301587306,18,19,124,1,107
2791,561,540,35.75873015873016,38.59156462585034,18,15,124,3,21
2792,561,680,35.75873015873016,37.17514739229025,18,16,134,1,119
2793,561,619,35.75873015873016,38.49868480725624,18,15,131,3,58
2794,561,849,35.75873015873016,37.964625850340134,18,13,303,2,288
2795,491,10,36.80362811791383,39.05596371882086,22,39,491,2,481
2796,491,383,36.80362811791383,38.638004535147395,22,24,134,2,108
2797,491,227,36.80362811791383,39.14884353741497,22,20,283,2,264
2798,491,540,36.80362811791383,38.59156462585034,22,15,91,2,49
2799,491,545,36.80362811791383,39.14884353741497,22,14,115,2,54
2800,491,619,36.80362811791383,38.49868480725624,22,15,147,2,128
2801,491,716,36.80362811791383,39.288163265306125,22,13,249,2,225
2802,491,849,36.80362811791383,37.964625850340134,22,13,361,1,358
2803,491,924,36.80362811791383,38.846984126984125,22,10,442,2,433
2804,454,10,37.221587301587306,39.05596371882086,19,39,451,2,444
2805,454,10,37.221587301587306,39.938321995464854,19,39,459,3,444
2806,454,383,37.221587301587306,38.638004535147395,19,24,94,1,71
2807,454,227,37.221587301587306,39.14884353741497,19,20,242,2,227
2808,454,540,37.221587301587306,38.59156462585034,19,15,104,1,86
2809,454,545,37.221587301587306,39.14884353741497,19,14,123,2,91
2810,454,533,37.221587301587306,40.19374149659864,19,15,150,3,79
2811,454,619,37.221587301587306,38.49868480725624,19,15,174,1,165
2812,454,716,37.221587301587306,39.288163265306125,19,13,277,2,262
2813,454,924,37.221587301587306,38.846984126984125,19,10,475,2,470
2814,540,227,38.59156462585034,40.91356009070295,15,25,329,2,313
2815,540,255,38.59156462585034,41.33151927437642,15,25,308,3,285
2816,540,533,38.59156462585034,40.19374149659864,15,15,69,2,7
2817,540,642,38.59156462585034,40.61170068027211,15,16,134,2,102
2818,545,227,39.14884353741497,40.91356009070295,14,25,327,2,318
2819,545,255,39.14884353741497,41.33151927437642,14,25,305,2,290
2820,545,533,39.14884353741497,40.19374149659864,14,15,47,1,12
2821,545,508,39.14884353741497,41.84235827664399,14,17,122,3,37
2822,545,642,39.14884353741497,40.61170068027211,14,16,116,1,97
2823,545,659,39.14884353741497,41.84235827664399,14,16,163,3,114
2824,545,827,39.14884353741497,41.88879818594104,14,14,306,3,282
2825,533,255,40.19374149659864,41.33151927437642,15,25,282,1,278
2826,533,382,40.19374149659864,42.399637188208615,15,21,178,2,151
2827,533,508,40.19374149659864,41.84235827664399,15,17,75,2,25
2828,533,537,40.19374149659864,42.98013605442177,15,17,120,3,4
2829,533,659,40.19374149659864,41.84235827664399,15,16,145,2,126
2830,533,664,40.19374149659864,42.81759637188209,15,14,173,3,131
2831,533,827,40.19374149659864,41.88879818594104,15,14,303,2,294
2832,533,825,40.19374149659864,42.399637188208615,15,11,307,2,292
2833,508,238,41.84235827664399,43.490975056689344,17,26,279,2,270
2834,508,537,41.84235827664399,42.98013605442177,17,17,57,1,29
2835,508,421,41.84235827664399,43.97859410430839,17,23,127,2,87
2836,508,641,41.84235827664399,43.69995464852608,17,18,155,2,133
2837,508,618,41.84235827664399,44.1643537414966,17,15,149,2,110
2838,508,855,41.84235827664399,43.67673469387755,17,12,356,2,347
2839,537,212,42.98013605442177,44.83773242630386,17,28,335,2,325
2840,537,254,42.98013605442177,45.51111111111111,17,23,303,3,283
2841,537,520,42.98013605442177,45.023492063492064,17,14,90,2,17
2842,537,542,42.98013605442177,45.67365079365079,17,13,116,3,5
2843,537,618,42.98013605442177,44.1643537414966,17,15,96,1,81
2844,537,642,42.98013605442177,45.46467120181406,17,13,150,2,105
2845,537,873,42.98013605442177,45.023492063492064,17,11,347,2,336
2846,421,7,43.97859410430839,45.2324716553288,23,39,418,1,414
2847,421,4,43.97859410430839,46.18448979591837,23,39,428,2,417
2848,421,254,43.97859410430839,45.51111111111111,23,23,180,2,167
2849,421,520,43.97859410430839,45.023492063492064,23,14,109,1,99
2850,421,542,43.97859410430839,45.67365079365079,23,13,141,2,121
2851,421,568,43.97859410430839,46.78820861678005,23,15,190,3,147
2852,421,642,43.97859410430839,45.46467120181406,23,13,230,1,221
2853,421,625,43.97859410430839,46.78820861678005,23,14,237,3,204
2854,421,873,43.97859410430839,45.023492063492064,23,11,454,1,452
2855,520,218,45.023492063492064,47.04362811791383,14,26,314,2,302
2856,520,231,45.023492063492064,47.763446712018144,14,27,312,3,289
2857,520,568,45.023492063492064,46.78820861678005,14,15,90,2,48
2858,520,625,45.023492063492064,46.78820861678005,14,14,130,2,105
2859,520,726,45.023492063492064,47.67056689342404,14,14,235,3,206
2860,520,825,45.023492063492064,47.25260770975057,14,10,320,2,305
2861,542,218,45.67365079365079,47.04362811791383,13,26,329,1,324
2862,542,231,45.67365079365079,47.763446712018144,13,27,324,2,311
2863,542,228,45.67365079365079,48.4368253968254,13,30,336,3,314
2864,542,568,45.67365079365079,46.78820861678005,13,15,55,1,26
2865,542,594,45.67365079365079,48.15818594104309,13,13,119,2,52
2866,542,554,45.67365079365079,48.529705215419504,13,18,124,3,12
2867,542,625,45.67365079365079,46.78820861678005,13,14,96,1,83
2868,542,726,45.67365079365079,47.67056689342404,13,14,203,2,184
2869,542,825,45.67365079365079,47.25260770975057,13,10,291,2,283
2870,568,228,46.78820861678005,48.4368253968254,15,30,347,2,340
2871,568,594,46.78820861678005,48.15818594104309,15,13,64,1,26
2872,568,554,46.78820861678005,48.529705215419504,15,18,76,2,14
2873,568,699,46.78820861678005,49.15664399092971,15,19,166,2,131
2874,568,743,46.78820861678005,49.55138321995465,15,25,212,3,175
2875,568,877,46.78820861678005,49.15664399092971,15,16,325,2,309
2876,568,910,46.78820861678005,49.621043083900226,15,17,363,3,342
2877,594,261,48.15818594104309,49.946122448979594,13,27,342,2,333
2878,594,341,48.15818594104309,50.29442176870749,13,26,269,2,253
2879,594,515,48.15818594104309,50.08544217687075,13,17,115,2,79
2880,594,515,48.15818594104309,50.874920634920635,13,20,141,3,79
2881,594,743,48.15818594104309,49.55138321995465,13,25,161,1,149
2882,594,679,48.15818594104309,50.73560090702948,13,16,140,3,85
2883,594,910,48.15818594104309,49.621043083900226,13,17,322,1,316
2884,594,822,48.15818594104309,50.712380952380954,13,18,253,3,228
2885,554,261,48.529705215419504,49.946122448979594,18,27,299,1,293
2886,554,341,48.529705215419504,50.29442176870749,18,26,226,2,213
2887,554,515,48.529705215419504,50.08544217687075,18,17,78,2,39
2888,554,515,48.529705215419504,50.874920634920635,18,20,108,2,39
2889,554,578,48.529705215419504,51.432199546485265,18,14,127,3,24
2890,554,743,48.529705215419504,49.55138321995465,18,25,194,1,189
2891,554,679,48.529705215419504,50.73560090702948,18,16,157,2,125
2892,554,910,48.529705215419504,49.621043083900226,18,17,359,1,356
2893,554,822,48.529705215419504,50.712380952380954,18,18,284,2,268
2894,515,256,50.08544217687075,52.082358276643994,17,25,273,2,259
2895,515,229,50.08544217687075,52.38421768707483,17,20,303,2,286
2896,515,578,50.08544217687075,51.432199546485265,17,14,86,1,63
2897,515,519,50.08544217687075,52.964716553287985,17,15,124,3,4
2898,515,618,50.08544217687075,52.082358276643994,17,16,134,2,103
2899,515,631,50.08544217687075,52.523537414965986,17,16,156,2,116
2900,515,906,50.08544217687075,52.082358276643994,17,12,400,2,391
2901,515,967,50.08544217687075,52.964716553287985,17,13,469,3,452
2902,515,256,50.874920634920635,52.082358276643994,20,25,264,1,259
2903,515,229,50.874920634920635,52.38421768707483,20,20,293,2,286
2904,515,519,50.874920634920635,52.964716553287985,20,15,90,2,4
2905,515,618,50.874920634920635,52.082358276643994,20,16,115,1,103
2906,515,631,50.874920634920635,52.523537414965986,20,16,136,2,116
2907,515,728,50.874920634920635,53.823854875283445,20,23,248,3,213
2908,515,906,50.874920634920635,52.082358276643994,20,12,394,1,391
2909,515,967,50.874920634920635,52.964716553287985,20,13,461,2,452
2910,515,831,50.874920634920635,53.823854875283445,20,15,341,3,316
2911,578,226,51.432199546485265,54.10249433106576,14,26,370,3,352
2912,578,519,51.432199546485265,52.964716553287985,14,15,89,2,59
2913,578,425,51.432199546485265,54.14893424036281,14,21,193,3,153
2914,578,631,51.432199546485265,52.523537414965986,14,16,71,1,53
2915,578,728,51.432199546485265,53.823854875283445,14,23,182,2,150
2916,578,967,51.432199546485265,52.964716553287985,14,13,395,2,389
2917,578,831,51.432199546485265,53.823854875283445,14,15,273,2,253
2918,519,226,52.964716553287985,54.10249433106576,15,26,297,1,293
2919,519,231,52.964716553287985,54.75265306122449,15,25,298,2,288
2920,519,247,52.964716553287985,55.89043083900227,15,25,300,3,272
2921,519,425,52.964716553287985,54.14893424036281,15,21,107,1,94
2922,519,410,52.964716553287985,54.984852607709755,15,17,139,2,109
2923,519,709,52.964716553287985,54.868752834467124,15,20,207,2,190
2924,519,729,52.964716553287985,55.28671201814059,15,17,233,2,210
2925,519,832,52.964716553287985,54.89197278911565,15,12,324,2,313
2926,519,885,52.964716553287985,55.263492063492066,15,14,379,2,366
2927,425,4,54.14893424036281,55.913650793650795,21,39,428,2,421
2928,425,10,54.14893424036281,56.70312925170068,21,39,429,3,415
2929,425,247,54.14893424036281,55.89043083900227,21,25,193,2,178
2930,425,225,54.14893424036281,56.91210884353742,21,24,233,3,200
2931,425,410,54.14893424036281,55.98331065759637,21,18,80,2,15
2932,425,552,54.14893424036281,56.26195011337869,21,15,156,2,127
2933,425,729,54.14893424036281,55.28671201814059,21,17,308,1,304
2934,425,675,54.14893424036281,56.47092970521542,21,14,269,2,250
2935,425,885,54.14893424036281,55.263492063492066,21,14,462,1,460
2936,410,10,54.984852607709755,56.70312925170068,17,39,407,2,400
2937,410,225,54.984852607709755,56.91210884353742,17,24,203,2,185
2938,410,241,54.984852607709755,57.72480725623583,17,28,206,3,169
2939,410,552,54.984852607709755,56.26195011337869,17,15,152,1,142
2940,410,569,54.984852607709755,57.5158276643991,17,17,193,3,159
2941,410,675,54.984852607709755,56.47092970521542,17,14,273,1,265
2942,410,655,54.984852607709755,57.817687074829934,17,15,274,3,245
2943,410,825,54.984852607709755,57.399727891156466,17,11,428,2,415
2944,410,4,55.98331065759637,58.096326530612245,18,39,416,2,406
2945,410,7,55.98331065759637,58.46784580498866,18,39,417,2,403
2946,410,241,55.98331065759637,57.72480725623583,18,28,185,2,169
2947,410,569,55.98331065759637,57.5158276643991,18,17,172,2,159
2948,410,439,55.98331065759637,58.90902494331066,18,13,129,3,29
2949,410,655,55.98331065759637,57.817687074829934,18,15,257,2,245
2950,410,825,55.98331065759637,57.399727891156466,18,11,419,1,415
2951,410,825,55.98331065759637,58.28208616780046,18,12,427,2,415
2952,552,241,56.26195011337869,57.72480725623583,15,28,317,1,311
2953,552,212,56.26195011337869,59.187664399092974,15,22,363,3,340
2954,552,569,56.26195011337869,57.5158276643991,15,17,57,1,17
2955,552,439,56.26195011337869,58.90902494331066,15,13,161,3,113
2956,552,655,56.26195011337869,57.817687074829934,15,15,123,2,103
2957,552,719,56.26195011337869,59.14122448979592,15,14,208,3,167
2958,552,825,56.26195011337869,57.399727891156466,15,11,277,1,273
2959,552,825,56.26195011337869,58.28208616780046,15,12,287,2,273
2960,569,212,57.5158276643991,59.187664399092974,17,22,364,2,357
2961,569,212,57.5158276643991,60.09324263038549,17,32,374,3,357
2962,569,439,57.5158276643991,58.90902494331066,17,13,143,1,130
2963,569,602,57.5158276643991,59.60562358276644,17,20,96,2,33
2964,569,719,57.5158276643991,59.14122448979592,17,14,166,2,150
2965,569,617,57.5158276643991,59.582403628117916,17,17,101,2,48
2966,569,826,57.5158276643991,59.582403628117916,17,11,272,2,257
2967,569,826,57.5158276643991,60.46476190476191,17,11,287,3,257
2968,439,7,58.90902494331066,61.11492063492064,13,39,442,2,432
2969,439,212,58.90902494331066,60.09324263038549,13,32,233,1,227
2970,439,225,58.90902494331066,61.18458049886621,13,28,235,2,214
2971,439,214,58.90902494331066,61.41678004535147,13,30,250,3,225
2972,439,424,58.90902494331066,61.161360544217686,13,22,98,2,15
2973,439,430,58.90902494331066,61.23102040816327,13,20,100,2,9
2974,439,720,58.90902494331066,60.9059410430839,13,14,294,2,281
2975,439,627,58.90902494331066,61.602539682539685,13,16,221,3,188
2976,439,826,58.90902494331066,60.46476190476191,13,11,393,2,387
2977,602,225,59.60562358276644,61.18458049886621,20,28,383,2,377
2978,602,214,59.60562358276644,61.41678004535147,20,30,396,2,388
2979,602,209,59.60562358276644,62.32235827664399,20,31,410,3,393
2980,602,424,59.60562358276644,61.161360544217686,20,22,190,2,178
2981,602,430,59.60562358276644,61.23102040816327,20,20,186,2,172
2982,602,720,59.60562358276644,60.9059410430839,20,14,131,1,118
2983,602,627,59.60562358276644,61.602539682539685,20,16,90,2,25
2984,602,957,59.60562358276644,61.46321995464853,20,13,364,2,355
2985,424,4,61.161360544217686,62.972517006802725,22,38,427,2,420
2986,424,209,61.161360544217686,62.32235827664399,22,31,221,1,215
2987,424,402,61.161360544217686,64.04063492063493,22,25,126,3,22
2988,424,596,61.161360544217686,63.22793650793651,22,16,194,2,172
2989,424,582,61.161360544217686,63.27437641723356,22,20,182,2,158
2990,424,630,61.161360544217686,63.11183673469388,22,15,222,2,206
2991,424,743,61.161360544217686,63.669115646258504,22,22,337,3,319
2992,424,922,61.161360544217686,62.67065759637188,22,11,502,2,498
2993,424,829,61.161360544217686,63.669115646258504,22,19,419,3,405
2994,430,4,61.23102040816327,62.972517006802725,20,38,433,2,426
2995,430,209,61.23102040816327,62.32235827664399,20,31,226,1,221
2996,430,402,61.23102040816327,64.04063492063493,20,25,124,3,28
2997,430,596,61.23102040816327,63.22793650793651,20,16,187,2,166
2998,430,582,61.23102040816327,63.27437641723356,20,20,176,2,152
2999,430,630,61.23102040816327,63.11183673469388,20,15,216,2,200
3000,430,743,61.23102040816327,63.669115646258504,20,22,330,2,313
3001,430,922,61.23102040816327,62.67065759637188,20,11,496,1,492
3002,430,829,61.23102040816327,63.669115646258504,20,19,413,2,399
3003,596,253,63.22793650793651,64.76045351473923,16,24,349,2,343
3004,596,258,63.22793650793651,65.75891156462585,16,26,355,3,338
3005,596,411,63.22793650793651,64.69079365079365,16,20,195,1,185
3006,596,422,63.22793650793651,65.38739229024944,16,17,197,2,174
3007,596,818,63.22793650793651,64.85333333333334,16,17,233,2,222
3008,596,640,63.22793650793651,65.31773242630386,16,16,100,2,44
3009,596,865,63.22793650793651,64.80689342403629,16,15,277,2,269
3010,596,826,63.22793650793651,66.20009070294785,16,14,263,3,230
3011,582,253,63.27437641723356,64.76045351473923,20,24,335,1,329
3012,582,258,63.27437641723356,65.75891156462585,20,26,341,2,324
3013,582,411,63.27437641723356,64.69079365079365,20,20,182,1,171
3014,582,422,63.27437641723356,65.38739229024944,20,17,184,2,160
3015,582,818,63.27437641723356,64.85333333333334,20,17,246,2,236
3016,582,640,63.27437641723356,65.31773242630386,20,16,105,2,58
3017,582,865,63.27437641723356,64.80689342403629,20,15,291,2,283
3018,582,826,63.27437641723356,66.20009070294785,20,14,275,3,244
3019,411,6,64.69079365079365,66.40907029478458,20,39,412,2,405
3020,411,258,64.69079365079365,65.75891156462585,20,26,160,1,153
3021,411,226,64.69079365079365,67.10566893424037,20,24,212,2,185
3022,411,430,64.69079365079365,66.26975056689342,20,15,71,2,19
3023,411,641,64.69079365079365,66.64126984126985,20,16,245,2,230
3024,411,826,64.69079365079365,66.20009070294785,20,14,420,2,415
3025,411,869,64.69079365079365,66.64126984126985,20,11,466,2,458
3026,422,6,65.38739229024944,66.40907029478458,17,39,418,1,416
3027,422,6,65.38739229024944,67.75582766439909,17,42,428,2,416
3028,422,226,65.38739229024944,67.10566893424037,17,24,210,2,196
3029,422,259,65.38739229024944,68.01124716553288,17,23,198,3,163
3030,422,641,65.38739229024944,66.64126984126985,17,16,226,1,219
3031,422,723,65.38739229024944,67.9415873015873,17,20,320,3,301
3032,422,869,65.38739229024944,66.64126984126985,17,11,450,1,447
3033,422,846,65.38739229024944,67.91836734693878,17,16,438,3,424
3034,430,6,66.26975056689342,67.75582766439909,15,42,429,1,424
3035,430,4,66.26975056689342,69.12580498866214,15,39,443,3,426
3036,430,259,66.26975056689342,68.01124716553288,15,23,187,2,171
3037,430,231,66.26975056689342,68.87038548752835,15,24,228,3,199
3038,430,422,66.26975056689342,68.08090702947845,15,16,78,2,8
3039,430,595,66.26975056689342,69.0097052154195,15,18,203,3,165
3040,430,723,66.26975056689342,67.9415873015873,15,20,302,2,293
3041,430,733,66.26975056689342,69.03292517006803,15,21,326,3,303
3042,430,846,66.26975056689342,67.91836734693878,15,16,422,2,416
3043,430,839,66.26975056689342,69.03292517006803,15,14,426,3,409
3044,422,4,68.08090702947845,69.12580498866214,16,39,420,1,418
3045,422,8,68.08090702947845,69.47410430839003,16,40,418,1,414
3046,422,252,68.08090702947845,69.75274376417234,16,24,185,2,170
3047,422,219,68.08090702947845,71.00662131519275,16,25,239,3,203
3048,422,410,68.08090702947845,69.5437641723356,16,15,64,1,12
3049,422,520,68.08090702947845,70.6118820861678,16,14,147,3,98
3050,422,698,68.08090702947845,69.40444444444445,16,15,282,1,276
3051,422,641,68.08090702947845,70.6118820861678,16,14,245,3,219
3052,422,826,68.08090702947845,69.40444444444445,16,12,408,1,404
3053,422,826,68.08090702947845,71.0530612244898,16,11,424,3,404
3054,595,219,69.0097052154195,71.00662131519275,18,25,386,2,376
3055,595,342,69.0097052154195,71.61034013605442,18,27,277,3,253
3056,595,520,69.0097052154195,70.6118820861678,18,14,102,2,75
3057,595,599,69.0097052154195,71.5871201814059,18,18,111,3,4
3058,595,641,69.0097052154195,70.6118820861678,18,14,83,2,46
3059,595,641,69.0097052154195,71.9354195011338,18,16,134,3,46
3060,595,826,69.0097052154195,71.0530612244898,18,11,247,2,231
3061,595,826,69.0097052154195,71.4942403628118,18,13,255,2,231
3062,410,10,69.5437641723356,71.26204081632653,15,39,407,2,400
3063,410,10,69.5437641723356,71.51746031746032,15,40,409,2,400
3064,410,219,69.5437641723356,71.00662131519275,15,25,201,1,191
3065,410,342,69.5437641723356,71.61034013605442,15,27,112,2,68
3066,410,520,69.5437641723356,70.6118820861678,15,14,119,1,110
3067,410,599,69.5437641723356,71.5871201814059,15,18,208,2,189
3068,410,569,69.5437641723356,72.49269841269842,15,15,203,3,159
3069,410,641,69.5437641723356,70.6118820861678,15,14,236,1,231
3070,410,641,69.5437641723356,71.9354195011338,15,16,253,2,231
3071,410,640,69.5437641723356,72.37659863945578,15,14,260,3,230
3072,410,826,69.5437641723356,71.0530612244898,15,11,421,2,416
3073,410,826,69.5437641723356,71.4942403628118,15,13,424,2,416
3074,520,210,70.6118820861678,73.25895691609978,14,20,330,3,310
3075,520,569,70.6118820861678,72.49269841269842,14,15,95,2,49
3076,520,641,70.6118820861678,71.9354195011338,14,16,134,1,121
3077,520,640,70.6118820861678,72.37659863945578,14,14,142,2,120
3078,520,953,70.6118820861678,72.37659863945578,14,12,440,2,433
3079,599,210,71.5871201814059,73.25895691609978,18,20,396,2,389
3080,599,212,71.5871201814059,74.18775510204082,18,31,403,3,387
3081,599,211,71.5871201814059,74.28063492063492,18,29,405,3,388
3082,599,605,71.5871201814059,73.76979591836735,18,19,94,2,6
3083,599,641,71.5871201814059,73.70013605442178,18,14,100,2,42
3084,599,870,71.5871201814059,74.14131519274376,18,11,292,3,271
3085,569,212,72.49269841269842,74.18775510204082,15,31,364,2,357
3086,569,211,72.49269841269842,74.28063492063492,15,29,366,2,358
3087,569,229,72.49269841269842,75.4184126984127,15,31,363,3,340
3088,569,605,72.49269841269842,73.76979591836735,15,19,66,1,36
3089,569,416,72.49269841269842,75.25587301587302,15,22,194,3,153
3090,569,423,72.49269841269842,75.27909297052155,15,23,189,3,146
3091,569,641,72.49269841269842,73.70013605442178,15,14,89,1,72
3092,569,720,72.49269841269842,74.58249433106576,15,13,176,2,151
3093,569,870,72.49269841269842,74.14131519274376,15,11,309,2,301
3094,569,826,72.49269841269842,74.58249433106576,15,10,272,2,257
3095,605,229,73.76979591836735,75.4184126984127,19,31,383,2,376
3096,605,210,73.76979591836735,76.41687074829932,19,32,411,3,395
3097,605,416,73.76979591836735,75.25587301587302,19,22,200,1,189
3098,605,423,73.76979591836735,75.27909297052155,19,23,193,2,182
3099,605,640,73.76979591836735,75.90603174603174,19,16,98,2,35
3100,605,641,73.76979591836735,76.34721088435374,19,16,117,3,36
3101,605,826,73.76979591836735,75.90603174603174,19,12,239,2,221
3102,416,5,75.25587301587302,77.06702947845805,22,40,418,2,411
3103,416,5,75.25587301587302,77.50820861678005,22,40,422,2,411
3104,416,210,75.25587301587302,76.41687074829932,22,32,212,1,206
3105,416,419,75.25587301587302,76.97414965986394,22,20,74,2,3
3106,416,444,75.25587301587302,78.22802721088435,22,15,131,3,28
3107,416,641,75.25587301587302,76.34721088435374,22,16,230,1,225
3108,416,626,75.25587301587302,78.20480725623582,22,14,245,3,210
3109,416,913,75.25587301587302,76.99736961451248,22,11,503,2,497
3110,423,5,75.27909297052155,77.06702947845805,23,40,425,2,418
3111,423,5,75.27909297052155,77.50820861678005,23,40,429,2,418
3112,423,210,75.27909297052155,76.41687074829932,23,32,219,1,213
3113,423,408,75.27909297052155,78.25124716553289,23,20,129,3,15
3114,423,419,75.27909297052155,76.97414965986394,23,20,73,2,4
3115,423,444,75.27909297052155,78.22802721088435,23,15,129,3,21
3116,423,641,75.27909297052155,76.34721088435374,23,16,223,1,218
3117,423,626,75.27909297052155,78.20480725623582,23,14,239,3,203
3118,423,913,75.27909297052155,76.99736961451248,23,11,496,2,490
3119,419,39,76.97414965986394,78.73886621315192,20,38,388,2,380
3120,419,408,76.97414965986394,78.25124716553289,20,20,56,1,11
3121,419,403,76.97414965986394,78.85496598639456,20,19,83,2,16
3122,419,211,76.97414965986394,79.87664399092971,20,17,243,3,208
3123,419,444,76.97414965986394,78.22802721088435,20,15,60,1,25
3124,419,515,76.97414965986394,78.57632653061225,20,17,118,2,96
3125,419,626,76.97414965986394,78.20480725623582,20,14,214,1,207
3126,419,819,76.97414965986394,78.32090702947846,20,14,404,1,400
3127,419,824,76.97414965986394,78.76208616780046,20,13,412,2,405
3128,444,19,78.22802721088435,80.01596371882086,15,36,432,2,425
3129,444,19,78.22802721088435,80.96798185941043,15,36,441,3,425
3130,444,211,78.22802721088435,79.87664399092971,15,17,244,2,233
3131,444,211,78.22802721088435,80.75900226757369,15,16,257,3,233
3132,444,589,78.22802721088435,80.17850340136054,15,14,168,2,145
3133,444,552,78.22802721088435,80.96798185941043,15,12,160,3,108
3134,444,717,78.22802721088435,80.15528344671202,15,15,285,2,273
3135,444,641,78.22802721088435,80.96798185941043,15,20,230,3,197
3136,515,19,78.57632653061225,80.01596371882086,17,36,500,1,496
3137,515,19,78.57632653061225,80.96798185941043,17,36,507,2,496
3138,515,211,78.57632653061225,79.87664399092971,17,17,309,1,304
3139,515,211,78.57632653061225,80.75900226757369,17,16,318,2,304
3140,515,589,78.57632653061225,80.17850340136054,17,14,101,2,74
3141,515,552,78.57632653061225,80.96798185941043,17,12,109,2,37
3142,515,717,78.57632653061225,80.15528344671202,17,15,213,2,202
3143,515,641,78.57632653061225,80.96798185941043,17,20,163,2,126
3144,589,244,80.17850340136054,81.92,14,23,353,2,345
3145,589,401,80.17850340136054,83.15065759637189,14,26,227,3,188
3146,589,442,80.17850340136054,81.89678004535148,14,13,165,2,147
3147,589,412,80.17850340136054,83.15065759637189,14,20,218,3,177
3148,589,649,80.17850340136054,81.89678004535148,14,16,95,2,60
3149,589,682,80.17850340136054,82.84879818594105,14,16,148,3,93
3150,589,843,80.17850340136054,82.87201814058957,14,11,279,3,254
3151,552,401,80.96798185941043,83.15065759637189,12,26,178,2,151
3152,552,412,80.96798185941043,83.15065759637189,12,20,169,2,140
3153,552,553,80.96798185941043,83.40607709750567,12,11,105,2,1
3154,552,682,80.96798185941043,82.84879818594105,12,16,153,2,130
3155,552,636,80.96798185941043,83.31319727891156,12,12,131,2,84
3156,552,843,80.96798185941043,82.87201814058957,12,11,302,2,291
3157,442,23,81.89678004535148,83.84725623582767,13,40,427,2,419
3158,442,401,81.89678004535148,83.15065759637189,13,26,68,1,41
3159,442,320,81.89678004535148,84.07945578231293,13,22,154,2,122
3160,442,412,81.89678004535148,83.15065759637189,13,20,62,1,30
3161,442,553,81.89678004535148,83.40607709750567,13,11,129,2,111
3162,442,636,81.89678004535148,83.31319727891156,13,12,203,1,194
3163,412,45,83.15065759637189,84.98503401360544,20,39,375,2,367
3164,412,5,83.15065759637189,85.89061224489797,20,39,424,3,407
3165,412,205,83.15065759637189,84.89215419501134,20,27,220,2,207
3166,412,228,83.15065759637189,85.40299319727892,20,26,208,2,184
3167,412,554,83.15065759637189,85.14757369614513,20,17,166,2,142
3168,412,515,83.15065759637189,86.12281179138323,20,19,164,3,103
3169,412,680,83.15065759637189,85.14757369614513,20,12,281,2,268
3170,412,819,83.15065759637189,86.05315192743764,20,16,426,3,407
3171,412,896,83.15065759637189,86.02993197278911,20,15,500,3,484
3172,553,205,83.40607709750567,84.89215419501134,11,27,354,1,348
3173,553,228,83.40607709750567,85.40299319727892,11,26,336,2,325
3174,553,554,83.40607709750567,85.14757369614513,11,17,75,2,1
3175,553,515,83.40607709750567,86.12281179138323,11,19,123,3,38
3176,553,680,83.40607709750567,85.14757369614513,11,12,147,2,127
3177,553,819,83.40607709750567,86.05315192743764,11,16,289,3,266
3178,553,896,83.40607709750567,86.02993197278911,11,15,361,3,343
3179,554,231,85.14757369614513,87.05160997732426,17,26,333,2,323
3180,554,227,85.14757369614513,87.60888888888888,17,26,344,2,327
3181,554,515,85.14757369614513,86.6336507936508,17,14,75,1,39
3182,554,424,85.14757369614513,87.81786848072562,17,15,174,3,130
3183,554,743,85.14757369614513,86.93551020408164,17,13,204,2,189
3184,554,640,85.14757369614513,87.37668934240364,17,16,129,2,86
3185,554,869,85.14757369614513,86.58721088435374,17,12,321,1,315
3186,554,844,85.14757369614513,87.42312925170069,17,15,306,2,290
3187,515,227,86.12281179138323,87.60888888888888,19,26,295,1,288
3188,515,208,86.12281179138323,88.72344671201814,19,25,327,3,307
3189,515,424,86.12281179138323,87.81786848072562,19,15,117,2,91
3190,515,416,86.12281179138323,88.72344671201814,19,18,149,3,99
3191,515,640,86.12281179138323,87.37668934240364,19,16,136,1,125
3192,515,844,86.12281179138323,87.42312925170069,19,15,334,1,329
3193,515,833,86.12281179138323,89.0485260770975,19,13,342,3,318
3194,515,208,86.6336507936508,88.72344671201814,14,25,320,2,307
3195,515,424,86.6336507936508,87.81786848072562,14,15,104,1,91
3196,515,416,86.6336507936508,88.72344671201814,14,18,134,2,99
3197,515,720,86.6336507936508,89.1414058956916,14,17,232,3,205
3198,515,630,86.6336507936508,89.5825850340136,14,14,171,3,115
3199,515,833,86.6336507936508,89.0485260770975,14,13,335,2,318
3200,424,10,87.81786848072562,88.90920634920636,15,38,417,1,414
3201,424,25,87.81786848072562,90.20952380952382,15,39,412,2,399
3202,424,232,87.81786848072562,89.83800453514739,15,28,211,2,192
3203,424,413,87.81786848072562,89.65224489795918,15,18,80,2,11
3204,424,546,87.81786848072562,90.4649433106576,15,14,167,3,122
3205,424,720,87.81786848072562,89.1414058956916,15,17,301,1,296
3206,424,630,87.81786848072562,89.5825850340136,15,14,220,2,206
3207,424,617,87.81786848072562,90.4649433106576,15,14,224,3,193
3208,424,833,87.81786848072562,89.0485260770975,15,13,412,1,409
3209,416,25,88.72344671201814,90.20952380952382,18,39,396,1,391
3210,416,31,88.72344671201814,90.92934240362813,18,40,397,2,385
3211,416,232,88.72344671201814,89.83800453514739,18,28,190,1,184
3212,416,211,88.72344671201814,91.16154195011337,18,28,230,2,205
3213,416,546,88.72344671201814,90.4649433106576,18,14,150,2,130
3214,416,617,88.72344671201814,90.4649433106576,18,14,215,2,201
3215,416,641,88.72344671201814,91.34730158730159,18,15,252,3,225
3216,413,31,89.65224489795918,90.92934240362813,18,40,386,1,382
3217,413,7,89.65224489795918,91.99746031746032,18,39,418,2,406
3218,413,18,89.65224489795918,92.43863945578231,18,40,413,3,395
3219,413,211,89.65224489795918,91.16154195011337,18,28,212,2,202
3220,413,272,89.65224489795918,92.16,18,25,178,3,141
3221,413,571,89.65224489795918,92.22965986394559,18,15,193,3,158
3222,413,641,89.65224489795918,91.34730158730159,18,15,239,2,228
3223,546,272,90.4649433106576,92.16,14,25,284,2,274
3224,546,215,90.4649433106576,92.64761904761905,14,27,344,2,331
3225,546,571,90.4649433106576,92.22965986394559,14,15,80,2,25
3226,546,418,90.4649433106576,92.67083900226757,14,20,159,2,128
3227,546,665,90.4649433106576,92.67083900226757,14,16,152,2,119
3228,546,922,90.4649433106576,91.95102040816327,14,13,381,1,376
3229,546,923,90.4649433106576,92.97269841269842,14,14,392,3,377
3230,571,230,92.22965986394559,93.55319727891157,15,21,346,1,341
3231,571,232,92.22965986394559,95.15537414965986,15,25,362,3,339
3232,571,539,92.22965986394559,93.71573696145126,15,18,72,1,32
3233,571,573,92.22965986394559,94.52843537414967,15,18,99,2,2
3234,571,641,92.22965986394559,93.52997732426304,15,15,90,1,70
3235,571,634,92.22965986394559,94.43555555555555,15,13,114,2,63
3236,571,889,92.22965986394559,93.64607709750567,15,15,324,1,318
3237,571,921,92.22965986394559,94.41233560090703,15,11,362,2,350
3238,418,6,92.67083900226757,93.7621768707483,20,39,415,1,412
3239,418,7,92.67083900226757,94.64453514739229,20,38,420,2,411
3240,418,10,92.67083900226757,95.52689342403629,20,39,426,3,408
3241,418,232,92.67083900226757,95.15537414965986,20,25,215,2,186
3242,418,539,92.67083900226757,93.71573696145126,20,18,129,1,121
3243,418,573,92.67083900226757,94.52843537414967,20,18,174,2,155
3244,418,634,92.67083900226757,94.43555555555555,20,13,229,2,216
3245,539,232,93.71573696145126,95.15537414965986,18,25,313,1,307
3246,539,222,93.71573696145126,96.17705215419501,18,22,334,2,317
3247,539,230,93.71573696145126,96.4324716553288,18,23,330,3,309
3248,539,562,93.71573696145126,96.36281179138322,18,25,116,3,23
3249,539,561,93.71573696145126,96.38603174603175,18,23,117,3,22
3250,539,766,93.71573696145126,96.29315192743765,18,20,253,3,227
3251,539,886,93.71573696145126,96.29315192743765,18,17,364,3,347
3252,573,222,94.52843537414967,96.17705215419501,18,22,358,2,351
3253,573,230,94.52843537414967,96.4324716553288,18,23,353,2,343
3254,573,562,94.52843537414967,96.36281179138322,18,25,80,2,11
3255,573,561,94.52843537414967,96.38603174603175,18,23,81,2,12
3256,573,766,94.52843537414967,96.29315192743765,18,20,207,2,193
3257,573,633,94.52843537414967,97.12907029478458,18,19,127,3,60
3258,573,886,94.52843537414967,96.29315192743765,18,17,322,2,313
3259,573,899,94.52843537414967,97.17551020408163,18,12,345,3,326
3260,562,256,96.36281179138322,98.10430839002268,25,25,315,2,306
3261,562,217,96.36281179138322,98.40616780045352,25,25,356,2,345
3262,562,609,96.36281179138322,97.61668934240363,25,21,72,1,47
3263,562,433,96.36281179138322,98.63836734693878,25,17,162,2,129
3264,562,668,96.36281179138322,97.6863492063492,25,17,120,1,106
3265,562,637,96.36281179138322,98.91700680272109,25,17,133,3,75
3266,562,828,96.36281179138322,97.70956916099773,25,13,272,1,266
3267,562,957,96.36281179138322,98.94022675736962,25,13,410,3,395
3268,561,256,96.38603174603175,98.10430839002268,23,25,314,2,305
3269,561,217,96.38603174603175,98.40616780045352,23,25,355,2,344
3270,561,609,96.38603174603175,97.61668934240363,23,21,72,1,48
3271,561,433,96.38603174603175,98.63836734693878,23,17,161,2,128
3272,561,668,96.38603174603175,97.6863492063492,23,17,121,1,107
3273,561,637,96.38603174603175,98.91700680272109,23,17,133,3,76
3274,561,828,96.38603174603175,97.70956916099773,23,13,273,1,267
3275,561,957,96.38603174603175,98.94022675736962,23,13,411,3,396
3276,609,207,97.61668934240363,99.96190476190476,21,30,414,2,402
3277,609,433,97.61668934240363,98.63836734693878,21,17,181,1,176
3278,609,555,97.61668934240363,100.0780045351474,21,23,119,2,54
3279,609,585,97.61668934240363,100.47274376417234,21,18,125,3,24
3280,609,637,97.61668934240363,98.91700680272109,21,17,63,1,28
3281,609,641,97.61668934240363,100.14766439909297,21,17,114,3,32
3282,609,623,97.61668934240363,100.40308390022676,21,17,121,3,14
3283,609,957,97.61668934240363,98.94022675736962,21,13,353,1,348
3284,609,882,97.61668934240363,100.10122448979592,21,14,293,2,273
3285,609,899,97.61668934240363,100.47274376417234,21,15,315,3,290
3286,433,4,98.63836734693878,100.89070294784581,17,38,440,2,429
3287,433,207,98.63836734693878,99.96190476190476,17,30,233,1,226
3288,433,227,98.63836734693878,101.28544217687075,17,25,235,3,206
3289,433,555,98.63836734693878,100.0780045351474,17,23,137,1,122
3290,433,585,98.63836734693878,100.47274376417234,17,18,171,2,152
3291,433,641,98.63836734693878,100.14766439909297,17,17,218,2,208
3292,433,623,98.63836734693878,100.40308390022676,17,17,205,2,190
3293,433,622,98.63836734693878,101.56408163265306,17,18,227,3,189
3294,433,882,98.63836734693878,100.10122448979592,17,14,453,1,449
3295,433,899,98.63836734693878,100.47274376417234,17,15,473,2,466
3296,555,227,100.0780045351474,101.28544217687075,23,25,332,1,328
3297,555,256,100.0780045351474,101.63374149659865,23,26,306,2,299
3298,555,596,100.0780045351474,101.65696145124717,23,16,79,2,41
3299,555,622,100.0780045351474,101.56408163265306,23,18,93,1,67
3300,555,952,100.0780045351474,101.47120181405896,23,12,402,1,397
3301,555,847,100.0780045351474,102.79473922902494,23,11,315,3,292
3302,585,256,100.47274376417234,101.63374149659865,18,26,333,1,329
3303,585,234,100.47274376417234,103.23591836734694,18,23,371,3,351
3304,585,596,100.47274376417234,101.65696145124717,18,16,52,1,11
3305,585,584,100.47274376417234,103.25913832199547,18,16,120,3,1
3306,585,622,100.47274376417234,101.56408163265306,18,18,60,1,37
3307,585,643,100.47274376417234,103.23591836734694,18,13,132,3,58
3308,585,847,100.47274376417234,102.79473922902494,18,11,280,2,262
3309,596,234,101.65696145124717,103.23591836734694,16,23,368,2,362
3310,596,236,101.65696145124717,104.14149659863946,16,29,376,2,360
3311,596,584,101.65696145124717,103.25913832199547,16,16,70,2,12
3312,596,415,101.65696145124717,103.4681179138322,16,18,197,2,181
3313,596,643,101.65696145124717,103.23591836734694,16,13,83,2,47
3314,596,650,101.65696145124717,103.79319727891156,16,13,107,2,54
3315,596,847,101.65696145124717,102.79473922902494,16,11,256,1,251
3316,596,896,101.65696145124717,104.11827664399094,16,12,318,2,300
3317,584,375,103.25913832199547,104.69877551020409,16,27,218,1,209
3318,584,410,103.25913832199547,104.79165532879819,16,21,186,2,174
3319,584,530,103.25913832199547,106.09197278911564,16,19,133,3,54
3320,584,683,103.25913832199547,105.00063492063492,16,15,124,2,99
3321,584,743,103.25913832199547,106.02231292517007,16,24,199,3,159
3322,584,944,103.25913832199547,105.00063492063492,16,11,368,2,360
3323,584,885,103.25913832199547,106.06875283446712,16,17,324,3,301
3324,415,7,103.4681179138322,105.23283446712018,18,38,415,2,408
3325,415,5,103.4681179138322,106.18485260770976,18,39,426,3,410
3326,415,375,103.4681179138322,104.69877551020409,18,27,66,1,40
3327,415,247,103.4681179138322,106.27773242630386,18,24,207,3,168
3328,415,410,103.4681179138322,104.79165532879819,18,21,57,1,5
3329,415,530,103.4681179138322,106.09197278911564,18,19,161,3,115
3330,415,683,103.4681179138322,105.00063492063492,18,15,276,2,268
3331,415,743,103.4681179138322,106.02231292517007,18,24,346,3,328
3332,415,885,103.4681179138322,106.06875283446712,18,17,483,3,470
3333,410,5,104.79165532879819,106.18485260770976,21,39,409,1,405
3334,410,4,104.79165532879819,107.06721088435374,21,39,418,2,406
3335,410,247,104.79165532879819,106.27773242630386,21,24,175,1,163
3336,410,343,104.79165532879819,106.81179138321995,21,27,110,2,67
3337,410,530,104.79165532879819,106.09197278911564,21,19,132,1,120
3338,410,461,104.79165532879819,106.64925170068028,21,19,95,2,51
3339,410,538,104.79165532879819,107.43873015873017,21,16,171,3,128
3340,410,743,104.79165532879819,106.02231292517007,21,24,337,1,333
3341,410,647,104.79165532879819,107.16009070294785,21,18,258,2,237
3342,410,885,104.79165532879819,106.06875283446712,21,17,478,1,475
3343,410,873,104.79165532879819,107.64770975056689,21,11,479,3,463
3344,530,254,106.09197278911564,108.2746485260771,19,26,292,2,276
3345,530,256,106.09197278911564,108.55328798185941,19,26,294,2,274
3346,530,538,106.09197278911564,107.43873015873017,19,16,59,1,8
3347,530,558,106.09197278911564,108.99446712018141,19,16,128,3,28
3348,530,647,106.09197278911564,107.16009070294785,19,18,126,1,117
3349,530,718,106.09197278911564,108.08888888888889,19,15,207,2,188
3350,530,625,106.09197278911564,108.99446712018141,19,14,157,3,95
3351,530,924,106.09197278911564,107.11365079365079,19,14,396,1,394
3352,530,873,106.09197278911564,107.64770975056689,19,11,349,2,343
3353,461,10,106.64925170068028,107.87990929705215,19,38,454,1,451
3354,461,6,106.64925170068028,109.20344671201815,19,40,468,3,455
3355,461,254,106.64925170068028,108.2746485260771,19,26,219,2,207
3356,461,256,106.64925170068028,108.55328798185941,19,26,221,2,205
3357,461,558,106.64925170068028,108.99446712018141,19,16,140,2,97
3358,461,718,106.64925170068028,108.08888888888889,19,15,264,1,257
3359,461,625,106.64925170068028,108.99446712018141,19,14,193,2,164
3360,461,921,106.64925170068028,109.41242630385487,19,12,475,3,460
3361,538,256,107.43873015873017,108.55328798185941,16,26,286,1,282
3362,538,254,107.43873015873017,110.38766439909297,16,25,311,3,284
3363,538,558,107.43873015873017,108.99446712018141,16,16,70,2,20
3364,538,465,107.43873015873017,110.06258503401361,16,14,135,3,73
3365,538,625,107.43873015873017,108.99446712018141,16,14,110,2,87
3366,538,743,107.43873015873017,110.27156462585035,16,20,239,3,205
3367,538,921,107.43873015873017,109.41242630385487,16,12,392,2,383
3368,538,836,107.43873015873017,110.27156462585035,16,15,322,3,298
3369,558,254,108.99446712018141,110.38766439909297,16,25,310,1,304
3370,558,227,108.99446712018141,110.5966439909297,16,26,338,2,331
3371,558,465,108.99446712018141,110.06258503401361,16,14,104,1,93
3372,558,425,108.99446712018141,110.5966439909297,16,19,150,2,133
3373,558,743,108.99446712018141,110.27156462585035,16,20,193,1,185
3374,558,717,108.99446712018141,111.33968253968254,16,22,188,2,159
3375,558,789,108.99446712018141,111.73442176870749,16,16,259,3,231
3376,558,836,108.99446712018141,110.27156462585035,16,15,283,1,278
3377,558,823,108.99446712018141,111.33968253968254,16,17,284,2,265
3378,558,829,108.99446712018141,111.73442176870749,16,13,296,3,271
3379,465,7,110.06258503401361,111.40934240362812,14,38,462,1,458
3380,465,4,110.06258503401361,112.36136054421769,14,38,472,2,461
3381,465,4,110.06258503401361,112.80253968253969,14,39,476,3,461
3382,465,405,110.06258503401361,112.36136054421769,14,26,116,2,60
3383,465,410,110.06258503401361,112.40780045351474,14,19,115,2,55
3384,465,410,110.06258503401361,112.43102040816326,14,19,116,2,55
3385,465,717,110.06258503401361,111.33968253968254,14,22,258,1,252
3386,465,789,110.06258503401361,111.73442176870749,14,16,332,2,324
3387,465,641,110.06258503401361,112.52390022675738,14,16,205,2,176
3388,465,823,110.06258503401361,111.33968253968254,14,17,362,1,358
3389,465,829,110.06258503401361,111.73442176870749,14,13,371,2,364
3390,425,4,110.5966439909297,112.36136054421769,19,38,428,2,421
3391,425,4,110.5966439909297,112.80253968253969,19,39,432,2,421
3392,425,405,110.5966439909297,112.36136054421769,19,26,79,2,20
3393,425,253,110.5966439909297,113.38303854875284,19,24,210,3,172
3394,425,410,110.5966439909297,112.40780045351474,19,19,79,2,15
3395,425,410,110.5966439909297,112.43102040816326,19,19,80,2,15
3396,425,789,110.5966439909297,111.73442176870749,19,16,367,1,364
3397,425,641,110.5966439909297,112.52390022675738,19,16,231,2,216
3398,425,829,110.5966439909297,111.73442176870749,19,13,407,1,404
3399,410,4,112.40780045351474,114.12607709750567,19,38,413,2,406
3400,410,6,112.40780045351474,114.93877551020408,19,39,418,3,404
3401,410,211,112.40780045351474,114.19573696145125,19,27,213,2,199
3402,410,564,112.40780045351474,113.91709750566893,19,18,167,2,154
3403,410,537,112.40780045351474,114.47437641723356,19,14,155,2,127
3404,410,745,112.40780045351474,114.28861678004536,19,14,345,2,335
3405,410,720,112.40780045351474,115.17097505668934,19,12,332,3,310
3406,410,825,112.40780045351474,114.72979591836734,19,10,427,2,415
3407,410,4,112.43102040816326,114.12607709750567,19,38,413,2,406
3408,410,6,112.43102040816326,114.93877551020408,19,39,418,3,404
3409,410,211,112.43102040816326,114.19573696145125,19,27,213,2,199
3410,410,249,112.43102040816326,115.4031746031746,19,18,206,3,161
3411,410,564,112.43102040816326,113.91709750566893,19,18,167,1,154
3412,410,537,112.43102040816326,114.47437641723356,19,14,155,2,127
3413,410,745,112.43102040816326,114.28861678004536,19,14,344,2,335
3414,410,720,112.43102040816326,115.17097505668934,19,12,332,3,310
3415,410,825,112.43102040816326,114.72979591836734,19,10,427,2,415
3416,564,249,113.91709750566893,115.4031746031746,18,18,321,1,315
3417,564,363,113.91709750566893,116.26231292517006,18,21,225,2,201
3418,564,211,113.91709750566893,116.58739229024944,18,32,371,3,353
3419,564,602,113.91709750566893,116.05333333333334,18,19,100,2,38
3420,564,720,113.91709750566893,115.17097505668934,18,12,165,1,156
3421,564,633,113.91709750566893,116.05333333333334,18,16,115,2,69
3422,564,690,113.91709750566893,116.49451247165533,18,14,168,3,126
3423,537,363,114.47437641723356,116.26231292517006,14,21,190,2,174
3424,537,211,114.47437641723356,116.58739229024944,14,32,338,2,326
3425,537,602,114.47437641723356,116.05333333333334,14,19,94,2,65
3426,537,539,114.47437641723356,117.37687074829932,14,17,125,3,2
3427,537,633,114.47437641723356,116.05333333333334,14,16,118,2,96
3428,537,690,114.47437641723356,116.49451247165533,14,14,176,2,153
3429,602,216,116.05333333333334,117.84126984126985,19,29,394,2,386
3430,602,209,116.05333333333334,118.79328798185941,19,32,410,3,393
3431,602,539,116.05333333333334,117.37687074829932,19,17,85,1,63
3432,602,423,116.05333333333334,117.63229024943311,19,23,191,2,179
3433,602,551,116.05333333333334,118.88616780045352,19,14,132,3,51
3434,602,642,116.05333333333334,117.81804988662132,19,16,86,2,40
3435,602,633,116.05333333333334,118.90938775510205,19,13,127,3,31
3436,602,848,116.05333333333334,117.79482993197279,19,11,257,2,246
3437,539,209,117.37687074829932,118.79328798185941,17,32,336,1,330
3438,539,551,117.37687074829932,118.88616780045352,17,14,66,2,12
3439,539,542,117.37687074829932,119.74530612244898,17,18,102,2,3
3440,539,633,117.37687074829932,118.90938775510205,17,13,115,2,94
3441,539,743,117.37687074829932,120.14004535147393,17,21,236,3,204
3442,539,826,117.37687074829932,119.14158730158731,17,10,297,2,287
3443,539,846,117.37687074829932,120.14004535147393,17,16,329,3,307
3444,423,4,117.63229024943311,119.42022675736962,23,39,426,2,419
3445,423,4,117.63229024943311,119.8381859410431,23,38,430,2,419
3446,423,209,117.63229024943311,118.79328798185941,23,32,220,1,214
3447,423,249,117.63229024943311,120.44190476190477,23,26,212,3,174
3448,423,258,117.63229024943311,120.51156462585034,23,26,206,3,165
3449,423,551,117.63229024943311,118.88616780045352,23,14,139,1,128
3450,423,542,117.63229024943311,119.74530612244898,23,18,150,2,119
3451,423,633,117.63229024943311,118.90938775510205,23,13,217,1,210
3452,423,743,117.63229024943311,120.14004535147393,23,21,338,3,320
3453,423,826,117.63229024943311,119.14158730158731,23,10,408,2,403
3454,423,846,117.63229024943311,120.14004535147393,23,16,437,3,423
3455,551,249,118.88616780045352,120.44190476190477,14,26,309,2,302
3456,551,258,118.88616780045352,120.51156462585034,14,26,301,2,293
3457,551,410,118.88616780045352,121.16172335600908,14,19,172,2,141
3458,551,538,118.88616780045352,121.53324263038549,14,16,115,3,13
3459,551,743,118.88616780045352,120.14004535147393,14,21,199,1,192
3460,551,819,118.88616780045352,121.32426303854875,14,18,288,2,268
3461,551,640,118.88616780045352,121.78866213151927,14,14,153,3,89
3462,551,846,118.88616780045352,120.14004535147393,14,16,300,1,295
3463,551,820,118.88616780045352,121.32426303854875,14,14,289,2,269
3464,542,253,119.74530612244898,122.06730158730159,18,25,306,2,289
3465,542,410,119.74530612244898,121.16172335600908,18,19,145,1,132
3466,542,538,119.74530612244898,121.53324263038549,18,16,77,2,4
3467,542,819,119.74530612244898,121.32426303854875,18,18,285,2,277
3468,542,640,119.74530612244898,121.78866213151927,18,14,132,2,98
3469,542,820,119.74530612244898,121.32426303854875,18,14,286,2,278
3470,542,821,119.74530612244898,122.64780045351475,18,12,306,3,279
3471,410,51,121.16172335600908,122.99609977324263,19,38,368,2,359
3472,410,5,121.16172335600908,123.80879818594104,19,37,421,3,405
3473,410,228,121.16172335600908,122.97287981859411,19,22,198,2,182
3474,410,226,121.16172335600908,123.57659863945578,19,23,211,2,184
3475,410,426,121.16172335600908,122.76390022675737,19,15,71,2,16
3476,410,640,121.16172335600908,123.11219954648526,19,13,245,2,230
3477,410,821,121.16172335600908,122.64780045351475,19,12,416,1,411
3478,538,51,121.53324263038549,122.99609977324263,16,38,491,1,487
3479,538,228,121.53324263038549,122.97287981859411,16,22,316,1,310
3480,538,226,121.53324263038549,123.57659863945578,16,23,324,2,312
3481,538,426,121.53324263038549,122.76390022675737,16,15,124,1,112
3482,538,590,121.53324263038549,124.36607709750567,16,15,133,3,52
3483,538,640,121.53324263038549,123.11219954648526,16,13,123,2,102
3484,538,671,121.53324263038549,124.38929705215419,16,22,181,3,133
3485,538,821,121.53324263038549,122.64780045351475,16,12,287,1,283
3486,538,823,121.53324263038549,124.38929705215419,16,18,310,3,285
3487,426,5,122.76390022675737,123.80879818594104,15,37,423,1,421
3488,426,6,122.76390022675737,125.08589569160998,15,38,432,2,420
3489,426,7,122.76390022675737,125.52707482993198,15,39,436,3,419
3490,426,228,122.76390022675737,125.17877551020409,15,24,224,2,198
3491,426,590,122.76390022675737,124.36607709750567,15,15,178,2,164
3492,426,425,122.76390022675737,124.71437641723357,15,19,84,2,1
3493,426,422,122.76390022675737,125.5502947845805,15,17,120,3,4
3494,426,671,122.76390022675737,124.38929705215419,15,22,255,2,245
3495,426,664,122.76390022675737,125.4574149659864,15,18,265,3,238
3496,426,726,122.76390022675737,125.48063492063493,15,19,322,3,300
3497,426,823,122.76390022675737,124.38929705215419,15,18,403,2,397
3498,426,821,122.76390022675737,125.43419501133788,15,16,411,3,395
3499,426,823,122.76390022675737,125.48063492063493,15,14,414,3,397
3500,590,406,124.36607709750567,126.20045351473924,15,23,200,2,184
3501,590,422,124.36607709750567,125.5502947845805,15,17,176,1,168
3502,590,412,124.36607709750567,126.57197278911565,15,16,202,2,178
3503,590,664,124.36607709750567,125.4574149659864,15,18,88,1,74
3504,590,726,124.36607709750567,125.48063492063493,15,19,144,1,136
3505,590,615,124.36607709750567,126.64163265306122,15,13,101,2,25
3506,590,821,124.36607709750567,125.43419501133788,15,16,236,1,231
3507,590,823,124.36607709750567,125.48063492063493,15,14,238,1,233
3508,590,841,124.36607709750567,126.6184126984127,15,12,269,2,251
3509,425,4,124.71437641723357,126.92027210884353,19,39,432,2,421
3510,425,406,124.71437641723357,126.20045351473924,19,23,67,1,19
3511,425,218,124.71437641723357,127.47755102040817,19,21,239,3,207
3512,425,412,124.71437641723357,126.57197278911565,19,16,81,2,13
3513,425,615,124.71437641723357,126.64163265306122,19,13,207,2,190
3514,425,841,124.71437641723357,126.6184126984127,19,12,424,2,416
3515,422,4,125.5502947845805,126.92027210884353,17,39,422,1,418
3516,422,7,125.5502947845805,128.17414965986396,17,39,430,3,415
3517,422,218,125.5502947845805,127.47755102040817,17,21,220,2,204
3518,422,215,125.5502947845805,128.220589569161,17,27,237,3,207
3519,422,385,125.5502947845805,128.52244897959184,17,23,133,3,37
3520,422,412,125.5502947845805,126.57197278911565,17,16,45,1,10
3521,422,599,125.5502947845805,128.05804988662132,17,20,207,3,177
3522,422,615,125.5502947845805,126.64163265306122,17,13,199,1,193
3523,422,641,125.5502947845805,128.4063492063492,17,16,251,3,219
3524,422,841,125.5502947845805,126.6184126984127,17,12,422,1,419
3525,422,896,125.5502947845805,127.94195011337868,17,11,485,2,474
3526,412,7,126.57197278911565,128.17414965986396,16,39,411,2,405
3527,412,7,126.57197278911565,128.61532879818594,16,38,414,2,405
3528,412,215,126.57197278911565,128.220589569161,16,27,209,2,197
3529,412,385,126.57197278911565,128.52244897959184,16,23,88,2,27
3530,412,599,126.57197278911565,128.05804988662132,16,20,198,1,187
3531,412,538,126.57197278911565,128.59210884353743,16,15,153,2,126
3532,412,641,126.57197278911565,128.4063492063492,16,16,242,2,229
3533,412,638,126.57197278911565,128.82430839002268,16,13,246,2,226
3534,412,896,126.57197278911565,127.94195011337868,16,11,488,1,484
3535,599,228,128.05804988662132,129.75310657596373,20,24,378,2,371
3536,599,211,128.05804988662132,130.70512471655329,20,28,404,3,388
3537,599,574,128.05804988662132,130.24072562358276,20,17,97,2,25
3538,599,422,128.05804988662132,130.65868480725624,20,21,209,3,177
3539,599,631,128.05804988662132,129.7298866213152,20,14,79,2,32
3540,538,228,128.59210884353743,129.75310657596373,15,24,314,1,310
3541,538,211,128.59210884353743,130.70512471655329,15,28,339,2,327
3542,538,574,128.59210884353743,130.24072562358276,15,17,80,2,36
3543,538,422,128.59210884353743,130.65868480725624,15,21,146,2,116
3544,538,631,128.59210884353743,129.7298866213152,15,14,105,1,93
3545,538,641,128.59210884353743,131.49460317460318,15,13,162,3,103
3546,538,825,128.59210884353743,131.49460317460318,15,12,313,3,287
3547,574,230,130.24072562358276,131.79646258503402,17,30,350,2,344
3548,574,214,130.24072562358276,132.81814058956917,17,33,377,3,360
3549,574,431,130.24072562358276,131.79646258503402,17,19,158,2,143
3550,574,641,130.24072562358276,131.49460317460318,17,13,86,1,67
3551,574,640,130.24072562358276,132.35374149659864,17,14,112,2,66
3552,574,825,130.24072562358276,131.49460317460318,17,12,257,1,251
3553,574,848,130.24072562358276,131.91256235827666,17,12,283,2,274
3554,422,10,130.65868480725624,131.70358276643992,21,38,414,1,412
3555,422,6,130.65868480725624,133.0271201814059,21,38,428,2,416
3556,422,230,130.65868480725624,131.79646258503402,21,30,198,1,192
3557,422,214,130.65868480725624,132.81814058956917,21,33,228,2,208
3558,422,227,130.65868480725624,133.51473922902494,21,25,231,3,195
3559,422,431,130.65868480725624,131.79646258503402,21,19,50,1,9
3560,422,419,130.65868480725624,133.44507936507938,21,15,120,3,3
3561,422,640,130.65868480725624,132.35374149659864,21,14,230,2,218
3562,422,632,130.65868480725624,133.23609977324264,21,14,238,3,210
3563,422,848,130.65868480725624,131.91256235827666,21,12,429,1,426
3564,422,826,130.65868480725624,133.25931972789115,21,10,419,3,404
3565,431,6,131.79646258503402,133.0271201814059,19,38,428,1,425
3566,431,5,131.79646258503402,134.42031746031745,19,40,441,3,426
3567,431,214,131.79646258503402,132.81814058956917,19,33,221,1,217
3568,431,227,131.79646258503402,133.51473922902494,19,25,217,2,204
3569,431,419,131.79646258503402,133.44507936507938,19,15,72,2,12
3570,431,551,131.79646258503402,134.1881179138322,19,14,158,2,120
3571,431,632,131.79646258503402,133.23609977324264,19,14,210,1,201
3572,431,630,131.79646258503402,133.67727891156463,19,14,215,2,199
3573,431,826,131.79646258503402,133.25931972789115,19,10,400,1,395
3574,431,837,131.79646258503402,134.3738775510204,19,10,421,3,406
3575,419,5,133.44507936507938,135.0704761904762,15,40,420,2,414
3576,419,7,133.44507936507938,136.11537414965986,15,39,428,3,412
3577,419,407,133.44507936507938,135.27945578231294,15,21,80,2,12
3578,419,214,133.44507936507938,135.58131519274377,15,23,225,2,205
3579,419,604,133.44507936507938,135.2562358276644,15,17,201,2,185
3580,419,515,133.44507936507938,135.67419501133787,15,18,136,2,96
3581,419,626,133.44507936507938,135.32589569161,15,16,222,2,207
3582,419,629,133.44507936507938,135.8831746031746,15,17,235,2,210
3583,419,902,133.44507936507938,135.3491156462585,15,15,490,2,483
3584,419,905,133.44507936507938,136.3243537414966,15,10,502,3,486
3585,551,407,134.1881179138322,135.27945578231294,14,21,151,1,144
3586,551,214,134.1881179138322,135.58131519274377,14,23,342,1,337
3587,551,345,134.1881179138322,137.0209523809524,14,24,239,3,206
3588,551,604,134.1881179138322,135.2562358276644,14,17,70,1,53
3589,551,515,134.1881179138322,135.67419501133787,14,18,73,1,36
3590,551,478,134.1881179138322,136.78875283446712,14,19,134,3,73
3591,551,626,134.1881179138322,135.32589569161,14,16,90,1,75
3592,551,629,134.1881179138322,135.8831746031746,14,17,107,2,78
3593,551,631,134.1881179138322,137.0209523809524,14,16,146,3,80
3594,551,902,134.1881179138322,135.3491156462585,14,15,355,1,351
3595,551,905,134.1881179138322,136.3243537414966,14,10,366,2,354
3596,551,821,134.1881179138322,136.78875283446712,14,12,292,3,270
3597,604,345,135.2562358276644,137.0209523809524,17,24,270,2,259
3598,604,230,135.2562358276644,137.60145124716553,17,26,387,2,374
3599,604,478,135.2562358276644,136.78875283446712,17,19,142,2,126
3600,604,631,135.2562358276644,137.0209523809524,17,16,81,2,27
3601,604,905,135.2562358276644,136.3243537414966,17,10,304,1,301
3602,604,821,135.2562358276644,136.78875283446712,17,12,227,2,217
3603,515,345,135.67419501133787,137.0209523809524,18,24,180,1,170
3604,515,230,135.67419501133787,137.60145124716553,18,26,297,2,285
3605,515,478,135.67419501133787,136.78875283446712,18,19,61,1,37
3606,515,410,135.67419501133787,138.32126984126984,18,22,155,3,105
3607,515,631,135.67419501133787,137.0209523809524,18,16,130,1,116
3608,515,615,135.67419501133787,138.32126984126984,18,16,152,3,100
3609,515,658,135.67419501133787,138.55346938775511,18,17,189,3,143
3610,515,821,135.67419501133787,136.78875283446712,18,12,310,1,306
3611,515,890,135.67419501133787,138.32126984126984,18,11,392,3,375
3612,515,826,135.67419501133787,138.55346938775511,18,13,335,3,311
3613,478,6,136.78875283446712,137.88009070294785,19,39,474,1,472
3614,478,4,136.78875283446712,138.8321088435374,19,39,482,2,474
3615,478,7,136.78875283446712,139.64480725623582,19,39,487,3,471
3616,478,229,136.78875283446712,139.43582766439908,19,23,274,3,249
3617,478,410,136.78875283446712,138.32126984126984,19,22,95,2,68
3618,478,424,136.78875283446712,139.2500680272109,19,20,119,2,54
3619,478,615,136.78875283446712,138.32126984126984,19,16,152,2,137
3620,478,658,136.78875283446712,138.55346938775511,19,17,195,2,180
3621,478,890,136.78875283446712,138.32126984126984,19,11,417,2,412
3622,478,826,136.78875283446712,138.55346938775511,19,13,356,2,348
3623,410,7,138.32126984126984,139.64480725623582,22,39,407,1,403
3624,410,4,138.32126984126984,140.5968253968254,22,39,418,2,406
3625,410,229,138.32126984126984,139.43582766439908,22,23,187,1,181
3626,410,230,138.32126984126984,140.13242630385488,22,26,196,2,180
3627,410,300,138.32126984126984,140.99156462585034,22,23,159,3,110
3628,410,461,138.32126984126984,140.10920634920635,22,16,92,2,51
3629,410,428,138.32126984126984,141.17732426303854,22,14,124,3,18
3630,410,724,138.32126984126984,140.29496598639457,22,12,325,2,314
3631,410,690,138.32126984126984,141.17732426303854,22,14,306,3,280
3632,410,826,138.32126984126984,140.31818594104308,22,12,425,2,416
3633,410,905,138.32126984126984,141.17732426303854,22,12,510,3,495
3634,424,4,139.2500680272109,140.5968253968254,20,39,424,1,420
3635,424,23,139.2500680272109,141.96680272108844,20,39,418,3,401
3636,424,300,139.2500680272109,140.99156462585034,20,23,145,2,124
3637,424,351,139.2500680272109,141.8274829931973,20,22,133,3,73
3638,424,428,139.2500680272109,141.17732426303854,20,14,83,2,4
3639,424,465,139.2500680272109,141.8274829931973,20,15,118,3,41
3640,424,724,139.2500680272109,140.29496598639457,20,12,303,1,300
3641,424,690,139.2500680272109,141.17732426303854,20,14,279,2,266
3642,424,720,139.2500680272109,141.64172335600907,20,12,313,2,296
3643,424,826,139.2500680272109,140.31818594104308,20,12,405,1,402
3644,424,905,139.2500680272109,141.17732426303854,20,12,488,2,481
3645,461,23,140.10920634920635,141.96680272108844,16,39,445,2,438
3646,461,351,140.10920634920635,141.8274829931973,16,22,133,2,110
3647,461,428,140.10920634920635,141.17732426303854,16,14,57,1,33
3648,461,465,140.10920634920635,141.8274829931973,16,15,74,2,4
3649,461,600,140.10920634920635,142.84916099773244,16,19,182,3,139
3650,461,690,140.10920634920635,141.17732426303854,16,14,234,1,229
3651,461,720,140.10920634920635,141.64172335600907,16,12,267,2,259
3652,461,624,140.10920634920635,142.8259410430839,16,17,201,3,163
3653,461,905,140.10920634920635,141.17732426303854,16,12,446,1,444
3654,461,924,140.10920634920635,142.40798185941043,16,13,473,2,463
3655,461,853,140.10920634920635,142.7562811791383,16,14,408,3,392
3656,428,22,141.17732426303854,143.15102040816328,14,37,415,2,406
3657,428,205,141.17732426303854,143.19746031746033,14,17,239,2,223
3658,428,223,141.17732426303854,144.10303854875283,14,22,241,3,205
3659,428,600,141.17732426303854,142.84916099773244,14,19,186,2,172
3660,428,577,141.17732426303854,143.75473922902495,14,21,186,3,149
3661,428,624,141.17732426303854,142.8259410430839,14,17,208,2,196
3662,428,625,141.17732426303854,143.801179138322,14,19,227,3,197
3663,428,924,141.17732426303854,142.40798185941043,14,13,499,1,496
3664,428,853,141.17732426303854,142.7562811791383,14,14,430,2,425
3665,428,859,141.17732426303854,143.77795918367346,14,15,445,3,431
3666,465,22,141.8274829931973,143.15102040816328,15,37,447,1,443
3667,465,23,141.8274829931973,144.47455782312926,15,37,456,3,442
3668,465,205,141.8274829931973,143.19746031746033,15,17,267,1,260
3669,465,223,141.8274829931973,144.10303854875283,15,22,261,2,242
3670,465,600,141.8274829931973,142.84916099773244,15,19,142,1,135
3671,465,577,141.8274829931973,143.75473922902495,15,21,139,2,112
3672,465,582,141.8274829931973,144.7764172335601,15,17,173,3,117
3673,465,625,141.8274829931973,143.801179138322,15,19,181,2,160
3674,465,859,141.8274829931973,143.77795918367346,15,15,403,2,394
3675,600,223,142.84916099773244,144.10303854875283,19,22,381,1,377
3676,600,222,142.84916099773244,145.0550566893424,19,20,390,2,378
3677,600,582,142.84916099773244,144.7764172335601,19,17,85,2,18
3678,600,624,142.84916099773244,145.4033560090703,19,18,113,3,24
3679,600,901,142.84916099773244,144.82285714285715,19,15,313,2,301
3680,577,222,143.75473922902495,145.0550566893424,21,20,359,1,355
3681,577,211,143.75473922902495,146.0302947845805,21,16,379,2,366
3682,577,582,143.75473922902495,144.7764172335601,21,17,44,1,5
3683,577,573,143.75473922902495,146.49469387755101,21,13,118,3,4
3684,577,624,143.75473922902495,145.4033560090703,21,18,85,2,47
3685,577,631,143.75473922902495,146.0302947845805,21,10,112,2,54
3686,577,627,143.75473922902495,146.68045351473924,21,11,136,3,50
3687,577,901,143.75473922902495,144.82285714285715,21,15,327,1,324
3688,577,937,143.75473922902495,146.3785941043084,21,12,377,3,360
3689,582,211,144.7764172335601,146.0302947845805,17,16,375,1,371
3690,582,205,144.7764172335601,147.42349206349206,17,22,394,3,377
3691,582,573,144.7764172335601,146.49469387755101,17,13,75,2,9
3692,582,428,144.7764172335601,147.49315192743765,17,15,193,3,154
3693,582,631,144.7764172335601,146.0302947845805,17,10,73,1,49
3694,582,627,144.7764172335601,146.68045351473924,17,11,94,2,45
3695,582,937,144.7764172335601,146.3785941043084,17,12,362,2,355
3696,573,224,146.49469387755101,148.5380498866213,13,26,360,2,349
3697,573,229,146.49469387755101,148.6077097505669,13,30,356,2,344
3698,573,481,146.49469387755101,148.09687074829932,13,14,115,2,92
3699,573,549,146.49469387755101,148.65414965986395,13,17,96,2,24
3700,573,667,146.49469387755101,147.8878911564626,13,14,112,1,94
3701,573,633,146.49469387755101,149.35074829931972,13,16,137,3,60
3702,573,933,146.49469387755101,148.12009070294786,13,16,367,2,360
3703,573,821,146.49469387755101,149.44362811791385,13,14,279,3,248
3704,428,52,147.49315192743765,148.83990929705215,15,39,380,1,376
3705,428,6,147.49315192743765,150.23310657596372,15,39,438,3,422
3706,428,224,147.49315192743765,148.5380498866213,15,26,209,1,204
3707,428,229,147.49315192743765,148.6077097505669,15,30,205,1,199
3708,428,252,147.49315192743765,150.02412698412698,15,19,207,3,176
3709,428,549,147.49315192743765,148.65414965986395,15,17,131,1,121
3710,428,515,147.49315192743765,149.65260770975058,15,18,127,2,87
3711,428,633,147.49315192743765,149.35074829931972,15,16,220,2,205
3712,428,625,147.49315192743765,150.00090702947847,15,16,225,3,197
3713,428,821,147.49315192743765,149.44362811791385,15,14,402,2,393
3714,428,821,147.49315192743765,149.79192743764173,15,14,405,2,393
3715,481,6,148.09687074829932,150.23310657596372,14,39,484,2,475
3716,481,252,148.09687074829932,150.02412698412698,14,19,244,2,229
3717,481,205,148.09687074829932,150.90648526077098,14,24,301,3,276
3718,481,515,148.09687074829932,149.65260770975058,14,18,75,2,34
3719,481,633,148.09687074829932,149.35074829931972,14,16,161,1,152
3720,481,625,148.09687074829932,150.00090702947847,14,16,166,2,144
3721,481,653,148.09687074829932,151.04580498866213,14,15,214,3,172
3722,481,821,148.09687074829932,149.44362811791385,14,14,345,1,340
3723,481,821,148.09687074829932,149.79192743764173,14,14,348,2,340
3724,549,252,148.65414965986395,150.02412698412698,17,19,303,1,297
3725,549,205,148.65414965986395,150.90648526077098,17,24,357,2,344
3726,549,472,148.65414965986395,151.11546485260772,17,14,131,2,77
3727,549,625,148.65414965986395,150.00090702947847,17,16,96,1,76
3728,549,653,148.65414965986395,151.04580498866213,17,15,146,2,104
3729,549,821,148.65414965986395,149.79192743764173,17,14,276,1,272
3730,549,923,148.65414965986395,151.09224489795918,17,15,388,2,374
3731,515,205,149.65260770975058,150.90648526077098,18,24,315,1,310
3732,515,229,149.65260770975058,151.9049433106576,18,22,302,2,286
3733,515,472,149.65260770975058,151.11546485260772,18,14,76,1,43
3734,515,483,149.65260770975058,152.41578231292516,18,14,123,3,32
3735,515,653,149.65260770975058,151.04580498866213,18,15,150,1,138
3736,515,676,149.65260770975058,151.76562358276644,18,16,185,2,161
3737,515,923,149.65260770975058,151.09224489795918,18,15,413,1,408
3738,515,922,149.65260770975058,151.76562358276644,18,11,417,2,407
3739,472,60,151.11546485260772,152.92662131519273,14,38,419,2,412
3740,472,336,151.11546485260772,152.69442176870749,14,28,152,2,136
3741,472,351,151.11546485260772,153.99473922902496,14,26,173,3,121
3742,472,483,151.11546485260772,152.41578231292516,14,14,57,1,11
3743,472,544,151.11546485260772,153.04272108843537,14,17,110,2,72
3744,472,617,151.11546485260772,153.53034013605443,14,15,178,2,145
3745,472,941,151.11546485260772,153.53034013605443,14,12,480,2,469
3746,472,825,151.11546485260772,153.99473922902496,14,12,374,3,353
3747,483,6,152.41578231292516,154.2037188208617,14,38,483,2,477
3748,483,4,152.41578231292516,155.364716553288,14,41,496,3,479
3749,483,351,152.41578231292516,153.99473922902496,14,26,148,2,132
3750,483,541,152.41578231292516,154.18049886621316,14,14,96,2,58
3751,483,432,152.41578231292516,155.06285714285715,14,22,125,3,51
3752,483,617,152.41578231292516,153.53034013605443,14,15,142,1,134
3753,483,719,152.41578231292516,154.55201814058958,14,18,253,2,236
3754,483,720,152.41578231292516,154.85387755102042,14,21,259,2,237
3755,483,941,152.41578231292516,153.53034013605443,14,12,461,1,458
3756,483,825,152.41578231292516,153.99473922902496,14,12,349,2,342
3757,544,354,153.04272108843537,155.57369614512473,17,27,219,3,190
3758,544,250,153.04272108843537,155.73623582766442,17,26,316,3,294
3759,544,541,153.04272108843537,154.18049886621316,17,14,49,1,3
3760,544,432,153.04272108843537,155.06285714285715,17,22,142,2,112
3761,544,719,153.04272108843537,154.55201814058958,17,18,187,2,175
3762,544,720,153.04272108843537,154.85387755102042,17,21,193,2,176
3763,544,902,153.04272108843537,155.43437641723355,17,16,373,2,358
3764,541,58,154.18049886621316,156.64181405895692,14,38,494,2,483
3765,541,354,154.18049886621316,155.57369614512473,14,27,196,1,187
3766,541,250,154.18049886621316,155.73623582766442,14,26,299,2,291
3767,541,223,154.18049886621316,156.64181405895692,14,22,335,2,318
3768,541,461,154.18049886621316,156.06131519274376,14,19,114,2,80
3769,541,515,154.18049886621316,156.82757369614512,14,18,117,3,26
3770,541,619,154.18049886621316,156.1774149659864,14,18,116,2,78
3771,541,655,154.18049886621316,156.6185941043084,14,16,155,2,114
3772,541,902,154.18049886621316,155.43437641723355,14,16,365,1,361
3773,541,902,154.18049886621316,156.5257142857143,14,16,375,2,361
3774,541,898,154.18049886621316,157.0597732426304,14,15,378,3,357
3775,432,4,155.06285714285715,156.47927437641724,22,41,432,1,428
3776,432,58,155.06285714285715,156.64181405895692,22,38,380,2,374
3777,432,223,155.06285714285715,156.64181405895692,22,22,220,2,209
3778,432,515,155.06285714285715,156.82757369614512,22,18,113,2,83
3779,432,427,155.06285714285715,158.0350113378685,22,20,128,3,5
3780,432,619,155.06285714285715,156.1774149659864,22,18,193,1,187
3781,432,655,155.06285714285715,156.6185941043084,22,16,233,2,223
3782,432,902,155.06285714285715,156.5257142857143,22,16,474,1,470
3783,432,898,155.06285714285715,157.0597732426304,22,15,474,2,466
3784,432,825,155.06285714285715,157.9653514739229,22,12,412,3,393
3785,461,5,156.06131519274376,158.2439909297052,19,38,466,2,456
3786,461,229,156.06131519274376,158.2439909297052,19,29,250,2,232
3787,461,427,156.06131519274376,158.0350113378685,19,20,92,2,34
3788,461,617,156.06131519274376,158.4065306122449,19,17,186,2,156
3789,461,681,156.06131519274376,158.82448979591837,19,15,250,3,220
3790,461,825,156.06131519274376,157.9653514739229,19,12,373,2,364
3791,461,845,156.06131519274376,158.82448979591837,19,12,402,3,384
3792,515,17,156.82757369614512,159.26566893424035,18,34,509,2,498
3793,515,229,156.82757369614512,158.2439909297052,18,29,292,1,286
3794,515,299,156.82757369614512,159.54430839002268,18,24,246,3,216
3795,515,427,156.82757369614512,158.0350113378685,18,20,102,1,88
3796,515,483,156.82757369614512,159.4746485260771,18,18,118,3,32
3797,515,617,156.82757369614512,158.4065306122449,18,17,123,2,102
3798,515,681,156.82757369614512,158.82448979591837,18,15,187,2,166
3799,515,739,156.82757369614512,159.63718820861678,18,18,255,3,224
3800,515,825,156.82757369614512,157.9653514739229,18,12,314,1,310
3801,515,845,156.82757369614512,158.82448979591837,18,12,341,2,330
3802,515,895,156.82757369614512,159.66040816326532,18,16,399,3,380
3803,427,17,158.0350113378685,159.26566893424035,20,34,413,1,410
3804,427,4,158.0350113378685,160.0087074829932,20,40,431,2,423
3805,427,299,158.0350113378685,159.54430839002268,20,24,144,2,128
3806,427,208,158.0350113378685,160.58920634920636,20,30,245,3,219
3807,427,483,158.0350113378685,159.4746485260771,20,18,84,1,56
3808,427,411,158.0350113378685,160.61242630385487,20,25,112,3,16
3809,427,411,158.0350113378685,160.6356462585034,20,22,113,3,16
3810,427,739,158.0350113378685,159.63718820861678,20,18,320,2,312
3811,427,809,158.0350113378685,160.6356462585034,20,15,398,3,382
3812,427,895,158.0350113378685,159.66040816326532,20,16,473,2,468
3813,483,4,159.4746485260771,161.6108843537415,18,37,488,2,479
3814,483,54,159.4746485260771,161.93596371882086,18,37,442,2,429
3815,483,208,159.4746485260771,160.58920634920636,18,30,279,1,275
3816,483,299,159.4746485260771,161.58766439909297,18,24,205,2,184
3817,483,278,159.4746485260771,162.44680272108843,18,22,242,3,205
3818,483,411,159.4746485260771,160.61242630385487,18,25,87,1,72
3819,483,411,159.4746485260771,160.6356462585034,18,22,88,1,72
3820,483,415,159.4746485260771,161.7037641723356,18,22,118,2,68
3821,483,809,159.4746485260771,160.6356462585034,18,15,330,1,326
3822,483,642,159.4746485260771,162.35392290249433,18,15,202,3,159
3823,483,897,159.4746485260771,161.44834467120182,18,12,423,2,414
3824,483,966,159.4746485260771,162.35392290249433,18,11,499,3,483
3825,411,54,160.61242630385487,161.93596371882086,25,37,362,1,357
3826,411,4,160.61242630385487,163.53814058956917,25,38,426,3,407
3827,411,278,160.61242630385487,162.44680272108843,25,22,155,2,133
3828,411,244,160.61242630385487,163.49170068027212,25,31,208,3,167
3829,411,415,160.61242630385487,161.7037641723356,25,22,47,1,4
3830,411,535,160.61242630385487,163.32916099773243,25,25,170,3,124
3831,411,642,160.61242630385487,162.35392290249433,25,15,243,2,231
3832,411,620,160.61242630385487,163.32916099773243,25,20,240,3,209
3833,411,826,160.61242630385487,162.81832199546486,25,12,426,2,415
3834,411,54,160.6356462585034,161.93596371882086,22,37,361,1,357
3835,411,4,160.6356462585034,163.53814058956917,22,38,426,3,407
3836,411,278,160.6356462585034,162.44680272108843,22,22,154,2,133
3837,411,244,160.6356462585034,163.49170068027212,22,31,207,3,167
3838,411,415,160.6356462585034,161.7037641723356,22,22,46,1,4
3839,411,535,160.6356462585034,163.32916099773243,22,25,170,3,124
3840,411,642,160.6356462585034,162.35392290249433,22,15,243,2,231
3841,411,620,160.6356462585034,163.32916099773243,22,20,239,3,209
3842,411,826,160.6356462585034,162.81832199546486,22,12,426,2,415
3843,415,4,161.7037641723356,163.53814058956917,22,38,419,2,411
3844,415,4,161.7037641723356,163.6542403628118,22,35,419,2,411
3845,415,244,161.7037641723356,163.49170068027212,22,31,188,2,171
3846,415,381,161.7037641723356,164.0954195011338,22,26,108,2,34
3847,415,535,161.7037641723356,163.32916099773243,22,25,139,2,120
3848,415,419,161.7037641723356,164.11863945578233,22,24,104,2,4
3849,415,620,161.7037641723356,163.32916099773243,22,20,217,2,205
3850,415,701,161.7037641723356,164.0954195011338,22,17,304,2,286
3851,415,826,161.7037641723356,162.81832199546486,22,12,414,1,411
3852,535,62,163.32916099773243,165.2564172335601,25,39,480,2,473
3853,535,61,163.32916099773243,165.65115646258505,25,36,484,2,474
3854,535,240,163.32916099773243,165.34929705215418,25,24,308,2,295
3855,535,256,163.32916099773243,165.99945578231294,25,26,302,3,279
3856,535,569,163.32916099773243,165.46539682539682,25,17,98,2,34
3857,535,422,163.32916099773243,165.92979591836735,25,20,159,3,113
3858,535,633,163.32916099773243,165.5350566893424,25,15,136,2,98
3859,535,619,163.32916099773243,165.9762358276644,25,15,142,3,84
3860,535,831,163.32916099773243,164.79201814058956,25,12,303,1,296
3861,535,940,163.32916099773243,165.67437641723356,25,12,417,2,405
3862,419,62,164.11863945578233,165.2564172335601,24,39,360,1,357
3863,419,61,164.11863945578233,165.65115646258505,24,36,364,2,358
3864,419,5,164.11863945578233,167.06757369614513,24,39,433,3,414
3865,419,240,164.11863945578233,165.34929705215418,24,24,187,1,179
3866,419,256,164.11863945578233,165.99945578231294,24,26,182,2,163
3867,419,569,164.11863945578233,165.46539682539682,24,17,161,1,150
3868,419,422,164.11863945578233,165.92979591836735,24,20,78,2,3
3869,419,423,164.11863945578233,167.06757369614513,24,22,127,3,4
3870,419,633,164.11863945578233,165.5350566893424,24,15,223,1,214
3871,419,619,164.11863945578233,165.9762358276644,24,15,215,2,200
3872,569,210,165.46539682539682,167.5784126984127,17,34,370,2,359
3873,569,212,165.46539682539682,168.18213151927438,17,32,376,3,357
3874,569,423,165.46539682539682,167.06757369614513,17,22,161,2,146
3875,569,470,165.46539682539682,168.29823129251702,17,17,157,3,99
3876,569,818,165.46539682539682,167.20689342403628,17,17,260,2,249
3877,569,896,165.46539682539682,167.20689342403628,17,15,335,2,327
3878,422,5,165.92979591836735,167.06757369614513,20,39,420,1,417
3879,422,5,165.92979591836735,168.36789115646258,20,39,430,2,417
3880,422,210,165.92979591836735,167.5784126984127,20,34,224,2,212
3881,422,212,165.92979591836735,168.18213151927438,20,32,231,2,210
3882,422,218,165.92979591836735,168.7161904761905,20,25,237,3,204
3883,422,423,165.92979591836735,167.06757369614513,20,22,49,1,1
3884,422,470,165.92979591836735,168.29823129251702,20,17,113,2,48
3885,422,818,165.92979591836735,167.20689342403628,20,17,400,1,396
3886,422,819,165.92979591836735,168.53043083900226,20,16,412,3,397
3887,422,896,165.92979591836735,167.20689342403628,20,15,477,1,474
3888,422,820,165.92979591836735,168.53043083900226,20,15,413,3,398
3889,423,5,167.06757369614513,168.36789115646258,22,39,422,1,418
3890,423,5,167.06757369614513,169.48244897959185,22,40,431,2,418
3891,423,212,167.06757369614513,168.18213151927438,22,32,216,1,211
3892,423,218,167.06757369614513,168.7161904761905,22,25,217,2,205
3893,423,248,167.06757369614513,169.76108843537415,22,20,210,3,175
3894,423,470,167.06757369614513,168.29823129251702,22,17,71,1,47
3895,423,580,167.06757369614513,169.13414965986394,22,19,180,2,157
3896,423,819,167.06757369614513,168.53043083900226,22,16,401,1,396
3897,423,691,167.06757369614513,169.59854875283446,22,25,289,3,268
3898,423,820,167.06757369614513,168.53043083900226,22,15,402,1,397
3899,423,829,167.06757369614513,169.5288888888889,22,18,420,2,406
3900,470,5,168.29823129251702,169.48244897959185,17,40,468,1,465
3901,470,5,168.29823129251702,170.5970068027211,17,39,475,2,465
3902,470,248,168.29823129251702,169.76108843537415,17,20,231,1,222
3903,470,342,168.29823129251702,171.13106575963718,17,26,177,3,128
3904,470,515,168.29823129251702,170.20226757369616,17,20,94,2,45
3905,470,515,168.29823129251702,170.82920634920634,17,17,118,3,45
3906,470,691,168.29823129251702,169.59854875283446,17,25,228,1,221
3907,470,723,168.29823129251702,170.55056689342405,17,17,271,2,253
3908,470,819,168.29823129251702,170.73632653061225,17,18,364,2,349
3909,470,829,168.29823129251702,169.5288888888889,17,18,363,1,359
3910,470,924,168.29823129251702,170.36480725623582,17,15,463,2,454
3911,470,821,168.29823129251702,170.73632653061225,17,16,366,2,351
3912,580,342,169.13414965986394,171.13106575963718,19,26,253,2,238
3913,580,515,169.13414965986394,170.20226757369616,19,20,80,1,65
3914,580,515,169.13414965986394,170.82920634920634,19,17,98,2,65
3915,580,439,169.13414965986394,171.82766439909298,19,16,183,3,141
3916,580,723,169.13414965986394,170.55056689342405,19,17,155,1,143
3917,580,819,169.13414965986394,170.73632653061225,19,18,249,2,239
3918,580,924,169.13414965986394,170.36480725623582,19,15,348,1,344
3919,580,821,169.13414965986394,170.73632653061225,19,16,251,2,241
3920,515,58,170.20226757369616,171.64190476190475,20,40,461,1,457
3921,515,211,170.20226757369616,172.52426303854875,20,18,320,2,304
3922,515,439,170.20226757369616,171.82766439909298,20,16,103,2,76
3923,515,458,170.20226757369616,172.80290249433108,20,20,126,3,57
3924,515,637,170.20226757369616,172.2920634920635,20,17,152,2,122
3925,515,751,170.20226757369616,172.94222222222223,20,16,264,3,236
3926,515,968,170.20226757369616,172.94222222222223,20,11,468,3,453
3927,515,211,170.82920634920634,172.52426303854875,17,18,313,2,304
3928,515,230,170.82920634920634,173.22086167800452,17,22,303,2,285
3929,515,458,170.82920634920634,172.80290249433108,17,20,102,2,57
3930,515,585,170.82920634920634,173.8013605442177,17,16,146,3,70
3931,515,637,170.82920634920634,172.2920634920635,17,17,137,1,122
3932,515,751,170.82920634920634,172.94222222222223,17,16,253,2,236
3933,515,737,170.82920634920634,173.8013605442177,17,20,256,3,222
3934,515,968,170.82920634920634,172.94222222222223,17,11,462,2,453
3935,515,840,170.82920634920634,173.75492063492064,17,15,349,3,325
3936,439,4,171.82766439909298,174.12643990929706,16,37,446,2,435
3937,439,230,171.82766439909298,173.22086167800452,16,22,217,1,209
3938,439,228,171.82766439909298,174.56761904761905,16,23,242,3,211
3939,439,585,171.82766439909298,173.8013605442177,16,16,169,2,146
3940,439,751,171.82766439909298,172.94222222222223,16,16,316,1,312
3941,439,737,171.82766439909298,173.8013605442177,16,20,310,2,298
3942,439,840,171.82766439909298,173.75492063492064,16,15,409,2,401
3943,458,4,172.80290249433108,174.12643990929706,20,37,458,1,454
3944,458,6,172.80290249433108,175.38031746031746,20,37,465,3,452
3945,458,228,172.80290249433108,174.56761904761905,20,23,242,2,230
3946,458,252,172.80290249433108,175.61251700680273,20,24,239,3,206
3947,458,410,172.80290249433108,175.403537414966,20,19,122,3,48
3948,458,710,172.80290249433108,174.84625850340137,20,21,267,2,252
3949,458,826,172.80290249433108,174.82303854875283,20,15,378,2,368
3950,585,252,173.8013605442177,175.61251700680273,16,24,342,2,333
3951,585,214,173.8013605442177,175.86793650793652,16,24,382,2,371
3952,585,410,173.8013605442177,175.403537414966,16,19,188,2,175
3953,585,410,173.8013605442177,175.96081632653062,16,19,198,2,175
3954,585,710,173.8013605442177,174.84625850340137,16,21,133,1,125
3955,585,666,173.8013605442177,176.0304761904762,16,14,126,2,81
3956,585,826,173.8013605442177,174.82303854875283,16,15,245,1,241
3957,585,892,173.8013605442177,176.4716553287982,16,11,328,3,307
3958,410,4,175.403537414966,177.65587301587303,19,37,417,2,406
3959,410,6,175.403537414966,178.02739229024942,19,37,420,3,404
3960,410,219,175.403537414966,176.88961451247167,19,23,201,1,191
3961,410,507,175.403537414966,177.67909297052154,19,17,138,2,97
3962,410,566,175.403537414966,178.30603174603175,19,20,200,3,156
3963,410,650,175.403537414966,176.91283446712018,19,15,249,2,240
3964,410,621,175.403537414966,178.3292517006803,19,18,246,3,211
3965,410,892,175.403537414966,176.4716553287982,19,11,484,1,482
3966,410,826,175.403537414966,177.79519274376418,19,11,429,2,416
3967,410,4,175.96081632653062,177.65587301587303,19,37,413,2,406
3968,410,6,175.96081632653062,178.02739229024942,19,37,414,2,404
3969,410,241,175.96081632653062,178.60789115646259,19,27,204,3,169
3970,410,507,175.96081632653062,177.67909297052154,19,17,122,2,97
3971,410,566,175.96081632653062,178.30603174603175,19,20,186,2,156
3972,410,621,175.96081632653062,178.3292517006803,19,18,234,2,211
3973,410,826,175.96081632653062,177.79519274376418,19,11,423,2,416
3974,507,61,177.67909297052154,179.60634920634922,17,38,454,2,446
3975,507,354,177.67909297052154,179.420589569161,17,28,170,2,153
3976,507,211,177.67909297052154,180.1171882086168,17,31,314,2,296
3977,507,575,177.67909297052154,179.5134693877551,17,17,104,2,68
3978,507,422,177.67909297052154,180.07074829931972,17,21,134,2,85
3979,507,656,177.67909297052154,179.55990929705214,17,16,170,2,149
3980,507,685,177.67909297052154,180.44226757369614,17,13,214,3,178
3981,507,968,177.67909297052154,179.11873015873016,17,10,465,1,461
3982,507,848,177.67909297052154,180.44226757369614,17,12,361,3,341
3983,566,354,178.30603174603175,179.420589569161,20,28,217,1,212
3984,566,211,178.30603174603175,180.1171882086168,20,31,363,2,355
3985,566,575,178.30603174603175,179.5134693877551,20,17,53,1,9
3986,566,422,178.30603174603175,180.07074829931972,20,21,163,2,144
3987,566,656,178.30603174603175,179.55990929705214,20,16,105,1,90
3988,566,685,178.30603174603175,180.44226757369614,20,13,150,2,119
3989,566,848,178.30603174603175,180.44226757369614,20,12,297,2,282
3990,566,902,178.30603174603175,181.25496598639455,20,14,359,3,336
3991,575,214,179.5134693877551,181.39428571428573,17,31,370,2,361
3992,575,209,179.5134693877551,182.29986394557824,17,31,385,3,366
3993,575,552,179.5134693877551,181.53360544217688,17,16,90,2,23
3994,575,524,179.5134693877551,182.41596371882088,17,16,135,3,51
3995,575,630,179.5134693877551,181.32462585034014,17,16,95,2,55
3996,575,649,179.5134693877551,182.20698412698414,17,15,138,3,74
3997,575,902,179.5134693877551,181.25496598639455,17,14,335,2,327
3998,575,878,179.5134693877551,182.0908843537415,17,14,323,3,303
3999,422,4,180.07074829931972,181.185306122449,21,41,421,1,418
4000,422,4,180.07074829931972,181.8354648526077,21,40,425,2,418
4001,422,6,180.07074829931972,182.95002267573696,21,41,434,3,416
4002,422,214,180.07074829931972,181.39428571428573,21,31,216,1,208
4003,422,209,180.07074829931972,182.29986394557824,21,31,234,2,213
4004,422,227,180.07074829931972,182.9035827664399,21,27,230,3,195
4005,422,552,180.07074829931972,181.53360544217688,21,16,144,1,130
4006,422,524,180.07074829931972,182.41596371882088,21,16,144,2,102
4007,422,630,180.07074829931972,181.32462585034014,21,16,215,1,208
4008,422,649,180.07074829931972,182.20698412698414,21,15,245,2,227
4009,422,902,180.07074829931972,181.25496598639455,21,14,483,1,480
4010,422,878,180.07074829931972,182.0908843537415,21,14,464,2,456
4011,552,227,181.53360544217688,182.9035827664399,16,27,330,1,325
4012,552,247,181.53360544217688,183.83238095238096,16,24,321,2,305
4013,552,459,181.53360544217688,183.20544217687075,16,19,118,2,93
4014,552,515,181.53360544217688,184.29678004535148,16,19,125,3,37
4015,552,743,181.53360544217688,183.64662131519276,16,22,212,2,191
4016,552,672,181.53360544217688,183.71628117913832,16,21,152,2,120
4017,552,903,181.53360544217688,183.6930612244898,16,19,363,2,351
4018,552,860,181.53360544217688,183.71628117913832,16,17,322,2,308
4019,524,247,182.41596371882088,183.83238095238096,16,24,284,1,277
4020,524,515,182.41596371882088,184.29678004535148,16,19,81,2,9
4021,524,743,182.41596371882088,183.64662131519276,16,22,225,1,219
4022,524,672,182.41596371882088,183.71628117913832,16,21,158,1,148
4023,524,671,182.41596371882088,184.97015873015874,16,17,184,3,147
4024,524,903,182.41596371882088,183.6930612244898,16,19,383,1,379
4025,524,860,182.41596371882088,183.71628117913832,16,17,341,1,336
4026,524,932,182.41596371882088,184.83083900226757,16,15,421,2,408
4027,459,5,183.20544217687075,184.69151927437642,19,40,458,1,454
4028,459,6,183.20544217687075,185.52743764172337,19,39,464,2,453
4029,459,6,183.20544217687075,185.94539682539684,19,39,468,3,453
4030,459,401,183.20544217687075,185.71319727891157,19,26,123,3,58
4031,459,230,183.20544217687075,185.80607709750566,19,26,255,3,229
4032,459,515,183.20544217687075,184.29678004535148,19,19,73,1,56
4033,459,458,183.20544217687075,185.71319727891157,19,20,108,3,1
4034,459,671,183.20544217687075,184.97015873015874,19,17,225,2,212
4035,459,689,183.20544217687075,185.78285714285715,19,17,255,3,230
4036,459,932,183.20544217687075,184.83083900226757,19,15,478,2,473
4037,459,859,183.20544217687075,185.7364172335601,19,11,415,3,400
4038,515,401,184.29678004535148,185.71319727891157,19,26,129,1,114
4039,515,230,184.29678004535148,185.80607709750566,19,26,292,2,285
4040,515,458,184.29678004535148,185.71319727891157,19,20,83,1,57
4041,515,459,184.29678004535148,185.78285714285715,19,20,85,1,56
4042,515,689,184.29678004535148,185.78285714285715,19,17,185,1,174
4043,515,859,184.29678004535148,185.7364172335601,19,11,350,1,344
4044,515,896,184.29678004535148,187.0831746031746,19,12,399,3,381
4045,458,10,185.71319727891157,187.26893424036282,20,39,453,2,448
4046,458,6,185.71319727891157,187.73333333333335,20,38,460,2,452
4047,458,228,185.71319727891157,187.5243537414966,20,24,243,2,230
4048,458,270,185.71319727891157,188.66213151927437,20,25,227,3,188
4049,458,461,185.71319727891157,187.33859410430838,20,18,70,2,3
4050,458,425,185.71319727891157,188.24417233560092,20,21,114,3,33
4051,458,633,185.71319727891157,187.36181405895692,20,18,189,2,175
4052,458,753,185.71319727891157,187.895873015873,20,21,310,2,295
4053,458,896,185.71319727891157,187.0831746031746,20,12,442,1,438
4054,458,847,185.71319727891157,187.895873015873,20,17,400,2,389
4055,459,10,185.78285714285715,187.26893424036282,20,39,454,1,449
4056,459,6,185.78285714285715,187.73333333333335,20,38,461,2,453
4057,459,228,185.78285714285715,187.5243537414966,20,24,243,2,231
4058,459,270,185.78285714285715,188.66213151927437,20,25,226,3,189
4059,459,461,185.78285714285715,187.33859410430838,20,18,67,2,2
4060,459,425,185.78285714285715,188.24417233560092,20,21,111,2,34
4061,459,633,185.78285714285715,187.36181405895692,20,18,187,2,174
4062,459,753,185.78285714285715,187.895873015873,20,21,308,2,294
4063,459,896,185.78285714285715,187.0831746031746,20,12,441,1,437
4064,459,847,185.78285714285715,187.895873015873,20,17,399,2,388
4065,461,10,187.33859410430838,189.0336507936508,18,38,457,2,451
4066,461,4,187.33859410430838,190.0088888888889,18,39,471,3,457
4067,461,270,187.33859410430838,188.66213151927437,18,25,199,1,191
4068,461,232,187.33859410430838,188.82467120181406,18,26,238,1,229
4069,461,247,187.33859410430838,189.98566893424038,18,24,242,3,214
4070,461,410,187.33859410430838,189.19619047619048,18,20,95,2,51
4071,461,617,187.33859410430838,189.14975056689343,18,20,174,2,156
4072,461,822,187.33859410430838,189.01043083900228,18,16,368,2,361
4073,425,4,188.24417233560092,190.0088888888889,21,39,428,2,421
4074,425,247,188.24417233560092,189.98566893424038,21,24,193,2,178
4075,425,470,188.24417233560092,190.61260770975056,21,20,111,2,45
4076,425,814,188.24417233560092,190.58938775510205,21,16,402,2,389
4077,425,641,188.24417233560092,191.03056689342404,21,15,247,3,216
4078,425,821,188.24417233560092,190.6358276643991,21,12,409,2,396
4079,425,872,188.24417233560092,191.03056689342404,21,13,463,3,447
4080,410,4,189.19619047619048,191.30920634920636,20,38,416,2,406
4081,410,4,189.19619047619048,191.75038548752835,20,38,421,3,406
4082,410,246,189.19619047619048,191.7271655328798,20,28,197,3,164
4083,410,240,189.19619047619048,191.7968253968254,20,27,204,3,170
4084,410,470,189.19619047619048,190.61260770975056,20,20,86,1,60
4085,410,423,189.19619047619048,191.3556462585034,20,21,94,2,13
4086,410,425,189.19619047619048,191.7968253968254,20,20,113,3,15
4087,410,814,189.19619047619048,190.58938775510205,20,16,408,1,404
4088,410,641,189.19619047619048,191.03056689342404,20,15,244,2,231
4089,410,616,189.19619047619048,191.7736054421769,20,17,234,3,206
4090,410,821,189.19619047619048,190.6358276643991,20,12,416,1,411
4091,410,872,189.19619047619048,191.03056689342404,20,13,469,2,462
4092,410,856,189.19619047619048,191.91292517006804,20,13,461,3,446
4093,470,4,190.61260770975056,191.75038548752835,20,38,469,1,466
4094,470,4,190.61260770975056,193.53832199546486,20,38,483,3,466
4095,470,246,190.61260770975056,191.7271655328798,20,28,229,1,224
4096,470,240,190.61260770975056,191.7968253968254,20,27,236,1,230
4097,470,227,190.61260770975056,193.02748299319728,20,24,264,2,243
4098,470,425,190.61260770975056,191.7968253968254,20,20,68,1,45
4099,470,616,190.61260770975056,191.7736054421769,20,17,154,1,146
4100,470,856,190.61260770975056,191.91292517006804,20,13,390,1,386
4101,470,969,190.61260770975056,193.23646258503402,20,11,512,3,499
4102,423,4,191.3556462585034,193.53832199546486,21,38,429,2,419
4103,423,10,191.3556462585034,194.32780045351475,21,38,432,3,413
4104,423,227,191.3556462585034,193.02748299319728,21,24,209,2,196
4105,423,212,191.3556462585034,194.18848072562358,21,32,244,3,211
4106,423,600,191.3556462585034,193.7473015873016,21,17,205,2,177
4107,423,630,191.3556462585034,193.7473015873016,21,16,231,2,207
4108,425,4,191.7968253968254,193.53832199546486,20,38,428,2,421
4109,425,10,191.7968253968254,194.32780045351475,20,38,429,3,415
4110,425,227,191.7968253968254,193.02748299319728,20,24,205,1,198
4111,425,212,191.7968253968254,194.18848072562358,20,32,237,2,213
4112,425,600,191.7968253968254,193.7473015873016,20,17,194,2,175
4113,425,453,191.7968253968254,194.4903401360544,20,17,119,3,28
4114,425,630,191.7968253968254,193.7473015873016,20,16,222,2,205
4115,425,633,191.7968253968254,194.44390022675736,20,14,237,3,208
4116,425,850,191.7968253968254,194.44390022675736,20,11,440,3,425
4117,600,215,193.7473015873016,195.48879818594105,17,29,392,2,385
4118,600,209,193.7473015873016,196.4175963718821,17,30,408,3,391
4119,600,464,193.7473015873016,195.30303854875285,17,18,152,2,136
4120,600,417,193.7473015873016,195.95319727891157,17,20,206,2,183
4121,600,638,193.7473015873016,195.2798185941043,17,19,76,2,38
4122,600,859,193.7473015873016,195.442358276644,17,12,269,2,259
4123,600,895,193.7473015873016,195.92997732426304,17,11,310,2,295
4124,453,7,194.4903401360544,196.11573696145126,17,38,451,2,446
4125,453,6,194.4903401360544,197.3928344671202,17,39,464,3,447
4126,453,209,194.4903401360544,196.4175963718821,17,30,258,2,244
4127,453,227,194.4903401360544,196.7891156462585,17,28,247,2,226
4128,453,417,194.4903401360544,195.95319727891157,17,20,73,1,36
4129,453,633,194.4903401360544,196.76589569160998,17,16,205,2,180
4130,453,895,194.4903401360544,195.92997732426304,17,11,446,1,442
4131,453,835,194.4903401360544,197.36961451247166,17,17,402,3,382
4132,464,6,195.30303854875285,197.3928344671202,18,39,467,2,458
4133,464,209,195.30303854875285,196.4175963718821,18,30,259,1,255
4134,464,227,195.30303854875285,196.7891156462585,18,28,245,1,237
4135,464,413,195.30303854875285,197.4857142857143,18,17,107,2,51
4136,464,633,195.30303854875285,196.76589569160998,18,16,180,1,169
4137,464,743,195.30303854875285,197.7643537414966,18,23,298,2,279
4138,464,743,195.30303854875285,197.78757369614513,18,22,299,2,279
4139,464,835,195.30303854875285,197.36961451247166,18,17,382,2,371
4140,464,902,195.30303854875285,197.81079365079364,18,18,451,3,438
4141,417,6,195.95319727891157,197.3928344671202,20,39,416,1,411
4142,417,14,195.95319727891157,198.34485260770975,20,40,416,2,403
4143,417,343,195.95319727891157,198.5538321995465,20,26,134,3,74
4144,417,228,195.95319727891157,198.85569160997733,20,26,227,3,189
4145,417,413,195.95319727891157,197.4857142857143,20,17,66,2,4
4146,417,498,195.95319727891157,198.76281179138323,20,17,146,3,81
4147,417,743,195.95319727891157,197.7643537414966,20,23,335,2,326
4148,417,743,195.95319727891157,197.78757369614513,20,22,335,2,326
4149,417,835,195.95319727891157,197.36961451247166,20,17,422,1,418
4150,417,902,195.95319727891157,197.81079365079364,20,18,492,2,485
4151,413,6,197.4857142857143,199.64517006802723,17,40,417,2,407
4152,413,6,197.4857142857143,200.0863492063492,17,39,422,3,407
4153,413,343,197.4857142857143,198.5538321995465,17,26,84,1,70
4154,413,228,197.4857142857143,198.85569160997733,17,26,194,1,185
4155,413,230,197.4857142857143,200.1792290249433,17,27,217,3,183
4156,413,498,197.4857142857143,198.76281179138323,17,17,101,1,85
4157,413,496,197.4857142857143,198.97179138321997,17,19,105,1,83
4158,413,634,197.4857142857143,199.76126984126984,17,18,242,2,221
4159,413,802,197.4857142857143,199.83092970521542,17,17,402,2,389
4160,413,898,197.4857142857143,199.38975056689344,17,17,492,2,485
4161,498,6,198.76281179138323,200.0863492063492,17,39,495,1,492
4162,498,5,198.76281179138323,201.01514739229026,17,38,502,2,493
4163,498,230,198.76281179138323,200.1792290249433,17,27,275,1,268
4164,498,226,198.76281179138323,201.20090702947846,17,25,292,2,272
4165,498,492,198.76281179138323,200.75972789115647,17,20,86,2,6
4166,498,492,198.76281179138323,200.78294784580498,17,19,87,2,6
4167,498,802,198.76281179138323,199.83092970521542,17,17,307,1,304
4168,498,634,198.76281179138323,201.47954648526078,17,17,179,3,136
4169,498,823,198.76281179138323,200.73650793650793,17,15,336,2,325
4170,498,862,198.76281179138323,201.5027664399093,17,13,383,3,364
4171,496,6,198.97179138321997,200.0863492063492,19,39,492,1,490
4172,496,5,198.97179138321997,201.01514739229026,19,38,499,2,491
4173,496,230,198.97179138321997,200.1792290249433,19,27,271,1,266
4174,496,226,198.97179138321997,201.20090702947846,19,25,287,2,270
4175,496,492,198.97179138321997,200.75972789115647,19,20,77,2,4
4176,496,492,198.97179138321997,200.78294784580498,19,19,78,2,4
4177,496,634,198.97179138321997,201.47954648526078,19,17,175,3,138
4178,496,823,198.97179138321997,200.73650793650793,19,15,336,2,327
4179,496,862,198.97179138321997,201.5027664399093,19,13,382,3,366
4180,492,10,200.75972789115647,202.26902494331065,20,37,486,2,482
4181,492,4,200.75972789115647,203.66222222222223,20,37,504,3,488
4182,492,227,200.75972789115647,202.33868480725624,20,27,274,2,265
4183,492,270,200.75972789115647,202.87274376417233,20,25,240,2,222
4184,492,474,200.75972789115647,202.73342403628118,20,17,87,2,18
4185,492,410,200.75972789115647,203.31392290249434,20,20,137,3,82
4186,492,717,200.75972789115647,202.0368253968254,20,22,232,1,225
4187,492,644,200.75972789115647,203.1281632653061,20,20,183,2,152
4188,492,947,200.75972789115647,202.45478458049888,20,15,461,2,455
4189,492,856,200.75972789115647,203.1281632653061,20,15,378,2,364
4190,492,10,200.78294784580498,202.26902494331065,19,37,486,1,482
4191,492,4,200.78294784580498,203.66222222222223,19,37,504,3,488
4192,492,227,200.78294784580498,202.33868480725624,19,27,273,2,265
4193,492,270,200.78294784580498,202.87274376417233,19,25,240,2,222
4194,492,474,200.78294784580498,202.73342403628118,19,17,86,2,18
4195,492,410,200.78294784580498,203.31392290249434,19,20,136,3,82
4196,492,717,200.78294784580498,202.0368253968254,19,22,231,1,225
4197,492,644,200.78294784580498,203.1281632653061,19,20,182,2,152
4198,492,947,200.78294784580498,202.45478458049888,19,15,461,2,455
4199,492,856,200.78294784580498,203.1281632653061,19,15,378,2,364
4200,474,4,202.73342403628118,204.54458049886622,17,38,476,2,470
4201,474,57,202.73342403628118,205.68235827664398,17,39,436,3,417
4202,474,271,202.73342403628118,204.61424036281178,17,24,219,2,203
4203,474,342,202.73342403628118,205.70557823129252,17,26,184,3,132
4204,474,429,202.73342403628118,204.12662131519275,17,18,75,1,45
4205,474,423,202.73342403628118,205.35727891156463,17,21,124,3,51
4206,474,815,202.73342403628118,204.7071201814059,17,16,351,2,341
4207,474,738,202.73342403628118,204.8,17,15,279,2,264
4208,474,876,202.73342403628118,204.7071201814059,17,13,411,2,402
4209,474,922,202.73342403628118,205.56625850340137,17,12,464,3,448
4210,410,4,203.31392290249434,204.54458049886622,20,38,409,1,406
4211,410,57,203.31392290249434,205.68235827664398,20,39,367,2,353
4212,410,4,203.31392290249434,205.89133786848072,20,39,421,3,406
4213,410,271,203.31392290249434,204.61424036281178,20,24,150,1,139
4214,410,342,203.31392290249434,205.70557823129252,20,26,123,2,68
4215,410,363,203.31392290249434,206.1467573696145,20,27,131,3,47
4216,410,423,203.31392290249434,205.35727891156463,20,21,89,2,13
4217,410,414,203.31392290249434,205.84489795918367,20,19,109,3,4
4218,410,815,203.31392290249434,204.7071201814059,20,16,409,1,405
4219,410,738,203.31392290249434,204.8,20,15,334,1,328
4220,410,616,203.31392290249434,205.89133786848072,20,16,234,3,206
4221,410,876,203.31392290249434,204.7071201814059,20,13,470,1,466
4222,410,832,203.31392290249434,205.8681179138322,20,13,436,3,422
4223,429,57,204.12662131519275,205.68235827664398,18,39,378,2,372
4224,429,4,204.12662131519275,205.89133786848072,18,39,432,2,425
4225,429,342,204.12662131519275,205.70557823129252,18,26,110,2,87
4226,429,363,204.12662131519275,206.1467573696145,18,27,109,2,66
4227,429,423,204.12662131519275,205.35727891156463,18,21,53,1,6
4228,429,414,204.12662131519275,205.84489795918367,18,19,76,2,15
4229,429,410,204.12662131519275,206.8433560090703,18,20,119,3,19
4230,429,616,204.12662131519275,205.89133786848072,18,16,202,2,187
4231,429,632,204.12662131519275,207.00589569161,18,15,238,3,203
4232,429,922,204.12662131519275,205.56625850340137,18,12,497,1,493
4233,429,832,204.12662131519275,205.8681179138322,18,13,410,2,403
4234,423,4,205.35727891156463,207.63283446712018,21,38,430,2,419
4235,423,228,205.35727891156463,207.40063492063493,21,26,214,2,195
4236,423,410,205.35727891156463,206.8433560090703,21,20,65,1,13
4237,423,422,205.35727891156463,208.28299319727893,21,20,126,3,1
4238,423,632,205.35727891156463,207.00589569161,21,15,221,2,209
4239,414,4,205.84489795918367,207.63283446712018,19,38,417,2,410
4240,414,4,205.84489795918367,208.51519274376417,19,38,426,3,410
4241,414,228,205.84489795918367,207.40063492063493,19,26,198,2,186
4242,414,211,205.84489795918367,208.3526530612245,19,33,230,3,203
4243,414,422,205.84489795918367,208.28299319727893,19,20,105,2,8
4244,414,632,205.84489795918367,207.00589569161,19,15,224,1,218
4245,414,631,205.84489795918367,208.67773242630386,19,18,249,3,217
4246,410,4,206.8433560090703,208.51519274376417,20,38,412,2,406
4247,410,7,206.8433560090703,209.7690702947846,20,38,422,3,403
4248,410,211,206.8433560090703,208.3526530612245,20,33,209,2,199
4249,410,229,206.8433560090703,209.49043083900227,20,32,214,3,181
4250,410,422,206.8433560090703,208.28299319727893,20,20,63,1,12
4251,410,428,206.8433560090703,209.39755102040817,20,23,111,3,18
4252,410,631,206.8433560090703,208.67773242630386,20,18,235,2,221
4253,410,634,206.8433560090703,209.49043083900227,20,18,251,3,224
4254,410,863,206.8433560090703,209.35111111111112,20,12,466,3,453
4255,422,7,208.28299319727893,209.7690702947846,20,38,420,1,415
4256,422,4,208.28299319727893,209.83873015873016,20,38,423,2,418
4257,422,229,208.28299319727893,209.49043083900227,20,32,200,1,193
4258,422,214,208.28299319727893,210.44244897959183,20,33,228,2,208
4259,422,227,208.28299319727893,211.13904761904763,20,26,231,3,195
4260,422,428,208.28299319727893,209.39755102040817,20,23,48,1,6
4261,422,572,208.28299319727893,210.32634920634922,20,19,174,2,150
4262,422,419,208.28299319727893,211.06938775510204,20,18,120,3,3
4263,422,634,208.28299319727893,209.49043083900227,20,18,218,1,212
4264,422,663,208.28299319727893,210.44244897959183,20,16,258,2,241
4265,422,863,208.28299319727893,209.35111111111112,20,12,443,1,441
4266,422,866,208.28299319727893,210.74430839002267,20,11,456,2,444
4267,428,86,209.39755102040817,211.60344671201815,23,39,355,2,342
4268,428,214,209.39755102040817,210.44244897959183,23,33,219,1,214
4269,428,227,209.39755102040817,211.13904761904763,23,26,215,2,201
4270,428,258,209.39755102040817,212.2768253968254,23,23,210,3,170
4271,428,419,209.39755102040817,211.06938775510204,23,18,73,2,9
4272,428,590,209.39755102040817,211.9285260770975,23,18,195,3,162
4273,428,663,209.39755102040817,210.44244897959183,23,16,239,1,235
4274,428,699,209.39755102040817,211.48734693877552,23,18,286,2,271
4275,428,747,209.39755102040817,211.9285260770975,23,23,337,3,319
4276,428,866,209.39755102040817,210.74430839002267,23,11,442,1,438
4277,428,884,209.39755102040817,211.48734693877552,23,17,465,2,456
4278,428,827,209.39755102040817,211.905306122449,23,18,413,3,399
4279,572,86,210.32634920634922,211.60344671201815,19,39,489,1,486
4280,572,258,210.32634920634922,212.2768253968254,19,23,325,2,314
4281,572,256,210.32634920634922,212.9037641723356,19,22,335,3,316
4282,572,590,210.32634920634922,211.9285260770975,19,18,71,2,18
4283,572,515,210.32634920634922,213.20562358276644,19,19,136,3,57
4284,572,699,210.32634920634922,211.48734693877552,19,18,136,1,127
4285,572,747,210.32634920634922,211.9285260770975,19,23,188,2,175
4286,572,626,210.32634920634922,212.95020408163265,19,17,125,3,54
4287,572,884,210.32634920634922,211.48734693877552,19,17,316,1,312
4288,572,827,210.32634920634922,211.905306122449,19,18,264,2,255
4289,572,864,210.32634920634922,213.01986394557824,19,14,314,3,292
4290,419,10,211.06938775510204,212.41614512471656,18,39,413,1,409
4291,419,5,211.06938775510204,212.92698412698414,18,41,422,2,414
4292,419,258,211.06938775510204,212.2768253968254,18,23,169,1,161
4293,419,256,211.06938775510204,212.9037641723356,18,22,181,2,163
4294,419,515,211.06938775510204,213.20562358276644,18,19,133,2,96
4295,419,515,211.06938775510204,213.8557823129252,18,12,154,3,96
4296,419,626,211.06938775510204,212.95020408163265,18,17,222,2,207
4297,419,864,211.06938775510204,213.01986394557824,18,14,453,2,445
4298,590,222,211.9285260770975,214.11120181405897,18,13,380,2,368
4299,590,515,211.9285260770975,213.20562358276644,18,19,93,1,75
4300,590,515,211.9285260770975,213.8557823129252,18,12,112,2,75
4301,590,626,211.9285260770975,212.95020408163265,18,17,57,1,36
4302,590,864,211.9285260770975,213.01986394557824,18,14,278,1,274
4303,515,21,213.20562358276644,216.17777777777778,19,39,510,3,494
4304,515,298,213.20562358276644,215.3882993197279,19,12,236,2,217
4305,515,21,213.8557823129252,216.17777777777778,12,39,504,2,494
4306,515,298,213.8557823129252,215.3882993197279,12,12,227,2,217
4307,515,243,213.8557823129252,216.38675736961451,12,15,293,3,272
4308,819,541,7.918004535147393,9.496961451247167,14,15,286,2,278
4309,819,538,7.918004535147393,10.379319727891156,14,14,300,2,281
4310,819,641,7.918004535147393,9.729160997732427,14,16,194,2,178
4311,819,642,7.918004535147393,10.170340136054422,14,14,202,2,177
4312,819,825,7.918004535147393,9.752380952380953,14,10,79,2,6
4313,819,931,7.918004535147393,10.286439909297052,14,13,151,2,112
4314,819,541,8.40562358276644,9.496961451247167,17,15,282,1,278
4315,819,538,8.40562358276644,10.379319727891156,17,14,294,2,281
4316,819,524,8.40562358276644,11.261678004535147,17,15,320,3,295
4317,819,641,8.40562358276644,9.729160997732427,17,16,187,1,178
4318,819,642,8.40562358276644,10.170340136054422,17,14,193,2,177
4319,819,825,8.40562358276644,9.752380952380953,17,10,58,1,6
4320,819,931,8.40562358276644,10.286439909297052,17,13,138,2,112
4321,641,266,9.729160997732427,11.54031746031746,16,17,383,2,375
4322,641,237,9.729160997732427,12.631655328798185,16,16,423,3,404
4323,641,524,9.729160997732427,11.261678004535147,16,15,134,2,117
4324,641,638,9.729160997732427,11.49387755102041,16,14,76,2,3
4325,641,680,9.729160997732427,12.376235827664399,16,14,120,3,39
4326,641,896,9.729160997732427,11.935056689342403,16,11,272,2,255
4327,641,849,9.729160997732427,12.376235827664399,16,12,237,3,208
4328,642,266,10.170340136054422,11.54031746031746,14,17,381,1,376
4329,642,237,10.170340136054422,12.631655328798185,14,16,419,2,405
4330,642,524,10.170340136054422,11.261678004535147,14,15,127,1,118
4331,642,524,10.170340136054422,13.02639455782313,14,16,170,3,118
4332,642,638,10.170340136054422,11.49387755102041,14,14,57,1,4
4333,642,680,10.170340136054422,12.376235827664399,14,14,102,2,38
4334,642,896,10.170340136054422,11.935056689342403,14,11,265,2,254
4335,642,849,10.170340136054422,12.376235827664399,14,12,228,2,207
4336,638,237,11.49387755102041,12.631655328798185,14,16,404,1,401
4337,638,211,11.49387755102041,13.722993197278912,14,17,438,2,427
4338,638,235,11.49387755102041,14.210612244897959,14,16,420,3,403
4339,638,524,11.49387755102041,13.02639455782313,14,16,132,2,114
4340,638,529,11.49387755102041,13.908752834467121,14,14,151,2,109
4341,638,689,11.49387755102041,13.25859410430839,14,14,92,2,51
4342,638,825,11.49387755102041,13.722993197278912,14,11,210,2,187
4343,680,211,12.376235827664399,13.722993197278912,14,17,473,1,469
4344,680,235,12.376235827664399,14.210612244897959,14,16,452,2,445
4345,680,529,12.376235827664399,13.908752834467121,14,14,165,2,151
4346,680,524,12.376235827664399,14.791111111111112,14,15,187,2,156
4347,680,641,12.376235827664399,14.582131519274377,14,14,103,2,39
4348,680,825,12.376235827664399,13.722993197278912,14,11,156,1,145
4349,680,905,12.376235827664399,15.023310657596372,14,13,252,3,225
4350,689,211,13.25859410430839,15.464489795918368,14,16,487,2,478
4351,689,211,13.25859410430839,16.23074829931973,14,17,495,3,478
4352,689,524,13.25859410430839,14.791111111111112,14,15,178,2,165
4353,689,425,13.25859410430839,15.603809523809524,14,13,283,2,264
4354,689,641,13.25859410430839,14.582131519274377,14,14,75,1,48
4355,689,641,13.25859410430839,15.464489795918368,14,15,106,2,48
4356,689,905,13.25859410430839,15.023310657596372,14,13,229,2,216
4357,689,873,13.25859410430839,15.905668934240364,14,12,216,3,184
4358,641,211,14.582131519274377,16.23074829931973,14,17,436,2,430
4359,641,425,14.582131519274377,15.603809523809524,14,13,220,1,216
4360,641,523,14.582131519274377,16.555827664399093,14,15,145,2,118
4361,641,424,14.582131519274377,17.34530612244898,14,13,247,3,217
4362,641,873,14.582131519274377,15.905668934240364,14,12,239,1,232
4363,641,847,14.582131519274377,16.34684807256236,14,11,220,2,206
4364,641,841,14.582131519274377,17.22920634920635,14,11,230,3,200
4365,641,271,15.464489795918368,17.949024943310658,15,18,385,2,370
4366,641,523,15.464489795918368,16.555827664399093,15,15,127,1,118
4367,641,424,15.464489795918368,17.34530612244898,15,13,232,2,217
4368,641,524,15.464489795918368,18.320544217687075,15,16,170,3,117
4369,641,640,15.464489795918368,17.670385487528346,15,14,95,2,1
4370,641,841,15.464489795918368,17.22920634920635,15,11,214,2,200
4371,641,955,15.464489795918368,18.22766439909297,15,11,336,3,314
4372,641,271,16.34684807256236,17.949024943310658,15,18,376,2,370
4373,641,299,16.34684807256236,19.040362811791383,15,17,361,3,342
4374,641,524,16.34684807256236,18.320544217687075,15,16,145,2,117
4375,641,640,16.34684807256236,17.670385487528346,15,14,57,1,1
4376,641,955,16.34684807256236,18.22766439909297,15,11,324,2,314
4377,641,956,16.34684807256236,19.11002267573696,15,14,337,3,315
4378,640,299,17.670385487528346,19.040362811791383,14,17,346,1,341
4379,640,213,17.670385487528346,19.89950113378685,14,17,438,2,427
4380,640,403,17.670385487528346,20.54965986394558,14,20,267,3,237
4381,640,473,17.670385487528346,19.99238095238095,14,15,195,2,167
4382,640,641,17.670385487528346,18.993922902494333,14,15,57,1,1
4383,640,641,17.670385487528346,19.87628117913832,14,14,95,2,1
4384,640,956,17.670385487528346,19.11002267573696,14,14,322,1,316
4385,641,403,18.993922902494333,20.54965986394558,15,20,247,2,238
4386,641,401,18.993922902494333,21.106938775510205,15,14,257,2,240
4387,641,515,18.993922902494333,20.82829931972789,15,19,149,2,126
4388,641,515,18.993922902494333,21.339138321995467,15,14,161,2,126
4389,641,819,18.993922902494333,20.758639455782312,15,16,194,2,178
4390,641,902,18.993922902494333,20.66575963718821,15,15,271,2,261
4391,641,401,19.87628117913832,21.106938775510205,14,14,246,1,240
4392,641,249,19.87628117913832,22.128616780045352,14,17,404,2,392
4393,641,515,19.87628117913832,21.339138321995467,14,14,141,1,126
4394,641,539,19.87628117913832,22.73233560090703,14,14,160,3,102
4395,641,659,19.87628117913832,22.639455782312925,14,18,120,3,18
4396,819,539,20.758639455782312,22.73233560090703,16,14,293,2,280
4397,819,605,20.758639455782312,23.6843537414966,16,16,248,3,214
4398,819,659,20.758639455782312,22.639455782312925,16,18,179,2,160
4399,819,617,20.758639455782312,23.6843537414966,16,12,238,3,202
4400,819,824,20.758639455782312,22.96453514739229,16,13,95,2,5
4401,819,954,20.758639455782312,23.405714285714286,16,11,177,3,135
4402,659,342,22.639455782312925,23.91655328798186,18,20,322,1,317
4403,659,387,22.639455782312925,25.031111111111112,18,23,291,2,272
4404,659,214,22.639455782312925,25.611609977324264,18,25,463,3,445
4405,659,605,22.639455782312925,23.6843537414966,18,16,70,1,54
4406,659,410,22.639455782312925,25.031111111111112,18,15,269,2,249
4407,659,617,22.639455782312925,23.6843537414966,18,12,62,1,42
4408,659,641,22.639455782312925,24.729251700680273,18,14,92,2,18
4409,659,885,22.639455782312925,24.729251700680273,18,12,243,2,226
4410,617,387,23.6843537414966,25.031111111111112,12,23,237,1,230
4411,617,214,23.6843537414966,25.611609977324264,12,25,411,2,403
4412,617,410,23.6843537414966,25.031111111111112,12,15,215,1,207
4413,617,613,23.6843537414966,25.843809523809526,12,16,93,2,4
4414,617,539,23.6843537414966,26.261768707482993,12,14,136,3,78
4415,617,641,23.6843537414966,24.729251700680273,12,14,51,1,24
4416,617,646,23.6843537414966,25.98312925170068,12,15,103,2,29
4417,617,720,23.6843537414966,26.493968253968255,12,14,159,3,103
4418,617,885,23.6843537414966,24.729251700680273,12,12,272,1,268
4419,617,965,23.6843537414966,26.21532879818594,12,11,365,3,348
4420,641,227,24.729251700680273,26.795827664399095,14,23,423,2,414
4421,641,206,24.729251700680273,27.23700680272109,14,28,448,3,435
4422,641,613,24.729251700680273,25.843809523809526,14,16,56,1,28
4423,641,539,24.729251700680273,26.261768707482993,14,14,121,2,102
4424,641,646,24.729251700680273,25.98312925170068,14,15,54,1,5
4425,641,720,24.729251700680273,26.493968253968255,14,14,110,2,79
4426,641,662,24.729251700680273,27.376326530612246,14,18,116,3,21
4427,641,965,24.729251700680273,26.21532879818594,14,11,330,1,324
4428,641,923,24.729251700680273,27.376326530612246,14,11,304,3,282
4429,646,206,25.98312925170068,27.23700680272109,15,28,443,1,440
4430,646,389,25.98312925170068,28.23546485260771,15,19,275,2,257
4431,646,415,25.98312925170068,28.0497052154195,15,15,248,2,231
4432,646,412,25.98312925170068,28.908843537414967,15,15,266,3,234
4433,646,662,25.98312925170068,27.376326530612246,15,18,62,1,16
4434,646,640,25.98312925170068,28.258684807256238,15,14,98,2,6
4435,646,923,25.98312925170068,27.376326530612246,15,11,283,1,277
4436,720,389,26.493968253968255,28.23546485260771,14,19,339,2,331
4437,720,415,26.493968253968255,28.0497052154195,14,15,312,2,305
4438,720,412,26.493968253968255,28.908843537414967,14,15,325,2,308
4439,720,640,26.493968253968255,28.258684807256238,14,14,110,2,80
4440,720,886,26.493968253968255,29.257142857142856,14,14,204,3,166
4441,662,384,27.376326530612246,29.860861678004536,18,26,298,2,278
4442,662,412,27.376326530612246,28.908843537414967,18,15,259,2,250
4443,662,410,27.376326530612246,29.860861678004536,18,21,274,2,252
4444,662,625,27.376326530612246,30.02340136054422,18,15,120,3,37
4445,662,886,27.376326530612246,29.257142857142856,18,14,238,2,224
4446,640,384,28.258684807256238,29.860861678004536,14,26,265,2,256
4447,640,211,28.258684807256238,30.464580498866212,14,17,439,2,429
4448,640,410,28.258684807256238,29.860861678004536,14,21,240,2,230
4449,640,566,28.258684807256238,31.068299319727892,14,19,142,3,74
4450,640,625,28.258684807256238,30.02340136054422,14,15,77,2,15
4451,640,656,28.258684807256238,30.464580498866212,14,14,96,2,16
4452,640,826,28.258684807256238,30.928979591836736,14,11,219,3,186
4453,625,268,30.02340136054422,32.066757369614514,15,21,368,2,357
4454,625,239,30.02340136054422,32.949115646258505,15,25,406,3,386
4455,625,566,30.02340136054422,31.068299319727892,15,19,74,1,59
4456,625,554,30.02340136054422,31.55591836734694,15,15,97,2,71
4457,625,538,30.02340136054422,32.949115646258505,15,14,153,3,87
4458,625,642,30.02340136054422,31.346938775510203,15,14,59,1,17
4459,625,665,30.02340136054422,32.670476190476194,15,15,121,3,40
4460,625,826,30.02340136054422,31.811337868480727,15,12,215,2,201
4461,656,268,30.464580498866212,32.066757369614514,14,21,394,2,388
4462,656,239,30.464580498866212,32.949115646258505,14,25,431,2,417
4463,656,554,30.464580498866212,31.55591836734694,14,15,112,1,102
4464,656,538,30.464580498866212,32.949115646258505,14,14,159,2,118
4465,656,539,30.464580498866212,33.32063492063492,14,15,170,3,117
4466,656,665,30.464580498866212,32.670476190476194,14,15,95,2,9
4467,656,826,30.464580498866212,31.811337868480727,14,12,180,1,170
4468,642,239,31.346938775510203,32.949115646258505,14,25,409,2,403
4469,642,209,31.346938775510203,33.99401360544218,14,26,448,3,433
4470,642,538,31.346938775510203,32.949115646258505,14,14,125,2,104
4471,642,539,31.346938775510203,33.32063492063492,14,15,134,2,103
4472,642,665,31.346938775510203,32.670476190476194,14,15,61,1,23
4473,642,726,31.346938775510203,33.552834467120185,14,14,127,2,84
4474,642,618,31.346938775510203,34.17977324263039,14,14,124,3,24
4475,665,209,32.670476190476194,33.99401360544218,15,26,460,1,456
4476,665,210,32.670476190476194,35.10857142857143,15,22,467,2,455
4477,665,569,32.670476190476194,34.481632653061226,15,22,124,2,96
4478,665,618,32.670476190476194,34.17977324263039,15,14,80,2,47
4479,665,896,32.670476190476194,34.87637188208617,15,10,250,2,231
4480,726,331,33.552834467120185,35.80517006802721,14,22,407,2,395
4481,726,561,33.552834467120185,35.75873015873016,14,18,190,2,165
4482,726,638,33.552834467120185,35.735510204081635,14,16,129,2,88
4483,726,654,33.552834467120185,36.24634920634921,14,20,137,3,72
4484,726,896,33.552834467120185,34.87637188208617,14,10,179,1,170
4485,726,826,33.552834467120185,35.75873015873016,14,10,138,2,100
4486,726,934,33.552834467120185,36.29278911564626,14,14,239,3,208
4487,618,331,34.17977324263039,35.80517006802721,14,22,295,2,287
4488,618,228,34.17977324263039,36.91972789115646,14,27,407,3,390
4489,618,561,34.17977324263039,35.75873015873016,14,18,89,2,57
4490,618,491,34.17977324263039,36.80362811791383,14,22,170,3,127
4491,618,638,34.17977324263039,35.735510204081635,14,16,70,2,20
4492,618,654,34.17977324263039,36.24634920634921,14,20,96,2,36
4493,618,826,34.17977324263039,35.75873015873016,14,10,219,2,208
4494,618,934,34.17977324263039,36.29278911564626,14,14,329,2,316
4495,638,228,35.735510204081635,36.91972789115646,16,27,413,1,410
4496,638,225,35.735510204081635,37.45378684807256,16,26,420,2,413
4497,638,383,35.735510204081635,38.638004535147395,16,24,284,3,255
4498,638,491,35.735510204081635,36.80362811791383,16,22,154,1,147
4499,638,454,35.735510204081635,37.221587301587306,16,19,195,1,184
4500,638,540,35.735510204081635,38.59156462585034,16,15,157,3,98
4501,638,680,35.735510204081635,37.17514739229025,16,16,75,1,42
4502,638,619,35.735510204081635,38.49868480725624,16,15,121,3,19
4503,638,849,35.735510204081635,37.964625850340134,16,13,232,2,211
4504,654,225,36.24634920634921,37.45378684807256,20,26,432,1,429
4505,654,383,36.24634920634921,38.638004535147395,20,24,290,2,271
4506,654,227,36.24634920634921,39.14884353741497,20,20,445,3,427
4507,654,540,36.24634920634921,38.59156462585034,20,15,152,2,114
4508,654,545,36.24634920634921,39.14884353741497,20,14,166,3,109
4509,654,619,36.24634920634921,38.49868480725624,20,15,103,2,35
4510,654,849,36.24634920634921,37.964625850340134,20,13,209,2,195
4511,654,924,36.24634920634921,38.846984126984125,20,10,292,3,270
4512,680,383,37.17514739229025,38.638004535147395,16,24,304,1,297
4513,680,227,37.17514739229025,39.14884353741497,16,20,461,2,453
4514,680,540,37.17514739229025,38.59156462585034,16,15,153,1,140
4515,680,545,37.17514739229025,39.14884353741497,16,14,160,2,135
4516,680,619,37.17514739229025,38.49868480725624,16,15,83,1,61
4517,680,716,37.17514739229025,39.288163265306125,16,13,98,2,36
4518,680,924,37.17514739229025,38.846984126984125,16,10,254,2,244
4519,619,227,38.49868480725624,40.91356009070295,15,25,406,2,392
4520,619,255,38.49868480725624,41.33151927437642,15,25,384,3,364
4521,619,533,38.49868480725624,40.19374149659864,15,15,113,2,86
4522,619,642,38.49868480725624,40.61170068027211,15,16,94,2,23
4523,716,227,39.288163265306125,40.91356009070295,13,25,494,2,489
4524,716,255,39.288163265306125,41.33151927437642,13,25,469,2,461
4525,716,508,39.288163265306125,41.84235827664399,13,17,235,3,208
4526,716,642,39.288163265306125,40.61170068027211,13,16,93,1,74
4527,716,659,39.288163265306125,41.84235827664399,13,16,124,3,57
4528,716,827,39.288163265306125,41.88879818594104,13,14,158,3,111
4529,642,382,40.61170068027211,42.399637188208615,16,21,271,2,260
4530,642,238,40.61170068027211,43.490975056689344,16,26,423,3,404
4531,642,508,40.61170068027211,41.84235827664399,16,17,144,1,134
4532,642,537,40.61170068027211,42.98013605442177,16,17,146,2,105
4533,642,659,40.61170068027211,41.84235827664399,16,16,56,1,17
4534,642,664,40.61170068027211,42.81759637188209,16,14,98,2,22
4535,642,827,40.61170068027211,41.88879818594104,16,14,193,1,185
4536,642,825,40.61170068027211,42.399637188208615,16,11,199,2,183
4537,659,238,41.84235827664399,43.490975056689344,16,26,427,2,421
4538,659,537,41.84235827664399,42.98013605442177,16,17,131,1,122
4539,659,421,41.84235827664399,43.97859410430839,16,23,255,2,238
4540,659,641,41.84235827664399,43.69995464852608,16,18,82,2,18
4541,659,618,41.84235827664399,44.1643537414966,16,15,108,2,41
4542,659,855,41.84235827664399,43.67673469387755,16,12,211,2,196
4543,664,212,42.81759637188209,44.83773242630386,14,28,460,2,452
4544,664,254,42.81759637188209,45.51111111111111,14,23,426,3,410
4545,664,421,42.81759637188209,43.97859410430839,14,23,248,1,243
4546,664,520,42.81759637188209,45.023492063492064,14,14,173,2,144
4547,664,542,42.81759637188209,45.67365079365079,14,13,173,3,122
4548,664,618,42.81759637188209,44.1643537414966,14,15,74,1,46
4549,664,642,42.81759637188209,45.46467120181406,14,13,116,3,22
4550,664,873,42.81759637188209,45.023492063492064,14,11,230,2,209
4551,641,212,43.69995464852608,44.83773242630386,18,28,432,1,429
4552,641,254,43.69995464852608,45.51111111111111,18,23,395,2,387
4553,641,520,43.69995464852608,45.023492063492064,18,14,134,1,121
4554,641,542,43.69995464852608,45.67365079365079,18,13,130,2,99
4555,641,642,43.69995464852608,45.46467120181406,18,13,76,2,1
4556,641,873,43.69995464852608,45.023492063492064,18,11,239,1,232
4557,618,254,44.1643537414966,45.51111111111111,15,23,369,1,364
4558,618,218,44.1643537414966,47.04362811791383,15,26,419,3,400
4559,618,542,44.1643537414966,45.67365079365079,15,13,100,2,76
4560,618,568,44.1643537414966,46.78820861678005,15,15,124,3,50
4561,618,642,44.1643537414966,45.46467120181406,15,13,61,1,24
4562,618,625,44.1643537414966,46.78820861678005,15,14,113,3,7
4563,642,218,45.46467120181406,47.04362811791383,13,26,429,2,424
4564,642,231,45.46467120181406,47.763446712018144,13,27,423,2,411
4565,642,228,45.46467120181406,48.4368253968254,13,30,433,3,414
4566,642,568,45.46467120181406,46.78820861678005,13,15,93,1,74
4567,642,594,45.46467120181406,48.15818594104309,13,13,126,3,48
4568,642,625,45.46467120181406,46.78820861678005,13,14,59,1,17
4569,642,726,45.46467120181406,47.67056689342404,13,14,127,2,84
4570,642,825,45.46467120181406,47.25260770975057,13,10,199,2,183
4571,625,228,46.78820861678005,48.4368253968254,14,30,403,2,397
4572,625,594,46.78820861678005,48.15818594104309,14,13,67,1,31
4573,625,554,46.78820861678005,48.529705215419504,14,18,103,2,71
4574,625,699,46.78820861678005,49.15664399092971,14,19,126,2,74
4575,625,743,46.78820861678005,49.55138321995465,14,25,168,3,118
4576,625,877,46.78820861678005,49.15664399092971,14,16,272,2,252
4577,625,910,46.78820861678005,49.621043083900226,14,17,310,3,285
4578,726,261,47.67056689342404,49.946122448979594,14,27,475,2,465
4579,726,341,47.67056689342404,50.29442176870749,14,26,401,3,385
4580,726,515,47.67056689342404,50.08544217687075,14,17,235,2,211
4581,726,699,47.67056689342404,49.15664399092971,14,19,69,1,27
4582,726,743,47.67056689342404,49.55138321995465,14,25,83,2,17
4583,726,877,47.67056689342404,49.15664399092971,14,16,164,1,151
4584,726,910,47.67056689342404,49.621043083900226,14,17,202,2,184
4585,699,341,49.15664399092971,50.29442176870749,19,26,361,1,358
4586,699,256,49.15664399092971,52.082358276643994,19,25,461,3,443
4587,699,515,49.15664399092971,50.874920634920635,19,20,198,2,184
4588,699,578,49.15664399092971,51.432199546485265,19,14,156,2,121
4589,699,679,49.15664399092971,50.73560090702948,19,16,71,2,20
4590,699,618,49.15664399092971,52.082358276643994,19,16,150,3,81
4591,699,822,49.15664399092971,50.712380952380954,19,18,140,2,123
4592,699,906,49.15664399092971,52.082358276643994,19,12,242,3,207
4593,743,256,49.55138321995465,52.082358276643994,25,25,499,3,487
4594,743,515,49.55138321995465,50.874920634920635,25,20,235,1,228
4595,743,578,49.55138321995465,51.432199546485265,25,14,184,2,165
4596,743,679,49.55138321995465,50.73560090702948,25,16,82,1,64
4597,743,618,49.55138321995465,52.082358276643994,25,16,166,3,125
4598,743,631,49.55138321995465,52.523537414965986,25,16,170,3,112
4599,743,822,49.55138321995465,50.712380952380954,25,18,93,1,79
4600,743,906,49.55138321995465,52.082358276643994,25,12,196,3,163
4601,679,256,50.73560090702948,52.082358276643994,16,25,427,1,423
4602,679,229,50.73560090702948,52.38421768707483,16,20,456,2,450
4603,679,519,50.73560090702948,52.964716553287985,16,15,187,2,160
4604,679,618,50.73560090702948,52.082358276643994,16,16,84,1,61
4605,679,631,50.73560090702948,52.523537414965986,16,16,91,2,48
4606,679,906,50.73560090702948,52.082358276643994,16,12,234,1,227
4607,679,967,50.73560090702948,52.964716553287985,16,13,304,2,288
4608,618,226,52.082358276643994,54.10249433106576,16,26,402,2,392
4609,618,231,52.082358276643994,54.75265306122449,16,25,404,3,387
4610,618,425,52.082358276643994,54.14893424036281,16,21,213,2,193
4611,618,410,52.082358276643994,54.984852607709755,16,17,243,3,208
4612,618,728,52.082358276643994,53.823854875283445,16,23,133,2,110
4613,618,709,52.082358276643994,54.868752834467124,16,20,151,3,91
4614,618,831,52.082358276643994,53.823854875283445,16,15,226,2,213
4615,618,832,52.082358276643994,54.89197278911565,16,12,246,3,214
4616,631,226,52.523537414965986,54.10249433106576,16,26,411,2,405
4617,631,231,52.523537414965986,54.75265306122449,16,25,411,2,400
4618,631,425,52.523537414965986,54.14893424036281,16,21,218,2,206
4619,631,410,52.523537414965986,54.984852607709755,16,17,245,2,221
4620,631,728,52.523537414965986,53.823854875283445,16,23,112,1,97
4621,631,709,52.523537414965986,54.868752834467124,16,20,128,2,78
4622,631,729,52.523537414965986,55.28671201814059,16,17,154,3,98
4623,631,831,52.523537414965986,53.823854875283445,16,15,208,1,200
4624,631,832,52.523537414965986,54.89197278911565,16,12,225,2,201
4625,631,885,52.523537414965986,55.263492063492066,16,14,280,3,254
4626,728,247,53.823854875283445,55.89043083900227,23,25,489,2,481
4627,728,410,53.823854875283445,54.984852607709755,23,17,322,1,318
4628,728,410,53.823854875283445,55.98331065759637,23,18,331,2,318
4629,728,552,53.823854875283445,56.26195011337869,23,15,205,2,176
4630,728,709,53.823854875283445,54.868752834467124,23,20,49,1,19
4631,728,729,53.823854875283445,55.28671201814059,23,17,63,1,1
4632,728,675,53.823854875283445,56.47092970521542,23,14,126,3,53
4633,728,832,53.823854875283445,54.89197278911565,23,12,114,1,104
4634,728,885,53.823854875283445,55.263492063492066,23,14,169,1,157
4635,728,932,53.823854875283445,56.49414965986394,23,13,234,3,204
4636,709,247,54.868752834467124,55.89043083900227,20,25,464,1,462
4637,709,225,54.868752834467124,56.91210884353742,20,24,492,2,484
4638,709,241,54.868752834467124,57.72480725623583,20,28,484,3,468
4639,709,410,54.868752834467124,55.98331065759637,20,18,303,1,299
4640,709,552,54.868752834467124,56.26195011337869,20,15,168,1,157
4641,709,569,54.868752834467124,57.5158276643991,20,17,181,3,140
4642,709,675,54.868752834467124,56.47092970521542,20,14,77,2,34
4643,709,655,54.868752834467124,57.817687074829934,20,15,138,3,54
4644,709,932,54.868752834467124,56.49414965986394,20,13,234,2,223
4645,709,825,54.868752834467124,57.399727891156466,20,11,159,3,116
4646,729,241,55.28671201814059,57.72480725623583,17,28,499,2,488
4647,729,569,55.28671201814059,57.5158276643991,17,17,187,2,160
4648,729,675,55.28671201814059,56.47092970521542,17,14,74,1,54
4649,729,655,55.28671201814059,57.817687074829934,17,15,132,3,74
4650,729,932,55.28671201814059,56.49414965986394,17,13,210,1,203
4651,729,825,55.28671201814059,57.399727891156466,17,11,132,2,96
4652,675,241,56.47092970521542,57.72480725623583,14,28,437,1,434
4653,675,212,56.47092970521542,59.187664399092974,14,22,478,3,463
4654,675,569,56.47092970521542,57.5158276643991,14,17,115,1,106
4655,675,439,56.47092970521542,58.90902494331066,14,13,258,2,236
4656,675,655,56.47092970521542,57.817687074829934,14,15,61,1,20
4657,675,719,56.47092970521542,59.14122448979592,14,14,123,3,44
4658,675,825,56.47092970521542,58.28208616780046,14,12,169,2,150
4659,655,212,57.817687074829934,59.187664399092974,15,22,447,1,443
4660,655,212,57.817687074829934,60.09324263038549,15,32,454,2,443
4661,655,439,57.817687074829934,58.90902494331066,15,13,221,1,216
4662,655,602,57.817687074829934,59.60562358276644,15,20,93,2,53
4663,655,719,57.817687074829934,59.14122448979592,15,14,86,1,64
4664,655,617,57.817687074829934,59.582403628117916,15,17,85,2,38
4665,655,826,57.817687074829934,59.582403628117916,15,11,187,2,171
4666,655,826,57.817687074829934,60.46476190476191,15,11,206,3,171
4667,719,225,59.14122448979592,61.18458049886621,14,28,502,2,494
4668,719,424,59.14122448979592,61.161360544217686,14,22,308,2,295
4669,719,430,59.14122448979592,61.23102040816327,14,20,303,2,289
4670,719,720,59.14122448979592,60.9059410430839,14,14,76,2,1
4671,719,627,59.14122448979592,61.602539682539685,14,16,140,2,92
4672,719,826,59.14122448979592,60.46476190476191,14,11,121,1,107
4673,719,957,59.14122448979592,61.46321995464853,14,13,258,2,238
4674,617,225,59.582403628117916,61.18458049886621,17,28,398,2,392
4675,617,214,59.582403628117916,61.41678004535147,17,30,411,2,403
4676,617,209,59.582403628117916,62.32235827664399,17,31,425,3,408
4677,617,424,59.582403628117916,61.161360544217686,17,22,205,2,193
4678,617,430,59.582403628117916,61.23102040816327,17,20,200,2,187
4679,617,720,59.582403628117916,60.9059410430839,17,14,118,1,103
4680,617,627,59.582403628117916,61.602539682539685,17,16,88,2,10
4681,617,957,59.582403628117916,61.46321995464853,17,13,350,2,340
4682,720,596,60.9059410430839,63.22793650793651,14,16,159,2,124
4683,720,582,60.9059410430839,63.27437641723356,14,20,172,2,138
4684,720,630,60.9059410430839,63.11183673469388,14,15,131,2,90
4685,720,743,60.9059410430839,63.669115646258504,14,22,121,3,23
4686,720,922,60.9059410430839,62.67065759637188,14,11,216,2,202
4687,720,829,60.9059410430839,63.669115646258504,14,19,161,3,109
4688,627,402,61.602539682539685,64.04063492063493,16,25,248,2,225
4689,627,596,61.602539682539685,63.22793650793651,16,16,77,2,31
4690,627,582,61.602539682539685,63.27437641723356,16,20,85,2,45
4691,627,630,61.602539682539685,63.11183673469388,16,15,65,2,3
4692,627,743,61.602539682539685,63.669115646258504,16,22,146,2,116
4693,627,922,61.602539682539685,62.67065759637188,16,11,299,1,295
4694,627,829,61.602539682539685,63.669115646258504,16,19,221,2,202
4695,630,253,63.11183673469388,64.76045351473923,15,24,384,2,377
4696,630,258,63.11183673469388,65.75891156462585,15,26,389,3,372
4697,630,411,63.11183673469388,64.69079365079365,15,20,229,2,219
4698,630,422,63.11183673469388,65.38739229024944,15,17,230,2,208
4699,630,818,63.11183673469388,64.85333333333334,15,17,202,2,188
4700,630,640,63.11183673469388,65.31773242630386,15,16,96,2,10
4701,630,865,63.11183673469388,64.80689342403629,15,15,246,2,235
4702,743,253,63.669115646258504,64.76045351473923,22,24,492,1,490
4703,743,258,63.669115646258504,65.75891156462585,22,26,493,2,485
4704,743,411,63.669115646258504,64.69079365079365,22,20,335,1,332
4705,743,422,63.669115646258504,65.38739229024944,22,17,329,2,321
4706,743,430,63.669115646258504,66.26975056689342,22,15,332,3,313
4707,743,818,63.669115646258504,64.85333333333334,22,17,91,1,75
4708,743,640,63.669115646258504,65.31773242630386,22,16,125,2,103
4709,743,641,63.669115646258504,66.64126984126985,22,16,164,3,102
4710,743,865,63.669115646258504,64.80689342403629,22,15,131,1,122
4711,743,826,63.669115646258504,66.20009070294785,22,14,137,3,83
4712,743,869,63.669115646258504,66.64126984126985,22,11,180,3,126
4713,818,430,64.85333333333334,66.26975056689342,17,15,393,1,388
4714,818,641,64.85333333333334,66.64126984126985,17,16,193,2,177
4715,818,826,64.85333333333334,66.20009070294785,17,14,59,1,8
4716,818,869,64.85333333333334,66.64126984126985,17,11,92,2,51
4717,640,226,65.31773242630386,67.10566893424037,16,24,421,2,414
4718,640,259,65.31773242630386,68.01124716553288,16,23,398,3,381
4719,640,422,65.31773242630386,68.08090702947845,16,16,248,3,218
4720,640,641,65.31773242630386,66.64126984126985,16,16,57,1,1
4721,640,723,65.31773242630386,67.9415873015873,16,20,140,3,83
4722,640,869,65.31773242630386,66.64126984126985,16,11,236,1,229
4723,640,846,65.31773242630386,67.91836734693878,16,16,234,3,206
4724,641,259,66.64126984126985,68.01124716553288,16,23,387,1,382
4725,641,231,66.64126984126985,68.87038548752835,16,24,421,2,410
4726,641,422,66.64126984126985,68.08090702947845,16,16,228,1,219
4727,641,595,66.64126984126985,69.0097052154195,16,18,112,2,46
4728,641,410,66.64126984126985,69.5437641723356,16,15,263,3,231
4729,641,723,66.64126984126985,67.9415873015873,16,20,99,1,82
4730,641,733,66.64126984126985,69.03292517006803,16,21,138,2,92
4731,641,698,66.64126984126985,69.40444444444445,16,15,132,3,57
4732,641,846,66.64126984126985,67.91836734693878,16,16,212,1,205
4733,641,839,66.64126984126985,69.03292517006803,16,14,223,2,198
4734,641,826,66.64126984126985,69.40444444444445,16,12,220,3,185
4735,723,252,67.9415873015873,69.75274376417234,20,24,477,2,471
4736,723,595,67.9415873015873,69.0097052154195,20,18,136,1,128
4737,723,410,67.9415873015873,69.5437641723356,20,15,321,2,313
4738,723,520,67.9415873015873,70.6118820861678,20,14,233,3,203
4739,723,733,67.9415873015873,69.03292517006803,20,21,48,1,10
4740,723,698,67.9415873015873,69.40444444444445,20,15,68,1,25
4741,723,641,67.9415873015873,70.6118820861678,20,14,141,3,82
4742,723,839,67.9415873015873,69.03292517006803,20,14,125,1,116
4743,723,826,67.9415873015873,69.40444444444445,20,12,121,1,103
4744,733,342,69.03292517006803,71.61034013605442,21,27,406,3,391
4745,733,520,69.03292517006803,70.6118820861678,21,14,224,2,213
4746,733,599,69.03292517006803,71.5871201814059,21,18,173,3,134
4747,733,641,69.03292517006803,70.6118820861678,21,14,114,2,92
4748,733,641,69.03292517006803,71.9354195011338,21,16,155,3,92
4749,733,826,69.03292517006803,71.0530612244898,21,11,127,2,93
4750,733,826,69.03292517006803,71.4942403628118,21,13,141,2,93
4751,698,219,69.40444444444445,71.00662131519275,15,25,484,2,479
4752,698,342,69.40444444444445,71.61034013605442,15,27,368,2,356
4753,698,520,69.40444444444445,70.6118820861678,15,14,185,1,178
4754,698,599,69.40444444444445,71.5871201814059,15,18,137,2,99
4755,698,641,69.40444444444445,70.6118820861678,15,14,77,1,57
4756,698,641,69.40444444444445,71.9354195011338,15,16,123,3,57
4757,698,640,69.40444444444445,72.37659863945578,15,14,141,3,58
4758,698,826,69.40444444444445,71.0530612244898,15,11,146,2,128
4759,698,826,69.40444444444445,71.4942403628118,15,13,156,2,128
4760,698,953,69.40444444444445,72.37659863945578,15,12,285,3,255
4761,641,210,70.6118820861678,73.25895691609978,14,20,446,3,431
4762,641,569,70.6118820861678,72.49269841269842,14,15,108,2,72
4763,641,640,70.6118820861678,72.37659863945578,14,14,76,2,1
4764,641,953,70.6118820861678,72.37659863945578,14,12,321,2,312
4765,641,210,71.9354195011338,73.25895691609978,16,20,435,1,431
4766,641,212,71.9354195011338,74.18775510204082,16,31,440,2,429
4767,641,211,71.9354195011338,74.28063492063492,16,29,442,2,430
4768,641,605,71.9354195011338,73.76979591836735,16,19,87,2,36
4769,641,720,71.9354195011338,74.58249433106576,16,13,139,3,79
4770,641,870,71.9354195011338,74.14131519274376,16,11,248,2,229
4771,641,826,71.9354195011338,74.58249433106576,16,10,217,3,185
4772,640,212,72.37659863945578,74.18775510204082,14,31,435,2,428
4773,640,211,72.37659863945578,74.28063492063492,14,29,437,2,429
4774,640,605,72.37659863945578,73.76979591836735,14,19,69,1,35
4775,640,416,72.37659863945578,75.25587301587302,14,22,256,3,224
4776,640,423,72.37659863945578,75.27909297052155,14,23,250,3,217
4777,640,641,72.37659863945578,73.70013605442178,14,14,57,1,1
4778,640,720,72.37659863945578,74.58249433106576,14,13,124,2,80
4779,640,870,72.37659863945578,74.14131519274376,14,11,242,2,230
4780,640,826,72.37659863945578,74.58249433106576,14,10,209,2,186
4781,641,229,73.70013605442178,75.4184126984127,14,31,419,2,412
4782,641,210,73.70013605442178,76.41687074829932,14,32,447,3,431
4783,641,416,73.70013605442178,75.25587301587302,14,22,235,2,225
4784,641,423,73.70013605442178,75.27909297052155,14,23,228,2,218
4785,641,640,73.70013605442178,75.90603174603174,14,16,95,2,1
4786,641,826,73.70013605442178,75.90603174603174,14,12,208,2,185
4787,720,419,74.58249433106576,76.97414965986394,13,20,318,2,301
4788,720,640,74.58249433106576,75.90603174603174,13,16,98,1,80
4789,720,641,74.58249433106576,76.34721088435374,13,16,110,2,79
4790,720,826,74.58249433106576,75.90603174603174,13,12,120,1,106
4791,720,913,74.58249433106576,76.99736961451248,13,11,219,2,193
4792,640,408,75.90603174603174,78.25124716553289,16,20,253,2,232
4793,640,403,75.90603174603174,78.85496598639456,16,19,269,3,237
4794,640,419,75.90603174603174,76.97414965986394,16,20,226,1,221
4795,640,444,75.90603174603174,78.22802721088435,16,15,220,2,196
4796,640,515,75.90603174603174,78.57632653061225,16,17,170,3,125
4797,640,626,75.90603174603174,78.20480725623582,16,14,100,2,14
4798,640,819,75.90603174603174,78.32090702947846,16,14,207,2,179
4799,640,913,75.90603174603174,76.99736961451248,16,11,277,1,273
4800,640,923,75.90603174603174,78.25124716553289,16,13,300,2,283
4801,640,824,75.90603174603174,78.76208616780046,16,13,221,3,184
4802,641,408,76.34721088435374,78.25124716553289,16,20,247,2,233
4803,641,403,76.34721088435374,78.85496598639456,16,19,261,3,238
4804,641,444,76.34721088435374,78.22802721088435,16,15,213,2,197
4805,641,515,76.34721088435374,78.57632653061225,16,17,158,2,126
4806,641,626,76.34721088435374,78.20480725623582,16,14,81,2,15
4807,641,819,76.34721088435374,78.32090702947846,16,14,197,2,178
4808,641,923,76.34721088435374,78.25124716553289,16,13,294,2,282
4809,641,824,76.34721088435374,78.76208616780046,16,13,210,2,183
4810,626,211,78.20480725623582,79.87664399092971,14,17,421,2,415
4811,626,211,78.20480725623582,80.75900226757369,14,16,429,3,415
4812,626,589,78.20480725623582,80.17850340136054,14,14,93,2,37
4813,626,552,78.20480725623582,80.96798185941043,14,12,140,3,74
4814,626,717,78.20480725623582,80.15528344671202,14,15,124,2,91
4815,626,641,78.20480725623582,80.96798185941043,14,20,120,3,15
4816,819,589,78.32090702947846,80.17850340136054,14,14,244,2,230
4817,819,552,78.32090702947846,80.96798185941043,14,12,290,3,267
4818,819,717,78.32090702947846,80.15528344671202,14,15,129,2,102
4819,819,641,78.32090702947846,80.96798185941043,14,20,211,3,178
4820,717,244,80.15528344671202,81.92,15,23,479,2,473
4821,717,442,80.15528344671202,81.89678004535148,15,13,285,2,275
4822,717,649,80.15528344671202,81.89678004535148,15,16,101,2,68
4823,717,682,80.15528344671202,82.84879818594105,15,16,121,3,35
4824,717,843,80.15528344671202,82.87201814058957,15,11,172,3,126
4825,641,401,80.96798185941043,83.15065759637189,20,26,258,2,240
4826,641,412,80.96798185941043,83.15065759637189,20,20,248,2,229
4827,641,553,80.96798185941043,83.40607709750567,20,11,137,2,88
4828,641,682,80.96798185941043,82.84879818594105,20,16,91,2,41
4829,641,636,80.96798185941043,83.31319727891156,20,12,101,2,5
4830,641,843,80.96798185941043,82.87201814058957,20,11,218,2,202
4831,649,401,81.89678004535148,83.15065759637189,16,26,254,1,248
4832,649,320,81.89678004535148,84.07945578231293,16,22,342,2,329
4833,649,412,81.89678004535148,83.15065759637189,16,20,243,1,237
4834,649,553,81.89678004535148,83.40607709750567,16,11,116,2,96
4835,649,636,81.89678004535148,83.31319727891156,16,12,62,1,13
4836,682,320,82.84879818594105,84.07945578231293,16,22,366,1,362
4837,682,205,82.84879818594105,84.89215419501134,16,27,485,2,477
4838,682,228,82.84879818594105,85.40299319727892,16,26,467,3,454
4839,682,554,82.84879818594105,85.14757369614513,16,17,162,2,128
4840,682,680,82.84879818594105,85.14757369614513,16,12,99,2,2
4841,636,205,83.31319727891156,84.89215419501134,12,27,436,2,431
4842,636,228,83.31319727891156,85.40299319727892,12,26,418,2,408
4843,636,554,83.31319727891156,85.14757369614513,12,17,114,2,82
4844,636,515,83.31319727891156,86.12281179138323,12,19,171,3,121
4845,636,680,83.31319727891156,85.14757369614513,12,12,90,2,44
4846,636,819,83.31319727891156,86.05315192743764,12,16,218,3,183
4847,636,896,83.31319727891156,86.02993197278911,12,15,285,3,260
4848,680,231,85.14757369614513,87.05160997732426,12,26,456,2,449
4849,680,227,85.14757369614513,87.60888888888888,12,26,465,2,453
4850,680,515,85.14757369614513,86.6336507936508,12,14,177,1,165
4851,680,424,85.14757369614513,87.81786848072562,12,15,281,3,256
4852,680,743,85.14757369614513,86.93551020408164,12,13,99,2,63
4853,680,640,85.14757369614513,87.37668934240364,12,16,104,2,40
4854,680,869,85.14757369614513,86.58721088435374,12,12,199,1,189
4855,680,844,85.14757369614513,87.42312925170069,12,15,191,2,164
4856,819,424,86.05315192743764,87.81786848072562,16,15,402,2,395
4857,819,416,86.05315192743764,88.72344671201814,16,18,419,3,403
4858,819,640,86.05315192743764,87.37668934240364,16,16,188,1,179
4859,819,844,86.05315192743764,87.42312925170069,16,15,64,1,25
4860,743,416,86.93551020408164,88.72344671201814,13,18,336,2,327
4861,743,413,86.93551020408164,89.65224489795918,13,18,350,3,330
4862,743,720,86.93551020408164,89.1414058956916,13,17,98,2,23
4863,743,630,86.93551020408164,89.5825850340136,13,14,161,3,113
4864,743,833,86.93551020408164,89.0485260770975,13,13,128,2,90
4865,640,208,87.37668934240364,88.72344671201814,16,25,436,1,432
4866,640,232,87.37668934240364,89.83800453514739,16,28,422,2,408
4867,640,416,87.37668934240364,88.72344671201814,16,18,231,1,224
4868,640,413,87.37668934240364,89.65224489795918,16,18,247,2,227
4869,640,720,87.37668934240364,89.1414058956916,16,17,110,2,80
4870,640,630,87.37668934240364,89.5825850340136,16,14,96,2,10
4871,640,833,87.37668934240364,89.0485260770975,16,13,206,2,193
4872,640,932,87.37668934240364,90.00054421768708,16,11,313,3,292
4873,720,546,89.1414058956916,90.4649433106576,17,14,183,1,174
4874,720,617,89.1414058956916,90.4649433106576,17,14,118,1,103
4875,720,641,89.1414058956916,91.34730158730159,17,15,124,2,79
4876,720,932,89.1414058956916,90.88290249433106,17,14,225,2,212
4877,720,922,89.1414058956916,91.95102040816327,17,13,235,3,202
4878,630,211,89.5825850340136,91.16154195011337,14,28,424,2,419
4879,630,272,89.5825850340136,92.16,14,25,375,3,358
4880,630,571,89.5825850340136,92.22965986394559,14,15,128,3,59
4881,630,641,89.5825850340136,91.34730158730159,14,15,77,2,11
4882,630,932,89.5825850340136,90.88290249433106,14,14,307,1,302
4883,630,922,89.5825850340136,91.95102040816327,14,13,309,2,292
4884,617,272,90.4649433106576,92.16,14,25,353,2,345
4885,617,215,90.4649433106576,92.64761904761905,14,27,413,2,402
4886,617,571,90.4649433106576,92.22965986394559,14,15,89,2,46
4887,617,418,90.4649433106576,92.67083900226757,14,20,221,2,199
4888,617,665,90.4649433106576,92.67083900226757,14,16,106,2,48
4889,617,922,90.4649433106576,91.95102040816327,14,13,312,1,305
4890,617,923,90.4649433106576,92.97269841269842,14,14,324,3,306
4891,641,215,91.34730158730159,92.64761904761905,15,27,430,1,426
4892,641,230,91.34730158730159,93.55319727891157,15,21,422,2,411
4893,641,418,91.34730158730159,92.67083900226757,15,20,230,1,223
4894,641,539,91.34730158730159,93.71573696145126,15,18,144,2,102
4895,641,665,91.34730158730159,92.67083900226757,15,16,62,1,24
4896,641,923,91.34730158730159,92.97269841269842,15,14,291,2,282
4897,641,889,91.34730158730159,93.64607709750567,15,15,267,2,248
4898,665,232,92.67083900226757,95.15537414965986,16,25,446,2,433
4899,665,539,92.67083900226757,93.71573696145126,16,18,134,1,126
4900,665,573,92.67083900226757,94.52843537414967,16,18,122,2,92
4901,665,634,92.67083900226757,94.43555555555555,16,13,82,2,31
4902,665,921,92.67083900226757,94.41233560090703,16,11,267,2,256
4903,641,232,93.52997732426304,95.15537414965986,15,25,415,2,409
4904,641,222,93.52997732426304,96.17705215419501,15,22,434,3,419
4905,641,230,93.52997732426304,96.4324716553288,15,23,430,3,411
4906,641,562,93.52997732426304,96.36281179138322,15,25,145,3,79
4907,641,561,93.52997732426304,96.38603174603175,15,23,147,3,80
4908,641,766,93.52997732426304,96.29315192743765,15,20,173,3,125
4909,641,886,93.52997732426304,96.29315192743765,15,17,272,3,245
4910,634,222,94.43555555555555,96.17705215419501,13,22,419,2,412
4911,634,230,94.43555555555555,96.4324716553288,13,23,413,2,404
4912,634,562,94.43555555555555,96.36281179138322,13,25,110,2,72
4913,634,561,94.43555555555555,96.38603174603175,13,23,111,2,73
4914,634,766,94.43555555555555,96.29315192743765,13,20,154,2,132
4915,634,633,94.43555555555555,97.12907029478458,13,19,116,3,1
4916,634,886,94.43555555555555,96.29315192743765,13,17,264,2,252
4917,634,899,94.43555555555555,97.17551020408163,13,12,290,3,265
4918,766,609,96.29315192743765,97.61668934240363,20,21,167,1,157
4919,766,433,96.29315192743765,98.63836734693878,20,17,348,2,333
4920,766,668,96.29315192743765,97.6863492063492,20,17,115,1,98
4921,766,637,96.29315192743765,98.91700680272109,20,17,171,3,129
4922,766,828,96.29315192743765,97.70956916099773,20,13,87,1,62
4923,766,957,96.29315192743765,98.94022675736962,20,13,222,3,191
4924,633,217,97.12907029478458,98.40616780045352,19,25,420,1,416
4925,633,207,97.12907029478458,99.96190476190476,19,30,443,3,426
4926,633,433,97.12907029478458,98.63836734693878,19,17,210,2,200
4927,633,555,97.12907029478458,100.0780045351474,19,23,149,3,78
4928,633,637,97.12907029478458,98.91700680272109,19,17,77,2,4
4929,633,957,97.12907029478458,98.94022675736962,19,13,333,2,324
4930,633,882,97.12907029478458,100.10122448979592,19,14,280,3,249
4931,668,207,97.6863492063492,99.96190476190476,17,30,471,2,461
4932,668,555,97.6863492063492,100.0780045351474,17,23,153,2,113
4933,668,585,97.6863492063492,100.47274376417234,17,18,146,3,83
4934,668,637,97.6863492063492,98.91700680272109,17,17,61,1,31
4935,668,641,97.6863492063492,100.14766439909297,17,17,109,2,27
4936,668,623,97.6863492063492,100.40308390022676,17,17,125,3,45
4937,668,957,97.6863492063492,98.94022675736962,17,13,294,1,289
4938,668,882,97.6863492063492,100.10122448979592,17,14,238,2,214
4939,668,899,97.6863492063492,100.47274376417234,17,15,260,3,231
4940,637,207,98.91700680272109,99.96190476190476,17,30,432,1,430
4941,637,227,98.91700680272109,101.28544217687075,17,25,422,2,410
4942,637,256,98.91700680272109,101.63374149659865,17,26,399,3,381
4943,637,555,98.91700680272109,100.0780045351474,17,23,96,1,82
4944,637,585,98.91700680272109,100.47274376417234,17,18,85,2,52
4945,637,596,98.91700680272109,101.65696145124717,17,16,125,3,41
4946,637,641,98.91700680272109,100.14766439909297,17,17,53,1,4
4947,637,623,98.91700680272109,100.40308390022676,17,17,66,1,14
4948,637,622,98.91700680272109,101.56408163265306,17,18,115,3,15
4949,637,882,98.91700680272109,100.10122448979592,17,14,250,1,245
4950,637,899,98.91700680272109,100.47274376417234,17,15,270,2,262
4951,637,952,98.91700680272109,101.47120181405896,17,12,334,3,315
4952,641,227,100.14766439909297,101.28544217687075,17,25,417,1,414
4953,641,256,100.14766439909297,101.63374149659865,17,26,390,1,385
4954,641,596,100.14766439909297,101.65696145124717,17,16,79,2,45
4955,641,622,100.14766439909297,101.56408163265306,17,18,64,1,19
4956,641,952,100.14766439909297,101.47120181405896,17,12,316,1,311
4957,641,847,100.14766439909297,102.79473922902494,17,11,235,3,206
4958,623,256,100.40308390022676,101.63374149659865,17,26,371,1,367
4959,623,234,100.40308390022676,103.23591836734694,17,23,408,3,389
4960,623,596,100.40308390022676,101.65696145124717,17,16,60,1,27
4961,623,584,100.40308390022676,103.25913832199547,17,16,129,3,39
4962,623,622,100.40308390022676,101.56408163265306,17,18,50,1,1
4963,623,643,100.40308390022676,103.23591836734694,17,13,124,3,20
4964,623,952,100.40308390022676,101.47120181405896,17,12,332,1,329
4965,623,847,100.40308390022676,102.79473922902494,17,11,247,2,224
4966,622,234,101.56408163265306,103.23591836734694,18,23,395,2,388
4967,622,236,101.56408163265306,104.14149659863946,18,29,402,3,386
4968,622,584,101.56408163265306,103.25913832199547,18,16,82,2,38
4969,622,415,101.56408163265306,103.4681179138322,18,18,223,2,207
4970,622,643,101.56408163265306,103.23591836734694,18,13,75,2,21
4971,622,650,101.56408163265306,103.79319727891156,18,13,100,2,28
4972,622,847,101.56408163265306,102.79473922902494,18,11,231,1,225
4973,622,896,101.56408163265306,104.11827664399094,18,12,295,3,274
4974,643,375,103.23591836734694,104.69877551020409,13,27,275,1,268
4975,643,410,103.23591836734694,104.79165532879819,13,21,242,2,233
4976,643,530,103.23591836734694,106.09197278911564,13,19,167,3,113
4977,643,683,103.23591836734694,105.00063492063492,13,15,86,2,40
4978,643,743,103.23591836734694,106.02231292517007,13,24,156,3,100
4979,643,944,103.23591836734694,105.00063492063492,13,11,310,2,301
4980,643,885,103.23591836734694,106.06875283446712,13,17,271,3,242
4981,650,247,103.79319727891156,106.27773242630386,13,24,417,2,403
4982,650,530,103.79319727891156,106.09197278911564,13,19,156,2,120
4983,650,461,103.79319727891156,106.64925170068028,13,19,225,3,189
4984,650,683,103.79319727891156,105.00063492063492,13,15,62,1,33
4985,650,743,103.79319727891156,106.02231292517007,13,24,134,2,93
4986,650,944,103.79319727891156,105.00063492063492,13,11,299,1,294
4987,650,885,103.79319727891156,106.06875283446712,13,17,255,2,235
4988,683,247,105.00063492063492,106.27773242630386,15,24,439,1,436
4989,683,343,105.00063492063492,106.81179138321995,15,27,349,2,340
4990,683,530,105.00063492063492,106.09197278911564,15,19,160,1,153
4991,683,461,105.00063492063492,106.64925170068028,15,19,233,2,222
4992,683,538,105.00063492063492,107.43873015873017,15,16,179,2,145
4993,683,743,105.00063492063492,106.02231292517007,15,24,74,1,60
4994,683,647,105.00063492063492,107.16009070294785,15,18,100,2,36
4995,683,885,105.00063492063492,106.06875283446712,15,17,207,1,202
4996,683,924,105.00063492063492,107.11365079365079,15,14,258,2,241
4997,683,873,105.00063492063492,107.64770975056689,15,11,222,3,190
4998,743,254,106.02231292517007,108.2746485260771,24,26,499,2,489
4999,743,256,106.02231292517007,108.55328798185941,24,26,499,3,487
5000,743,538,106.02231292517007,107.43873015873017,24,16,214,1,205
5001,743,558,106.02231292517007,108.99446712018141,24,16,225,3,185
5002,743,647,106.02231292517007,107.16009070294785,24,18,108,1,96
5003,743,718,106.02231292517007,108.08888888888889,24,15,92,2,25
5004,743,625,106.02231292517007,108.99446712018141,24,14,174,3,118
5005,743,924,106.02231292517007,107.11365079365079,24,14,187,1,181
5006,743,873,106.02231292517007,107.64770975056689,24,11,148,2,130
5007,647,254,107.16009070294785,108.2746485260771,18,26,396,1,393
5008,647,256,107.16009070294785,108.55328798185941,18,26,396,1,391
5009,647,558,107.16009070294785,108.99446712018141,18,16,119,2,89
5010,647,465,107.16009070294785,110.06258503401361,18,14,221,3,182
5011,647,625,107.16009070294785,108.99446712018141,18,14,82,2,22
5012,647,921,107.16009070294785,109.41242630385487,18,12,291,2,274
5013,718,254,108.08888888888889,110.38766439909297,15,25,474,2,464
5014,718,227,108.08888888888889,110.5966439909297,15,26,503,3,491
5015,718,465,108.08888888888889,110.06258503401361,15,14,267,2,253
5016,718,425,108.08888888888889,110.5966439909297,15,19,312,3,293
5017,718,743,108.08888888888889,110.27156462585035,15,20,97,2,25
5018,718,921,108.08888888888889,109.41242630385487,15,12,211,1,203
5019,718,836,108.08888888888889,110.27156462585035,15,15,151,2,118
5020,625,254,108.99446712018141,110.38766439909297,14,25,376,1,371
5021,625,227,108.99446712018141,110.5966439909297,14,26,404,2,398
5022,625,465,108.99446712018141,110.06258503401361,14,14,166,1,160
5023,625,425,108.99446712018141,110.5966439909297,14,19,212,2,200
5024,625,743,108.99446712018141,110.27156462585035,14,20,130,1,118
5025,625,717,108.99446712018141,111.33968253968254,14,22,137,2,92
5026,625,789,108.99446712018141,111.73442176870749,14,16,202,3,164
5027,625,836,108.99446712018141,110.27156462585035,14,15,218,1,211
5028,625,823,108.99446712018141,111.33968253968254,14,17,222,2,198
5029,625,829,108.99446712018141,111.73442176870749,14,13,236,3,204
5030,743,405,110.27156462585035,112.36136054421769,20,26,350,2,338
5031,743,410,110.27156462585035,112.40780045351474,20,19,345,2,333
5032,743,410,110.27156462585035,112.43102040816326,20,19,346,2,333
5033,743,717,110.27156462585035,111.33968253968254,20,22,53,1,26
5034,743,789,110.27156462585035,111.73442176870749,20,16,78,1,46
5035,743,641,110.27156462585035,112.52390022675738,20,16,141,2,102
5036,743,823,110.27156462585035,111.33968253968254,20,17,92,1,80
5037,743,829,110.27156462585035,111.73442176870749,20,13,107,1,86
5038,717,405,111.33968253968254,112.36136054421769,22,26,315,1,312
5039,717,253,111.33968253968254,113.38303854875284,22,24,472,2,464
5040,717,410,111.33968253968254,112.40780045351474,22,19,310,1,307
5041,717,410,111.33968253968254,112.43102040816326,22,19,311,1,307
5042,717,564,111.33968253968254,113.91709750566893,22,18,189,3,153
5043,717,641,111.33968253968254,112.52390022675738,22,16,92,1,76
5044,717,745,111.33968253968254,114.28861678004536,22,14,130,3,28
5045,717,921,111.33968253968254,113.82421768707484,22,10,230,2,204
5046,789,564,111.73442176870749,113.91709750566893,16,18,244,2,225
5047,789,537,111.73442176870749,114.47437641723356,16,14,278,3,252
5048,789,745,111.73442176870749,114.28861678004536,16,14,118,3,44
5049,789,921,111.73442176870749,113.82421768707484,16,10,160,2,132
5050,641,211,112.52390022675738,114.19573696145125,16,27,436,2,430
5051,641,249,112.52390022675738,115.4031746031746,16,18,411,3,392
5052,641,564,112.52390022675738,113.91709750566893,16,18,98,1,77
5053,641,537,112.52390022675738,114.47437641723356,16,14,134,2,104
5054,641,745,112.52390022675738,114.28861678004536,16,14,129,2,104
5055,641,720,112.52390022675738,115.17097505668934,16,12,139,3,79
5056,641,921,112.52390022675738,113.82421768707484,16,10,286,1,280
5057,641,825,112.52390022675738,114.72979591836734,16,10,207,2,184
5058,745,249,114.28861678004536,115.4031746031746,14,18,498,1,496
5059,745,363,114.28861678004536,116.26231292517006,14,21,391,2,382
5060,745,602,114.28861678004536,116.05333333333334,14,19,162,2,143
5061,745,633,114.28861678004536,116.05333333333334,14,16,135,2,112
5062,745,690,114.28861678004536,116.49451247165533,14,14,110,2,55
5063,720,363,115.17097505668934,116.26231292517006,12,21,360,1,357
5064,720,539,115.17097505668934,117.37687074829932,12,17,204,2,181
5065,720,423,115.17097505668934,117.63229024943311,12,23,315,2,297
5066,720,690,115.17097505668934,116.49451247165533,12,14,64,1,30
5067,720,642,115.17097505668934,117.81804988662132,12,16,138,3,78
5068,720,848,115.17097505668934,117.79482993197279,12,11,171,3,128
5069,633,216,116.05333333333334,117.84126984126985,16,29,424,2,417
5070,633,209,116.05333333333334,118.79328798185941,16,32,440,3,424
5071,633,539,116.05333333333334,117.37687074829932,16,17,110,1,94
5072,633,423,116.05333333333334,117.63229024943311,16,23,221,2,210
5073,633,551,116.05333333333334,118.88616780045352,16,14,147,3,82
5074,633,642,116.05333333333334,117.81804988662132,16,16,77,2,9
5075,633,848,116.05333333333334,117.79482993197279,16,11,228,2,215
5076,690,216,116.49451247165533,117.84126984126985,14,29,478,1,474
5077,690,209,116.49451247165533,118.79328798185941,14,32,491,2,481
5078,690,423,116.49451247165533,117.63229024943311,14,23,271,1,267
5079,690,551,116.49451247165533,118.88616780045352,14,14,173,2,139
5080,690,642,116.49451247165533,117.81804988662132,14,16,75,1,48
5081,690,633,116.49451247165533,118.90938775510205,14,13,119,2,57
5082,690,848,116.49451247165533,117.79482993197279,14,11,168,1,158
5083,690,826,116.49451247165533,119.14158730158731,14,10,177,3,136
5084,642,249,117.81804988662132,120.44190476190477,16,26,409,3,393
5085,642,258,117.81804988662132,120.51156462585034,16,26,401,3,384
5086,642,551,117.81804988662132,118.88616780045352,16,14,102,1,91
5087,642,542,117.81804988662132,119.74530612244898,16,18,130,2,100
5088,642,633,117.81804988662132,118.90938775510205,16,13,48,1,9
5089,642,743,117.81804988662132,120.14004535147393,16,21,142,2,101
5090,642,826,117.81804988662132,119.14158730158731,16,10,193,1,184
5091,642,846,117.81804988662132,120.14004535147393,16,16,227,2,204
5092,633,249,118.90938775510205,120.44190476190477,13,26,390,2,384
5093,633,258,118.90938775510205,120.51156462585034,13,26,381,2,375
5094,633,410,118.90938775510205,121.16172335600908,13,19,243,2,223
5095,633,538,118.90938775510205,121.53324263038549,13,16,148,3,95
5096,633,743,118.90938775510205,120.14004535147393,13,21,122,1,110
5097,633,819,118.90938775510205,121.32426303854875,13,18,213,2,186
5098,633,640,118.90938775510205,121.78866213151927,13,14,124,3,7
5099,633,846,118.90938775510205,120.14004535147393,13,16,219,1,213
5100,633,820,118.90938775510205,121.32426303854875,13,14,214,2,187
5101,743,253,120.14004535147393,122.06730158730159,21,25,497,2,490
5102,743,410,120.14004535147393,121.16172335600908,21,19,336,1,333
5103,743,538,120.14004535147393,121.53324263038549,21,16,214,1,205
5104,743,426,120.14004535147393,122.76390022675737,21,15,337,3,317
5105,743,819,120.14004535147393,121.32426303854875,21,18,92,1,76
5106,743,640,120.14004535147393,121.78866213151927,21,14,125,2,103
5107,743,640,120.14004535147393,123.11219954648526,21,13,164,3,103
5108,743,820,120.14004535147393,121.32426303854875,21,14,92,1,77
5109,743,821,120.14004535147393,122.64780045351475,21,12,133,3,78
5110,819,426,121.32426303854875,122.76390022675737,18,15,398,1,393
5111,819,640,121.32426303854875,123.11219954648526,18,13,195,2,179
5112,819,821,121.32426303854875,122.64780045351475,18,12,57,1,2
5113,640,228,121.78866213151927,122.97287981859411,14,22,415,1,412
5114,640,226,121.78866213151927,123.57659863945578,14,23,421,2,414
5115,640,590,121.78866213151927,124.36607709750567,14,15,122,3,50
5116,640,425,121.78866213151927,124.71437641723357,14,19,249,3,215
5117,640,671,121.78866213151927,124.38929705215419,14,22,116,3,31
5118,640,823,121.78866213151927,124.38929705215419,14,18,215,3,183
5119,640,228,123.11219954648526,125.17877551020409,13,24,422,2,412
5120,640,590,123.11219954648526,124.36607709750567,13,15,74,1,50
5121,640,425,123.11219954648526,124.71437641723357,13,19,226,2,215
5122,640,422,123.11219954648526,125.5502947845805,13,17,242,2,218
5123,640,671,123.11219954648526,124.38929705215419,13,22,63,1,31
5124,640,664,123.11219954648526,125.4574149659864,13,18,104,2,24
5125,640,726,123.11219954648526,125.48063492063493,13,19,133,2,86
5126,640,823,123.11219954648526,124.38929705215419,13,18,191,1,183
5127,640,821,123.11219954648526,125.43419501133788,13,16,207,2,181
5128,640,823,123.11219954648526,125.48063492063493,13,14,210,2,183
5129,671,406,124.38929705215419,126.20045351473924,22,23,276,2,265
5130,671,422,124.38929705215419,125.5502947845805,22,17,254,1,249
5131,671,412,124.38929705215419,126.57197278911565,22,16,276,2,259
5132,671,664,124.38929705215419,125.4574149659864,22,18,47,1,7
5133,671,726,124.38929705215419,125.48063492063493,22,19,72,1,55
5134,671,615,124.38929705215419,126.64163265306122,22,13,112,2,56
5135,671,821,124.38929705215419,125.43419501133788,22,16,157,1,150
5136,671,823,124.38929705215419,125.48063492063493,22,14,159,1,152
5137,671,841,124.38929705215419,126.6184126984127,22,12,195,2,170
5138,664,218,125.4574149659864,127.47755102040817,18,21,454,2,446
5139,664,215,125.4574149659864,128.220589569161,18,27,465,3,449
5140,664,412,125.4574149659864,126.57197278911565,18,16,257,1,252
5141,664,599,125.4574149659864,128.05804988662132,18,20,129,3,65
5142,664,615,125.4574149659864,126.64163265306122,18,13,71,1,49
5143,664,641,125.4574149659864,128.4063492063492,18,16,129,3,23
5144,664,841,125.4574149659864,126.6184126984127,18,12,184,1,177
5145,664,896,125.4574149659864,127.94195011337868,18,11,255,2,232
5146,726,412,125.48063492063493,126.57197278911565,19,16,317,1,314
5147,726,599,125.48063492063493,128.05804988662132,19,20,169,3,127
5148,726,615,125.48063492063493,126.64163265306122,19,13,122,1,111
5149,726,641,125.48063492063493,128.4063492063492,19,16,152,3,85
5150,726,841,125.48063492063493,126.6184126984127,19,12,125,1,115
5151,726,896,125.48063492063493,127.94195011337868,19,11,200,2,170
5152,615,215,126.64163265306122,128.220589569161,13,27,406,2,400
5153,615,385,126.64163265306122,128.52244897959184,13,23,244,2,230
5154,615,599,126.64163265306122,128.05804988662132,13,20,63,1,16
5155,615,538,126.64163265306122,128.59210884353743,13,15,114,2,77
5156,615,641,126.64163265306122,128.4063492063492,13,16,80,2,26
5157,615,638,126.64163265306122,128.82430839002268,13,13,97,2,23
5158,615,896,126.64163265306122,127.94195011337868,13,11,287,1,281
5159,615,922,126.64163265306122,128.82430839002268,13,11,321,2,307
5160,641,228,128.4063492063492,129.75310657596373,16,24,417,1,413
5161,641,211,128.4063492063492,130.70512471655329,16,28,441,2,430
5162,641,574,128.4063492063492,130.24072562358276,16,17,104,2,67
5163,641,422,128.4063492063492,130.65868480725624,16,21,240,2,219
5164,641,631,128.4063492063492,129.7298866213152,16,14,58,1,10
5165,638,211,128.82430839002268,130.70512471655329,13,28,435,2,427
5166,638,230,128.82430839002268,131.79646258503402,13,30,428,3,408
5167,638,574,128.82430839002268,130.24072562358276,13,17,88,1,64
5168,638,422,128.82430839002268,130.65868480725624,13,21,230,2,216
5169,638,431,128.82430839002268,131.79646258503402,13,19,243,3,207
5170,638,641,128.82430839002268,131.49460317460318,13,13,115,3,3
5171,638,825,128.82430839002268,131.49460317460318,13,12,220,3,187
5172,631,230,129.7298866213152,131.79646258503402,14,30,411,2,401
5173,631,431,129.7298866213152,131.79646258503402,14,19,219,2,200
5174,631,641,129.7298866213152,131.49460317460318,14,13,77,2,10
5175,631,640,129.7298866213152,132.35374149659864,14,14,113,3,9
5176,631,825,129.7298866213152,131.49460317460318,14,12,208,2,194
5177,631,848,129.7298866213152,131.91256235827666,14,12,236,2,217
5178,641,214,131.49460317460318,132.81814058956917,13,33,431,1,427
5179,641,227,131.49460317460318,133.51473922902494,13,25,423,2,414
5180,641,419,131.49460317460318,133.44507936507938,13,15,237,2,222
5181,641,551,131.49460317460318,134.1881179138322,13,14,147,3,90
5182,641,632,131.49460317460318,133.23609977324264,13,14,76,2,9
5183,641,630,131.49460317460318,133.67727891156463,13,14,95,2,11
5184,641,826,131.49460317460318,133.25931972789115,13,10,200,2,185
5185,641,837,131.49460317460318,134.3738775510204,13,10,232,3,196
5186,640,227,132.35374149659864,133.51473922902494,14,25,416,1,413
5187,640,407,132.35374149659864,135.27945578231294,14,21,265,3,233
5188,640,419,132.35374149659864,133.44507936507938,14,15,226,1,221
5189,640,551,132.35374149659864,134.1881179138322,14,14,119,2,89
5190,640,604,132.35374149659864,135.2562358276644,14,17,130,3,36
5191,640,630,132.35374149659864,133.67727891156463,14,14,58,1,10
5192,640,626,132.35374149659864,135.32589569161,14,16,129,3,14
5193,640,837,132.35374149659864,134.3738775510204,14,10,215,2,197
5194,632,407,133.23609977324264,135.27945578231294,14,21,242,2,225
5195,632,214,133.23609977324264,135.58131519274377,14,23,430,2,418
5196,632,604,133.23609977324264,135.2562358276644,14,17,91,2,28
5197,632,515,133.23609977324264,135.67419501133787,14,18,157,2,117
5198,632,626,133.23609977324264,135.32589569161,14,16,90,2,6
5199,632,629,133.23609977324264,135.8831746031746,14,17,114,3,3
5200,632,837,133.23609977324264,134.3738775510204,14,10,211,1,205
5201,632,902,133.23609977324264,135.3491156462585,14,15,285,2,270
5202,630,407,133.67727891156463,135.27945578231294,14,21,233,2,223
5203,630,214,133.67727891156463,135.58131519274377,14,23,424,2,416
5204,630,604,133.67727891156463,135.2562358276644,14,17,73,2,26
5205,630,515,133.67727891156463,135.67419501133787,14,18,144,2,115
5206,630,626,133.67727891156463,135.32589569161,14,16,71,2,4
5207,630,629,133.67727891156463,135.8831746031746,14,17,95,2,1
5208,630,902,133.67727891156463,135.3491156462585,14,15,281,2,272
5209,630,905,133.67727891156463,136.3243537414966,14,10,298,3,275
5210,626,345,135.32589569161,137.0209523809524,16,24,290,2,281
5211,626,230,135.32589569161,137.60145124716553,16,26,408,2,396
5212,626,478,135.32589569161,136.78875283446712,16,19,161,1,148
5213,626,631,135.32589569161,137.0209523809524,16,16,73,2,5
5214,626,821,135.32589569161,136.78875283446712,16,12,205,1,195
5215,629,345,135.8831746031746,137.0209523809524,17,24,288,1,284
5216,629,230,135.8831746031746,137.60145124716553,17,26,406,2,399
5217,629,410,135.8831746031746,138.32126984126984,17,22,243,2,219
5218,629,631,135.8831746031746,137.0209523809524,17,16,49,1,2
5219,629,615,135.8831746031746,138.32126984126984,17,16,106,2,14
5220,629,658,135.8831746031746,138.55346938775511,17,17,119,3,29
5221,629,890,135.8831746031746,138.32126984126984,17,11,281,2,261
5222,629,826,135.8831746031746,138.55346938775511,17,13,228,3,197
5223,631,229,137.0209523809524,139.43582766439908,16,23,415,2,402
5224,631,410,137.0209523809524,138.32126984126984,16,22,228,1,221
5225,631,424,137.0209523809524,139.2500680272109,16,20,228,2,207
5226,631,615,137.0209523809524,138.32126984126984,16,16,58,1,16
5227,631,658,137.0209523809524,138.55346938775511,16,17,71,2,27
5228,631,890,137.0209523809524,138.32126984126984,16,11,265,1,259
5229,631,826,137.0209523809524,138.55346938775511,16,13,206,2,195
5230,615,229,138.32126984126984,139.43582766439908,16,23,389,1,386
5231,615,230,138.32126984126984,140.13242630385488,16,26,393,2,385
5232,615,300,138.32126984126984,140.99156462585034,16,23,335,3,315
5233,615,461,138.32126984126984,140.10920634920635,16,16,172,2,154
5234,615,428,138.32126984126984,141.17732426303854,16,14,224,3,187
5235,615,724,138.32126984126984,140.29496598639457,16,12,138,2,109
5236,615,690,138.32126984126984,141.17732426303854,16,14,144,3,75
5237,615,826,138.32126984126984,140.31818594104308,16,12,228,2,211
5238,615,905,138.32126984126984,141.17732426303854,16,12,315,3,290
5239,658,230,138.55346938775511,140.13242630385488,17,26,433,2,428
5240,658,300,138.55346938775511,140.99156462585034,17,23,373,2,358
5241,658,461,138.55346938775511,140.10920634920635,17,16,208,2,197
5242,658,428,138.55346938775511,141.17732426303854,17,14,256,3,230
5243,658,724,138.55346938775511,140.29496598639457,17,12,100,2,66
5244,658,690,138.55346938775511,141.17732426303854,17,14,117,3,32
5245,658,826,138.55346938775511,140.31818594104308,17,12,184,2,168
5246,658,905,138.55346938775511,141.17732426303854,17,12,272,3,247
5247,724,351,140.29496598639457,141.8274829931973,12,22,379,2,373
5248,724,465,140.29496598639457,141.8274829931973,12,15,267,2,259
5249,724,600,140.29496598639457,142.84916099773244,12,19,166,3,124
5250,724,720,140.29496598639457,141.64172335600907,12,12,58,1,4
5251,724,624,140.29496598639457,142.8259410430839,12,17,148,3,100
5252,724,924,140.29496598639457,142.40798185941043,12,13,220,2,200
5253,724,853,140.29496598639457,142.7562811791383,12,14,167,2,129
5254,690,205,141.17732426303854,143.19746031746033,14,17,493,2,485
5255,690,223,141.17732426303854,144.10303854875283,14,22,484,3,467
5256,690,600,141.17732426303854,142.84916099773244,14,19,115,2,90
5257,690,577,141.17732426303854,143.75473922902495,14,21,158,3,113
5258,690,624,141.17732426303854,142.8259410430839,14,17,97,2,66
5259,690,625,141.17732426303854,143.801179138322,14,19,130,3,65
5260,690,924,141.17732426303854,142.40798185941043,14,13,240,1,234
5261,690,853,141.17732426303854,142.7562811791383,14,14,177,2,163
5262,690,859,141.17732426303854,143.77795918367346,14,15,203,3,169
5263,720,223,141.64172335600907,144.10303854875283,12,22,508,2,497
5264,720,600,141.64172335600907,142.84916099773244,12,19,131,1,120
5265,720,577,141.64172335600907,143.75473922902495,12,21,169,2,143
5266,720,624,141.64172335600907,142.8259410430839,12,17,109,1,96
5267,720,625,141.64172335600907,143.801179138322,12,19,133,2,95
5268,720,853,141.64172335600907,142.7562811791383,12,14,141,1,133
5269,720,859,141.64172335600907,143.77795918367346,12,15,167,2,139
5270,624,223,142.8259410430839,144.10303854875283,17,22,405,1,401
5271,624,222,142.8259410430839,145.0550566893424,17,20,413,2,402
5272,624,582,142.8259410430839,144.7764172335601,17,17,94,2,42
5273,624,901,142.8259410430839,144.82285714285715,17,15,290,2,277
5274,625,222,143.801179138322,145.0550566893424,19,20,407,1,403
5275,625,211,143.801179138322,146.0302947845805,19,16,425,2,414
5276,625,573,143.801179138322,146.49469387755101,19,13,127,3,52
5277,625,624,143.801179138322,145.4033560090703,19,18,69,2,1
5278,625,631,143.801179138322,146.0302947845805,19,10,96,2,6
5279,625,627,143.801179138322,146.68045351473924,19,11,124,3,2
5280,625,901,143.801179138322,144.82285714285715,19,15,279,1,276
5281,625,937,143.801179138322,146.3785941043084,19,12,331,3,312
5282,624,205,145.4033560090703,147.42349206349206,18,22,428,2,419
5283,624,573,145.4033560090703,146.49469387755101,18,13,69,1,51
5284,624,428,145.4033560090703,147.49315192743765,18,15,216,2,196
5285,624,481,145.4033560090703,148.09687074829932,18,14,184,3,143
5286,624,627,145.4033560090703,146.68045351473924,18,11,55,1,3
5287,624,667,145.4033560090703,147.8878911564626,18,14,115,2,43
5288,624,933,145.4033560090703,148.12009070294786,18,16,330,3,309
5289,631,205,146.0302947845805,147.42349206349206,10,22,430,1,426
5290,631,224,146.0302947845805,148.5380498866213,10,26,421,3,407
5291,631,229,146.0302947845805,148.6077097505669,10,30,417,3,402
5292,631,428,146.0302947845805,147.49315192743765,10,15,213,1,203
5293,631,481,146.0302947845805,148.09687074829932,10,14,174,2,150
5294,631,549,146.0302947845805,148.65414965986395,10,17,140,3,82
5295,631,667,146.0302947845805,147.8878911564626,10,14,88,2,36
5296,631,933,146.0302947845805,148.12009070294786,10,16,315,2,302
5297,627,224,146.68045351473924,148.5380498866213,11,26,411,2,403
5298,627,229,146.68045351473924,148.6077097505669,11,30,407,2,398
5299,627,481,146.68045351473924,148.09687074829932,11,14,158,1,146
5300,627,549,146.68045351473924,148.65414965986395,11,17,115,2,78
5301,627,515,146.68045351473924,149.65260770975058,11,18,170,3,112
5302,627,667,146.68045351473924,147.8878911564626,11,14,66,1,40
5303,627,633,146.68045351473924,149.35074829931972,11,16,115,3,6
5304,627,933,146.68045351473924,148.12009070294786,11,16,312,1,306
5305,627,821,146.68045351473924,149.44362811791385,11,14,228,3,194
5306,667,252,147.8878911564626,150.02412698412698,14,19,425,2,415
5307,667,515,147.8878911564626,149.65260770975058,14,18,170,2,152
5308,667,633,147.8878911564626,149.35074829931972,14,16,72,1,34
5309,667,625,147.8878911564626,150.00090702947847,14,16,100,2,42
5310,667,821,147.8878911564626,149.44362811791385,14,14,168,2,154
5311,667,821,147.8878911564626,149.79192743764173,14,14,174,2,154
5312,633,205,149.35074829931972,150.90648526077098,16,24,433,2,428
5313,633,229,149.35074829931972,151.9049433106576,16,22,419,3,404
5314,633,472,149.35074829931972,151.11546485260772,16,14,178,2,161
5315,633,653,149.35074829931972,151.04580498866213,16,15,76,2,20
5316,633,676,149.35074829931972,151.76562358276644,16,16,113,2,43
5317,633,923,149.35074829931972,151.09224489795918,16,15,300,2,290
5318,633,922,149.35074829931972,151.76562358276644,16,11,307,2,289
5319,625,229,150.00090702947847,151.9049433106576,16,22,404,2,396
5320,625,336,150.00090702947847,152.69442176870749,16,28,311,3,289
5321,625,472,150.00090702947847,151.11546485260772,16,14,160,1,153
5322,625,483,150.00090702947847,152.41578231292516,16,14,176,2,142
5323,625,653,150.00090702947847,151.04580498866213,16,15,53,1,28
5324,625,676,150.00090702947847,151.76562358276644,16,16,92,2,51
5325,625,923,150.00090702947847,151.09224489795918,16,15,302,1,298
5326,625,922,150.00090702947847,151.76562358276644,16,11,307,2,297
5327,653,336,151.04580498866213,152.69442176870749,15,28,325,2,317
5328,653,351,151.04580498866213,153.99473922902496,15,26,328,3,302
5329,653,483,151.04580498866213,152.41578231292516,15,14,180,1,170
5330,653,544,151.04580498866213,153.04272108843537,15,17,139,2,109
5331,653,617,151.04580498866213,153.53034013605443,15,15,113,2,36
5332,653,941,151.04580498866213,153.53034013605443,15,12,307,2,288
5333,653,825,151.04580498866213,153.99473922902496,15,12,214,3,172
5334,676,351,151.76562358276644,153.99473922902496,16,26,339,2,325
5335,676,544,151.76562358276644,153.04272108843537,16,17,143,1,132
5336,676,541,151.76562358276644,154.18049886621316,16,14,170,2,135
5337,676,617,151.76562358276644,153.53034013605443,16,15,96,2,59
5338,676,719,151.76562358276644,154.55201814058958,16,18,127,3,43
5339,676,941,151.76562358276644,153.53034013605443,16,12,276,2,265
5340,676,825,151.76562358276644,153.99473922902496,16,12,177,2,149
5341,617,354,153.53034013605443,155.57369614512473,15,27,277,2,263
5342,617,250,153.53034013605443,155.73623582766442,15,26,379,2,367
5343,617,432,153.53034013605443,155.06285714285715,15,22,196,2,185
5344,617,461,153.53034013605443,156.06131519274376,15,19,190,3,156
5345,617,719,153.53034013605443,154.55201814058958,15,18,111,1,102
5346,617,720,153.53034013605443,154.85387755102042,15,21,118,1,103
5347,617,619,153.53034013605443,156.1774149659864,15,18,114,3,2
5348,617,902,153.53034013605443,155.43437641723355,15,16,297,2,285
5349,719,354,154.55201814058958,155.57369614512473,18,27,368,1,365
5350,719,250,154.55201814058958,155.73623582766442,18,26,472,1,469
5351,719,223,154.55201814058958,156.64181405895692,18,22,504,2,496
5352,719,461,154.55201814058958,156.06131519274376,18,19,266,2,258
5353,719,515,154.55201814058958,156.82757369614512,18,18,226,2,204
5354,719,619,154.55201814058958,156.1774149659864,18,18,122,2,100
5355,719,655,154.55201814058958,156.6185941043084,18,16,110,2,64
5356,719,902,154.55201814058958,156.5257142857143,18,16,202,2,183
5357,719,898,154.55201814058958,157.0597732426304,18,15,209,3,179
5358,720,223,154.85387755102042,156.64181405895692,21,22,503,2,497
5359,720,461,154.85387755102042,156.06131519274376,21,19,264,1,259
5360,720,515,154.85387755102042,156.82757369614512,21,18,222,2,205
5361,720,619,154.85387755102042,156.1774149659864,21,18,116,1,101
5362,720,655,154.85387755102042,156.6185941043084,21,16,100,2,65
5363,720,902,154.85387755102042,156.5257142857143,21,16,196,2,182
5364,720,898,154.85387755102042,157.0597732426304,21,15,202,2,178
5365,619,229,156.1774149659864,158.2439909297052,18,29,400,2,390
5366,619,427,156.1774149659864,158.0350113378685,18,20,208,2,192
5367,619,617,156.1774149659864,158.4065306122449,18,17,96,2,2
5368,619,681,156.1774149659864,158.82448979591837,18,15,130,3,62
5369,619,825,156.1774149659864,157.9653514739229,18,12,220,2,206
5370,619,845,156.1774149659864,158.82448979591837,18,12,253,3,226
5371,655,229,156.6185941043084,158.2439909297052,16,29,432,2,426
5372,655,299,156.6185941043084,159.54430839002268,16,24,378,3,356
5373,655,427,156.6185941043084,158.0350113378685,16,20,236,1,228
5374,655,483,156.6185941043084,159.4746485260771,16,18,211,3,172
5375,655,617,156.6185941043084,158.4065306122449,16,17,86,2,38
5376,655,681,156.6185941043084,158.82448979591837,16,15,98,2,26
5377,655,825,156.6185941043084,157.9653514739229,16,12,180,1,170
5378,655,845,156.6185941043084,158.82448979591837,16,12,212,2,190
5379,617,299,158.4065306122449,159.54430839002268,17,24,322,1,318
5380,617,208,158.4065306122449,160.58920634920636,17,30,420,2,409
5381,617,483,158.4065306122449,159.4746485260771,17,18,142,1,134
5382,617,411,158.4065306122449,160.61242630385487,17,25,227,2,206
5383,617,411,158.4065306122449,160.6356462585034,17,22,227,2,206
5384,617,739,158.4065306122449,159.63718820861678,17,18,133,1,122
5385,617,809,158.4065306122449,160.6356462585034,17,15,215,2,192
5386,617,895,158.4065306122449,159.66040816326532,17,16,283,1,278
5387,681,208,158.82448979591837,160.58920634920636,15,30,479,2,473
5388,681,299,158.82448979591837,161.58766439909297,15,24,400,3,382
5389,681,411,158.82448979591837,160.61242630385487,15,25,281,2,270
5390,681,411,158.82448979591837,160.6356462585034,15,22,281,2,270
5391,681,415,158.82448979591837,161.7037641723356,15,22,293,3,266
5392,681,809,158.82448979591837,160.6356462585034,15,15,150,2,128
5393,681,897,158.82448979591837,161.44834467120182,15,12,244,3,216
5394,739,299,159.63718820861678,161.58766439909297,18,24,448,2,440
5395,739,278,159.63718820861678,162.44680272108843,18,22,477,3,461
5396,739,415,159.63718820861678,161.7037641723356,18,22,336,2,324
5397,739,642,159.63718820861678,162.35392290249433,18,15,152,3,97
5398,739,897,159.63718820861678,161.44834467120182,18,12,176,2,158
5399,739,966,159.63718820861678,162.35392290249433,18,11,255,3,227
5400,809,415,160.6356462585034,161.7037641723356,15,22,397,1,394
5401,809,535,160.6356462585034,163.32916099773243,15,25,298,3,274
5402,809,642,160.6356462585034,162.35392290249433,15,15,183,2,167
5403,809,620,160.6356462585034,163.32916099773243,15,20,222,3,189
5404,809,966,160.6356462585034,162.35392290249433,15,11,174,2,157
5405,809,826,160.6356462585034,162.81832199546486,15,12,96,2,17
5406,642,244,162.35392290249433,163.49170068027212,15,31,401,1,398
5407,642,381,162.35392290249433,164.0954195011338,15,26,272,2,261
5408,642,419,162.35392290249433,164.11863945578233,15,24,236,2,223
5409,642,701,162.35392290249433,164.0954195011338,15,17,95,2,59
5410,642,933,162.35392290249433,164.11863945578233,15,13,301,2,291
5411,642,831,162.35392290249433,164.79201814058956,15,12,216,2,189
5412,620,240,163.32916099773243,165.34929705215418,20,24,390,2,380
5413,620,256,163.32916099773243,165.99945578231294,20,26,382,3,364
5414,620,569,163.32916099773243,165.46539682539682,20,17,105,2,51
5415,620,422,163.32916099773243,165.92979591836735,20,20,227,3,198
5416,620,633,163.32916099773243,165.5350566893424,20,15,96,2,13
5417,620,619,163.32916099773243,165.9762358276644,20,15,114,3,1
5418,620,831,163.32916099773243,164.79201814058956,20,12,220,1,211
5419,620,940,163.32916099773243,165.67437641723356,20,12,336,2,320
5420,701,240,164.0954195011338,165.34929705215418,17,24,464,1,461
5421,701,256,164.0954195011338,165.99945578231294,17,26,452,2,445
5422,701,569,164.0954195011338,165.46539682539682,17,17,145,1,132
5423,701,422,164.0954195011338,165.92979591836735,17,20,290,2,279
5424,701,423,164.0954195011338,167.06757369614513,17,22,306,3,278
5425,701,633,164.0954195011338,165.5350566893424,17,15,92,1,68
5426,701,619,164.0954195011338,165.9762358276644,17,15,115,2,82
5427,701,940,164.0954195011338,165.67437641723356,17,12,248,2,239
5428,633,210,165.5350566893424,167.5784126984127,15,34,432,2,423
5429,633,212,165.5350566893424,168.18213151927438,15,32,436,3,421
5430,633,423,165.5350566893424,167.06757369614513,15,22,220,2,210
5431,633,470,165.5350566893424,168.29823129251702,15,17,202,3,163
5432,633,818,165.5350566893424,167.20689342403628,15,17,199,2,185
5433,633,896,165.5350566893424,167.20689342403628,15,15,273,2,263
5434,619,210,165.9762358276644,167.5784126984127,15,34,415,2,409
5435,619,212,165.9762358276644,168.18213151927438,15,32,418,2,407
5436,619,218,165.9762358276644,168.7161904761905,15,25,418,3,401
5437,619,423,165.9762358276644,167.06757369614513,15,22,202,1,196
5438,619,470,165.9762358276644,168.29823129251702,15,17,179,2,149
5439,619,818,165.9762358276644,167.20689342403628,15,17,206,1,199
5440,619,819,165.9762358276644,168.53043083900226,15,16,228,3,200
5441,619,896,165.9762358276644,167.20689342403628,15,15,282,1,277
5442,619,820,165.9762358276644,168.53043083900226,15,15,229,3,201
5443,818,470,167.20689342403628,168.29823129251702,17,17,351,1,348
5444,818,580,167.20689342403628,169.13414965986394,17,19,252,2,238
5445,818,819,167.20689342403628,168.53043083900226,17,16,57,1,1
5446,818,691,167.20689342403628,169.59854875283446,17,25,164,2,127
5447,818,820,167.20689342403628,168.53043083900226,17,15,57,1,2
5448,818,829,167.20689342403628,169.5288888888889,17,18,101,2,11
5449,819,342,168.53043083900226,171.13106575963718,16,26,490,3,477
5450,819,515,168.53043083900226,170.20226757369616,16,20,312,2,304
5451,819,515,168.53043083900226,170.82920634920634,16,17,320,2,304
5452,819,691,168.53043083900226,169.59854875283446,16,25,136,1,128
5453,819,723,168.53043083900226,170.55056689342405,16,17,130,2,96
5454,819,924,168.53043083900226,170.36480725623582,16,15,131,2,105
5455,819,821,168.53043083900226,170.73632653061225,16,16,95,2,2
5456,691,342,169.59854875283446,171.13106575963718,25,26,355,2,349
5457,691,211,169.59854875283446,172.52426303854875,25,18,496,3,480
5458,691,515,169.59854875283446,170.82920634920634,25,17,184,1,176
5459,691,439,169.59854875283446,171.82766439909298,25,16,270,2,252
5460,691,819,169.59854875283446,170.73632653061225,25,18,137,1,128
5461,691,637,169.59854875283446,172.2920634920635,25,17,128,3,54
5462,691,821,169.59854875283446,170.73632653061225,25,16,139,1,130
5463,723,230,170.55056689342405,173.22086167800452,17,22,506,3,493
5464,723,439,170.55056689342405,171.82766439909298,17,16,289,1,284
5465,723,458,170.55056689342405,172.80290249433108,17,20,282,2,265
5466,723,637,170.55056689342405,172.2920634920635,17,17,114,2,86
5467,723,751,170.55056689342405,172.94222222222223,17,16,107,2,28
5468,723,968,170.55056689342405,172.94222222222223,17,11,266,2,245
5469,819,439,170.73632653061225,171.82766439909298,18,16,383,1,380
5470,819,458,170.73632653061225,172.80290249433108,18,20,372,2,361
5471,819,637,170.73632653061225,172.2920634920635,18,17,194,2,182
5472,819,751,170.73632653061225,172.94222222222223,18,16,117,2,68
5473,819,968,170.73632653061225,172.94222222222223,18,11,177,2,149
5474,637,228,172.2920634920635,174.56761904761905,17,23,421,2,409
5475,637,585,172.2920634920635,173.8013605442177,17,16,83,2,52
5476,637,737,172.2920634920635,173.8013605442177,17,20,119,2,100
5477,637,710,172.2920634920635,174.84625850340137,17,21,132,3,73
5478,637,840,172.2920634920635,173.75492063492064,17,15,213,1,203
5479,637,826,172.2920634920635,174.82303854875283,17,15,218,3,189
5480,751,252,172.94222222222223,175.61251700680273,16,24,512,3,499
5481,751,410,172.94222222222223,175.403537414966,16,19,357,2,341
5482,751,710,172.94222222222223,174.84625850340137,16,21,92,2,41
5483,751,826,172.94222222222223,174.82303854875283,16,15,110,2,75
5484,737,252,173.8013605442177,175.61251700680273,20,24,491,2,485
5485,737,410,173.8013605442177,175.403537414966,20,19,334,2,327
5486,737,410,173.8013605442177,175.96081632653062,20,19,340,2,327
5487,737,710,173.8013605442177,174.84625850340137,20,21,52,1,27
5488,737,666,173.8013605442177,176.0304761904762,20,14,119,2,71
5489,737,826,173.8013605442177,174.82303854875283,20,15,99,1,89
5490,737,892,173.8013605442177,176.4716553287982,20,11,193,3,155
5491,710,214,174.84625850340137,175.86793650793652,21,24,498,1,496
5492,710,219,174.84625850340137,176.88961451247167,21,23,499,2,491
5493,710,410,174.84625850340137,175.96081632653062,21,19,304,1,300
5494,710,507,174.84625850340137,177.67909297052154,21,17,237,3,203
5495,710,666,174.84625850340137,176.0304761904762,21,14,67,1,44
5496,710,650,174.84625850340137,176.91283446712018,21,15,107,2,60
5497,710,892,174.84625850340137,176.4716553287982,21,11,195,2,182
5498,710,826,174.84625850340137,177.79519274376418,21,11,172,3,116
5499,666,241,176.0304761904762,178.60789115646259,14,27,439,3,425
5500,666,507,176.0304761904762,177.67909297052154,14,17,174,2,159
5501,666,566,176.0304761904762,178.30603174603175,14,20,140,2,100
5502,666,621,176.0304761904762,178.3292517006803,14,18,109,2,45
5503,666,826,176.0304761904762,177.79519274376418,14,11,177,2,160
5504,650,241,176.91283446712018,178.60789115646259,15,27,415,2,409
5505,650,354,176.91283446712018,179.420589569161,15,28,315,3,296
5506,650,566,176.91283446712018,178.30603174603175,15,20,103,1,84
5507,650,575,176.91283446712018,179.5134693877551,15,17,135,3,75
5508,650,621,176.91283446712018,178.3292517006803,15,18,68,1,29
5509,650,656,176.91283446712018,179.55990929705214,15,16,114,3,6
5510,650,968,176.91283446712018,179.11873015873016,15,10,332,2,318
5511,621,354,178.3292517006803,179.420589569161,18,28,271,1,267
5512,621,211,178.3292517006803,180.1171882086168,18,31,417,2,410
5513,621,575,178.3292517006803,179.5134693877551,18,17,69,1,46
5514,621,422,178.3292517006803,180.07074829931972,18,21,213,2,199
5515,621,656,178.3292517006803,179.55990929705214,18,16,64,1,35
5516,621,685,178.3292517006803,180.44226757369614,18,13,111,2,64
5517,621,848,178.3292517006803,180.44226757369614,18,12,245,2,227
5518,621,902,178.3292517006803,181.25496598639455,18,14,308,3,281
5519,656,214,179.55990929705214,181.39428571428573,16,31,449,2,442
5520,656,209,179.55990929705214,182.29986394557824,16,31,462,3,447
5521,656,552,179.55990929705214,181.53360544217688,16,16,134,2,104
5522,656,524,179.55990929705214,182.41596371882088,16,16,180,3,132
5523,656,630,179.55990929705214,181.32462585034014,16,16,80,2,26
5524,656,649,179.55990929705214,182.20698412698414,16,15,114,3,7
5525,656,902,179.55990929705214,181.25496598639455,16,14,257,2,246
5526,656,878,179.55990929705214,182.0908843537415,16,14,247,3,222
5527,685,209,180.44226757369614,182.29986394557824,13,31,483,2,476
5528,685,227,180.44226757369614,182.9035827664399,13,27,470,2,458
5529,685,552,180.44226757369614,181.53360544217688,13,16,141,1,133
5530,685,524,180.44226757369614,182.41596371882088,13,16,182,2,161
5531,685,459,180.44226757369614,183.20544217687075,13,19,255,3,226
5532,685,649,180.44226757369614,182.20698412698414,13,15,84,2,36
5533,685,878,180.44226757369614,182.0908843537415,13,14,206,2,193
5534,630,227,181.32462585034014,182.9035827664399,16,27,409,2,403
5535,630,247,181.32462585034014,183.83238095238096,16,24,398,3,383
5536,630,524,181.32462585034014,182.41596371882088,16,16,116,1,106
5537,630,459,181.32462585034014,183.20544217687075,16,19,189,2,171
5538,630,515,181.32462585034014,184.29678004535148,16,19,172,3,115
5539,630,743,181.32462585034014,183.64662131519276,16,22,151,2,113
5540,630,672,181.32462585034014,183.71628117913832,16,21,111,2,42
5541,630,903,181.32462585034014,183.6930612244898,16,19,291,2,273
5542,630,860,181.32462585034014,183.71628117913832,16,17,252,2,230
5543,649,247,182.20698412698414,183.83238095238096,15,24,408,2,402
5544,649,515,182.20698412698414,184.29678004535148,15,19,161,2,134
5545,649,743,182.20698412698414,183.64662131519276,15,22,113,1,94
5546,649,672,182.20698412698414,183.71628117913832,15,21,69,2,23
5547,649,671,182.20698412698414,184.97015873015874,15,17,121,3,22
5548,649,903,182.20698412698414,183.6930612244898,15,19,262,1,254
5549,649,860,182.20698412698414,183.71628117913832,15,17,221,2,211
5550,649,932,182.20698412698414,184.83083900226757,15,15,305,3,283
5551,743,401,183.64662131519276,185.71319727891157,22,26,353,2,342
5552,743,458,183.64662131519276,185.71319727891157,22,20,299,2,285
5553,743,459,183.64662131519276,185.78285714285715,22,20,299,2,284
5554,743,671,183.64662131519276,184.97015873015874,22,17,92,1,72
5555,743,689,183.64662131519276,185.78285714285715,22,17,107,2,54
5556,743,932,183.64662131519276,184.83083900226757,22,15,196,1,189
5557,743,859,183.64662131519276,185.7364172335601,22,11,147,2,116
5558,672,401,183.71628117913832,185.71319727891157,21,26,284,2,271
5559,672,230,183.71628117913832,185.80607709750566,21,26,451,2,442
5560,672,458,183.71628117913832,185.71319727891157,21,20,231,2,214
5561,672,459,183.71628117913832,185.78285714285715,21,20,231,2,213
5562,672,671,183.71628117913832,184.97015873015874,21,17,54,1,1
5563,672,689,183.71628117913832,185.78285714285715,21,17,91,2,17
5564,672,932,183.71628117913832,184.83083900226757,21,15,264,1,260
5565,672,859,183.71628117913832,185.7364172335601,21,11,206,2,187
5566,671,228,184.97015873015874,187.5243537414966,17,24,456,3,443
5567,671,461,184.97015873015874,187.33859410430838,17,18,233,2,210
5568,671,633,184.97015873015874,187.36181405895692,17,18,110,2,38
5569,671,753,184.97015873015874,187.895873015873,17,21,150,3,82
5570,671,896,184.97015873015874,187.0831746031746,17,12,243,2,225
5571,671,847,184.97015873015874,187.895873015873,17,17,216,3,176
5572,689,228,185.78285714285715,187.5243537414966,17,24,467,2,461
5573,689,270,185.78285714285715,188.66213151927437,17,25,437,3,419
5574,689,461,185.78285714285715,187.33859410430838,17,18,238,2,228
5575,689,425,185.78285714285715,188.24417233560092,17,21,284,2,264
5576,689,633,185.78285714285715,187.36181405895692,17,18,88,2,56
5577,689,753,185.78285714285715,187.895873015873,17,21,111,2,64
5578,689,896,185.78285714285715,187.0831746031746,17,12,214,1,207
5579,689,847,185.78285714285715,187.895873015873,17,17,182,2,158
5580,633,270,187.36181405895692,188.66213151927437,18,25,367,1,363
5581,633,232,187.36181405895692,188.82467120181406,18,26,406,1,401
5582,633,247,187.36181405895692,189.98566893424038,18,24,402,3,386
5583,633,410,187.36181405895692,189.19619047619048,18,20,237,2,223
5584,633,617,187.36181405895692,189.14975056689343,18,20,79,2,16
5585,633,822,187.36181405895692,189.01043083900228,18,16,202,2,189
5586,753,410,187.895873015873,189.19619047619048,21,20,348,1,343
5587,753,470,187.895873015873,190.61260770975056,21,20,306,3,283
5588,753,617,187.895873015873,189.14975056689343,21,20,146,1,136
5589,753,814,187.895873015873,190.58938775510205,21,16,131,3,61
5590,753,822,187.895873015873,189.01043083900228,21,16,84,1,69
5591,753,821,187.895873015873,190.6358276643991,21,12,136,3,68
5592,617,246,189.14975056689343,191.7271655328798,20,28,387,3,371
5593,617,240,189.14975056689343,191.7968253968254,20,27,394,3,377
5594,617,470,189.14975056689343,190.61260770975056,20,20,160,1,147
5595,617,423,189.14975056689343,191.3556462585034,20,21,216,2,194
5596,617,425,189.14975056689343,191.7968253968254,20,20,223,3,192
5597,617,814,189.14975056689343,190.58938775510205,20,16,207,1,197
5598,617,641,189.14975056689343,191.03056689342404,20,15,84,2,24
5599,617,616,189.14975056689343,191.7736054421769,20,17,113,3,1
5600,617,821,189.14975056689343,190.6358276643991,20,12,214,1,204
5601,617,872,189.14975056689343,191.03056689342404,20,13,268,2,255
5602,617,856,189.14975056689343,191.91292517006804,20,13,267,3,239
5603,814,425,190.58938775510205,191.7968253968254,16,20,392,1,389
5604,814,616,190.58938775510205,191.7736054421769,16,17,204,1,198
5605,814,856,190.58938775510205,191.91292517006804,16,13,71,1,42
5606,814,969,190.58938775510205,193.23646258503402,16,11,192,3,155
5607,641,227,191.03056689342404,193.02748299319728,15,24,423,2,414
5608,641,600,191.03056689342404,193.7473015873016,15,17,124,3,41
5609,641,630,191.03056689342404,193.7473015873016,15,16,118,3,11
5610,641,969,191.03056689342404,193.23646258503402,15,11,341,2,328
5611,616,227,191.7736054421769,193.02748299319728,17,24,393,1,389
5612,616,212,191.7736054421769,194.18848072562358,17,32,417,2,404
5613,616,600,191.7736054421769,193.7473015873016,17,17,86,2,16
5614,616,453,191.7736054421769,194.4903401360544,17,17,201,3,163
5615,616,630,191.7736054421769,193.7473015873016,17,16,86,2,14
5616,616,633,191.7736054421769,194.44390022675736,17,14,116,3,17
5617,616,969,191.7736054421769,193.23646258503402,17,11,359,1,353
5618,616,850,191.7736054421769,194.44390022675736,17,11,261,3,234
5619,630,215,193.7473015873016,195.48879818594105,16,29,422,2,415
5620,630,209,193.7473015873016,196.4175963718821,16,30,436,3,421
5621,630,464,193.7473015873016,195.30303854875285,16,18,179,2,166
5622,630,417,193.7473015873016,195.95319727891157,16,20,233,2,213
5623,630,638,193.7473015873016,195.2798185941043,16,19,66,2,8
5624,630,859,193.7473015873016,195.442358276644,16,12,240,2,229
5625,630,895,193.7473015873016,195.92997732426304,16,11,281,2,265
5626,633,215,194.44390022675736,195.48879818594105,14,29,420,1,418
5627,633,209,194.44390022675736,196.4175963718821,14,30,432,2,424
5628,633,227,194.44390022675736,196.7891156462585,14,28,418,2,406
5629,633,417,194.44390022675736,195.95319727891157,14,20,226,2,216
5630,633,895,194.44390022675736,195.92997732426304,14,11,270,1,262
5631,633,835,194.44390022675736,197.36961451247166,14,17,238,3,202
5632,638,209,195.2798185941043,196.4175963718821,19,30,432,1,429
5633,638,227,195.2798185941043,196.7891156462585,19,28,416,2,411
5634,638,413,195.2798185941043,197.4857142857143,19,17,244,2,225
5635,638,633,195.2798185941043,196.76589569160998,19,16,64,1,5
5636,638,743,195.2798185941043,197.7643537414966,19,23,150,2,105
5637,638,743,195.2798185941043,197.78757369614513,19,22,151,3,105
5638,638,835,195.2798185941043,197.36961451247166,19,17,217,2,197
5639,638,902,195.2798185941043,197.81079365079364,19,18,286,3,264
5640,633,343,196.76589569160998,198.5538321995465,16,26,300,2,290
5641,633,228,196.76589569160998,198.85569160997733,16,26,415,2,405
5642,633,498,196.76589569160998,198.76281179138323,16,17,160,2,135
5643,633,496,196.76589569160998,198.97179138321997,16,19,167,2,137
5644,633,743,196.76589569160998,197.78757369614513,16,22,118,1,110
5645,633,902,196.76589569160998,197.81079365079364,16,18,273,1,269
5646,633,898,196.76589569160998,199.38975056689344,16,17,288,3,265
5647,743,496,197.7643537414966,198.97179138321997,23,19,252,1,247
5648,743,634,197.7643537414966,199.76126984126984,23,18,139,2,109
5649,743,802,197.7643537414966,199.83092970521542,23,17,107,2,59
5650,743,898,197.7643537414966,199.38975056689344,23,17,170,2,155
5651,743,823,197.7643537414966,200.73650793650793,23,15,151,3,80
5652,743,496,197.78757369614513,198.97179138321997,22,19,252,1,247
5653,743,492,197.78757369614513,200.75972789115647,22,20,282,3,251
5654,743,634,197.78757369614513,199.76126984126984,22,18,138,2,109
5655,743,802,197.78757369614513,199.83092970521542,22,17,106,2,59
5656,743,898,197.78757369614513,199.38975056689344,22,17,170,2,155
5657,743,823,197.78757369614513,200.73650793650793,22,15,150,3,80
5658,634,226,199.76126984126984,201.20090702947846,18,25,413,1,408
5659,634,227,199.76126984126984,202.33868480725624,18,27,422,3,407
5660,634,492,199.76126984126984,200.78294784580498,18,19,149,1,142
5661,634,474,199.76126984126984,202.73342403628118,18,17,205,3,160
5662,634,717,199.76126984126984,202.0368253968254,18,22,128,2,83
5663,634,862,199.76126984126984,201.5027664399093,18,13,240,2,228
5664,634,947,199.76126984126984,202.45478458049888,18,15,334,3,313
5665,802,474,199.83092970521542,202.73342403628118,17,17,351,3,328
5666,802,634,199.83092970521542,201.47954648526078,17,17,182,2,168
5667,802,717,199.83092970521542,202.0368253968254,17,22,127,2,85
5668,802,862,199.83092970521542,201.5027664399093,17,13,94,2,60
5669,802,947,199.83092970521542,202.45478458049888,17,15,184,3,145
5670,634,270,201.47954648526078,202.87274376417233,17,25,369,1,364
5671,634,474,201.47954648526078,202.73342403628118,17,17,169,1,160
5672,634,410,201.47954648526078,203.31392290249434,17,20,238,2,224
5673,634,429,201.47954648526078,204.12662131519275,17,18,235,3,205
5674,634,644,201.47954648526078,203.1281632653061,17,20,72,2,10
5675,634,856,201.47954648526078,203.1281632653061,17,15,233,2,222
5676,717,271,202.0368253968254,204.61424036281178,22,24,460,3,446
5677,717,410,202.0368253968254,203.31392290249434,22,20,312,1,307
5678,717,429,202.0368253968254,204.12662131519275,22,18,302,2,288
5679,717,644,202.0368253968254,203.1281632653061,22,20,87,1,73
5680,717,815,202.0368253968254,204.7071201814059,22,16,151,3,98
5681,717,738,202.0368253968254,204.8,22,15,121,3,21
5682,717,856,202.0368253968254,203.1281632653061,22,15,147,1,139
5683,717,876,202.0368253968254,204.7071201814059,22,13,196,3,159
5684,644,271,203.1281632653061,204.61424036281178,20,24,378,1,373
5685,644,342,203.1281632653061,205.70557823129252,20,26,322,3,302
5686,644,423,203.1281632653061,205.35727891156463,20,21,241,2,221
5687,644,414,203.1281632653061,205.84489795918367,20,19,258,3,230
5688,644,815,203.1281632653061,204.7071201814059,20,16,184,2,171
5689,644,738,203.1281632653061,204.8,20,15,118,2,94
5690,644,616,203.1281632653061,205.89133786848072,20,16,122,3,28
5691,644,876,203.1281632653061,204.7071201814059,20,13,242,2,232
5692,644,922,203.1281632653061,205.56625850340137,20,12,297,2,278
5693,644,832,203.1281632653061,205.8681179138322,20,13,222,3,188
5694,815,363,204.7071201814059,206.1467573696145,16,27,456,1,452
5695,815,414,204.7071201814059,205.84489795918367,16,19,404,1,401
5696,815,410,204.7071201814059,206.8433560090703,16,20,415,2,405
5697,815,616,204.7071201814059,205.89133786848072,16,16,205,1,199
5698,815,632,204.7071201814059,207.00589569161,16,15,208,2,183
5699,815,832,204.7071201814059,205.8681179138322,16,13,53,1,17
5700,738,363,204.8,206.1467573696145,15,27,379,1,375
5701,738,414,204.8,205.84489795918367,15,19,327,1,324
5702,738,410,204.8,206.8433560090703,15,20,340,2,328
5703,738,616,204.8,205.89133786848072,15,16,131,1,122
5704,738,632,204.8,207.00589569161,15,15,142,2,106
5705,738,832,204.8,205.8681179138322,15,13,105,1,94
5706,616,228,205.89133786848072,207.40063492063493,16,26,393,2,388
5707,616,211,205.89133786848072,208.3526530612245,16,33,419,2,405
5708,616,422,205.89133786848072,208.28299319727893,16,20,220,2,194
5709,616,632,205.89133786848072,207.00589569161,16,15,51,1,16
5710,616,631,205.89133786848072,208.67773242630386,16,18,121,3,15
5711,616,923,205.89133786848072,208.5384126984127,16,12,327,3,307
5712,632,211,207.00589569161,208.3526530612245,15,33,425,1,421
5713,632,229,207.00589569161,209.49043083900227,15,32,417,2,403
5714,632,422,207.00589569161,208.28299319727893,15,20,217,1,210
5715,632,428,207.00589569161,209.39755102040817,15,23,229,2,204
5716,632,631,207.00589569161,208.67773242630386,15,18,72,2,1
5717,632,634,207.00589569161,209.49043083900227,15,18,107,2,2
5718,632,923,207.00589569161,208.5384126984127,15,12,298,2,291
5719,632,863,207.00589569161,209.35111111111112,15,12,252,2,231
5720,631,214,208.67773242630386,210.44244897959183,18,33,424,2,417
5721,631,227,208.67773242630386,211.13904761904763,18,26,418,2,404
5722,631,572,208.67773242630386,210.32634920634922,18,19,92,2,59
5723,631,419,208.67773242630386,211.06938775510204,18,18,236,2,212
5724,631,663,208.67773242630386,210.44244897959183,18,16,82,2,32
5725,631,699,208.67773242630386,211.48734693877552,18,18,139,3,68
5726,631,866,208.67773242630386,210.74430839002267,18,11,251,2,235
5727,631,884,208.67773242630386,211.48734693877552,18,17,280,3,253
5728,634,227,209.49043083900227,211.13904761904763,18,26,413,2,407
5729,634,258,209.49043083900227,212.2768253968254,18,23,395,3,376
5730,634,419,209.49043083900227,211.06938775510204,18,18,225,2,215
5731,634,590,209.49043083900227,211.9285260770975,18,18,114,2,44
5732,634,699,209.49043083900227,211.48734693877552,18,18,108,2,65
5733,634,747,209.49043083900227,211.9285260770975,18,23,154,2,113
5734,634,866,209.49043083900227,210.74430839002267,18,11,238,1,232
5735,634,884,209.49043083900227,211.48734693877552,18,17,264,2,250
5736,634,827,209.49043083900227,211.905306122449,18,18,219,2,193
5737,663,258,210.44244897959183,212.2768253968254,16,23,413,2,405
5738,663,256,210.44244897959183,212.9037641723356,16,22,421,2,407
5739,663,590,210.44244897959183,211.9285260770975,16,18,97,1,73
5740,663,515,210.44244897959183,213.20562358276644,16,19,190,3,148
5741,663,699,210.44244897959183,211.48734693877552,16,18,58,1,36
5742,663,747,210.44244897959183,211.9285260770975,16,23,106,1,84
5743,663,626,210.44244897959183,212.95020408163265,16,17,114,3,37
5744,663,884,210.44244897959183,211.48734693877552,16,17,226,1,221
5745,663,827,210.44244897959183,211.905306122449,16,18,176,1,164
5746,663,864,210.44244897959183,213.01986394557824,16,14,230,3,201
5747,699,256,211.48734693877552,212.9037641723356,18,22,447,1,443
5748,699,222,211.48734693877552,214.11120181405897,18,13,490,3,477
5749,699,515,211.48734693877552,213.20562358276644,18,19,198,2,184
5750,699,515,211.48734693877552,213.8557823129252,18,12,210,2,184
5751,699,626,211.48734693877552,212.95020408163265,18,17,96,1,73
5752,699,864,211.48734693877552,213.01986394557824,18,14,178,2,165
5753,747,515,211.9285260770975,213.20562358276644,23,19,238,1,232
5754,747,515,211.9285260770975,213.8557823129252,23,12,246,2,232
5755,747,626,211.9285260770975,212.95020408163265,23,17,129,1,121
5756,747,864,211.9285260770975,213.01986394557824,23,14,126,1,117
5757,626,222,212.95020408163265,214.11120181405897,17,13,407,1,404
5758,626,298,212.95020408163265,215.3882993197279,17,12,344,2,328
5759,902,541,7.987664399092971,9.496961451247167,13,15,367,2,361
5760,902,538,7.987664399092971,10.379319727891156,13,14,378,2,364
5761,902,641,7.987664399092971,9.729160997732427,13,16,272,2,261
5762,902,642,7.987664399092971,10.170340136054422,13,14,276,2,260
5763,902,825,7.987664399092971,9.752380952380953,13,10,108,2,77
5764,902,931,7.987664399092971,10.286439909297052,13,13,103,2,29
5765,902,541,8.010884353741497,9.496961451247167,14,15,367,1,361
5766,902,538,8.010884353741497,10.379319727891156,14,14,378,2,364
5767,902,641,8.010884353741497,9.729160997732427,14,16,271,2,261
5768,902,642,8.010884353741497,10.170340136054422,14,14,276,2,260
5769,902,825,8.010884353741497,9.752380952380953,14,10,107,2,77
5770,902,931,8.010884353741497,10.286439909297052,14,13,102,2,29
5771,825,524,9.752380952380953,11.261678004535147,10,15,308,2,301
5772,825,638,9.752380952380953,11.49387755102041,10,14,201,2,187
5773,825,680,9.752380952380953,12.376235827664399,10,14,184,3,145
5774,825,896,9.752380952380953,11.935056689342403,10,11,118,2,71
5775,825,849,9.752380952380953,12.376235827664399,10,12,116,3,24
5776,931,524,10.286439909297052,13.02639455782313,13,16,424,3,407
5777,931,638,10.286439909297052,11.49387755102041,13,14,298,1,293
5778,931,680,10.286439909297052,12.376235827664399,13,14,267,2,251
5779,931,689,10.286439909297052,13.25859410430839,13,14,274,3,242
5780,931,896,10.286439909297052,11.935056689342403,13,11,79,2,35
5781,931,849,10.286439909297052,12.376235827664399,13,12,122,2,82
5782,896,524,11.935056689342403,13.02639455782313,11,16,375,1,372
5783,896,529,11.935056689342403,13.908752834467121,11,14,377,2,367
5784,896,524,11.935056689342403,14.791111111111112,11,15,392,3,372
5785,896,689,11.935056689342403,13.25859410430839,11,14,215,1,207
5786,896,641,11.935056689342403,14.582131519274377,11,14,279,3,255
5787,896,825,11.935056689342403,13.722993197278912,11,11,105,2,71
5788,849,529,12.376235827664399,13.908752834467121,12,14,327,2,320
5789,849,524,12.376235827664399,14.791111111111112,12,15,341,2,325
5790,849,641,12.376235827664399,14.582131519274377,12,14,229,2,208
5791,849,825,12.376235827664399,13.722993197278912,12,11,63,1,24
5792,849,905,12.376235827664399,15.023310657596372,12,13,127,3,56
5793,825,524,13.722993197278912,14.791111111111112,11,15,304,1,301
5794,825,425,13.722993197278912,15.603809523809524,11,13,408,2,400
5795,825,523,13.722993197278912,16.555827664399093,11,15,326,3,302
5796,825,641,13.722993197278912,15.464489795918368,11,15,199,2,184
5797,825,641,13.722993197278912,16.34684807256236,11,15,216,3,184
5798,825,905,13.722993197278912,15.023310657596372,11,13,98,1,80
5799,825,873,13.722993197278912,15.905668934240364,11,12,106,2,48
5800,825,847,13.722993197278912,16.34684807256236,11,11,115,3,22
5801,905,523,15.023310657596372,16.555827664399093,13,15,388,2,382
5802,905,424,15.023310657596372,17.34530612244898,13,13,491,2,481
5803,905,641,15.023310657596372,16.34684807256236,13,15,270,1,264
5804,905,640,15.023310657596372,17.670385487528346,13,14,288,3,265
5805,905,847,15.023310657596372,16.34684807256236,13,11,81,1,58
5806,905,841,15.023310657596372,17.22920634920635,13,11,115,2,64
5807,873,424,15.905668934240364,17.34530612244898,12,13,453,1,449
5808,873,524,15.905668934240364,18.320544217687075,12,16,364,2,349
5809,873,640,15.905668934240364,17.670385487528346,12,14,245,2,233
5810,873,841,15.905668934240364,17.22920634920635,12,11,65,1,32
5811,873,955,15.905668934240364,18.22766439909297,12,11,129,2,82
5812,847,524,16.34684807256236,18.320544217687075,11,16,334,2,323
5813,847,640,16.34684807256236,17.670385487528346,11,14,215,1,207
5814,847,641,16.34684807256236,18.993922902494333,11,15,235,3,206
5815,847,955,16.34684807256236,18.22766439909297,11,11,135,2,108
5816,847,956,16.34684807256236,19.11002267573696,11,14,161,3,109
5817,841,524,17.22920634920635,18.320544217687075,11,16,320,1,317
5818,841,473,17.22920634920635,19.99238095238095,11,15,387,3,368
5819,841,641,17.22920634920635,18.993922902494333,11,15,214,2,200
5820,841,641,17.22920634920635,19.87628117913832,11,14,230,3,200
5821,841,956,17.22920634920635,19.11002267573696,11,14,141,2,115
5822,955,473,18.22766439909297,19.99238095238095,11,15,488,2,482
5823,955,515,18.22766439909297,20.82829931972789,11,19,454,3,440
5824,955,641,18.22766439909297,19.87628117913832,11,14,322,2,314
5825,955,819,18.22766439909297,20.758639455782312,11,16,174,3,136
5826,955,902,18.22766439909297,20.66575963718821,11,15,118,2,53
5827,956,515,19.11002267573696,20.82829931972789,14,19,447,2,441
5828,956,515,19.11002267573696,21.339138321995467,14,14,451,2,441
5829,956,819,19.11002267573696,20.758639455782312,14,16,154,2,137
5830,956,902,19.11002267573696,20.66575963718821,14,15,86,2,54
5831,902,539,20.66575963718821,22.73233560090703,15,14,374,2,363
5832,902,659,20.66575963718821,22.639455782312925,15,18,257,2,243
5833,902,824,20.66575963718821,22.96453514739229,15,13,126,2,78
5834,902,954,20.66575963718821,23.405714285714286,15,11,129,3,52
5835,824,387,22.96453514739229,25.031111111111112,13,23,446,2,437
5836,824,410,22.96453514739229,25.031111111111112,13,15,423,2,414
5837,824,613,22.96453514739229,25.843809523809526,13,16,245,3,211
5838,824,641,22.96453514739229,24.729251700680273,13,14,198,2,183
5839,824,885,22.96453514739229,24.729251700680273,13,12,97,2,61
5840,954,613,23.405714285714286,25.843809523809526,11,16,357,2,341
5841,954,539,23.405714285714286,26.261768707482993,11,14,433,3,415
5842,954,641,23.405714285714286,24.729251700680273,11,14,318,1,313
5843,954,646,23.405714285714286,25.98312925170068,11,15,327,3,308
5844,954,885,23.405714285714286,24.729251700680273,11,12,89,1,69
5845,954,965,23.405714285714286,26.21532879818594,11,11,121,3,11
5846,885,613,24.729251700680273,25.843809523809526,12,16,276,1,272
5847,885,539,24.729251700680273,26.261768707482993,12,14,352,2,346
5848,885,646,24.729251700680273,25.98312925170068,12,15,245,1,239
5849,885,720,24.729251700680273,26.493968253968255,12,14,182,2,165
5850,885,662,24.729251700680273,27.376326530612246,12,18,250,3,223
5851,885,965,24.729251700680273,26.21532879818594,12,11,102,1,80
5852,885,923,24.729251700680273,27.376326530612246,12,11,120,3,38
5853,965,662,26.21532879818594,27.376326530612246,11,18,307,1,303
5854,965,640,26.21532879818594,28.258684807256238,11,14,337,2,325
5855,965,923,26.21532879818594,27.376326530612246,11,11,65,1,42
5856,923,625,27.376326530612246,30.02340136054422,11,15,319,3,298
5857,923,886,27.376326530612246,29.257142857142856,11,14,89,2,37
5858,886,566,29.257142857142856,31.068299319727892,14,19,329,2,320
5859,886,554,29.257142857142856,31.55591836734694,14,15,346,2,332
5860,886,656,29.257142857142856,30.464580498866212,14,14,236,1,230
5861,886,642,29.257142857142856,31.346938775510203,14,14,260,2,244
5862,886,826,29.257142857142856,30.928979591836736,14,11,94,2,60
5863,886,826,29.257142857142856,31.811337868480727,14,12,125,3,60
5864,826,538,30.928979591836736,32.949115646258505,11,14,301,2,288
5865,826,539,30.928979591836736,33.32063492063492,11,15,305,2,287
5866,826,665,30.928979591836736,32.670476190476194,11,15,178,2,161
5867,826,726,30.928979591836736,33.552834467120185,11,14,151,3,100
5868,826,538,31.811337868480727,32.949115646258505,12,14,292,1,288
5869,826,539,31.811337868480727,33.32063492063492,12,15,294,2,287
5870,826,569,31.811337868480727,34.481632653061226,12,22,282,3,257
5871,826,726,31.811337868480727,33.552834467120185,12,14,125,2,100
5872,826,618,31.811337868480727,34.17977324263039,12,14,232,2,208
5873,896,491,34.87637188208617,36.80362811791383,10,22,413,2,405
5874,896,454,34.87637188208617,37.221587301587306,10,19,453,2,442
5875,896,654,34.87637188208617,36.24634920634921,10,20,249,1,242
5876,896,680,34.87637188208617,37.17514739229025,10,16,238,2,216
5877,896,934,34.87637188208617,36.29278911564626,10,14,72,1,38
5878,826,383,35.75873015873016,38.638004535147395,10,24,460,3,443
5879,826,491,35.75873015873016,36.80362811791383,10,22,338,1,335
5880,826,454,35.75873015873016,37.221587301587306,10,19,377,1,372
5881,826,540,35.75873015873016,38.59156462585034,10,15,311,3,286
5882,826,680,35.75873015873016,37.17514739229025,10,16,158,1,146
5883,826,619,35.75873015873016,38.49868480725624,10,15,238,3,207
5884,826,849,35.75873015873016,37.964625850340134,10,13,98,2,23
5885,934,540,36.29278911564626,38.59156462585034,14,15,406,2,394
5886,934,545,36.29278911564626,39.14884353741497,14,14,408,3,389
5887,934,619,36.29278911564626,38.49868480725624,14,15,329,2,315
5888,934,849,36.29278911564626,37.964625850340134,14,13,111,2,85
5889,934,924,36.29278911564626,38.846984126984125,14,10,110,3,10
5890,849,545,37.964625850340134,39.14884353741497,13,14,308,1,304
5891,849,533,37.964625850340134,40.19374149659864,13,15,330,2,316
5892,849,716,37.964625850340134,39.288163265306125,13,13,145,1,133
5893,849,642,37.964625850340134,40.61170068027211,13,16,236,3,207
5894,924,533,38.846984126984125,40.19374149659864,10,15,395,1,391
5895,924,642,38.846984126984125,40.61170068027211,10,16,292,2,282
5896,827,537,41.88879818594104,42.98013605442177,14,17,294,1,290
5897,827,421,41.88879818594104,43.97859410430839,14,23,416,2,406
5898,827,641,41.88879818594104,43.69995464852608,14,18,202,2,186
5899,827,618,41.88879818594104,44.1643537414966,14,15,231,2,209
5900,827,855,41.88879818594104,43.67673469387755,14,12,82,2,28
5901,825,421,42.399637188208615,43.97859410430839,11,23,410,2,404
5902,825,520,42.399637188208615,45.023492063492064,11,14,325,3,305
5903,825,641,42.399637188208615,43.69995464852608,11,18,192,1,184
5904,825,618,42.399637188208615,44.1643537414966,11,15,221,2,207
5905,825,855,42.399637188208615,43.67673469387755,11,12,63,1,30
5906,825,873,42.399637188208615,45.023492063492064,11,11,123,3,48
5907,855,520,43.67673469387755,45.023492063492064,12,14,340,1,335
5908,855,542,43.67673469387755,45.67365079365079,12,13,325,2,313
5909,855,642,43.67673469387755,45.46467120181406,12,13,226,2,213
5910,855,873,43.67673469387755,45.023492063492064,12,11,61,1,18
5911,873,568,45.023492063492064,46.78820861678005,11,15,314,2,305
5912,873,625,45.023492063492064,46.78820861678005,11,14,259,2,248
5913,873,726,45.023492063492064,47.67056689342404,11,14,186,3,147
5914,873,825,45.023492063492064,47.25260770975057,11,10,107,2,48
5915,825,554,47.25260770975057,48.529705215419504,10,18,277,1,271
5916,825,515,47.25260770975057,50.08544217687075,10,17,333,3,310
5917,825,699,47.25260770975057,49.15664399092971,10,19,150,2,126
5918,825,743,47.25260770975057,49.55138321995465,10,25,129,2,82
5919,825,877,47.25260770975057,49.15664399092971,10,16,97,2,52
5920,825,910,47.25260770975057,49.621043083900226,10,17,133,2,85
5921,877,515,49.15664399092971,50.874920634920635,16,20,369,2,362
5922,877,578,49.15664399092971,51.432199546485265,16,14,315,2,299
5923,877,679,49.15664399092971,50.73560090702948,16,16,209,2,198
5924,877,618,49.15664399092971,52.082358276643994,16,16,288,3,259
5925,877,822,49.15664399092971,50.712380952380954,16,18,87,2,55
5926,877,906,49.15664399092971,52.082358276643994,16,12,129,3,29
5927,910,515,49.621043083900226,50.874920634920635,17,20,399,1,395
5928,910,578,49.621043083900226,51.432199546485265,17,14,341,2,332
5929,910,679,49.621043083900226,50.73560090702948,17,16,236,1,231
5930,910,618,49.621043083900226,52.082358276643994,17,16,311,2,292
5931,910,631,49.621043083900226,52.523537414965986,17,16,306,3,279
5932,910,822,49.621043083900226,50.712380952380954,17,18,100,1,88
5933,910,906,49.621043083900226,52.082358276643994,17,12,106,2,4
5934,822,519,50.712380952380954,52.964716553287985,18,15,318,2,303
5935,822,618,50.712380952380954,52.082358276643994,18,16,212,1,204
5936,822,631,50.712380952380954,52.523537414965986,18,16,206,2,191
5937,822,906,50.712380952380954,52.082358276643994,18,12,103,1,84
5938,822,967,50.712380952380954,52.964716553287985,18,13,174,2,145
5939,906,425,52.082358276643994,54.14893424036281,12,21,489,2,481
5940,906,410,52.082358276643994,54.984852607709755,12,17,512,3,496
5941,906,728,52.082358276643994,53.823854875283445,12,23,193,2,178
5942,906,709,52.082358276643994,54.868752834467124,12,20,231,3,197
5943,906,831,52.082358276643994,53.823854875283445,12,15,106,2,75
5944,906,832,52.082358276643994,54.89197278911565,12,12,142,3,74
5945,967,709,52.964716553287985,54.868752834467124,13,20,271,2,258
5946,967,729,52.964716553287985,55.28671201814059,13,17,258,2,238
5947,967,832,52.964716553287985,54.89197278911565,13,12,158,2,135
5948,967,885,52.964716553287985,55.263492063492066,13,14,129,2,82
5949,831,410,53.823854875283445,54.984852607709755,15,17,424,1,421
5950,831,410,53.823854875283445,55.98331065759637,15,18,431,2,421
5951,831,552,53.823854875283445,56.26195011337869,15,15,298,2,279
5952,831,709,53.823854875283445,54.868752834467124,15,20,130,1,122
5953,831,729,53.823854875283445,55.28671201814059,15,17,120,1,102
5954,831,675,53.823854875283445,56.47092970521542,15,14,193,3,156
5955,831,832,53.823854875283445,54.89197278911565,15,12,46,1,1
5956,831,885,53.823854875283445,55.263492063492066,15,14,82,1,54
5957,831,932,53.823854875283445,56.49414965986394,15,13,153,3,101
5958,832,410,54.89197278911565,55.98331065759637,12,18,425,1,422
5959,832,552,54.89197278911565,56.26195011337869,12,15,286,1,280
5960,832,569,54.89197278911565,57.5158276643991,12,17,286,3,263
5961,832,675,54.89197278911565,56.47092970521542,12,14,171,2,157
5962,832,655,54.89197278911565,57.817687074829934,12,15,217,3,177
5963,832,932,54.89197278911565,56.49414965986394,12,13,121,2,100
5964,832,825,54.89197278911565,57.399727891156466,12,11,108,3,7
5965,885,569,55.263492063492066,57.5158276643991,14,17,331,2,316
5966,885,675,55.263492063492066,56.47092970521542,14,14,216,1,210
5967,885,655,55.263492063492066,57.817687074829934,14,15,255,3,230
5968,885,932,55.263492063492066,56.49414965986394,14,13,71,1,47
5969,885,825,55.263492063492066,57.399727891156466,14,11,110,2,60
5970,932,569,56.49414965986394,57.5158276643991,13,17,366,1,363
5971,932,439,56.49414965986394,58.90902494331066,13,13,504,2,493
5972,932,655,56.49414965986394,57.817687074829934,13,15,283,1,277
5973,932,719,56.49414965986394,59.14122448979592,13,14,242,3,213
5974,932,825,56.49414965986394,58.28208616780046,13,12,132,2,107
5975,825,439,57.399727891156466,58.90902494331066,11,13,391,2,386
5976,825,602,57.399727891156466,59.60562358276644,11,20,242,2,223
5977,825,719,57.399727891156466,59.14122448979592,11,14,130,2,106
5978,825,617,57.399727891156466,59.582403628117916,11,17,228,2,208
5979,825,826,57.399727891156466,59.582403628117916,11,11,94,2,1
5980,825,602,58.28208616780046,59.60562358276644,12,20,230,1,223
5981,825,424,58.28208616780046,61.161360544217686,12,22,420,3,401
5982,825,430,58.28208616780046,61.23102040816327,12,20,415,3,395
5983,825,617,58.28208616780046,59.582403628117916,12,17,215,1,208
5984,825,720,58.28208616780046,60.9059410430839,12,14,154,3,105
5985,825,826,58.28208616780046,59.582403628117916,12,11,56,1,1
5986,825,826,58.28208616780046,60.46476190476191,12,11,94,2,1
5987,826,424,59.582403628117916,61.161360544217686,11,22,408,2,402
5988,826,430,59.582403628117916,61.23102040816327,11,20,402,2,396
5989,826,720,59.582403628117916,60.9059410430839,11,14,120,1,106
5990,826,627,59.582403628117916,61.602539682539685,11,16,217,2,199
5991,826,957,59.582403628117916,61.46321995464853,11,13,154,2,131
5992,826,596,60.46476190476191,63.22793650793651,11,16,259,3,230
5993,826,582,60.46476190476191,63.27437641723356,11,20,272,3,244
5994,826,627,60.46476190476191,61.602539682539685,11,16,205,1,199
5995,826,630,60.46476190476191,63.11183673469388,11,15,227,3,196
5996,826,922,60.46476190476191,62.67065759637188,11,11,135,2,96
5997,957,596,61.46321995464853,63.22793650793651,13,16,369,2,361
5998,957,582,61.46321995464853,63.27437641723356,13,20,383,2,375
5999,957,630,61.46321995464853,63.11183673469388,13,15,335,2,327
6000,957,743,61.46321995464853,63.669115646258504,13,22,234,2,214
6001,957,922,61.46321995464853,62.67065759637188,13,11,63,1,35
6002,957,829,61.46321995464853,63.669115646258504,13,19,159,2,128
6003,922,818,62.67065759637188,64.85333333333334,11,17,140,2,104
6004,922,640,62.67065759637188,65.31773242630386,11,16,304,3,282
6005,922,865,62.67065759637188,64.80689342403629,11,15,108,2,57
6006,829,411,63.669115646258504,64.69079365079365,19,20,420,1,418
6007,829,422,63.669115646258504,65.38739229024944,19,17,414,2,407
6008,829,430,63.669115646258504,66.26975056689342,19,15,414,3,399
6009,829,818,63.669115646258504,64.85333333333334,19,17,52,1,11
6010,829,640,63.669115646258504,65.31773242630386,19,16,202,2,189
6011,829,641,63.669115646258504,66.64126984126985,19,16,227,3,188
6012,829,865,63.669115646258504,64.80689342403629,19,15,61,1,36
6013,829,826,63.669115646258504,66.20009070294785,19,14,109,3,3
6014,829,869,63.669115646258504,66.64126984126985,19,11,134,3,40
6015,865,430,64.80689342403629,66.26975056689342,15,15,440,1,435
6016,865,641,64.80689342403629,66.64126984126985,15,16,238,2,224
6017,865,826,64.80689342403629,66.20009070294785,15,14,72,1,39
6018,865,869,64.80689342403629,66.64126984126985,15,11,79,2,4
6019,826,422,66.20009070294785,68.08090702947845,14,16,412,2,404
6020,826,595,66.20009070294785,69.0097052154195,14,18,261,3,231
6021,826,723,66.20009070294785,67.9415873015873,14,20,127,2,103
6022,826,733,66.20009070294785,69.03292517006803,14,21,153,3,93
6023,826,846,66.20009070294785,67.91836734693878,14,16,77,2,20
6024,826,839,66.20009070294785,69.03292517006803,14,14,123,3,13
6025,869,422,66.64126984126985,68.08090702947845,11,16,451,1,447
6026,869,595,66.64126984126985,69.0097052154195,11,18,292,2,274
6027,869,410,66.64126984126985,69.5437641723356,11,15,476,3,459
6028,869,723,66.64126984126985,67.9415873015873,11,20,156,1,146
6029,869,733,66.64126984126985,69.03292517006803,11,21,171,2,136
6030,869,698,66.64126984126985,69.40444444444445,11,15,208,3,171
6031,869,846,66.64126984126985,67.91836734693878,11,16,60,1,23
6032,869,839,66.64126984126985,69.03292517006803,11,14,107,2,30
6033,869,826,66.64126984126985,69.40444444444445,11,12,127,3,43
6034,846,595,67.91836734693878,69.0097052154195,16,18,255,1,251
6035,846,410,67.91836734693878,69.5437641723356,16,15,442,2,436
6036,846,520,67.91836734693878,70.6118820861678,16,14,346,3,326
6037,846,733,67.91836734693878,69.03292517006803,16,21,123,1,113
6038,846,698,67.91836734693878,69.40444444444445,16,15,161,1,148
6039,846,641,67.91836734693878,70.6118820861678,16,14,236,3,205
6040,846,839,67.91836734693878,69.03292517006803,16,14,49,1,7
6041,846,826,67.91836734693878,69.40444444444445,16,12,67,1,20
6042,839,342,69.03292517006803,71.61034013605442,14,27,509,3,497
6043,839,520,69.03292517006803,70.6118820861678,14,14,326,2,319
6044,839,599,69.03292517006803,71.5871201814059,14,18,264,3,240
6045,839,641,69.03292517006803,70.6118820861678,14,14,209,2,198
6046,839,641,69.03292517006803,71.9354195011338,14,16,234,3,198
6047,839,826,69.03292517006803,71.0530612244898,14,11,88,2,13
6048,839,826,69.03292517006803,71.4942403628118,14,13,107,2,13
6049,826,342,69.40444444444445,71.61034013605442,12,27,493,2,484
6050,826,520,69.40444444444445,70.6118820861678,12,14,310,1,306
6051,826,599,69.40444444444445,71.5871201814059,12,18,246,2,227
6052,826,641,69.40444444444445,70.6118820861678,12,14,192,1,185
6053,826,641,69.40444444444445,71.9354195011338,12,16,215,3,185
6054,826,640,69.40444444444445,72.37659863945578,12,14,226,3,186
6055,826,953,69.40444444444445,72.37659863945578,12,12,180,3,127
6056,826,569,71.0530612244898,72.49269841269842,11,15,264,1,257
6057,826,605,71.0530612244898,73.76979591836735,11,19,250,3,221
6058,826,640,71.0530612244898,72.37659863945578,11,14,195,1,186
6059,826,641,71.0530612244898,73.70013605442178,11,14,217,3,185
6060,826,953,71.0530612244898,72.37659863945578,11,12,139,1,127
6061,826,605,71.4942403628118,73.76979591836735,13,19,242,2,221
6062,826,641,71.4942403628118,73.70013605442178,13,14,208,2,185
6063,826,870,71.4942403628118,74.14131519274376,13,11,122,3,44
6064,953,605,72.37659863945578,73.76979591836735,12,19,353,1,348
6065,953,641,72.37659863945578,73.70013605442178,12,14,317,1,312
6066,953,720,72.37659863945578,74.58249433106576,12,13,252,2,233
6067,953,870,72.37659863945578,74.14131519274376,12,11,113,2,83
6068,953,826,72.37659863945578,74.58249433106576,12,10,159,2,127
6069,870,416,74.14131519274376,75.25587301587302,11,22,457,1,454
6070,870,423,74.14131519274376,75.27909297052155,11,23,450,1,447
6071,870,419,74.14131519274376,76.97414965986394,11,20,467,3,451
6072,870,640,74.14131519274376,75.90603174603174,11,16,242,2,230
6073,870,641,74.14131519274376,76.34721088435374,11,16,248,2,229
6074,870,826,74.14131519274376,75.90603174603174,11,12,88,2,44
6075,870,913,74.14131519274376,76.99736961451248,11,11,130,3,43
6076,826,419,74.58249433106576,76.97414965986394,10,20,420,2,407
6077,826,640,74.58249433106576,75.90603174603174,10,16,195,1,186
6078,826,641,74.58249433106576,76.34721088435374,10,16,200,2,185
6079,826,913,74.58249433106576,76.99736961451248,10,11,136,2,87
6080,826,408,75.90603174603174,78.25124716553289,12,20,430,2,418
6081,826,403,75.90603174603174,78.85496598639456,12,19,442,3,423
6082,826,419,75.90603174603174,76.97414965986394,12,20,410,1,407
6083,826,444,75.90603174603174,78.22802721088435,12,15,395,2,382
6084,826,515,75.90603174603174,78.57632653061225,12,17,332,3,311
6085,826,626,75.90603174603174,78.20480725623582,12,14,223,2,200
6086,826,819,75.90603174603174,78.32090702947846,12,14,104,2,7
6087,826,913,75.90603174603174,76.99736961451248,12,11,99,1,87
6088,826,923,75.90603174603174,78.25124716553289,12,13,140,2,97
6089,826,824,75.90603174603174,78.76208616780046,12,13,123,3,2
6090,913,444,76.99736961451248,78.22802721088435,11,15,472,1,469
6091,913,515,76.99736961451248,78.57632653061225,11,17,404,2,398
6092,913,626,76.99736961451248,78.20480725623582,11,14,292,1,287
6093,913,819,76.99736961451248,78.32090702947846,11,14,110,1,94
6094,913,923,76.99736961451248,78.25124716553289,11,13,55,1,10
6095,913,824,76.99736961451248,78.76208616780046,11,13,117,2,89
6096,923,589,78.25124716553289,80.17850340136054,13,14,344,2,334
6097,923,552,78.25124716553289,80.96798185941043,13,12,389,3,371
6098,923,717,78.25124716553289,80.15528344671202,13,15,222,2,206
6099,923,641,78.25124716553289,80.96798185941043,13,20,305,3,282
6100,824,589,78.76208616780046,80.17850340136054,13,14,243,1,235
6101,824,552,78.76208616780046,80.96798185941043,13,12,288,2,272
6102,824,717,78.76208616780046,80.15528344671202,13,15,123,1,107
6103,824,641,78.76208616780046,80.96798185941043,13,20,206,2,183
6104,843,554,82.87201814058957,85.14757369614513,11,17,305,2,289
6105,843,680,82.87201814058957,85.14757369614513,11,12,190,2,163
6106,896,424,86.02993197278911,87.81786848072562,15,15,478,2,472
6107,896,416,86.02993197278911,88.72344671201814,15,18,494,3,480
6108,896,640,86.02993197278911,87.37668934240364,15,16,262,1,256
6109,896,844,86.02993197278911,87.42312925170069,15,15,79,1,52
6110,869,424,86.58721088435374,87.81786848072562,12,15,448,1,445
6111,869,416,86.58721088435374,88.72344671201814,12,18,462,2,453
6112,869,720,86.58721088435374,89.1414058956916,12,17,185,3,149
6113,869,833,86.58721088435374,89.0485260770975,12,13,112,2,36
6114,844,416,87.42312925170069,88.72344671201814,15,18,432,1,428
6115,844,413,87.42312925170069,89.65224489795918,15,18,442,2,431
6116,844,720,87.42312925170069,89.1414058956916,15,17,144,2,124
6117,844,630,87.42312925170069,89.5825850340136,15,14,233,2,214
6118,844,833,87.42312925170069,89.0485260770975,15,13,71,2,11
6119,844,932,87.42312925170069,90.00054421768708,15,11,142,3,88
6120,833,546,89.0485260770975,90.4649433106576,13,14,293,1,287
6121,833,617,89.0485260770975,90.4649433106576,13,14,224,1,216
6122,833,641,89.0485260770975,91.34730158730159,13,15,216,2,192
6123,833,932,89.0485260770975,90.88290249433106,13,14,127,2,99
6124,833,922,89.0485260770975,91.95102040816327,13,13,153,3,89
6125,932,571,90.00054421768708,92.22965986394559,11,15,374,2,361
6126,932,641,90.00054421768708,91.34730158730159,11,15,297,1,291
6127,932,665,90.00054421768708,92.67083900226757,11,16,291,3,267
6128,932,922,90.00054421768708,91.95102040816327,11,13,85,2,10
6129,932,923,90.00054421768708,92.97269841269842,11,14,128,3,9
6130,932,571,90.88290249433106,92.22965986394559,14,15,366,1,361
6131,932,539,90.88290249433106,93.71573696145126,14,18,412,3,393
6132,932,665,90.88290249433106,92.67083900226757,14,16,278,2,267
6133,932,641,90.88290249433106,93.52997732426304,14,15,313,3,291
6134,932,922,90.88290249433106,91.95102040816327,14,13,47,1,10
6135,932,923,90.88290249433106,92.97269841269842,14,14,90,2,9
6136,932,889,90.88290249433106,93.64607709750567,14,15,127,3,43
6137,922,539,91.95102040816327,93.71573696145126,13,18,390,2,383
6138,922,573,91.95102040816327,94.52843537414967,13,18,366,3,349
6139,922,641,91.95102040816327,93.52997732426304,13,15,289,2,281
6140,922,634,91.95102040816327,94.43555555555555,13,13,307,2,288
6141,922,923,91.95102040816327,92.97269841269842,13,14,44,1,1
6142,922,889,91.95102040816327,93.64607709750567,13,15,80,2,33
6143,922,921,91.95102040816327,94.41233560090703,13,11,106,2,1
6144,923,573,92.97269841269842,94.52843537414967,14,18,356,2,350
6145,923,634,92.97269841269842,94.43555555555555,14,13,296,1,289
6146,923,921,92.97269841269842,94.41233560090703,14,11,62,1,2
6147,889,562,93.64607709750567,96.36281179138322,15,25,347,3,327
6148,889,561,93.64607709750567,96.38603174603175,15,23,349,3,328
6149,889,766,93.64607709750567,96.29315192743765,15,20,168,3,123
6150,889,886,93.64607709750567,96.29315192743765,15,17,114,3,3
6151,921,562,94.41233560090703,96.36281179138322,11,25,369,2,359
6152,921,561,94.41233560090703,96.38603174603175,11,23,370,2,360
6153,921,766,94.41233560090703,96.29315192743765,11,20,175,2,155
6154,921,633,94.41233560090703,97.12907029478458,11,19,311,3,288
6155,921,886,94.41233560090703,96.29315192743765,11,17,88,2,35
6156,921,899,94.41233560090703,97.17551020408163,11,12,121,3,22
6157,886,609,96.29315192743765,97.61668934240363,17,21,283,1,277
6158,886,433,96.29315192743765,98.63836734693878,17,17,464,2,453
6159,886,668,96.29315192743765,97.6863492063492,17,17,226,1,218
6160,886,637,96.29315192743765,98.91700680272109,17,17,273,3,249
6161,886,828,96.29315192743765,97.70956916099773,17,13,84,1,58
6162,886,957,96.29315192743765,98.94022675736962,17,13,134,3,71
6163,899,433,97.17551020408163,98.63836734693878,12,17,470,1,466
6164,899,555,97.17551020408163,100.0780045351474,12,23,366,3,344
6165,899,637,97.17551020408163,98.91700680272109,12,17,273,2,262
6166,899,641,97.17551020408163,100.14766439909297,12,17,288,3,258
6167,899,957,97.17551020408163,98.94022675736962,12,13,96,2,58
6168,899,882,97.17551020408163,100.10122448979592,12,14,127,3,17
6169,828,555,97.70956916099773,100.0780045351474,13,23,291,2,273
6170,828,585,97.70956916099773,100.47274376417234,13,18,271,3,243
6171,828,637,97.70956916099773,98.91700680272109,13,17,198,1,191
6172,828,641,97.70956916099773,100.14766439909297,13,17,214,2,187
6173,828,623,97.70956916099773,100.40308390022676,13,17,236,3,205
6174,828,957,97.70956916099773,98.94022675736962,13,13,139,1,129
6175,828,882,97.70956916099773,100.10122448979592,13,14,116,2,54
6176,828,899,97.70956916099773,100.47274376417234,13,15,139,3,71
6177,957,555,98.94022675736962,100.0780045351474,13,23,405,1,402
6178,957,585,98.94022675736962,100.47274376417234,13,18,378,2,372
6179,957,596,98.94022675736962,101.65696145124717,13,16,379,3,361
6180,957,641,98.94022675736962,100.14766439909297,13,17,320,1,316
6181,957,623,98.94022675736962,100.40308390022676,13,17,340,1,334
6182,957,622,98.94022675736962,101.56408163265306,13,18,354,3,335
6183,957,882,98.94022675736962,100.10122448979592,13,14,90,1,75
6184,957,899,98.94022675736962,100.47274376417234,13,15,88,2,58
6185,957,952,98.94022675736962,101.47120181405896,13,12,109,3,5
6186,882,596,100.10122448979592,101.65696145124717,14,16,294,2,286
6187,882,622,100.10122448979592,101.56408163265306,14,18,268,1,260
6188,882,952,100.10122448979592,101.47120181405896,14,12,92,1,70
6189,882,847,100.10122448979592,102.79473922902494,14,11,121,3,35
6190,899,596,100.47274376417234,101.65696145124717,15,16,307,1,303
6191,899,584,100.47274376417234,103.25913832199547,15,16,337,3,315
6192,899,622,100.47274376417234,101.56408163265306,15,18,281,1,277
6193,899,643,100.47274376417234,103.23591836734694,15,13,282,3,256
6194,899,847,100.47274376417234,102.79473922902494,15,11,113,2,52
6195,952,584,101.47120181405896,103.25913832199547,12,16,376,2,368
6196,952,643,101.47120181405896,103.23591836734694,12,13,318,2,309
6197,952,650,101.47120181405896,103.79319727891156,12,13,318,2,302
6198,952,847,101.47120181405896,102.79473922902494,12,11,119,1,105
6199,952,896,101.47120181405896,104.11827664399094,12,12,127,3,56
6200,847,375,102.79473922902494,104.69877551020409,11,27,479,2,472
6201,847,410,102.79473922902494,104.79165532879819,11,21,445,2,437
6202,847,683,102.79473922902494,105.00063492063492,11,15,190,2,164
6203,847,896,102.79473922902494,104.11827664399094,11,12,75,1,49
6204,847,944,102.79473922902494,105.00063492063492,11,11,136,2,97
6205,896,530,104.11827664399094,106.09197278911564,12,19,376,2,366
6206,896,461,104.11827664399094,106.64925170068028,12,19,448,3,435
6207,896,743,104.11827664399094,106.02231292517007,12,24,174,2,153
6208,896,885,104.11827664399094,106.06875283446712,12,17,85,2,11
6209,944,530,105.00063492063492,106.09197278911564,11,19,417,1,414
6210,944,461,105.00063492063492,106.64925170068028,11,19,488,2,483
6211,944,538,105.00063492063492,107.43873015873017,11,16,419,2,406
6212,944,743,105.00063492063492,106.02231292517007,11,24,206,1,201
6213,944,647,105.00063492063492,107.16009070294785,11,18,311,2,297
6214,944,885,105.00063492063492,106.06875283446712,11,17,75,1,59
6215,944,924,105.00063492063492,107.11365079365079,11,14,93,2,20
6216,944,873,105.00063492063492,107.64770975056689,11,11,134,3,71
6217,885,538,106.06875283446712,107.43873015873017,17,16,352,1,347
6218,885,558,106.06875283446712,108.99446712018141,17,16,350,3,327
6219,885,647,106.06875283446712,107.16009070294785,17,18,243,1,238
6220,885,718,106.06875283446712,108.08888888888889,17,15,188,2,167
6221,885,625,106.06875283446712,108.99446712018141,17,14,289,3,260
6222,885,924,106.06875283446712,107.11365079365079,17,14,60,1,39
6223,885,873,106.06875283446712,107.64770975056689,17,11,69,2,12
6224,924,558,107.11365079365079,108.99446712018141,14,16,375,2,366
6225,924,465,107.11365079365079,110.06258503401361,14,14,476,3,459
6226,924,625,107.11365079365079,108.99446712018141,14,14,310,2,299
6227,924,921,107.11365079365079,109.41242630385487,14,12,99,2,3
6228,873,558,107.64770975056689,108.99446712018141,11,16,320,1,315
6229,873,465,107.64770975056689,110.06258503401361,11,14,421,2,408
6230,873,425,107.64770975056689,110.5966439909297,11,19,466,3,448
6231,873,625,107.64770975056689,108.99446712018141,11,14,255,1,248
6232,873,743,107.64770975056689,110.27156462585035,11,20,172,3,130
6233,873,921,107.64770975056689,109.41242630385487,11,12,90,2,48
6234,873,836,107.64770975056689,110.27156462585035,11,15,119,3,37
6235,921,425,109.41242630385487,110.5966439909297,12,19,499,1,496
6236,921,717,109.41242630385487,111.33968253968254,12,22,220,2,204
6237,921,789,109.41242630385487,111.73442176870749,12,16,166,2,132
6238,921,823,109.41242630385487,111.33968253968254,12,17,128,2,98
6239,921,829,109.41242630385487,111.73442176870749,12,13,136,2,92
6240,836,405,110.27156462585035,112.36136054421769,15,26,440,2,431
6241,836,410,110.27156462585035,112.40780045351474,15,19,436,2,426
6242,836,410,110.27156462585035,112.43102040816326,15,19,436,2,426
6243,836,717,110.27156462585035,111.33968253968254,15,22,128,1,119
6244,836,789,110.27156462585035,111.73442176870749,15,16,79,1,47
6245,836,641,110.27156462585035,112.52390022675738,15,16,218,2,195
6246,836,823,110.27156462585035,111.33968253968254,15,17,48,1,13
6247,836,829,110.27156462585035,111.73442176870749,15,13,63,1,7
6248,823,405,111.33968253968254,112.36136054421769,17,26,420,1,418
6249,823,410,111.33968253968254,112.40780045351474,17,19,416,1,413
6250,823,410,111.33968253968254,112.43102040816326,17,19,416,1,413
6251,823,564,111.33968253968254,113.91709750566893,17,18,282,3,259
6252,823,641,111.33968253968254,112.52390022675738,17,16,189,1,182
6253,823,745,111.33968253968254,114.28861678004536,17,14,149,3,78
6254,823,921,111.33968253968254,113.82421768707484,17,10,145,2,98
6255,829,564,111.73442176870749,113.91709750566893,13,18,281,2,265
6256,829,537,111.73442176870749,114.47437641723356,13,14,315,3,292
6257,829,745,111.73442176870749,114.28861678004536,13,14,138,3,84
6258,829,921,111.73442176870749,113.82421768707484,13,10,129,2,92
6259,921,602,113.82421768707484,116.05333333333334,10,19,333,2,319
6260,921,720,113.82421768707484,115.17097505668934,10,12,209,1,201
6261,921,633,113.82421768707484,116.05333333333334,10,16,304,2,288
6262,921,690,113.82421768707484,116.49451247165533,10,14,258,3,231
6263,825,363,114.72979591836734,116.26231292517006,10,21,467,2,462
6264,825,602,114.72979591836734,116.05333333333334,10,19,230,1,223
6265,825,539,114.72979591836734,117.37687074829932,10,17,308,3,286
6266,825,423,114.72979591836734,117.63229024943311,10,23,421,3,402
6267,825,633,114.72979591836734,116.05333333333334,10,16,200,1,192
6268,825,690,114.72979591836734,116.49451247165533,10,14,155,2,135
6269,848,551,117.79482993197279,118.88616780045352,11,14,301,1,297
6270,848,542,117.79482993197279,119.74530612244898,11,18,317,2,306
6271,848,633,117.79482993197279,118.90938775510205,11,13,220,1,215
6272,848,743,117.79482993197279,120.14004535147393,11,21,146,2,105
6273,848,826,117.79482993197279,119.14158730158731,11,10,62,1,22
6274,848,846,117.79482993197279,120.14004535147393,11,16,101,2,2
6275,826,410,119.14158730158731,121.16172335600908,10,19,425,2,416
6276,826,538,119.14158730158731,121.53324263038549,10,16,306,2,288
6277,826,819,119.14158730158731,121.32426303854875,10,18,94,2,7
6278,826,640,119.14158730158731,121.78866213151927,10,14,218,3,186
6279,826,820,119.14158730158731,121.32426303854875,10,14,94,2,6
6280,846,410,120.14004535147393,121.16172335600908,16,19,438,1,436
6281,846,538,120.14004535147393,121.53324263038549,16,16,314,1,308
6282,846,426,120.14004535147393,122.76390022675737,16,15,435,3,420
6283,846,819,120.14004535147393,121.32426303854875,16,18,58,1,27
6284,846,640,120.14004535147393,121.78866213151927,16,14,218,2,206
6285,846,640,120.14004535147393,123.11219954648526,16,13,243,3,206
6286,846,820,120.14004535147393,121.32426303854875,16,14,57,1,26
6287,846,821,120.14004535147393,122.64780045351475,16,12,111,3,25
6288,820,426,121.32426303854875,122.76390022675737,14,15,399,1,394
6289,820,640,121.32426303854875,123.11219954648526,14,13,196,2,180
6290,820,821,121.32426303854875,122.64780045351475,14,12,57,1,1
6291,821,590,122.64780045351475,124.36607709750567,12,15,243,2,231
6292,821,425,122.64780045351475,124.71437641723357,12,19,406,2,396
6293,821,422,122.64780045351475,125.5502947845805,12,17,418,3,399
6294,821,671,122.64780045351475,124.38929705215419,12,22,168,2,150
6295,821,664,122.64780045351475,125.4574149659864,12,18,198,3,157
6296,821,726,122.64780045351475,125.48063492063493,12,19,155,3,95
6297,821,823,122.64780045351475,124.38929705215419,12,18,75,2,2
6298,821,823,122.64780045351475,125.48063492063493,12,14,122,3,2
6299,823,406,124.38929705215419,126.20045351473924,18,23,424,2,417
6300,823,422,124.38929705215419,125.5502947845805,18,17,404,1,401
6301,823,412,124.38929705215419,126.57197278911565,18,16,422,2,411
6302,823,664,124.38929705215419,125.4574149659864,18,18,166,1,159
6303,823,726,124.38929705215419,125.48063492063493,18,19,108,1,97
6304,823,615,124.38929705215419,126.64163265306122,18,13,230,2,208
6305,823,821,124.38929705215419,125.43419501133788,18,16,45,1,2
6306,823,841,124.38929705215419,126.6184126984127,18,12,98,2,18
6307,821,412,125.43419501133788,126.57197278911565,16,16,412,1,409
6308,821,599,125.43419501133788,128.05804988662132,16,20,249,3,222
6309,821,615,125.43419501133788,126.64163265306122,16,13,212,1,206
6310,821,641,125.43419501133788,128.4063492063492,16,16,221,3,180
6311,821,841,125.43419501133788,126.6184126984127,16,12,55,1,20
6312,821,896,125.43419501133788,127.94195011337868,16,11,131,3,75
6313,823,412,125.48063492063493,126.57197278911565,14,16,414,1,411
6314,823,599,125.48063492063493,128.05804988662132,14,20,250,3,224
6315,823,615,125.48063492063493,126.64163265306122,14,13,214,1,208
6316,823,641,125.48063492063493,128.4063492063492,14,16,221,3,182
6317,823,841,125.48063492063493,126.6184126984127,14,12,52,1,18
6318,823,896,125.48063492063493,127.94195011337868,14,11,129,2,73
6319,841,385,126.6184126984127,128.52244897959184,12,23,463,2,456
6320,841,599,126.6184126984127,128.05804988662132,12,20,250,1,242
6321,841,538,126.6184126984127,128.59210884353743,12,15,315,2,303
6322,841,641,126.6184126984127,128.4063492063492,12,16,214,2,200
6323,841,638,126.6184126984127,128.82430839002268,12,13,224,2,203
6324,841,896,126.6184126984127,127.94195011337868,12,11,79,1,55
6325,841,922,126.6184126984127,128.82430839002268,12,11,125,2,81
6326,896,574,127.94195011337868,130.24072562358276,11,17,337,2,322
6327,896,422,127.94195011337868,130.65868480725624,11,21,488,3,474
6328,896,631,127.94195011337868,129.7298866213152,11,14,276,2,265
6329,922,574,128.82430839002268,130.24072562358276,11,17,353,1,348
6330,922,431,128.82430839002268,131.79646258503402,11,19,507,3,491
6331,922,641,128.82430839002268,131.49460317460318,11,13,304,3,281
6332,922,825,128.82430839002268,131.49460317460318,11,12,150,3,97
6333,825,419,131.49460317460318,133.44507936507938,12,15,415,2,406
6334,825,551,131.49460317460318,134.1881179138322,12,14,298,3,274
6335,825,632,131.49460317460318,133.23609977324264,12,14,207,2,193
6336,825,630,131.49460317460318,133.67727891156463,12,14,216,2,195
6337,825,826,131.49460317460318,133.25931972789115,12,10,76,2,1
6338,825,837,131.49460317460318,134.3738775510204,12,10,125,3,12
6339,848,419,131.91256235827666,133.44507936507938,12,15,434,2,429
6340,848,551,131.91256235827666,134.1881179138322,12,14,313,2,297
6341,848,632,131.91256235827666,133.23609977324264,12,14,223,1,216
6342,848,630,131.91256235827666,133.67727891156463,12,14,231,2,218
6343,848,826,131.91256235827666,133.25931972789115,12,10,62,1,22
6344,848,837,131.91256235827666,134.3738775510204,12,10,107,2,11
6345,826,407,133.25931972789115,135.27945578231294,10,21,428,2,419
6346,826,604,133.25931972789115,135.2562358276644,10,17,238,2,222
6347,826,515,133.25931972789115,135.67419501133787,10,18,328,2,311
6348,826,626,133.25931972789115,135.32589569161,10,16,219,2,200
6349,826,629,133.25931972789115,135.8831746031746,10,17,227,3,197
6350,826,837,133.25931972789115,134.3738775510204,10,10,49,1,11
6351,826,902,133.25931972789115,135.3491156462585,10,15,118,2,76
6352,837,345,134.3738775510204,137.0209523809524,10,24,505,3,492
6353,837,515,134.3738775510204,135.67419501133787,10,18,327,1,322
6354,837,478,134.3738775510204,136.78875283446712,10,19,374,2,359
6355,837,629,134.3738775510204,135.8831746031746,10,17,218,2,208
6356,837,631,134.3738775510204,137.0209523809524,10,16,235,3,206
6357,837,905,134.3738775510204,136.3243537414966,10,10,108,2,68
6358,837,821,134.3738775510204,136.78875283446712,10,12,105,2,16
6359,902,478,135.3491156462585,136.78875283446712,15,19,429,1,424
6360,902,410,135.3491156462585,138.32126984126984,15,22,508,3,492
6361,902,631,135.3491156462585,137.0209523809524,15,16,280,2,271
6362,902,615,135.3491156462585,138.32126984126984,15,16,314,3,287
6363,902,821,135.3491156462585,136.78875283446712,15,12,102,1,81
6364,902,890,135.3491156462585,138.32126984126984,15,11,129,3,12
6365,905,410,136.3243537414966,138.32126984126984,10,22,502,2,495
6366,905,424,136.3243537414966,139.2500680272109,10,20,497,3,481
6367,905,615,136.3243537414966,138.32126984126984,10,16,302,2,290
6368,905,658,136.3243537414966,138.55346938775511,10,17,265,2,247
6369,905,890,136.3243537414966,138.32126984126984,10,11,87,2,15
6370,905,826,136.3243537414966,138.55346938775511,10,13,124,2,79
6371,821,410,136.78875283446712,138.32126984126984,12,22,416,2,411
6372,821,424,136.78875283446712,139.2500680272109,12,20,411,2,397
6373,821,615,136.78875283446712,138.32126984126984,12,16,216,2,206
6374,821,658,136.78875283446712,138.55346938775511,12,17,180,2,163
6375,821,890,136.78875283446712,138.32126984126984,12,11,95,2,69
6376,821,826,136.78875283446712,138.55346938775511,12,13,76,2,5
6377,890,461,138.32126984126984,140.10920634920635,11,16,436,2,429
6378,890,428,138.32126984126984,141.17732426303854,11,14,478,3,462
6379,890,724,138.32126984126984,140.29496598639457,11,12,186,2,166
6380,890,690,138.32126984126984,141.17732426303854,11,14,235,3,200
6381,890,826,138.32126984126984,140.31818594104308,11,12,107,2,64
6382,890,905,138.32126984126984,141.17732426303854,11,12,124,3,15
6383,826,461,138.55346938775511,140.10920634920635,13,16,371,2,365
6384,826,428,138.55346938775511,141.17732426303854,13,14,414,3,398
6385,826,724,138.55346938775511,140.29496598639457,13,12,127,2,102
6386,826,690,138.55346938775511,141.17732426303854,13,14,177,3,136
6387,826,905,138.55346938775511,141.17732426303854,13,12,138,3,79
6388,826,351,140.31818594104308,141.8274829931973,12,22,479,2,475
6389,826,465,140.31818594104308,141.8274829931973,12,15,367,2,361
6390,826,600,140.31818594104308,142.84916099773244,12,19,251,3,226
6391,826,720,140.31818594104308,141.64172335600907,12,12,120,1,106
6392,826,624,140.31818594104308,142.8259410430839,12,17,229,3,202
6393,826,924,140.31818594104308,142.40798185941043,12,13,133,2,98
6394,826,853,140.31818594104308,142.7562811791383,12,14,108,2,27
6395,905,600,141.17732426303854,142.84916099773244,12,19,313,2,305
6396,905,577,141.17732426303854,143.75473922902495,12,21,346,3,328
6397,905,624,141.17732426303854,142.8259410430839,12,17,290,2,281
6398,905,625,141.17732426303854,143.801179138322,12,19,302,3,280
6399,905,924,141.17732426303854,142.40798185941043,12,13,56,1,19
6400,905,853,141.17732426303854,142.7562811791383,12,14,86,2,52
6401,905,859,141.17732426303854,143.77795918367346,12,15,121,3,46
6402,924,577,142.40798185941043,143.75473922902495,13,21,352,1,347
6403,924,582,142.40798185941043,144.7764172335601,13,17,357,2,342
6404,924,625,142.40798185941043,143.801179138322,13,19,305,1,299
6405,924,859,142.40798185941043,143.77795918367346,13,15,88,1,65
6406,924,901,142.40798185941043,144.82285714285715,13,15,107,2,23
6407,853,582,142.7562811791383,144.7764172335601,14,17,285,2,271
6408,853,625,142.7562811791383,143.801179138322,14,19,232,1,228
6409,853,624,142.7562811791383,145.4033560090703,14,18,256,3,229
6410,853,859,142.7562811791383,143.77795918367346,14,15,44,1,6
6411,853,901,142.7562811791383,144.82285714285715,14,15,101,2,48
6412,859,573,143.77795918367346,146.49469387755101,15,13,309,3,286
6413,859,624,143.77795918367346,145.4033560090703,15,18,245,2,235
6414,859,631,143.77795918367346,146.0302947845805,15,10,248,2,228
6415,859,627,143.77795918367346,146.68045351473924,15,11,264,3,232
6416,859,901,143.77795918367346,144.82285714285715,15,15,62,1,42
6417,859,937,143.77795918367346,146.3785941043084,15,12,136,3,78
6418,901,573,144.82285714285715,146.49469387755101,15,13,336,2,328
6419,901,428,144.82285714285715,147.49315192743765,15,15,487,3,473
6420,901,631,144.82285714285715,146.0302947845805,15,10,275,1,270
6421,901,627,144.82285714285715,146.68045351473924,15,11,285,2,274
6422,901,937,144.82285714285715,146.3785941043084,15,12,76,2,36
6423,937,481,146.3785941043084,148.09687074829932,12,14,462,2,456
6424,937,549,146.3785941043084,148.65414965986395,12,17,400,2,388
6425,937,667,146.3785941043084,147.8878911564626,12,14,278,2,270
6426,937,633,146.3785941043084,149.35074829931972,12,16,330,3,304
6427,937,933,146.3785941043084,148.12009070294786,12,16,75,2,4
6428,933,515,148.12009070294786,149.65260770975058,16,18,423,2,418
6429,933,633,148.12009070294786,149.35074829931972,16,16,305,1,300
6430,933,625,148.12009070294786,150.00090702947847,16,16,318,2,308
6431,933,653,148.12009070294786,151.04580498866213,16,15,307,3,280
6432,933,821,148.12009070294786,149.44362811791385,16,14,126,1,112
6433,933,821,148.12009070294786,149.79192743764173,16,14,133,2,112
6434,933,923,148.12009070294786,151.09224489795918,16,15,128,3,10
6435,821,472,149.44362811791385,151.11546485260772,14,14,356,2,349
6436,821,483,149.44362811791385,152.41578231292516,14,14,361,3,338
6437,821,653,149.44362811791385,151.04580498866213,14,15,182,2,168
6438,821,676,149.44362811791385,151.76562358276644,14,16,176,2,145
6439,821,923,149.44362811791385,151.09224489795918,14,15,124,2,102
6440,821,922,149.44362811791385,151.76562358276644,14,11,142,2,101
6441,821,336,149.79192743764173,152.69442176870749,14,28,501,3,485
6442,821,472,149.79192743764173,151.11546485260772,14,14,354,1,349
6443,821,483,149.79192743764173,152.41578231292516,14,14,356,3,338
6444,821,653,149.79192743764173,151.04580498866213,14,15,176,1,168
6445,821,676,149.79192743764173,151.76562358276644,14,16,168,2,145
6446,821,923,149.79192743764173,151.09224489795918,14,15,116,1,102
6447,821,922,149.79192743764173,151.76562358276644,14,11,132,2,101
6448,923,483,151.09224489795918,152.41578231292516,15,14,444,1,440
6449,923,544,151.09224489795918,153.04272108843537,15,17,388,2,379
6450,923,617,151.09224489795918,153.53034013605443,15,15,324,2,306
6451,923,941,151.09224489795918,153.53034013605443,15,12,107,2,18
6452,923,825,151.09224489795918,153.99473922902496,15,12,159,3,98
6453,922,544,151.76562358276644,153.04272108843537,11,17,382,1,378
6454,922,541,151.76562358276644,154.18049886621316,11,14,395,2,381
6455,922,617,151.76562358276644,153.53034013605443,11,15,314,2,305
6456,922,719,151.76562358276644,154.55201814058958,11,18,236,3,203
6457,922,941,151.76562358276644,153.53034013605443,11,12,78,2,19
6458,922,825,151.76562358276644,153.99473922902496,11,12,136,2,97
6459,941,461,153.53034013605443,156.06131519274376,12,19,492,3,480
6460,941,719,153.53034013605443,154.55201814058958,12,18,226,1,222
6461,941,720,153.53034013605443,154.85387755102042,12,21,228,1,221
6462,941,619,153.53034013605443,156.1774149659864,12,18,342,3,322
6463,941,902,153.53034013605443,155.43437641723355,12,16,91,2,39
6464,825,354,153.99473922902496,155.57369614512473,12,27,476,2,471
6465,825,432,153.99473922902496,155.06285714285715,12,22,396,1,393
6466,825,461,153.99473922902496,156.06131519274376,12,19,375,2,364
6467,825,515,153.99473922902496,156.82757369614512,12,18,333,3,310
6468,825,619,153.99473922902496,156.1774149659864,12,18,226,2,206
6469,825,655,153.99473922902496,156.6185941043084,12,16,204,3,170
6470,825,902,153.99473922902496,155.43437641723355,12,16,99,1,77
6471,825,902,153.99473922902496,156.5257142857143,12,16,133,3,77
6472,902,515,155.43437641723355,156.82757369614512,16,18,392,1,387
6473,902,427,155.43437641723355,158.0350113378685,16,20,488,3,475
6474,902,655,155.43437641723355,156.6185941043084,16,16,252,1,247
6475,902,617,155.43437641723355,158.4065306122449,16,17,312,3,285
6476,902,898,155.43437641723355,157.0597732426304,16,15,70,2,4
6477,902,825,155.43437641723355,157.9653514739229,16,12,133,3,77
6478,902,427,156.5257142857143,158.0350113378685,16,20,479,2,475
6479,902,483,156.5257142857143,159.4746485260771,16,18,438,3,419
6480,902,617,156.5257142857143,158.4065306122449,16,17,296,2,285
6481,902,681,156.5257142857143,158.82448979591837,16,15,242,2,221
6482,902,825,156.5257142857143,157.9653514739229,16,12,99,1,77
6483,902,845,156.5257142857143,158.82448979591837,16,12,114,2,57
6484,898,483,157.0597732426304,159.4746485260771,15,18,428,2,415
6485,898,617,157.0597732426304,158.4065306122449,15,17,287,1,281
6486,898,681,157.0597732426304,158.82448979591837,15,15,230,2,217
6487,898,739,157.0597732426304,159.63718820861678,15,18,194,3,159
6488,898,845,157.0597732426304,158.82448979591837,15,12,93,2,53
6489,898,895,157.0597732426304,159.66040816326532,15,16,112,3,3
6490,825,483,157.9653514739229,159.4746485260771,12,18,348,2,342
6491,825,411,157.9653514739229,160.61242630385487,12,25,429,3,414
6492,825,411,157.9653514739229,160.6356462585034,12,22,430,3,414
6493,825,739,157.9653514739229,159.63718820861678,12,18,112,2,86
6494,825,809,157.9653514739229,160.6356462585034,12,15,116,3,16
6495,825,895,157.9653514739229,159.66040816326532,12,16,101,2,70
6496,845,411,158.82448979591837,160.61242630385487,12,25,441,2,434
6497,845,411,158.82448979591837,160.6356462585034,12,22,441,2,434
6498,845,415,158.82448979591837,161.7037641723356,12,22,448,3,430
6499,845,809,158.82448979591837,160.6356462585034,12,15,86,2,36
6500,845,897,158.82448979591837,161.44834467120182,12,12,124,3,52
6501,895,415,159.66040816326532,161.7037641723356,16,22,488,2,480
6502,895,642,159.66040816326532,162.35392290249433,16,15,278,3,253
6503,895,897,159.66040816326532,161.44834467120182,16,12,77,2,2
6504,895,966,159.66040816326532,162.35392290249433,16,11,136,3,71
6505,897,535,161.44834467120182,163.32916099773243,12,25,371,2,362
6506,897,419,161.44834467120182,164.11863945578233,12,24,492,3,478
6507,897,620,161.44834467120182,163.32916099773243,12,20,289,2,277
6508,897,701,161.44834467120182,164.0954195011338,12,17,227,3,196
6509,897,826,161.44834467120182,162.81832199546486,12,12,92,1,71
6510,897,933,161.44834467120182,164.11863945578233,12,13,121,3,36
6511,966,701,162.35392290249433,164.0954195011338,11,17,275,2,265
6512,966,933,162.35392290249433,164.11863945578233,11,13,83,2,33
6513,966,831,162.35392290249433,164.79201814058956,11,12,171,2,135
6514,826,381,162.81832199546486,164.0954195011338,12,26,448,1,445
6515,826,419,162.81832199546486,164.11863945578233,12,24,411,1,407
6516,826,569,162.81832199546486,165.46539682539682,12,17,281,3,257
6517,826,701,162.81832199546486,164.0954195011338,12,17,137,1,125
6518,826,633,162.81832199546486,165.5350566893424,12,15,226,3,193
6519,826,933,162.81832199546486,164.11863945578233,12,13,121,1,107
6520,826,831,162.81832199546486,164.79201814058956,12,12,85,2,5
6521,826,940,162.81832199546486,165.67437641723356,12,12,168,3,114
6522,933,569,164.11863945578233,165.46539682539682,13,17,369,1,364
6523,933,633,164.11863945578233,165.5350566893424,13,15,306,1,300
6524,933,619,164.11863945578233,165.9762358276644,13,15,324,2,314
6525,933,940,164.11863945578233,165.67437641723356,13,12,67,2,7
6526,831,422,164.79201814058956,165.92979591836735,12,20,412,1,409
6527,831,423,164.79201814058956,167.06757369614513,12,22,420,2,408
6528,831,619,164.79201814058956,165.9762358276644,12,15,218,1,212
6529,831,818,164.79201814058956,167.20689342403628,12,17,105,2,13
6530,831,896,164.79201814058956,167.20689342403628,12,15,123,2,65
6531,940,470,165.67437641723356,168.29823129251702,12,17,483,3,470
6532,940,818,165.67437641723356,167.20689342403628,12,17,139,2,122
6533,940,819,165.67437641723356,168.53043083900226,12,16,173,3,121
6534,940,896,165.67437641723356,167.20689342403628,12,15,79,2,44
6535,940,820,165.67437641723356,168.53043083900226,12,15,172,3,120
6536,896,470,167.20689342403628,168.29823129251702,15,17,429,1,426
6537,896,580,167.20689342403628,169.13414965986394,15,19,327,2,316
6538,896,819,167.20689342403628,168.53043083900226,15,16,96,1,77
6539,896,691,167.20689342403628,169.59854875283446,15,25,229,2,205
6540,896,820,167.20689342403628,168.53043083900226,15,15,95,1,76
6541,896,829,167.20689342403628,169.5288888888889,15,18,120,2,67
6542,820,342,168.53043083900226,171.13106575963718,15,26,491,3,478
6543,820,515,168.53043083900226,170.20226757369616,15,20,313,2,305
6544,820,515,168.53043083900226,170.82920634920634,15,17,321,2,305
6545,820,691,168.53043083900226,169.59854875283446,15,25,137,1,129
6546,820,723,168.53043083900226,170.55056689342405,15,17,130,2,97
6547,820,819,168.53043083900226,170.73632653061225,15,18,95,2,1
6548,820,924,168.53043083900226,170.36480725623582,15,15,131,2,104
6549,820,821,168.53043083900226,170.73632653061225,15,16,95,2,1
6550,829,342,169.5288888888889,171.13106575963718,18,26,492,2,487
6551,829,515,169.5288888888889,170.82920634920634,18,17,319,1,314
6552,829,439,169.5288888888889,171.82766439909298,18,16,402,2,390
6553,829,723,169.5288888888889,170.55056689342405,18,17,115,1,106
6554,829,819,169.5288888888889,170.73632653061225,18,18,53,1,10
6555,829,637,169.5288888888889,172.2920634920635,18,17,226,3,192
6556,829,821,169.5288888888889,170.73632653061225,18,16,53,1,8
6557,924,439,170.36480725623582,171.82766439909298,15,16,489,1,485
6558,924,458,170.36480725623582,172.80290249433108,15,20,478,2,466
6559,924,637,170.36480725623582,172.2920634920635,15,17,299,2,287
6560,924,751,170.36480725623582,172.94222222222223,15,16,206,3,173
6561,924,968,170.36480725623582,172.94222222222223,15,11,119,3,44
6562,821,439,170.73632653061225,171.82766439909298,16,16,385,1,382
6563,821,458,170.73632653061225,172.80290249433108,16,20,374,2,363
6564,821,637,170.73632653061225,172.2920634920635,16,17,196,2,184
6565,821,751,170.73632653061225,172.94222222222223,16,16,118,2,70
6566,821,968,170.73632653061225,172.94222222222223,16,11,175,2,147
6567,968,710,172.94222222222223,174.84625850340137,11,21,271,2,258
6568,968,826,172.94222222222223,174.82303854875283,11,15,163,2,142
6569,840,410,173.75492063492064,175.403537414966,15,19,436,2,430
6570,840,410,173.75492063492064,175.96081632653062,15,19,440,2,430
6571,840,710,173.75492063492064,174.84625850340137,15,21,138,1,130
6572,840,666,173.75492063492064,176.0304761904762,15,14,200,2,174
6573,840,826,173.75492063492064,174.82303854875283,15,15,48,1,14
6574,840,892,173.75492063492064,176.4716553287982,15,11,128,3,52
6575,826,410,174.82303854875283,175.96081632653062,15,19,419,1,416
6576,826,507,174.82303854875283,177.67909297052154,15,17,342,3,319
6577,826,666,174.82303854875283,176.0304761904762,15,14,168,1,160
6578,826,650,174.82303854875283,176.91283446712018,15,15,198,2,176
6579,826,892,174.82303854875283,176.4716553287982,15,11,97,2,66
6580,892,507,176.4716553287982,177.67909297052154,11,17,388,1,385
6581,892,566,176.4716553287982,178.30603174603175,11,20,335,2,326
6582,892,621,176.4716553287982,178.3292517006803,11,18,283,2,271
6583,892,826,176.4716553287982,177.79519274376418,11,11,87,1,66
6584,892,968,176.4716553287982,179.11873015873016,11,10,137,3,76
6585,826,354,177.79519274376418,179.420589569161,11,28,477,2,472
6586,826,575,177.79519274376418,179.5134693877551,11,17,262,2,251
6587,826,422,177.79519274376418,180.07074829931972,11,21,416,2,404
6588,826,656,177.79519274376418,179.55990929705214,11,16,186,2,170
6589,826,685,177.79519274376418,180.44226757369614,11,13,181,3,141
6590,826,968,177.79519274376418,179.11873015873016,11,10,153,1,142
6591,826,848,177.79519274376418,180.44226757369614,11,12,116,3,22
6592,968,552,179.11873015873016,181.53360544217688,10,16,429,2,416
6593,968,685,179.11873015873016,180.44226757369614,10,13,289,1,283
6594,968,630,179.11873015873016,181.32462585034014,10,16,351,2,338
6595,968,848,179.11873015873016,180.44226757369614,10,12,133,1,120
6596,968,902,179.11873015873016,181.25496598639455,10,14,113,2,66
6597,968,878,179.11873015873016,182.0908843537415,10,14,156,3,90
6598,848,552,180.44226757369614,181.53360544217688,12,16,300,1,296
6599,848,524,180.44226757369614,182.41596371882088,12,16,335,2,324
6600,848,459,180.44226757369614,183.20544217687075,12,19,407,3,389
6601,848,649,180.44226757369614,182.20698412698414,12,15,213,2,199
6602,848,878,180.44226757369614,182.0908843537415,12,14,77,2,30
6603,902,524,181.25496598639455,182.41596371882088,14,16,381,1,378
6604,902,459,181.25496598639455,183.20544217687075,14,19,451,2,443
6605,902,743,181.25496598639455,183.64662131519276,14,22,189,2,159
6606,902,672,181.25496598639455,183.71628117913832,14,21,253,2,230
6607,902,903,181.25496598639455,183.6930612244898,14,19,105,2,1
6608,902,860,181.25496598639455,183.71628117913832,14,17,114,2,42
6609,878,459,182.0908843537415,183.20544217687075,14,19,422,1,419
6610,878,515,182.0908843537415,184.29678004535148,14,19,375,2,363
6611,878,743,182.0908843537415,183.64662131519276,14,22,151,2,135
6612,878,672,182.0908843537415,183.71628117913832,14,21,218,2,206
6613,878,671,182.0908843537415,184.97015873015874,14,17,241,3,207
6614,878,903,182.0908843537415,183.6930612244898,14,19,73,2,25
6615,878,860,182.0908843537415,183.71628117913832,14,17,72,2,18
6616,878,932,182.0908843537415,184.83083900226757,14,15,130,3,54
6617,903,458,183.6930612244898,185.71319727891157,19,20,453,2,445
6618,903,459,183.6930612244898,185.78285714285715,19,20,453,2,444
6619,903,671,183.6930612244898,184.97015873015874,19,17,238,1,232
6620,903,689,183.6930612244898,185.78285714285715,19,17,232,2,214
6621,903,932,183.6930612244898,184.83083900226757,19,15,57,1,29
6622,903,859,183.6930612244898,185.7364172335601,19,11,98,2,44
6623,860,401,183.71628117913832,185.71319727891157,17,26,467,2,459
6624,860,458,183.71628117913832,185.71319727891157,17,20,411,2,402
6625,860,459,183.71628117913832,185.78285714285715,17,20,411,2,401
6626,860,671,183.71628117913832,184.97015873015874,17,17,197,1,189
6627,860,689,183.71628117913832,185.78285714285715,17,17,193,2,171
6628,860,932,183.71628117913832,184.83083900226757,17,15,87,1,72
6629,860,859,183.71628117913832,185.7364172335601,17,11,87,2,1
6630,932,461,184.83083900226757,187.33859410430838,15,18,483,3,471
6631,932,633,184.83083900226757,187.36181405895692,15,18,318,3,299
6632,932,896,184.83083900226757,187.0831746031746,15,12,103,2,36
6633,859,461,185.7364172335601,187.33859410430838,11,18,404,2,398
6634,859,425,185.7364172335601,188.24417233560092,11,21,447,3,434
6635,859,633,185.7364172335601,187.36181405895692,11,18,237,2,226
6636,859,753,185.7364172335601,187.895873015873,11,21,141,2,106
6637,859,896,185.7364172335601,187.0831746031746,11,12,69,1,37
6638,859,847,185.7364172335601,187.895873015873,11,17,94,2,12
6639,896,425,187.0831746031746,188.24417233560092,12,21,474,1,471
6640,896,410,187.0831746031746,189.19619047619048,12,20,494,2,486
6641,896,617,187.0831746031746,189.14975056689343,12,20,293,2,279
6642,896,822,187.0831746031746,189.01043083900228,12,16,111,2,74
6643,847,410,187.895873015873,189.19619047619048,17,20,441,1,437
6644,847,470,187.895873015873,190.61260770975056,17,20,395,3,377
6645,847,617,187.895873015873,189.14975056689343,17,20,236,1,230
6646,847,814,187.895873015873,190.58938775510205,17,16,121,3,33
6647,847,822,187.895873015873,189.01043083900228,17,16,54,1,25
6648,847,821,187.895873015873,190.6358276643991,17,12,121,3,26
6649,822,470,189.01043083900228,190.61260770975056,16,20,359,2,352
6650,822,423,189.01043083900228,191.3556462585034,16,21,412,2,399
6651,822,425,189.01043083900228,191.7968253968254,16,20,415,3,397
6652,822,814,189.01043083900228,190.58938775510205,16,16,68,2,8
6653,822,641,189.01043083900228,191.03056689342404,16,15,201,2,181
6654,822,616,189.01043083900228,191.7736054421769,16,17,238,3,206
6655,822,821,189.01043083900228,190.6358276643991,16,12,70,2,1
6656,822,872,189.01043083900228,191.03056689342404,16,13,100,2,50
6657,822,856,189.01043083900228,191.91292517006804,16,13,130,3,34
6658,821,425,190.6358276643991,191.7968253968254,12,20,399,1,396
6659,821,616,190.6358276643991,191.7736054421769,12,17,211,1,205
6660,821,856,190.6358276643991,191.91292517006804,12,13,65,1,35
6661,821,969,190.6358276643991,193.23646258503402,12,11,186,3,148
6662,872,600,191.03056689342404,193.7473015873016,13,17,296,3,272
6663,872,630,191.03056689342404,193.7473015873016,13,16,269,3,242
6664,872,969,191.03056689342404,193.23646258503402,13,11,136,2,97
6665,856,600,191.91292517006804,193.7473015873016,13,17,268,2,256
6666,856,453,191.91292517006804,194.4903401360544,13,17,418,3,403
6667,856,630,191.91292517006804,193.7473015873016,13,16,239,2,226
6668,856,633,191.91292517006804,194.44390022675736,13,14,248,3,223
6669,856,969,191.91292517006804,193.23646258503402,13,11,127,1,113
6670,856,850,191.91292517006804,194.44390022675736,13,11,109,3,6
6671,969,633,193.23646258503402,194.44390022675736,11,14,340,1,336
6672,969,638,193.23646258503402,195.2798185941043,11,19,342,2,331
6673,969,850,193.23646258503402,194.44390022675736,11,11,130,1,119
6674,969,859,193.23646258503402,195.442358276644,11,12,145,2,110
6675,969,895,193.23646258503402,195.92997732426304,11,11,138,3,74
6676,850,417,194.44390022675736,195.95319727891157,11,20,438,2,433
6677,850,633,194.44390022675736,196.76589569160998,11,16,239,2,217
6678,850,895,194.44390022675736,195.92997732426304,11,11,78,1,45
6679,850,835,194.44390022675736,197.36961451247166,11,17,127,3,15
6680,859,413,195.442358276644,197.4857142857143,12,17,455,2,446
6681,859,633,195.442358276644,196.76589569160998,12,16,233,1,226
6682,859,743,195.442358276644,197.7643537414966,12,23,153,2,116
6683,859,743,195.442358276644,197.78757369614513,12,22,154,2,116
6684,859,835,195.442358276644,197.36961451247166,12,17,86,2,24
6685,859,902,195.442358276644,197.81079365079364,12,18,111,2,43
6686,895,413,195.92997732426304,197.4857142857143,11,17,487,2,482
6687,895,498,195.92997732426304,198.76281179138323,11,17,415,3,397
6688,895,743,195.92997732426304,197.7643537414966,11,23,171,2,152
6689,895,743,195.92997732426304,197.78757369614513,11,22,172,2,152
6690,895,835,195.92997732426304,197.36961451247166,11,17,86,1,60
6691,895,902,195.92997732426304,197.81079365079364,11,18,81,2,7
6692,835,343,197.36961451247166,198.5538321995465,17,26,495,1,492
6693,835,498,197.36961451247166,198.76281179138323,17,17,342,1,337
6694,835,496,197.36961451247166,198.97179138321997,17,19,346,2,339
6695,835,634,197.36961451247166,199.76126984126984,17,18,226,2,201
6696,835,802,197.36961451247166,199.83092970521542,17,17,111,2,33
6697,835,898,197.36961451247166,199.38975056689344,17,17,107,2,63
6698,902,496,197.81079365079364,198.97179138321997,18,19,409,1,406
6699,902,492,197.81079365079364,200.75972789115647,18,20,429,3,410
6700,902,492,197.81079365079364,200.78294784580498,18,19,430,3,410
6701,902,634,197.81079365079364,199.76126984126984,18,18,281,2,268
6702,902,802,197.81079365079364,199.83092970521542,18,17,133,2,100
6703,902,898,197.81079365079364,199.38975056689344,18,17,68,2,4
6704,902,823,197.81079365079364,200.73650793650793,18,15,149,3,79
6705,898,492,199.38975056689344,200.75972789115647,17,20,410,1,406
6706,898,492,199.38975056689344,200.78294784580498,17,19,410,1,406
6707,898,634,199.38975056689344,201.47954648526078,17,17,279,2,264
6708,898,717,199.38975056689344,202.0368253968254,17,22,214,3,181
6709,898,823,199.38975056689344,200.73650793650793,17,15,95,1,75
6710,898,862,199.38975056689344,201.5027664399093,17,13,98,2,36
6711,823,474,200.73650793650793,202.73342403628118,15,17,359,2,349
6712,823,410,200.73650793650793,203.31392290249434,15,20,428,3,413
6713,823,717,200.73650793650793,202.0368253968254,15,22,120,1,106
6714,823,644,200.73650793650793,203.1281632653061,15,20,207,2,179
6715,823,947,200.73650793650793,202.45478458049888,15,15,144,2,124
6716,823,856,200.73650793650793,203.1281632653061,15,15,108,2,33
6717,862,474,201.5027664399093,202.73342403628118,13,17,392,1,388
6718,862,410,201.5027664399093,203.31392290249434,13,20,459,2,452
6719,862,429,201.5027664399093,204.12662131519275,13,18,448,3,433
6720,862,644,201.5027664399093,203.1281632653061,13,20,229,2,218
6721,862,856,201.5027664399093,203.1281632653061,13,15,70,2,6
6722,947,815,202.45478458049888,204.7071201814059,15,16,164,2,132
6723,947,738,202.45478458049888,204.8,15,15,232,2,209
6724,947,876,202.45478458049888,204.7071201814059,15,13,120,2,71
6725,856,423,203.1281632653061,205.35727891156463,15,21,444,2,433
6726,856,414,203.1281632653061,205.84489795918367,15,19,457,3,442
6727,856,815,203.1281632653061,204.7071201814059,15,16,79,2,41
6728,856,738,203.1281632653061,204.8,15,15,138,2,118
6729,856,616,203.1281632653061,205.89133786848072,15,16,268,3,240
6730,856,876,203.1281632653061,204.7071201814059,15,13,71,2,20
6731,856,922,203.1281632653061,205.56625850340137,15,12,124,2,66
6732,856,832,203.1281632653061,205.8681179138322,15,13,120,3,24
6733,876,414,204.7071201814059,205.84489795918367,13,19,465,1,462
6734,876,410,204.7071201814059,206.8433560090703,13,20,475,2,466
6735,876,616,204.7071201814059,205.89133786848072,13,16,265,1,260
6736,876,632,204.7071201814059,207.00589569161,13,15,263,2,244
6737,876,832,204.7071201814059,205.8681179138322,13,13,67,1,44
6738,922,632,205.56625850340137,207.00589569161,12,15,297,1,290
6739,922,923,205.56625850340137,208.5384126984127,12,12,128,3,1
6740,832,422,205.8681179138322,208.28299319727893,13,20,423,2,410
6741,832,632,205.8681179138322,207.00589569161,13,15,206,1,200
6742,832,631,205.8681179138322,208.67773242630386,13,18,235,3,201
6743,832,923,205.8681179138322,208.5384126984127,13,12,147,3,91
6744,923,572,208.5384126984127,210.32634920634922,12,19,359,2,351
6745,923,663,208.5384126984127,210.44244897959183,12,16,273,2,260
6746,923,699,208.5384126984127,211.48734693877552,12,18,257,3,224
6747,923,866,208.5384126984127,210.74430839002267,12,11,111,2,57
6748,923,884,208.5384126984127,211.48734693877552,12,17,133,3,39
6749,863,419,209.35111111111112,211.06938775510204,12,18,450,2,444
6750,863,590,209.35111111111112,211.9285260770975,12,18,295,3,273
6751,863,663,209.35111111111112,210.44244897959183,12,16,205,1,200
6752,863,699,209.35111111111112,211.48734693877552,12,18,188,2,164
6753,863,747,209.35111111111112,211.9285260770975,12,23,161,3,116
6754,863,866,209.35111111111112,210.74430839002267,12,11,60,1,3
6755,863,884,209.35111111111112,211.48734693877552,12,17,94,2,21
6756,863,827,209.35111111111112,211.905306122449,12,18,116,3,36
6757,866,590,210.74430839002267,211.9285260770975,11,18,281,1,276
6758,866,515,210.74430839002267,213.20562358276644,11,19,367,2,351
6759,866,747,210.74430839002267,211.9285260770975,11,23,129,1,119
6760,866,626,210.74430839002267,212.95020408163265,11,17,258,2,240
6761,866,827,210.74430839002267,211.905306122449,11,18,63,1,39
6762,866,864,210.74430839002267,213.01986394557824,11,14,98,2,2
6763,884,515,211.48734693877552,213.20562358276644,17,19,376,2,369
6764,884,515,211.48734693877552,213.8557823129252,17,12,383,2,369
6765,884,626,211.48734693877552,212.95020408163265,17,17,266,1,258
6766,884,864,211.48734693877552,213.01986394557824,17,14,69,2,20
6767,827,515,211.905306122449,213.20562358276644,18,19,317,1,312
6768,827,515,211.905306122449,213.8557823129252,18,12,323,2,312
6769,827,626,211.905306122449,212.95020408163265,18,17,206,1,201
6770,827,864,211.905306122449,213.01986394557824,18,14,61,1,37
