,f0,f1,t0,t1,dB0,dB1,dist,utime,ufreq
0,136,105,3.7384126984126986,4.829750566893424,10,11,56,1,31
1,136,52,3.7384126984126986,5.712108843537415,10,17,120,2,84
2,136,52,3.7384126984126986,6.594467120181406,10,19,149,3,84
3,105,52,4.829750566893424,6.594467120181406,11,19,93,2,53
4,52,17,5.712108843537415,7.9412244897959186,17,25,102,2,35
5,52,17,5.712108843537415,8.034104308390022,17,25,106,2,35
6,52,17,6.594467120181406,7.9412244897959186,19,25,68,1,35
7,52,17,6.594467120181406,8.034104308390022,19,25,71,1,35
8,52,15,6.594467120181406,9.427301587301587,19,24,127,3,37
9,52,212,6.594467120181406,8.777142857142858,19,4,186,2,160
10,17,15,7.9412244897959186,9.427301587301587,25,24,64,1,2
11,17,26,7.9412244897959186,10.611519274376418,25,24,115,3,9
12,17,212,7.9412244897959186,10.7740589569161,25,5,230,3,195
13,17,15,8.034104308390022,9.427301587301587,25,24,60,1,2
14,17,26,8.034104308390022,10.611519274376418,25,24,111,3,9
15,17,212,8.034104308390022,10.7740589569161,25,5,228,3,195
16,15,26,9.427301587301587,10.611519274376418,24,24,52,1,11
17,15,13,9.427301587301587,11.633197278911565,24,29,95,2,2
18,15,212,9.427301587301587,10.7740589569161,24,5,205,1,197
19,15,232,9.427301587301587,12.027936507936507,24,4,244,3,217
20,26,13,10.611519274376418,11.633197278911565,24,29,46,1,13
21,26,20,10.611519274376418,12.79419501133787,24,29,94,2,6
22,26,232,10.611519274376418,12.027936507936507,24,4,215,1,206
23,26,248,10.611519274376418,13.444353741496599,24,14,253,3,222
24,13,20,11.633197278911565,12.79419501133787,29,29,50,1,7
25,13,20,11.633197278911565,13.699773242630386,29,27,89,2,7
26,13,20,11.633197278911565,14.001632653061225,29,22,102,2,7
27,13,248,11.633197278911565,13.444353741496599,29,14,248,2,235
28,13,437,11.633197278911565,13.978412698412699,29,1,436,2,424
29,13,437,11.633197278911565,14.001632653061225,29,2,436,2,424
30,20,437,12.79419501133787,13.978412698412699,29,1,420,1,417
31,20,437,12.79419501133787,14.001632653061225,29,2,420,1,417
32,20,9,13.699773242630386,15.789569160997733,27,35,91,2,11
33,20,17,13.699773242630386,15.998548752834468,27,30,99,2,3
34,20,206,13.699773242630386,15.928888888888888,27,3,209,2,186
35,20,207,13.699773242630386,16.416507936507937,27,8,221,3,187
36,20,9,14.001632653061225,15.789569160997733,22,35,78,2,11
37,20,17,14.001632653061225,15.998548752834468,22,30,86,2,3
38,20,206,14.001632653061225,15.928888888888888,22,3,204,2,186
39,20,207,14.001632653061225,16.416507936507937,22,8,214,2,187
40,9,206,15.789569160997733,17.87936507936508,35,7,217,2,197
41,9,207,15.789569160997733,18.36698412698413,35,10,227,3,198
42,17,9,15.998548752834468,17.670385487528346,30,35,72,2,8
43,17,9,15.998548752834468,18.274104308390022,30,31,98,2,8
44,17,206,15.998548752834468,17.87936507936508,30,7,206,2,189
45,17,207,15.998548752834468,18.36698412698413,30,10,216,2,190
46,9,13,17.670385487528346,19.87628117913832,35,34,95,2,4
47,9,13,17.670385487528346,20.108480725623583,35,35,105,2,4
48,9,246,17.670385487528346,19.574421768707484,35,9,251,2,237
49,9,306,17.670385487528346,20.038820861678005,35,12,314,2,297
50,9,13,18.274104308390022,19.87628117913832,31,34,69,2,4
51,9,13,18.274104308390022,20.108480725623583,31,35,79,2,4
52,9,246,18.274104308390022,19.574421768707484,31,9,244,1,237
53,9,306,18.274104308390022,20.038820861678005,31,12,307,2,297
54,13,9,19.87628117913832,21.73387755102041,34,35,80,2,4
55,13,248,19.87628117913832,21.292698412698414,34,14,243,1,235
56,13,206,19.87628117913832,22.825215419501134,34,3,231,3,193
57,13,9,20.108480725623583,21.73387755102041,35,35,70,2,4
58,13,17,20.108480725623583,22.96453514739229,35,31,123,3,4
59,13,248,20.108480725623583,21.292698412698414,35,14,240,1,235
60,13,206,20.108480725623583,22.825215419501134,35,3,226,3,193
61,9,17,21.73387755102041,22.96453514739229,35,31,54,1,8
62,9,20,21.73387755102041,23.986213151927437,35,37,98,2,11
63,9,20,21.73387755102041,24.009433106575965,35,38,99,2,11
64,9,206,21.73387755102041,22.825215419501134,35,3,203,1,197
65,9,305,21.73387755102041,23.84689342403628,35,13,310,2,296
66,9,440,21.73387755102041,23.173514739229024,35,11,435,1,431
67,17,20,22.96453514739229,23.986213151927437,31,37,44,1,3
68,17,20,22.96453514739229,24.009433106575965,31,38,45,1,3
69,17,20,22.96453514739229,25.843809523809526,31,39,124,3,3
70,17,229,22.96453514739229,24.752471655328797,31,14,226,2,212
71,17,428,22.96453514739229,24.822131519274375,31,5,419,2,411
72,17,439,22.96453514739229,25.93668934240363,31,6,441,3,422
73,20,259,23.986213151927437,25.98312925170068,37,18,254,2,239
74,20,259,23.986213151927437,26.006349206349206,37,15,254,2,239
75,20,439,23.986213151927437,25.93668934240363,37,6,427,2,419
76,20,419,23.986213151927437,26.610068027210886,37,7,415,3,399
77,20,259,24.009433106575965,25.98312925170068,38,18,254,2,239
78,20,259,24.009433106575965,26.006349206349206,38,15,254,2,239
79,20,439,24.009433106575965,25.93668934240363,38,6,427,2,419
80,20,419,24.009433106575965,26.610068027210886,38,7,414,3,399
81,20,80,25.843809523809526,27.028027210884353,39,32,79,1,60
82,20,17,25.843809523809526,28.606984126984127,39,34,119,3,3
83,20,254,25.843809523809526,27.00480725623583,39,6,239,1,234
84,20,480,25.843809523809526,27.46920634920635,39,3,465,2,460
85,20,17,26.029569160997735,28.606984126984127,37,34,111,3,3
86,20,480,26.029569160997735,27.46920634920635,37,3,464,1,460
87,80,17,27.028027210884353,28.606984126984127,32,34,93,2,63
88,80,17,27.028027210884353,29.071383219954647,32,34,108,2,63
89,17,20,28.606984126984127,30.162721088435376,34,22,67,2,3
90,17,21,28.606984126984127,31.55591836734694,34,37,127,3,4
91,17,20,29.071383219954647,30.162721088435376,34,22,47,1,3
92,17,21,29.071383219954647,31.55591836734694,34,37,107,2,4
93,17,274,29.071383219954647,31.857777777777777,34,10,284,3,257
94,20,21,30.162721088435376,31.55591836734694,22,37,60,1,1
95,20,26,30.162721088435376,32.298956916099776,22,36,92,2,6
96,20,274,30.162721088435376,31.857777777777777,22,10,264,2,254
97,20,211,30.162721088435376,32.298956916099776,22,23,212,2,191
98,20,453,30.162721088435376,32.97233560090703,22,7,450,3,433
99,20,412,30.162721088435376,32.995555555555555,22,6,411,3,392
100,21,20,31.55591836734694,33.94757369614513,37,36,103,2,1
101,21,26,31.55591836734694,34.365532879818595,37,38,121,3,5
102,21,261,31.55591836734694,33.90113378684807,37,13,260,2,240
103,21,205,31.55591836734694,34.202993197278914,37,16,216,3,184
104,21,453,31.55591836734694,32.97233560090703,37,7,436,1,432
105,21,412,31.55591836734694,32.995555555555555,37,6,396,1,391
106,26,20,32.298956916099776,33.94757369614513,36,36,71,2,6
107,26,261,32.298956916099776,33.90113378684807,36,13,245,2,235
108,26,205,32.298956916099776,34.202993197278914,36,16,197,2,179
109,26,410,32.298956916099776,34.73705215419501,36,1,398,2,384
110,20,15,33.94757369614513,35.619410430839004,36,35,72,2,5
111,20,222,33.94757369614513,35.50331065759637,36,4,213,2,202
112,26,15,34.365532879818595,35.619410430839004,38,35,55,1,11
113,26,20,34.365532879818595,36.78040816326531,38,36,104,2,6
114,26,21,34.365532879818595,37.105487528344675,38,37,118,3,5
115,26,222,34.365532879818595,35.50331065759637,38,4,202,1,196
116,26,248,34.365532879818595,36.96616780045352,38,14,249,3,222
117,26,328,34.365532879818595,37.01260770975057,38,11,323,3,302
118,15,20,35.619410430839004,36.78040816326531,35,36,50,1,5
119,15,21,35.619410430839004,37.105487528344675,35,37,64,1,6
120,15,248,35.619410430839004,36.96616780045352,35,14,240,1,233
121,15,328,35.619410430839004,37.01260770975057,35,11,319,1,313
122,20,26,36.78040816326531,38.98630385487528,36,39,95,2,6
123,20,26,36.78040816326531,39.00952380952381,36,39,96,2,6
124,20,311,36.78040816326531,38.98630385487528,36,18,306,2,291
125,20,312,36.78040816326531,39.19528344671202,36,20,310,2,292
126,20,466,36.78040816326531,38.98630385487528,36,3,456,2,446
127,20,443,36.78040816326531,39.172063492063494,36,12,435,2,423
128,21,26,37.105487528344675,38.98630385487528,37,39,81,2,5
129,21,26,37.105487528344675,39.00952380952381,37,39,82,2,5
130,21,311,37.105487528344675,38.98630385487528,37,18,301,2,290
131,21,312,37.105487528344675,39.19528344671202,37,20,305,2,291
132,21,466,37.105487528344675,38.98630385487528,37,3,452,2,445
133,21,443,37.105487528344675,39.172063492063494,37,12,431,2,422
134,26,29,38.98630385487528,40.26340136054422,39,40,55,1,3
135,26,243,38.98630385487528,40.47238095238095,39,18,226,1,217
136,26,231,38.98630385487528,41.703038548752836,39,14,236,3,205
137,26,468,38.98630385487528,41.517278911564624,39,6,455,3,442
138,26,29,39.00952380952381,40.26340136054422,39,40,54,1,3
139,26,243,39.00952380952381,40.47238095238095,39,18,226,1,217
140,26,231,39.00952380952381,41.703038548752836,39,14,236,3,205
141,26,468,39.00952380952381,41.517278911564624,39,6,455,3,442
142,29,26,40.26340136054422,41.517278911564624,40,39,54,1,3
143,29,31,40.26340136054422,42.26031746031746,40,40,86,2,2
144,29,231,40.26340136054422,41.703038548752836,40,14,211,1,202
145,29,275,40.26340136054422,42.49251700680272,40,12,264,2,246
146,29,468,40.26340136054422,41.517278911564624,40,6,442,1,439
147,26,23,41.517278911564624,43.97859410430839,39,35,106,2,3
148,26,210,41.517278911564624,43.83927437641724,39,13,209,2,184
149,26,410,41.517278911564624,43.932154195011336,39,8,398,2,384
150,26,437,41.517278911564624,44.39655328798186,39,3,429,3,411
151,31,23,42.26031746031746,43.97859410430839,40,35,74,2,8
152,31,21,42.26031746031746,44.74485260770975,40,36,107,2,10
153,31,21,42.26031746031746,45.093151927437646,40,36,122,3,10
154,31,210,42.26031746031746,43.83927437641724,40,13,191,2,179
155,31,248,42.26031746031746,44.7912925170068,40,13,243,3,217
156,31,278,42.26031746031746,45.00027210884354,40,4,274,3,247
157,31,410,42.26031746031746,43.932154195011336,40,8,386,2,379
158,31,437,42.26031746031746,44.39655328798186,40,3,416,2,406
159,23,21,43.97859410430839,45.093151927437646,35,36,48,1,2
160,23,25,43.97859410430839,46.9275283446712,35,34,127,3,2
161,23,278,43.97859410430839,45.00027210884354,35,4,259,1,255
162,23,285,43.97859410430839,46.88108843537415,35,4,290,3,262
163,23,437,43.97859410430839,45.34857142857143,35,1,418,1,414
164,21,25,44.74485260770975,46.9275283446712,36,34,94,2,4
165,21,51,44.74485260770975,47.64734693877551,36,38,129,3,30
166,21,285,44.74485260770975,46.88108843537415,36,4,280,2,264
167,21,231,44.74485260770975,47.34548752834467,36,13,238,3,210
168,21,417,44.74485260770975,46.97396825396825,36,0,407,2,396
169,21,419,44.74485260770975,47.113287981859415,36,7,411,2,398
170,21,25,45.093151927437646,46.9275283446712,36,34,79,2,4
171,21,51,45.093151927437646,47.64734693877551,36,38,114,3,30
172,21,285,45.093151927437646,46.88108843537415,36,4,275,2,264
173,21,231,45.093151927437646,47.34548752834467,36,13,231,2,210
174,21,417,45.093151927437646,46.97396825396825,36,0,404,2,396
175,21,419,45.093151927437646,47.113287981859415,36,7,407,2,398
176,21,435,45.093151927437646,48.06530612244898,36,9,433,3,414
177,25,26,46.9275283446712,49.04054421768708,34,37,91,2,1
178,25,309,46.9275283446712,48.36716553287982,34,12,291,1,284
179,25,435,46.9275283446712,48.06530612244898,34,9,413,1,410
180,51,25,47.64734693877551,48.970884353741496,38,37,63,1,26
181,51,26,47.64734693877551,49.04054421768708,38,37,65,1,25
182,51,31,47.64734693877551,50.29442176870749,38,37,116,3,20
183,51,215,47.64734693877551,49.99256235827664,38,21,193,2,164
184,51,218,47.64734693877551,50.31764172335601,38,20,203,3,167
185,51,489,47.64734693877551,49.946122448979594,38,9,449,2,438
186,51,498,47.64734693877551,50.340861678004536,38,12,462,3,447
187,25,31,48.970884353741496,50.29442176870749,37,37,57,1,6
188,25,23,48.970884353741496,51.50185941043084,37,35,109,3,2
189,25,215,48.970884353741496,49.99256235827664,37,21,195,1,190
190,25,218,48.970884353741496,50.31764172335601,37,20,202,1,193
191,25,233,48.970884353741496,51.57151927437642,37,16,236,3,208
192,25,498,48.970884353741496,50.340861678004536,37,12,477,1,473
193,25,410,48.970884353741496,51.13034013605442,37,8,396,2,385
194,26,31,49.04054421768708,50.29442176870749,37,37,54,1,5
195,26,23,49.04054421768708,51.50185941043084,37,35,106,2,3
196,26,218,49.04054421768708,50.31764172335601,37,20,200,1,192
197,26,233,49.04054421768708,51.57151927437642,37,16,234,3,207
198,26,498,49.04054421768708,50.340861678004536,37,12,475,1,472
199,26,410,49.04054421768708,51.13034013605442,37,8,394,2,384
200,31,23,50.29442176870749,51.50185941043084,37,35,53,1,8
201,31,21,50.29442176870749,52.61641723356009,37,36,100,2,10
202,31,17,50.29442176870749,53.15047619047619,37,37,124,3,14
203,31,233,50.29442176870749,51.57151927437642,37,16,209,1,202
204,31,248,50.29442176870749,52.63963718820862,37,12,239,2,217
205,23,21,51.50185941043084,52.61641723356009,35,36,48,1,2
206,23,17,51.50185941043084,53.15047619047619,35,37,71,2,6
207,23,248,51.50185941043084,52.63963718820862,35,12,230,1,225
208,23,488,51.50185941043084,54.381133786848075,35,2,481,3,465
209,21,15,52.61641723356009,54.89197278911565,36,35,98,2,6
210,21,213,52.61641723356009,54.497233560090706,36,9,208,2,192
211,21,230,52.61641723356009,55.077732426303854,36,7,234,2,209
212,21,488,52.61641723356009,54.381133786848075,36,2,473,2,467
213,17,15,53.15047619047619,54.89197278911565,37,35,75,2,2
214,17,15,53.15047619047619,55.70467120181406,37,33,110,3,2
215,17,213,53.15047619047619,54.497233560090706,37,9,204,1,196
216,17,230,53.15047619047619,55.077732426303854,37,7,229,2,213
217,17,488,53.15047619047619,54.381133786848075,37,2,474,1,471
218,15,18,54.89197278911565,56.33160997732426,35,35,62,1,3
219,15,34,54.89197278911565,57.14430839002268,35,28,99,2,19
220,15,248,54.89197278911565,56.540589569161,35,14,244,2,233
221,15,437,54.89197278911565,57.09786848072562,35,2,433,2,422
222,15,34,55.70467120181406,57.14430839002268,33,28,65,1,19
223,15,206,55.70467120181406,58.63038548752834,33,23,229,3,191
224,15,437,55.70467120181406,57.09786848072562,33,2,426,1,422
225,15,412,55.70467120181406,58.60716553287982,33,14,416,3,397
226,18,26,56.33160997732426,58.816145124716556,35,39,107,2,8
227,18,26,56.33160997732426,59.14122448979592,35,39,121,3,8
228,18,206,56.33160997732426,58.63038548752834,35,23,212,2,188
229,18,412,56.33160997732426,58.60716553287982,35,14,406,2,394
230,34,26,57.14430839002268,58.816145124716556,28,39,72,2,8
231,34,26,57.14430839002268,59.14122448979592,28,39,86,2,8
232,34,206,57.14430839002268,58.63038548752834,28,23,184,1,172
233,34,230,57.14430839002268,59.65206349206349,28,25,224,3,196
234,34,412,57.14430839002268,58.60716553287982,28,14,383,1,378
235,34,410,57.14430839002268,59.65206349206349,28,16,391,3,376
236,26,76,58.816145124716556,60.998820861678006,39,37,106,2,50
237,26,51,58.816145124716556,61.41678004535147,39,37,115,3,25
238,26,278,58.816145124716556,60.998820861678006,39,20,269,2,252
239,26,220,58.816145124716556,61.532879818594104,39,18,227,3,194
240,26,448,58.816145124716556,60.557641723356014,39,4,429,2,422
241,26,410,58.816145124716556,61.74185941043084,39,5,404,3,384
242,26,76,59.14122448979592,60.998820861678006,39,37,94,2,50
243,26,51,59.14122448979592,61.41678004535147,39,37,101,2,25
244,26,278,59.14122448979592,60.998820861678006,39,20,264,2,252
245,26,220,59.14122448979592,61.532879818594104,39,18,220,2,194
246,26,448,59.14122448979592,60.557641723356014,39,4,426,1,422
247,26,410,59.14122448979592,61.74185941043084,39,5,400,3,384
248,76,70,60.998820861678006,62.64743764172336,37,36,71,2,6
249,76,26,60.998820861678006,63.64589569160998,37,36,124,3,50
250,76,277,60.998820861678006,62.99573696145125,37,23,219,2,201
251,76,217,60.998820861678006,63.87809523809524,37,26,188,3,141
252,76,415,60.998820861678006,62.972517006802725,37,10,349,2,339
253,76,410,60.998820861678006,63.715555555555554,37,19,354,3,334
254,51,70,61.41678004535147,62.64743764172336,37,36,56,1,19
255,51,26,61.41678004535147,63.64589569160998,37,36,99,2,25
256,51,23,61.41678004535147,64.13351473922903,37,39,120,3,28
257,51,277,61.41678004535147,62.99573696145125,37,23,236,2,226
258,51,217,61.41678004535147,63.87809523809524,37,26,197,2,166
259,51,297,61.41678004535147,64.24961451247165,37,21,275,3,246
260,51,415,61.41678004535147,62.972517006802725,37,10,370,2,364
261,51,410,61.41678004535147,63.715555555555554,37,19,372,2,359
262,70,23,62.64743764172336,64.13351473922903,36,39,79,1,47
263,70,217,62.64743764172336,63.87809523809524,36,26,156,1,147
264,70,297,62.64743764172336,64.24961451247165,36,21,237,2,227
265,70,232,62.64743764172336,65.34095238095239,36,14,199,3,162
266,70,410,62.64743764172336,63.715555555555554,36,19,343,1,340
267,70,413,62.64743764172336,64.52825396825396,36,18,352,2,343
268,26,24,63.64589569160998,65.7124716553288,36,37,89,2,2
269,26,17,63.64589569160998,66.52517006802721,36,37,124,3,9
270,26,232,63.64589569160998,65.34095238095239,36,14,219,2,206
271,26,245,63.64589569160998,66.29297052154195,36,11,247,3,219
272,26,465,63.64589569160998,65.75891156462585,36,7,448,2,439
273,26,417,63.64589569160998,66.38585034013606,36,7,408,3,391
274,23,24,64.13351473922903,65.7124716553288,39,37,68,2,1
275,23,17,64.13351473922903,66.52517006802721,39,37,103,2,6
276,23,232,64.13351473922903,65.34095238095239,39,14,215,1,209
277,23,245,64.13351473922903,66.29297052154195,39,11,241,2,222
278,23,465,64.13351473922903,65.75891156462585,39,7,448,2,442
279,23,417,64.13351473922903,66.38585034013606,39,7,406,2,394
280,24,26,65.7124716553288,67.98802721088435,37,36,98,2,2
281,24,26,65.7124716553288,68.05768707482993,37,37,101,2,2
282,24,387,65.7124716553288,67.98802721088435,37,18,376,2,363
283,24,412,65.7124716553288,67.98802721088435,37,16,400,2,388
284,24,413,65.7124716553288,68.05768707482993,37,19,402,2,389
285,17,26,66.52517006802721,67.98802721088435,37,36,64,1,9
286,17,26,66.52517006802721,68.05768707482993,37,37,67,2,9
287,17,387,66.52517006802721,67.98802721088435,37,18,375,1,370
288,17,273,66.52517006802721,68.70784580498866,37,21,273,2,256
289,17,412,66.52517006802721,67.98802721088435,37,16,400,1,395
290,17,413,66.52517006802721,68.05768707482993,37,19,401,2,396
291,26,20,67.98802721088435,69.52054421768707,36,34,66,2,6
292,26,245,67.98802721088435,69.65986394557824,36,19,231,2,219
293,26,206,67.98802721088435,70.31002267573696,36,22,206,2,180
294,26,428,67.98802721088435,69.65986394557824,36,5,408,2,402
295,26,420,67.98802721088435,70.0778231292517,36,8,404,2,394
296,26,20,68.05768707482993,69.52054421768707,37,34,63,1,6
297,26,245,68.05768707482993,69.65986394557824,37,19,230,2,219
298,26,206,68.05768707482993,70.31002267573696,37,22,204,2,180
299,26,428,68.05768707482993,69.65986394557824,37,5,408,2,402
300,26,420,68.05768707482993,70.0778231292517,37,8,403,2,394
301,20,76,69.52054421768707,71.98185941043084,34,35,120,2,56
302,20,277,69.52054421768707,71.72643990929706,34,19,274,2,257
303,20,432,69.52054421768707,72.00507936507937,34,14,426,2,412
304,20,432,69.52054421768707,72.02829931972789,34,15,426,3,412
305,26,76,70.5190022675737,71.98185941043084,36,35,80,1,50
306,26,23,70.5190022675737,72.67845804988663,36,36,93,2,3
307,26,277,70.5190022675737,71.72643990929706,36,19,256,1,251
308,26,219,70.5190022675737,72.53913832199547,36,19,212,2,193
309,26,205,70.5190022675737,73.07319727891156,36,13,210,3,179
310,26,432,70.5190022675737,72.00507936507937,36,14,411,1,406
311,26,432,70.5190022675737,72.02829931972789,36,15,411,2,406
312,26,410,70.5190022675737,73.16607709750566,36,2,401,3,384
313,76,21,71.98185941043084,73.83945578231292,35,35,97,2,55
314,76,17,71.98185941043084,74.6985941043084,35,35,131,3,59
315,76,205,71.98185941043084,73.07319727891156,35,13,137,1,129
316,76,205,71.98185941043084,74.11809523809524,35,7,158,2,129
317,76,410,71.98185941043084,73.16607709750566,35,2,338,1,334
318,76,411,71.98185941043084,74.18775510204082,35,1,348,2,335
319,23,21,72.67845804988663,73.83945578231292,36,35,50,1,2
320,23,17,72.67845804988663,74.6985941043084,36,35,87,2,6
321,23,205,72.67845804988663,74.11809523809524,36,7,192,1,182
322,23,411,72.67845804988663,74.18775510204082,36,1,393,2,388
323,21,26,73.83945578231292,75.7667120181406,35,35,83,2,5
324,21,26,73.83945578231292,76.3007709750567,35,34,106,2,5
325,21,283,73.83945578231292,75.90603174603174,35,21,277,2,262
326,21,206,73.83945578231292,76.55619047619048,35,22,219,3,185
327,21,411,73.83945578231292,75.90603174603174,35,10,400,2,390
328,21,424,73.83945578231292,76.0453514739229,35,9,414,2,403
329,17,26,74.6985941043084,75.7667120181406,35,35,47,1,9
330,17,26,74.6985941043084,76.3007709750567,35,34,70,2,9
331,17,283,74.6985941043084,75.90603174603174,35,21,271,1,266
332,17,206,74.6985941043084,76.55619047619048,35,22,205,2,189
333,17,276,74.6985941043084,77.32244897959184,35,19,283,3,259
334,17,411,74.6985941043084,75.90603174603174,35,10,397,1,394
335,17,424,74.6985941043084,76.0453514739229,35,9,411,1,407
336,17,410,74.6985941043084,77.46176870748299,35,10,411,3,393
337,26,61,75.7667120181406,77.76362811791384,35,35,93,2,35
338,26,101,75.7667120181406,78.66920634920635,35,36,146,3,75
339,26,276,75.7667120181406,77.32244897959184,35,19,259,2,250
340,26,410,75.7667120181406,77.46176870748299,35,10,391,2,384
341,26,61,76.3007709750567,77.76362811791384,34,35,72,1,35
342,26,101,76.3007709750567,78.66920634920635,34,36,127,2,75
343,26,34,76.3007709750567,79.20326530612245,34,36,125,3,8
344,26,276,76.3007709750567,77.32244897959184,34,19,254,1,250
345,26,302,76.3007709750567,78.83174603174604,34,16,297,3,276
346,26,206,76.3007709750567,79.27292517006804,34,22,221,3,180
347,26,410,76.3007709750567,77.46176870748299,34,10,387,1,384
348,26,449,76.3007709750567,79.22648526077097,34,13,441,3,423
349,61,34,77.76362811791384,79.20326530612245,35,36,68,1,27
350,61,34,77.76362811791384,80.34104308390023,35,38,114,3,27
351,61,302,77.76362811791384,78.83174603174604,35,16,245,1,241
352,61,206,77.76362811791384,79.27292517006804,35,22,159,2,145
353,61,205,77.76362811791384,80.08562358276644,35,10,175,2,144
354,61,449,77.76362811791384,79.22648526077097,35,13,393,1,388
355,61,432,77.76362811791384,80.4107029478458,35,7,388,3,371
356,101,34,78.66920634920635,80.34104308390023,36,38,98,2,67
357,101,26,78.66920634920635,81.64136054421769,36,38,148,3,75
358,101,205,78.66920634920635,80.08562358276644,36,10,121,1,104
359,101,267,78.66920634920635,81.08408163265307,36,10,196,2,166
360,101,432,78.66920634920635,80.4107029478458,36,7,339,2,331
361,101,537,78.66920634920635,81.06086167800454,36,12,448,2,436
362,34,26,79.20326530612245,81.64136054421769,36,38,105,2,8
363,34,267,79.20326530612245,81.08408163265307,36,10,247,2,233
364,34,432,79.20326530612245,80.4107029478458,36,7,401,1,398
365,34,26,80.34104308390023,81.64136054421769,38,38,57,1,8
366,34,15,80.34104308390023,82.82557823129252,38,29,109,2,19
367,34,205,80.34104308390023,82.96489795918367,38,7,205,3,171
368,26,15,81.64136054421769,82.82557823129252,38,29,52,1,11
369,26,205,81.64136054421769,82.96489795918367,38,7,188,1,179
370,26,205,81.64136054421769,84.00979591836735,38,25,206,2,179
371,26,205,81.64136054421769,84.03301587301587,38,22,207,2,179
372,26,410,81.64136054421769,83.98657596371882,38,15,397,2,384
373,26,428,81.64136054421769,84.17233560090703,38,16,417,3,402
374,15,26,82.82557823129252,84.03301587301587,29,35,53,1,11
375,15,24,82.82557823129252,85.79773242630385,29,37,128,3,9
376,15,205,82.82557823129252,84.00979591836735,29,25,197,1,190
377,15,205,82.82557823129252,84.03301587301587,29,22,197,1,190
378,15,410,82.82557823129252,83.98657596371882,29,15,398,1,395
379,15,428,82.82557823129252,84.17233560090703,29,16,417,1,413
380,26,24,83.70793650793651,85.79773242630385,38,37,90,2,2
381,26,205,83.70793650793651,86.00671201814059,38,22,205,2,179
382,26,205,83.70793650793651,86.02993197278911,38,21,205,2,179
383,26,410,83.70793650793651,86.00671201814059,38,12,397,2,384
384,26,410,83.70793650793651,86.05315192743764,38,13,397,2,384
385,26,24,84.03301587301587,85.79773242630385,35,37,76,2,2
386,26,205,84.03301587301587,86.00671201814059,35,22,198,2,179
387,26,205,84.03301587301587,86.02993197278911,35,21,199,2,179
388,26,410,84.03301587301587,86.00671201814059,35,12,393,2,384
389,26,410,84.03301587301587,86.05315192743764,35,13,394,2,384
390,24,76,85.79773242630385,87.65532879818595,37,36,95,2,52
391,24,26,85.79773242630385,88.02684807256236,37,34,96,2,2
392,24,299,85.79773242630385,87.58566893424036,37,20,286,2,275
393,24,424,85.79773242630385,87.58566893424036,37,18,407,2,400
394,26,76,86.1924716553288,87.65532879818595,35,36,80,1,50
395,26,299,86.1924716553288,87.58566893424036,35,20,280,1,273
396,26,269,86.1924716553288,88.88598639455782,35,14,269,3,243
397,26,424,86.1924716553288,87.58566893424036,35,18,402,1,398
398,26,414,86.1924716553288,88.88598639455782,35,7,405,3,388
399,26,418,86.1924716553288,89.07174603174603,35,6,411,3,392
400,76,21,87.65532879818595,89.18784580498867,36,34,86,2,55
401,76,19,87.65532879818595,90.0237641723356,36,31,117,2,57
402,76,269,87.65532879818595,88.88598639455782,36,14,200,1,193
403,76,289,87.65532879818595,89.2110657596372,36,13,223,2,213
404,76,414,87.65532879818595,88.88598639455782,36,7,342,1,338
405,76,418,87.65532879818595,89.07174603174603,36,6,347,1,342
406,26,21,88.02684807256236,89.18784580498867,34,34,50,1,5
407,26,19,88.02684807256236,90.0237641723356,34,31,86,2,7
408,26,289,88.02684807256236,89.2110657596372,34,13,268,1,263
409,26,205,88.02684807256236,90.83646258503401,34,9,216,3,179
410,26,418,88.02684807256236,89.07174603174603,34,6,395,1,392
411,21,25,89.18784580498867,91.18476190476191,34,35,86,2,4
412,21,205,89.18784580498867,90.83646258503401,34,9,197,2,184
413,21,278,89.18784580498867,91.48662131519275,34,19,275,2,257
414,21,431,89.18784580498867,91.4401814058957,34,19,421,2,410
415,19,25,90.0237641723356,91.18476190476191,31,35,50,1,6
416,19,23,90.0237641723356,92.78693877551021,31,35,119,3,4
417,19,278,90.0237641723356,91.48662131519275,31,19,267,1,259
418,19,207,90.0237641723356,92.92625850340136,31,21,226,3,188
419,19,431,90.0237641723356,91.4401814058957,31,19,416,1,412
420,19,415,90.0237641723356,92.92625850340136,31,16,415,3,396
421,25,23,91.18476190476191,92.78693877551021,35,35,69,2,2
422,25,31,91.18476190476191,93.71573696145126,35,38,109,3,6
423,25,207,91.18476190476191,92.92625850340136,35,21,197,2,182
424,25,284,91.18476190476191,93.042358276644,35,14,271,2,259
425,25,415,91.18476190476191,92.92625850340136,35,16,397,2,390
426,25,436,91.18476190476191,93.08879818594104,35,15,419,2,411
427,23,69,92.78693877551021,94.80707482993198,35,34,98,2,46
428,23,34,92.78693877551021,95.22503401360544,35,36,106,2,11
429,23,211,92.78693877551021,94.99283446712019,35,24,211,2,188
430,23,243,92.78693877551021,95.29469387755103,35,23,245,3,220
431,23,414,92.78693877551021,94.78385487528345,35,18,400,2,391
432,23,418,92.78693877551021,95.15537414965986,35,19,408,2,395
433,31,69,93.71573696145126,94.80707482993198,38,34,60,1,38
434,31,34,93.71573696145126,95.22503401360544,38,36,65,2,3
435,31,211,93.71573696145126,94.99283446712019,38,24,188,1,180
436,31,243,93.71573696145126,95.29469387755103,38,23,223,2,212
437,31,219,93.71573696145126,96.66467120181406,38,10,227,3,188
438,31,414,93.71573696145126,94.78385487528345,38,18,386,1,383
439,31,418,93.71573696145126,95.15537414965986,38,19,392,1,387
440,69,33,94.80707482993198,96.8736507936508,34,32,96,2,36
441,69,219,94.80707482993198,96.66467120181406,34,10,170,2,150
442,69,212,94.80707482993198,97.500589569161,34,15,184,3,143
443,69,415,94.80707482993198,96.71111111111111,34,6,356,2,346
444,69,411,94.80707482993198,97.33804988662132,34,4,359,3,342
445,34,33,95.22503401360544,96.8736507936508,36,32,71,2,1
446,34,23,95.22503401360544,97.82566893424037,36,38,113,3,11
447,34,219,95.22503401360544,96.66467120181406,36,10,195,1,185
448,34,212,95.22503401360544,97.500589569161,36,15,203,2,178
449,34,415,95.22503401360544,96.71111111111111,36,6,386,1,381
450,34,411,95.22503401360544,97.33804988662132,36,4,388,2,377
451,33,23,96.8736507936508,98.26684807256235,32,36,61,1,10
452,33,16,96.8736507936508,99.66004535147393,32,30,121,3,17
453,33,324,96.8736507936508,98.82412698412699,32,10,303,2,291
454,33,325,96.8736507936508,99.31174603174604,32,11,310,2,292
455,23,16,97.82566893424037,99.66004535147393,38,30,79,2,7
456,23,21,97.82566893424037,100.68172335600907,38,36,123,3,2
457,23,325,97.82566893424037,99.31174603174604,38,11,309,1,302
458,23,223,97.82566893424037,100.58884353741497,38,16,233,3,200
459,23,411,97.82566893424037,100.75138321995465,38,3,408,3,388
460,23,16,98.26684807256235,99.66004535147393,36,30,60,1,7
461,23,21,98.26684807256235,100.68172335600907,36,36,104,2,2
462,23,325,98.26684807256235,99.31174603174604,36,11,305,1,302
463,23,223,98.26684807256235,100.58884353741497,36,16,224,2,200
464,23,411,98.26684807256235,100.75138321995465,36,3,402,2,388
465,16,21,99.66004535147393,100.68172335600907,30,36,44,1,5
466,16,9,99.66004535147393,101.93560090702948,30,35,98,2,7
467,16,9,99.66004535147393,102.02848072562358,30,34,102,2,7
468,16,360,99.66004535147393,101.5873015873016,30,9,354,2,344
469,16,207,99.66004535147393,102.63219954648527,30,8,230,3,191
470,16,411,99.66004535147393,100.75138321995465,30,3,398,1,395
471,21,9,100.68172335600907,101.93560090702948,36,35,55,1,12
472,21,9,100.68172335600907,102.02848072562358,36,34,59,1,12
473,21,207,100.68172335600907,102.63219954648527,36,8,204,2,186
474,21,306,100.68172335600907,103.60743764172337,36,5,312,3,285
475,9,20,101.93560090702948,104.69877551020409,35,37,120,3,11
476,9,306,101.93560090702948,103.60743764172337,35,5,306,2,297
477,9,207,101.93560090702948,104.55945578231292,35,10,228,3,198
478,9,20,102.02848072562358,104.69877551020409,34,37,116,3,11
479,9,306,102.02848072562358,103.60743764172337,34,5,305,2,297
480,9,207,102.02848072562358,104.55945578231292,34,10,226,3,198
481,9,23,103.88607709750568,105.85977324263038,35,39,86,2,14
482,9,23,103.88607709750568,106.0455328798186,35,39,94,2,14
483,9,245,103.88607709750568,105.79011337868481,35,9,250,2,236
484,9,306,103.88607709750568,106.25451247165533,35,11,314,2,297
485,20,23,104.69877551020409,105.85977324263038,37,39,50,1,3
486,20,23,104.69877551020409,106.0455328798186,37,39,58,1,3
487,20,245,104.69877551020409,105.79011337868481,37,9,230,1,225
488,20,306,104.69877551020409,106.25451247165533,37,11,294,2,286
489,20,248,104.69877551020409,107.48517006802722,37,13,258,3,228
490,23,20,105.85977324263038,107.04399092970522,39,34,51,1,3
491,23,248,105.85977324263038,107.48517006802722,39,13,236,2,225
492,23,271,105.85977324263038,108.08888888888889,39,11,266,2,248
493,23,437,105.85977324263038,108.01922902494331,39,1,424,2,414
494,23,437,105.85977324263038,108.04244897959184,39,3,425,2,414
495,23,14,106.0455328798186,108.97124716553289,39,30,126,3,9
496,23,248,106.0455328798186,107.48517006802722,39,13,233,1,225
497,23,271,106.0455328798186,108.08888888888889,39,11,263,2,248
498,23,437,106.0455328798186,108.01922902494331,39,1,423,2,414
499,23,437,106.0455328798186,108.04244897959184,39,3,423,2,414
500,20,14,107.04399092970522,108.97124716553289,34,30,83,2,6
501,20,21,107.04399092970522,109.96970521541951,34,37,126,3,1
502,20,271,107.04399092970522,108.08888888888889,34,11,255,1,251
503,20,306,107.04399092970522,110.01614512471656,34,14,313,3,286
504,14,20,108.97124716553289,110.15546485260771,30,38,51,1,6
505,14,20,108.97124716553289,111.64154195011338,30,38,115,3,6
506,14,306,108.97124716553289,110.01614512471656,30,14,295,1,292
507,14,223,108.97124716553289,110.29478458049887,30,24,217,1,209
508,14,255,108.97124716553289,111.22358276643992,30,12,260,2,241
509,14,465,108.97124716553289,110.3180045351474,30,10,455,1,451
510,21,20,109.96970521541951,111.64154195011338,37,38,72,2,1
511,21,20,109.96970521541951,112.24526077097507,37,36,98,2,1
512,21,255,109.96970521541951,111.22358276643992,37,12,240,1,234
513,21,220,109.96970521541951,112.26848072562359,37,19,222,2,199
514,21,514,109.96970521541951,111.38612244897959,37,10,497,1,493
515,21,432,109.96970521541951,112.82575963718821,37,8,429,3,411
516,20,255,110.15546485260771,111.22358276643992,38,12,239,1,235
517,20,220,110.15546485260771,112.26848072562359,38,19,220,2,200
518,20,514,110.15546485260771,111.38612244897959,38,10,497,1,494
519,20,432,110.15546485260771,112.82575963718821,38,8,428,3,412
520,20,26,111.64154195011338,113.19727891156462,38,35,67,2,6
521,20,401,111.64154195011338,113.35981859410431,38,11,388,2,381
522,20,282,111.64154195011338,114.52081632653062,38,4,290,3,262
523,20,432,111.64154195011338,112.82575963718821,38,8,415,1,412
524,20,423,111.64154195011338,113.35981859410431,38,9,410,2,403
525,20,17,112.24526077097507,114.82267573696146,36,34,111,3,3
526,20,401,112.24526077097507,113.35981859410431,36,11,384,1,381
527,20,282,112.24526077097507,114.52081632653062,36,4,280,2,262
528,20,423,112.24526077097507,113.35981859410431,36,9,406,1,403
529,26,17,113.19727891156462,114.82267573696146,35,34,71,2,9
530,26,19,113.19727891156462,115.24063492063492,35,34,88,2,7
531,26,282,113.19727891156462,114.52081632653062,35,4,262,1,256
532,26,248,113.19727891156462,115.33351473922903,35,13,240,2,222
533,26,437,113.19727891156462,115.86757369614513,35,2,427,3,411
534,17,63,114.82267573696146,117.0053514739229,34,38,105,2,46
535,17,226,114.82267573696146,116.74993197278911,34,10,225,2,209
536,17,221,114.82267573696146,117.72517006802721,34,15,239,3,204
537,17,437,114.82267573696146,115.86757369614513,34,2,422,1,420
538,17,450,114.82267573696146,116.77315192743764,34,0,441,2,433
539,19,63,115.24063492063492,117.0053514739229,34,38,88,2,44
540,19,21,115.24063492063492,117.980589569161,34,39,118,3,2
541,19,226,115.24063492063492,116.74993197278911,34,10,217,2,207
542,19,221,115.24063492063492,117.72517006802721,34,15,229,2,202
543,19,450,115.24063492063492,116.77315192743764,34,0,436,2,431
544,19,427,115.24063492063492,117.86448979591837,34,7,423,3,408
545,19,427,115.24063492063492,118.07346938775511,34,9,426,3,408
546,63,91,117.0053514739229,118.93260770975057,38,38,88,2,28
547,63,21,117.0053514739229,119.6756462585034,38,38,122,3,42
548,63,273,117.0053514739229,118.9558276643991,38,17,226,2,210
549,63,285,117.0053514739229,119.53632653061224,38,18,247,3,222
550,63,427,117.0053514739229,118.07346938775511,38,9,367,1,364
551,63,499,117.0053514739229,119.90784580498867,38,4,454,3,436
552,21,89,117.980589569161,120.92952380952381,39,38,144,3,68
553,21,285,117.980589569161,119.53632653061224,39,18,272,2,264
554,21,279,117.980589569161,120.48834467120182,39,13,280,3,258
555,21,499,117.980589569161,119.90784580498867,39,4,485,2,478
556,21,410,117.980589569161,120.81342403628118,39,6,408,3,389
557,91,89,118.93260770975057,120.92952380952381,38,38,86,2,2
558,91,15,118.93260770975057,121.6261224489796,38,33,139,3,76
559,91,279,118.93260770975057,120.48834467120182,38,13,200,2,188
560,91,231,118.93260770975057,121.64934240362813,38,9,182,3,140
561,91,410,118.93260770975057,120.81342403628118,38,6,329,2,319
562,91,555,118.93260770975057,121.11528344671203,38,8,473,2,464
563,21,89,119.6756462585034,120.92952380952381,38,38,87,1,68
564,21,15,119.6756462585034,121.6261224489796,38,33,84,2,6
565,21,231,119.6756462585034,121.64934240362813,38,9,227,2,210
566,21,410,119.6756462585034,120.81342403628118,38,6,392,1,389
567,21,415,119.6756462585034,122.2530612244898,38,4,409,3,394
568,89,21,120.92952380952381,122.97287981859411,38,39,111,2,68
569,89,21,120.92952380952381,123.1354195011338,38,39,117,2,68
570,89,208,120.92952380952381,122.67102040816327,38,18,141,2,119
571,89,207,120.92952380952381,123.5998185941043,38,20,165,3,118
572,89,415,120.92952380952381,122.2530612244898,38,4,331,1,326
573,89,414,120.92952380952381,123.1354195011338,38,4,339,2,325
574,15,21,121.6261224489796,122.97287981859411,33,39,58,1,6
575,15,21,121.6261224489796,123.1354195011338,33,39,65,2,6
576,15,208,121.6261224489796,122.67102040816327,33,18,198,1,193
577,15,207,121.6261224489796,123.5998185941043,33,20,210,2,192
578,15,414,121.6261224489796,123.1354195011338,33,4,404,2,399
579,21,25,122.97287981859411,125.0162358276644,39,32,88,2,4
580,21,26,122.97287981859411,125.50385487528345,39,39,109,3,5
581,21,226,122.97287981859411,125.0162358276644,39,23,223,2,205
582,21,226,122.97287981859411,125.03945578231293,39,25,223,2,205
583,21,453,122.97287981859411,125.0162358276644,39,8,441,2,432
584,21,411,122.97287981859411,125.80571428571429,39,16,409,3,390
585,21,25,123.1354195011338,125.0162358276644,39,32,81,2,4
586,21,26,123.1354195011338,125.50385487528345,39,39,102,2,5
587,21,226,123.1354195011338,125.0162358276644,39,23,220,2,205
588,21,226,123.1354195011338,125.03945578231293,39,25,221,2,205
589,21,453,123.1354195011338,125.0162358276644,39,8,440,2,432
590,21,411,123.1354195011338,125.80571428571429,39,16,407,3,390
591,25,61,125.0162358276644,126.40943310657596,32,37,70,1,36
592,25,26,125.0162358276644,127.54721088435375,32,36,109,3,1
593,25,274,125.0162358276644,126.27011337868481,32,28,255,1,249
594,25,209,125.0162358276644,127.84907029478458,32,20,221,3,184
595,25,426,125.0162358276644,126.29333333333334,32,13,405,1,401
596,26,209,125.50385487528345,127.84907029478458,39,20,209,2,183
597,26,207,125.50385487528345,128.220589569161,39,24,216,3,181
598,26,438,125.50385487528345,128.01160997732427,39,9,426,3,412
599,26,497,125.50385487528345,128.03482993197278,39,12,483,3,471
600,61,26,126.40943310657596,127.54721088435375,37,36,60,1,35
601,61,102,126.40943310657596,128.89396825396827,37,38,115,2,41
602,61,209,126.40943310657596,127.84907029478458,37,20,160,1,148
603,61,207,126.40943310657596,128.220589569161,37,24,166,2,146
604,61,438,126.40943310657596,128.01160997732427,37,9,383,2,377
605,61,497,126.40943310657596,128.03482993197278,37,12,442,2,436
606,26,102,127.54721088435375,128.89396825396827,36,38,96,1,76
607,26,71,127.54721088435375,129.84598639455783,36,35,109,2,45
608,26,297,127.54721088435375,129.91564625850341,36,16,290,2,271
609,102,20,128.89396825396827,130.86766439909297,38,34,118,2,82
610,102,20,128.89396825396827,131.19274376417235,38,33,129,2,82
611,102,297,128.89396825396827,129.91564625850341,38,16,200,1,195
612,102,248,128.89396825396827,130.9837641723356,38,14,172,2,146
613,102,328,128.89396825396827,131.05342403628117,38,12,244,2,226
614,102,593,128.89396825396827,130.07818594104307,38,5,494,1,491
615,102,437,128.89396825396827,131.54104308390023,38,2,354,3,335
616,71,20,129.84598639455783,130.86766439909297,35,34,67,1,51
617,71,20,129.84598639455783,131.19274376417235,35,33,77,1,51
618,71,248,129.84598639455783,130.9837641723356,35,14,184,1,177
619,71,328,129.84598639455783,131.05342403628117,35,12,262,1,257
620,71,437,129.84598639455783,131.54104308390023,35,2,373,2,366
621,20,88,130.86766439909297,133.0271201814059,34,33,115,2,68
622,20,25,130.86766439909297,133.3986394557823,34,38,109,3,5
623,20,371,130.86766439909297,133.0271201814059,34,11,363,2,351
624,20,381,130.86766439909297,133.79337868480727,34,21,382,3,361
625,20,426,130.86766439909297,133.70049886621317,34,20,424,3,406
626,20,88,131.19274376417235,133.0271201814059,33,33,104,2,68
627,20,25,131.19274376417235,133.3986394557823,33,38,95,2,5
628,20,371,131.19274376417235,133.0271201814059,33,11,360,2,351
629,20,381,131.19274376417235,133.79337868480727,33,21,378,3,361
630,20,293,131.19274376417235,134.1184580498866,33,17,301,3,273
631,20,426,131.19274376417235,133.70049886621317,33,20,420,3,406
632,88,31,133.0271201814059,134.23455782312925,33,39,77,1,57
633,88,26,133.0271201814059,135.32589569161,33,40,117,2,62
634,88,293,133.0271201814059,134.1184580498866,33,17,210,1,205
635,88,285,133.0271201814059,135.6974149659864,33,11,228,3,197
636,88,507,133.0271201814059,134.42031746031745,33,13,423,1,419
637,25,26,133.3986394557823,135.32589569161,38,40,83,2,1
638,25,62,133.3986394557823,136.1618140589569,38,37,125,3,37
639,25,285,133.3986394557823,135.6974149659864,38,11,278,2,260
640,25,311,133.3986394557823,136.1618140589569,38,8,310,3,286
641,25,507,133.3986394557823,134.42031746031745,38,13,484,1,482
642,31,26,134.23455782312925,135.32589569161,39,40,47,1,5
643,31,62,134.23455782312925,136.1618140589569,39,37,89,2,31
644,31,285,134.23455782312925,135.6974149659864,39,11,262,1,254
645,31,311,134.23455782312925,136.1618140589569,39,8,292,2,280
646,31,426,134.23455782312925,136.8584126984127,39,5,411,3,395
647,31,411,134.23455782312925,137.09061224489795,39,10,399,3,380
648,26,23,135.32589569161,137.3924716553288,40,37,89,2,3
649,26,272,135.32589569161,137.9961904761905,40,16,272,3,246
650,26,205,135.32589569161,138.04263038548754,40,15,214,3,179
651,26,426,135.32589569161,136.8584126984127,40,5,405,2,400
652,26,411,135.32589569161,137.09061224489795,40,10,392,2,385
653,26,418,135.32589569161,138.0890702947846,40,3,410,3,392
654,62,23,136.1618140589569,137.3924716553288,37,37,66,1,39
655,62,20,136.1618140589569,138.59990929705216,37,36,113,2,42
656,62,272,136.1618140589569,137.9961904761905,37,16,224,2,210
657,62,205,136.1618140589569,138.04263038548754,37,15,164,2,143
658,62,369,136.1618140589569,139.11074829931974,37,7,332,3,307
659,62,418,136.1618140589569,138.0890702947846,37,3,366,2,356
660,23,20,137.3924716553288,138.59990929705216,37,36,52,1,3
661,23,17,137.3924716553288,139.36616780045352,37,37,85,2,6
662,23,369,137.3924716553288,139.11074829931974,37,7,354,2,346
663,20,15,138.59990929705216,141.01478458049885,36,34,104,2,5
664,20,15,138.59990929705216,141.06122448979593,36,36,106,2,5
665,20,205,138.59990929705216,140.50394557823128,36,8,202,2,185
666,17,15,139.36616780045352,141.01478458049885,37,34,71,2,2
667,17,15,139.36616780045352,141.06122448979593,37,36,73,2,2
668,17,205,139.36616780045352,140.50394557823128,37,8,194,1,188
669,17,205,139.36616780045352,141.9203628117914,37,9,218,3,188
670,15,20,141.01478458049885,142.8956009070295,34,38,81,2,5
671,15,20,141.01478458049885,143.05814058956918,34,33,88,2,5
672,15,248,141.01478458049885,142.7562811791383,34,14,245,2,233
673,15,208,141.01478458049885,143.31356009070296,34,7,217,2,193
674,15,437,141.01478458049885,143.1742403628118,34,4,432,2,422
675,15,20,141.06122448979593,142.8956009070295,36,38,79,2,5
676,15,20,141.06122448979593,143.05814058956918,36,33,86,2,5
677,15,248,141.06122448979593,142.7562811791383,36,14,244,2,233
678,15,208,141.06122448979593,143.31356009070296,36,7,216,2,193
679,15,437,141.06122448979593,143.1742403628118,36,4,432,2,422
680,20,8,142.8956009070295,144.91573696145124,38,41,88,2,12
681,20,7,142.8956009070295,145.12471655328798,38,41,97,2,13
682,20,205,142.8956009070295,144.91573696145124,38,25,204,2,185
683,20,411,142.8956009070295,144.91573696145124,38,18,401,2,391
684,20,8,143.05814058956918,144.91573696145124,33,41,81,2,12
685,20,7,143.05814058956918,145.12471655328798,33,41,90,2,13
686,20,205,143.05814058956918,144.91573696145124,33,25,202,2,185
687,20,206,143.05814058956918,145.91419501133788,33,26,223,3,186
688,20,411,143.05814058956918,144.91573696145124,33,18,399,2,391
689,20,411,143.05814058956918,145.89097505668934,33,14,410,3,391
690,8,47,144.91573696145124,146.4714739229025,41,38,78,2,39
691,8,78,144.91573696145124,147.19129251700681,41,40,120,2,70
692,8,257,144.91573696145124,146.07673469387754,41,19,254,1,249
693,8,208,144.91573696145124,147.77179138321995,41,15,235,3,200
694,8,412,144.91573696145124,146.05351473922903,41,13,407,1,404
695,8,411,144.91573696145124,147.05197278911564,41,8,413,2,403
696,7,47,145.12471655328798,146.4714739229025,41,38,70,1,40
697,7,78,145.12471655328798,147.19129251700681,41,40,114,2,71
698,7,208,145.12471655328798,147.77179138321995,41,15,231,3,201
699,7,411,145.12471655328798,147.05197278911564,41,8,412,2,404
700,47,8,146.4714739229025,148.81668934240363,38,42,108,2,39
701,47,7,146.4714739229025,149.28108843537416,38,38,127,3,40
702,47,208,146.4714739229025,147.77179138321995,38,15,170,1,161
703,47,288,146.4714739229025,148.81668934240363,38,17,261,2,241
704,47,413,146.4714739229025,148.72380952380954,38,11,379,2,366
705,78,8,147.19129251700681,148.81668934240363,40,42,99,2,70
706,78,7,147.19129251700681,149.28108843537416,40,38,115,2,71
707,78,288,147.19129251700681,148.81668934240363,40,17,221,2,210
708,78,215,147.19129251700681,150.02412698412698,40,26,183,3,137
709,78,214,147.19129251700681,150.04734693877552,40,27,183,3,136
710,78,413,147.19129251700681,148.72380952380954,40,11,341,2,335
711,78,413,147.19129251700681,149.79192743764173,40,24,353,3,335
712,78,411,147.19129251700681,150.14022675736962,40,19,356,3,333
713,8,23,148.81668934240363,150.34920634920636,42,37,68,2,15
714,8,215,148.81668934240363,150.02412698412698,42,26,213,1,207
715,8,214,148.81668934240363,150.04734693877552,42,27,213,1,206
716,8,411,148.81668934240363,150.14022675736962,42,19,407,1,403
717,7,23,149.28108843537416,150.34920634920636,38,37,49,1,16
718,7,23,149.28108843537416,152.02104308390022,38,36,119,3,16
719,7,212,149.28108843537416,151.97460317460317,38,18,236,3,205
720,7,420,149.28108843537416,151.8120634920635,38,11,427,3,413
721,23,9,150.34920634920636,152.67120181405895,37,41,101,2,14
722,23,7,150.34920634920636,153.08916099773242,37,40,119,3,16
723,23,212,150.34920634920636,151.97460317460317,37,18,202,2,189
724,23,310,150.34920634920636,152.39256235827665,37,13,300,2,287
725,23,420,150.34920634920636,151.8120634920635,37,11,402,1,397
726,23,435,150.34920634920636,152.6015419501134,37,10,423,2,412
727,23,7,152.02104308390022,153.08916099773242,36,40,49,1,16
728,23,26,152.02104308390022,154.08761904761906,36,39,89,2,3
729,23,380,152.02104308390022,153.97151927437642,36,17,367,2,357
730,23,210,152.02104308390022,154.83065759637188,36,22,223,3,187
731,23,430,152.02104308390022,153.97151927437642,36,11,416,2,407
732,23,428,152.02104308390022,154.15727891156462,36,15,415,2,405
733,9,26,152.67120181405895,154.08761904761906,41,39,63,1,17
734,9,21,152.67120181405895,155.5504761904762,41,38,125,3,12
735,9,380,152.67120181405895,153.97151927437642,41,17,375,1,371
736,9,210,152.67120181405895,154.83065759637188,41,22,221,2,201
737,9,430,152.67120181405895,153.97151927437642,41,11,425,1,421
738,9,428,152.67120181405895,154.15727891156462,41,15,424,1,419
739,9,447,152.67120181405895,155.6433560090703,41,14,456,3,438
740,7,21,153.08916099773242,155.5504761904762,40,38,107,2,14
741,7,210,153.08916099773242,154.83065759637188,40,22,216,2,203
742,7,223,153.08916099773242,155.80589569160998,40,25,246,3,216
743,7,428,153.08916099773242,154.15727891156462,40,15,424,1,421
744,7,447,153.08916099773242,155.6433560090703,40,14,454,3,440
745,26,21,154.08761904761906,155.5504761904762,39,38,63,1,5
746,26,8,154.08761904761906,156.75791383219956,39,41,116,3,18
747,26,223,154.08761904761906,155.80589569160998,39,25,210,2,197
748,26,208,154.08761904761906,156.22385487528345,39,20,204,2,182
749,26,447,154.08761904761906,155.6433560090703,39,14,426,2,421
750,26,411,154.08761904761906,156.40961451247165,39,10,398,2,385
751,21,8,155.5504761904762,156.75791383219956,38,41,54,1,13
752,21,25,155.5504761904762,157.80281179138322,38,38,97,2,4
753,21,228,155.5504761904762,157.91891156462586,38,23,231,2,207
754,21,416,155.5504761904762,157.57061224489797,38,19,404,2,395
755,21,428,155.5504761904762,158.17433106575965,38,21,422,3,407
756,8,25,156.75791383219956,157.80281179138322,41,38,48,1,17
757,8,23,156.75791383219956,158.82448979591837,41,39,90,2,15
758,8,21,156.75791383219956,159.45142857142858,41,38,117,3,13
759,8,228,156.75791383219956,157.91891156462586,41,23,226,1,220
760,8,216,156.75791383219956,158.70839002267573,41,24,224,2,208
761,8,206,156.75791383219956,159.07990929705215,41,15,222,2,198
762,8,428,156.75791383219956,158.17433106575965,41,21,424,1,420
763,8,460,156.75791383219956,159.05668934240364,41,5,463,2,452
764,25,23,157.80281179138322,158.82448979591837,38,39,44,1,2
765,25,21,157.80281179138322,159.45142857142858,38,38,71,2,4
766,25,9,157.80281179138322,160.56598639455783,38,42,120,3,16
767,25,206,157.80281179138322,159.07990929705215,38,15,189,1,181
768,25,460,157.80281179138322,159.05668934240364,38,5,438,1,435
769,23,9,158.82448979591837,160.56598639455783,39,42,76,2,14
770,23,7,158.82448979591837,161.0768253968254,39,37,98,2,16
771,23,206,158.82448979591837,160.8910657596372,39,9,203,2,183
772,23,427,158.82448979591837,161.56444444444446,39,7,421,3,404
773,21,9,159.45142857142858,160.56598639455783,38,42,49,1,12
774,21,7,159.45142857142858,161.0768253968254,38,37,71,2,14
775,21,26,159.45142857142858,162.2378231292517,38,37,120,3,5
776,21,206,159.45142857142858,160.8910657596372,38,9,195,1,185
777,21,303,159.45142857142858,162.02884353741496,38,15,303,3,282
778,21,237,159.45142857142858,162.2378231292517,38,20,247,3,216
779,21,427,159.45142857142858,161.56444444444446,38,7,416,2,406
780,21,421,159.45142857142858,162.2378231292517,38,12,418,3,400
781,9,26,160.56598639455783,162.2378231292517,42,37,74,2,17
782,9,69,160.56598639455783,163.3059410430839,42,37,132,3,60
783,9,303,160.56598639455783,162.02884353741496,42,15,301,1,294
784,9,237,160.56598639455783,162.2378231292517,42,20,239,2,228
785,9,421,160.56598639455783,162.2378231292517,42,12,418,2,412
786,7,26,161.0768253968254,162.2378231292517,37,37,53,1,19
787,7,69,161.0768253968254,163.3059410430839,37,37,114,2,62
788,7,237,161.0768253968254,162.2378231292517,37,20,235,1,230
789,7,219,161.0768253968254,163.9328798185941,37,22,245,3,212
790,7,272,161.0768253968254,164.04897959183674,37,19,294,3,265
791,7,421,161.0768253968254,162.2378231292517,37,12,417,1,414
792,7,431,161.0768253968254,163.63102040816327,37,10,438,3,424
793,26,69,162.2378231292517,163.3059410430839,37,37,63,1,43
794,26,7,162.2378231292517,164.79201814058956,37,41,112,3,19
795,26,219,162.2378231292517,163.9328798185941,37,22,206,2,193
796,26,272,162.2378231292517,164.04897959183674,37,19,258,2,246
797,26,431,162.2378231292517,163.63102040816327,37,10,409,1,405
798,26,420,162.2378231292517,164.76879818594105,37,17,409,3,394
799,26,418,162.2378231292517,165.14031746031748,37,18,411,3,392
800,69,7,163.3059410430839,164.79201814058956,37,41,89,1,62
801,69,34,163.3059410430839,165.48861678004536,37,37,100,2,35
802,69,14,163.3059410430839,166.16199546485262,37,37,135,3,55
803,69,213,163.3059410430839,165.41895691609977,37,26,170,2,144
804,69,420,163.3059410430839,164.76879818594105,37,17,357,1,351
805,69,418,163.3059410430839,165.14031746031748,37,18,358,2,349
806,7,14,164.79201814058956,166.16199546485262,41,37,59,1,7
807,7,208,164.79201814058956,166.48707482993197,41,18,214,2,201
808,7,366,164.79201814058956,167.20689342403628,41,14,374,2,359
809,34,26,165.48861678004536,167.857052154195,37,38,102,2,8
810,34,366,165.48861678004536,167.20689342403628,37,14,340,2,332
811,34,306,165.48861678004536,168.13569160997733,37,8,295,3,272
812,14,26,166.16199546485262,167.857052154195,37,38,74,2,12
813,14,8,166.16199546485262,168.48399092970521,37,42,100,2,6
814,14,366,166.16199546485262,167.20689342403628,37,14,355,1,352
815,14,306,166.16199546485262,168.13569160997733,37,8,304,2,292
816,26,25,167.857052154195,169.99328798185942,38,37,92,2,1
817,26,70,167.857052154195,170.504126984127,38,37,122,3,44
818,26,330,167.857052154195,169.7843083900227,38,17,315,2,304
819,26,222,167.857052154195,170.3415873015873,38,28,223,2,196
820,26,413,167.857052154195,170.03972789115647,38,10,398,2,387
821,26,428,167.857052154195,170.27192743764172,38,21,415,2,402
822,8,25,168.48399092970521,169.99328798185942,42,37,67,2,17
823,8,70,168.48399092970521,170.504126984127,42,37,107,2,62
824,8,330,168.48399092970521,169.7843083900227,42,17,327,1,322
825,8,222,168.48399092970521,170.3415873015873,42,28,228,2,214
826,8,413,168.48399092970521,170.03972789115647,42,10,411,2,405
827,8,428,168.48399092970521,170.27192743764172,42,21,427,2,420
828,25,24,169.99328798185942,171.96698412698413,37,38,85,2,1
829,25,8,169.99328798185942,172.40816326530611,37,41,105,2,17
830,25,226,169.99328798185942,171.5025850340136,37,25,211,2,201
831,25,226,169.99328798185942,172.12952380952382,37,22,221,2,201
832,25,452,169.99328798185942,171.4793650793651,37,9,432,1,427
833,25,418,169.99328798185942,172.2920634920635,37,9,405,2,393
834,70,24,170.504126984127,171.96698412698413,37,38,78,1,46
835,70,8,170.504126984127,172.40816326530611,37,41,103,2,62
836,70,226,170.504126984127,172.12952380952382,37,22,171,2,156
837,70,418,170.504126984127,172.2920634920635,37,9,356,2,348
838,24,51,171.96698412698413,173.638820861678,38,36,77,2,27
839,24,51,171.96698412698413,174.2657596371882,38,35,103,2,27
840,24,283,171.96698412698413,173.6156009070295,38,19,269,2,259
841,24,205,171.96698412698413,174.4515192743764,38,14,210,2,181
842,24,411,171.96698412698413,173.59238095238095,38,8,393,2,387
843,24,432,171.96698412698413,174.38185941043085,38,4,421,2,408
844,8,51,172.40816326530611,173.638820861678,41,36,68,1,43
845,8,51,172.40816326530611,174.2657596371882,41,35,91,2,43
846,8,21,172.40816326530611,175.10167800453516,41,38,117,3,13
847,8,283,172.40816326530611,173.6156009070295,41,19,280,1,275
848,8,205,172.40816326530611,174.4515192743764,41,14,216,2,197
849,8,411,172.40816326530611,173.59238095238095,41,8,406,1,403
850,8,432,172.40816326530611,174.38185941043085,41,4,432,2,424
851,8,427,172.40816326530611,175.21777777777777,41,6,436,3,419
852,51,21,173.638820861678,175.10167800453516,36,38,70,1,30
853,51,8,173.638820861678,176.4019954648526,36,43,127,3,43
854,51,285,173.638820861678,175.79827664399093,36,16,252,2,234
855,51,427,173.638820861678,175.21777777777777,36,6,382,2,376
856,51,419,173.638820861678,176.16979591836736,36,1,384,3,368
857,51,8,174.2657596371882,176.4019954648526,35,43,102,2,43
858,51,285,174.2657596371882,175.79827664399093,35,16,243,2,234
859,51,205,174.2657596371882,177.02893424036282,35,10,195,3,154
860,51,419,174.2657596371882,176.16979591836736,35,1,377,2,368
861,21,8,175.10167800453516,176.4019954648526,38,43,57,1,13
862,21,25,175.10167800453516,177.3772335600907,38,38,98,2,4
863,21,205,175.10167800453516,177.02893424036282,38,10,202,2,184
864,21,278,175.10167800453516,177.70231292517008,38,24,280,3,257
865,21,419,175.10167800453516,176.16979591836736,38,1,401,1,398
866,21,440,175.10167800453516,177.5397732426304,38,12,432,2,419
867,8,23,176.4019954648526,179.00263038548752,43,37,113,3,15
868,8,278,176.4019954648526,177.70231292517008,43,24,276,1,270
869,8,207,176.4019954648526,178.77043083900227,43,27,224,2,199
870,8,208,176.4019954648526,179.09551020408165,43,23,231,3,200
871,8,440,176.4019954648526,177.5397732426304,43,12,435,1,432
872,8,432,176.4019954648526,178.1899319727891,43,12,431,2,424
873,8,420,176.4019954648526,179.2580498866213,43,14,430,3,412
874,25,23,177.3772335600907,179.00263038548752,38,37,70,2,2
875,25,9,177.3772335600907,180.0475283446712,38,39,116,3,16
876,25,8,177.3772335600907,180.16362811791385,38,42,121,3,17
877,25,207,177.3772335600907,178.77043083900227,38,27,192,1,182
878,25,208,177.3772335600907,179.09551020408165,38,23,197,2,183
879,25,420,177.3772335600907,179.2580498866213,38,14,403,2,395
880,23,9,179.00263038548752,180.0475283446712,37,39,47,1,14
881,23,8,179.00263038548752,180.16362811791385,37,42,52,1,15
882,23,34,179.00263038548752,181.39428571428573,37,39,104,2,11
883,23,308,179.00263038548752,180.90666666666667,37,20,297,2,285
884,23,210,179.00263038548752,181.3014058956916,37,30,212,2,187
885,23,410,179.00263038548752,180.90666666666667,37,11,396,2,387
886,23,411,179.00263038548752,181.23174603174604,37,20,400,2,388
887,9,34,180.0475283446712,181.39428571428573,39,39,63,1,25
888,9,36,180.0475283446712,182.6249433106576,39,35,114,3,27
889,9,210,180.0475283446712,181.3014058956916,39,30,208,1,201
890,9,246,180.0475283446712,182.9732426303855,39,10,268,3,237
891,9,411,180.0475283446712,181.23174603174604,39,20,405,1,402
892,9,419,180.0475283446712,182.8107029478458,39,5,427,3,410
893,8,34,180.16362811791385,181.39428571428573,42,39,59,1,26
894,8,36,180.16362811791385,182.6249433106576,42,35,110,2,28
895,8,210,180.16362811791385,181.3014058956916,42,30,208,1,202
896,8,246,180.16362811791385,182.9732426303855,42,10,267,3,238
897,8,411,180.16362811791385,181.23174603174604,42,20,406,1,403
898,8,419,180.16362811791385,182.8107029478458,42,5,427,3,411
899,34,36,181.39428571428573,182.6249433106576,39,35,53,1,2
900,34,8,181.39428571428573,184.0413605442177,39,41,117,3,26
901,34,8,181.39428571428573,184.15746031746033,39,42,122,3,26
902,34,246,181.39428571428573,182.9732426303855,39,10,223,2,212
903,34,205,181.39428571428573,183.41442176870748,39,11,192,2,171
904,34,419,181.39428571428573,182.8107029478458,39,5,390,1,385
905,34,410,181.39428571428573,183.55374149659863,39,2,387,2,376
906,36,8,182.6249433106576,184.0413605442177,35,41,67,1,28
907,36,8,182.6249433106576,184.15746031746033,35,42,72,2,28
908,36,5,182.6249433106576,185.06303854875284,35,35,109,2,31
909,36,324,182.6249433106576,185.0165986394558,35,9,306,2,288
910,36,325,182.6249433106576,185.50421768707483,35,11,314,3,289
911,8,5,184.0413605442177,185.06303854875284,41,35,44,1,3
912,8,21,184.0413605442177,186.9206349206349,41,41,125,3,13
913,8,325,184.0413605442177,185.50421768707483,41,11,323,1,317
914,8,230,184.0413605442177,186.78131519274376,41,20,251,3,222
915,8,493,184.0413605442177,186.47945578231293,41,2,496,2,485
916,8,21,184.15746031746033,186.9206349206349,42,41,120,3,13
917,8,325,184.15746031746033,185.50421768707483,42,11,322,1,317
918,8,230,184.15746031746033,186.78131519274376,42,20,249,3,222
919,8,292,184.15746031746033,187.12961451247165,42,7,312,3,284
920,8,493,184.15746031746033,186.47945578231293,42,2,495,2,485
921,5,21,185.06303854875284,186.9206349206349,35,41,82,2,16
922,5,7,185.06303854875284,187.31537414965987,35,42,97,2,2
923,5,230,185.06303854875284,186.78131519274376,35,20,237,2,225
924,5,292,185.06303854875284,187.12961451247165,35,7,300,2,287
925,5,493,185.06303854875284,186.47945578231293,35,2,492,1,488
926,5,491,185.06303854875284,187.91909297052155,35,0,501,3,486
927,21,9,186.9206349206349,188.22095238095238,41,35,57,1,12
928,21,207,186.9206349206349,188.778231292517,41,9,202,2,186
929,21,206,186.9206349206349,189.89278911564625,41,5,225,3,185
930,7,9,187.31537414965987,190.03210884353743,42,33,117,3,2
931,7,9,187.31537414965987,190.12498866213153,42,35,121,3,2
932,7,207,187.31537414965987,188.778231292517,42,9,210,1,200
933,7,206,187.31537414965987,189.89278911564625,42,5,228,3,199
934,9,206,188.22095238095238,189.89278911564625,35,5,210,2,197
935,9,207,188.22095238095238,190.75192743764174,35,10,226,3,198
936,9,8,190.03210884353743,191.5181859410431,33,42,64,1,1
937,9,6,190.03210884353743,192.14512471655328,33,38,91,2,3
938,9,245,190.03210884353743,192.00580498866213,33,10,251,2,236
939,9,306,190.03210884353743,192.44698412698412,33,12,315,2,297
940,9,8,190.12498866213153,191.5181859410431,35,42,60,1,1
941,9,6,190.12498866213153,192.14512471655328,35,38,87,2,3
942,9,245,190.12498866213153,192.00580498866213,35,10,250,2,236
943,9,306,190.12498866213153,192.44698412698412,35,12,313,2,297
944,8,23,191.5181859410431,193.77052154195013,42,31,98,2,15
945,8,248,191.5181859410431,193.70086167800454,42,14,258,2,240
946,8,437,191.5181859410431,194.23492063492063,42,1,445,3,429
947,6,23,192.14512471655328,193.77052154195013,38,31,72,2,17
948,6,8,192.14512471655328,194.88507936507938,38,42,118,3,2
949,6,248,192.14512471655328,193.70086167800454,38,14,251,2,242
950,6,232,192.14512471655328,194.67609977324264,38,10,251,3,226
951,6,437,192.14512471655328,194.23492063492063,38,1,440,2,431
952,23,8,193.77052154195013,194.88507936507938,31,42,50,1,15
953,23,7,193.77052154195013,195.16371882086167,31,42,62,1,16
954,23,9,193.77052154195013,196.0692970521542,31,35,100,2,14
955,23,205,193.77052154195013,195.67455782312925,31,11,200,2,182
956,23,246,193.77052154195013,196.30149659863946,31,7,248,3,223
957,8,9,194.88507936507938,196.0692970521542,42,35,51,1,1
958,8,246,194.88507936507938,196.30149659863946,42,7,246,1,238
959,8,246,194.88507936507938,197.1374149659864,42,12,257,2,238
960,8,410,194.88507936507938,196.83555555555557,42,7,411,2,402
961,8,411,194.88507936507938,197.5089342403628,42,6,419,3,403
962,7,9,195.16371882086167,197.92689342403628,42,35,119,3,2
963,7,246,195.16371882086167,196.30149659863946,42,7,244,1,239
964,7,246,195.16371882086167,197.1374149659864,42,12,254,2,239
965,7,410,195.16371882086167,196.83555555555557,42,7,409,2,403
966,7,411,195.16371882086167,197.5089342403628,42,6,416,2,404
967,7,411,195.16371882086167,198.06621315192743,42,3,423,3,404
968,9,8,196.0692970521542,198.43773242630385,35,42,102,2,1
969,9,246,196.0692970521542,197.1374149659864,35,12,241,1,237
970,9,246,196.0692970521542,198.6467120181406,35,10,262,3,237
971,9,411,196.0692970521542,197.5089342403628,35,6,407,1,402
972,9,411,196.0692970521542,198.06621315192743,35,3,411,2,402
973,9,5,197.92689342403628,199.2039909297052,35,37,55,1,4
974,9,13,197.92689342403628,200.31854875283446,35,35,103,2,4
975,9,246,197.92689342403628,199.50585034013605,35,11,247,2,237
976,9,306,197.92689342403628,200.2721088435374,35,11,314,2,297
977,9,411,197.92689342403628,199.15755102040816,35,6,405,1,402
978,8,13,198.43773242630385,200.31854875283446,42,35,81,2,5
979,8,246,198.43773242630385,199.50585034013605,42,11,242,1,238
980,8,306,198.43773242630385,200.2721088435374,42,11,308,2,298
981,5,13,199.2039909297052,200.31854875283446,37,35,49,1,8
982,5,8,199.2039909297052,201.87428571428572,37,43,115,3,3
983,5,7,199.2039909297052,202.08326530612246,37,41,124,3,2
984,5,306,199.2039909297052,200.2721088435374,37,11,304,1,301
985,5,248,199.2039909297052,201.52598639455783,37,14,263,2,243
986,5,414,199.2039909297052,201.54920634920634,37,2,421,2,409
987,13,8,200.31854875283446,201.87428571428572,35,43,67,2,5
988,13,7,200.31854875283446,202.08326530612246,35,41,76,2,6
989,13,248,200.31854875283446,201.52598639455783,35,14,241,1,235
990,13,206,200.31854875283446,202.45478458049888,35,14,214,2,193
991,13,414,200.31854875283446,201.54920634920634,35,2,404,1,401
992,13,411,200.31854875283446,202.64054421768708,35,1,410,2,398
993,8,26,201.87428571428572,204.66068027210883,43,39,121,3,18
994,8,228,201.87428571428572,203.61578231292518,43,25,232,2,220
995,8,207,201.87428571428572,204.7071201814059,43,28,233,3,199
996,8,420,201.87428571428572,203.6390022675737,43,21,419,2,412
997,8,415,201.87428571428572,204.7071201814059,43,20,425,3,407
998,7,8,202.08326530612246,203.77832199546486,41,41,73,2,1
999,7,26,202.08326530612246,204.66068027210883,41,39,113,3,19
1000,7,228,202.08326530612246,203.61578231292518,41,25,231,2,221
1001,7,207,202.08326530612246,204.7071201814059,41,28,230,3,200
1002,7,420,202.08326530612246,203.6390022675737,41,21,418,2,413
1003,7,415,202.08326530612246,204.7071201814059,41,20,423,3,408
1004,8,78,203.77832199546486,206.0306575963719,41,38,120,2,70
1005,8,277,203.77832199546486,205.84489795918367,41,23,283,2,269
1006,8,285,203.77832199546486,206.07709750566895,41,13,294,2,277
1007,8,410,203.77832199546486,205.63591836734693,41,14,410,2,402
1008,26,78,204.66068027210883,206.0306575963719,39,38,79,1,52
1009,26,9,204.66068027210883,207.00589569161,39,40,102,2,17
1010,26,8,204.66068027210883,207.23809523809524,39,42,112,3,18
1011,26,277,204.66068027210883,205.84489795918367,39,23,256,1,251
1012,26,285,204.66068027210883,206.07709750566895,39,13,266,1,259
1013,26,431,204.66068027210883,207.58639455782313,39,18,424,3,405
1014,78,8,206.0306575963719,207.23809523809524,38,42,87,1,70
1015,78,281,206.0306575963719,207.8418140589569,38,22,217,2,203
1016,78,232,206.0306575963719,208.9099319727891,38,27,198,3,154
1017,78,431,206.0306575963719,207.58639455782313,38,18,359,2,353
1018,78,417,206.0306575963719,208.93315192743765,38,22,361,3,339
1019,9,23,207.00589569161,209.0492517006803,40,39,89,2,14
1020,9,23,207.00589569161,209.0724716553288,40,39,90,2,14
1021,9,232,207.00589569161,208.9099319727891,40,27,238,2,223
1022,9,296,207.00589569161,209.28145124716553,40,24,303,2,287
1023,9,417,207.00589569161,208.93315192743765,40,22,416,2,408
1024,9,410,207.00589569161,209.30467120181407,40,22,413,2,401
1025,8,23,207.23809523809524,209.0492517006803,42,39,79,2,15
1026,8,23,207.23809523809524,209.0724716553288,42,39,80,2,15
1027,8,232,207.23809523809524,208.9099319727891,42,27,235,2,224
1028,8,296,207.23809523809524,209.28145124716553,42,24,301,2,288
1029,8,417,207.23809523809524,208.93315192743765,42,22,415,2,409
1030,8,410,207.23809523809524,209.30467120181407,42,22,412,2,402
1031,23,9,209.0492517006803,210.90684807256235,39,39,81,2,14
1032,23,7,209.0492517006803,211.44090702947847,39,42,104,2,16
1033,23,232,209.0492517006803,210.72108843537416,39,19,221,2,209
1034,23,275,209.0492517006803,212.0214058956916,39,22,283,3,252
1035,23,410,209.0492517006803,210.65142857142857,39,10,393,2,387
1036,23,459,209.0492517006803,211.39446712018142,39,10,448,2,436
1037,23,9,209.0724716553288,210.90684807256235,39,39,80,2,14
1038,23,7,209.0724716553288,211.44090702947847,39,42,103,2,16
1039,23,232,209.0724716553288,210.72108843537416,39,19,221,2,209
1040,23,275,209.0724716553288,212.0214058956916,39,22,282,3,252
1041,23,410,209.0724716553288,210.65142857142857,39,10,393,2,387
1042,23,459,209.0724716553288,211.39446712018142,39,10,447,2,436
1043,9,26,210.90684807256235,212.95020408163265,39,39,90,2,17
1044,9,51,210.90684807256235,213.67002267573696,39,38,126,3,42
1045,9,275,210.90684807256235,212.0214058956916,39,22,270,1,266
1046,9,307,210.90684807256235,213.01986394557824,39,19,312,2,298
1047,9,281,210.90684807256235,213.67002267573696,39,25,297,3,272
1048,9,410,210.90684807256235,212.9966439909297,39,20,411,2,401
1049,9,410,210.90684807256235,213.67002267573696,39,15,418,3,401
1050,7,26,211.44090702947847,212.95020408163265,42,39,68,2,19
1051,7,51,211.44090702947847,213.67002267573696,42,38,106,2,44
1052,7,21,211.44090702947847,214.34340136054422,42,37,126,3,14
1053,7,307,211.44090702947847,213.01986394557824,42,19,308,2,300
1054,7,281,211.44090702947847,213.67002267573696,42,25,290,2,274
1055,7,410,211.44090702947847,212.9966439909297,42,20,409,2,403
1056,7,410,211.44090702947847,213.67002267573696,42,15,414,2,403
1057,26,21,212.95020408163265,214.34340136054422,39,37,60,1,5
1058,26,8,212.95020408163265,215.36507936507937,39,42,106,2,18
1059,26,210,212.95020408163265,214.97034013605443,39,23,204,2,184
1060,26,206,212.95020408163265,215.22575963718822,39,26,205,2,180
1061,26,428,212.95020408163265,214.62204081632655,39,16,408,2,402
1062,26,411,212.95020408163265,215.22575963718822,39,17,397,2,385
1063,51,8,213.67002267573696,215.36507936507937,38,42,85,2,43
1064,51,210,213.67002267573696,214.97034013605443,38,23,169,1,159
1065,51,206,213.67002267573696,215.22575963718822,38,26,169,2,155
1066,51,411,213.67002267573696,215.22575963718822,38,17,366,2,360
1067,21,8,214.34340136054422,215.36507936507937,37,42,46,1,13
1068,21,77,214.34340136054422,216.87437641723358,37,39,123,3,56
1069,21,279,214.34340136054422,216.68861678004535,37,25,277,2,258
1070,21,420,214.34340136054422,216.9904761904762,37,20,415,3,399
1071,8,77,215.36507936507937,216.87437641723358,42,39,95,2,69
1072,8,23,215.36507936507937,217.6174149659864,42,38,98,2,15
1073,8,279,215.36507936507937,216.68861678004535,42,25,277,1,271
1074,8,212,215.36507936507937,217.50131519274376,42,26,224,2,204
1075,8,420,215.36507936507937,216.9904761904762,42,20,418,2,412
1076,8,417,215.36507936507937,217.38521541950115,42,18,418,2,409
1077,77,8,216.87437641723358,218.91773242630387,39,42,112,2,69
1078,77,7,216.87437641723358,219.08027210884353,39,40,118,2,70
1079,77,364,216.87437641723358,218.56943310657596,39,20,296,2,287
1080,77,249,216.87437641723358,219.19637188208617,39,11,199,2,172
1081,77,483,216.87437641723358,218.45333333333335,39,10,412,2,406
1082,77,471,216.87437641723358,219.19637188208617,39,5,406,2,394
1083,23,8,217.6174149659864,218.91773242630387,38,42,58,1,15
1084,23,7,217.6174149659864,219.08027210884353,38,40,65,1,16
1085,23,91,217.6174149659864,220.31092970521541,38,38,134,3,68
1086,23,249,217.6174149659864,219.19637188208617,38,11,236,2,226
1087,23,471,217.6174149659864,219.19637188208617,38,5,453,2,448
1088,23,410,217.6174149659864,220.35736961451246,38,10,405,3,387
1089,8,91,218.91773242630387,220.31092970521541,42,38,102,1,83
1090,8,75,218.91773242630387,221.30938775510205,42,36,123,2,67
1091,8,231,218.91773242630387,220.98430839002268,42,21,240,2,223
1092,8,208,218.91773242630387,221.49514739229025,42,25,229,3,200
1093,8,410,218.91773242630387,220.35736961451246,42,10,407,1,402
1094,8,426,218.91773242630387,221.2861678004535,42,16,430,2,418
1095,7,91,219.08027210884353,220.31092970521541,40,38,99,1,84
1096,7,75,219.08027210884353,221.30938775510205,40,36,118,2,68
1097,7,231,219.08027210884353,220.98430839002268,40,21,239,2,224
1098,7,208,219.08027210884353,221.49514739229025,40,25,226,2,201
1099,7,410,219.08027210884353,220.35736961451246,40,10,407,1,403
1100,7,426,219.08027210884353,221.2861678004535,40,16,430,2,419
1101,91,7,220.31092970521541,223.0508843537415,38,41,145,3,84
1102,91,7,220.31092970521541,223.07410430839002,38,41,146,3,84
1103,91,208,220.31092970521541,221.49514739229025,38,25,128,1,117
1104,91,248,220.31092970521541,222.6097052154195,38,24,186,2,157
1105,91,433,220.31092970521541,222.6097052154195,38,13,356,2,342
1106,75,7,221.30938775510205,223.0508843537415,36,41,101,2,68
1107,75,7,221.30938775510205,223.07410430839002,36,41,102,2,68
1108,75,34,221.30938775510205,224.2118820861678,36,39,132,3,41
1109,75,248,221.30938775510205,222.6097052154195,36,24,182,1,173
1110,75,315,221.30938775510205,223.95646258503402,36,22,266,3,240
1111,75,433,221.30938775510205,222.6097052154195,36,13,362,1,358
1112,75,420,221.30938775510205,223.95646258503402,36,12,363,3,345
1113,7,34,223.0508843537415,224.2118820861678,41,39,57,1,27
1114,7,35,223.0508843537415,225.32643990929705,41,40,102,2,28
1115,7,244,223.0508843537415,224.3047619047619,41,23,243,1,237
1116,7,212,223.0508843537415,225.65151927437643,41,20,234,3,205
1117,7,419,223.0508843537415,224.32798185941044,41,7,416,1,412
1118,7,34,223.07410430839002,224.2118820861678,41,39,56,1,27
1119,7,35,223.07410430839002,225.32643990929705,41,40,101,2,28
1120,7,244,223.07410430839002,224.3047619047619,41,23,243,1,237
1121,7,212,223.07410430839002,225.65151927437643,41,20,233,3,205
1122,7,419,223.07410430839002,224.32798185941044,41,7,416,1,412
1123,34,35,224.2118820861678,225.32643990929705,39,40,48,1,1
1124,34,9,224.2118820861678,227.0679365079365,39,40,126,3,25
1125,34,212,224.2118820861678,225.65151927437643,39,20,188,1,178
1126,34,267,224.2118820861678,226.0694784580499,39,18,246,2,233
1127,34,507,224.2118820861678,226.04625850340136,39,17,480,2,473
1128,34,507,224.2118820861678,226.0694784580499,39,20,480,2,473
1129,35,9,225.32643990929705,227.0679365079365,40,40,79,2,26
1130,35,7,225.32643990929705,227.50911564625852,40,42,98,2,28
1131,35,290,225.32643990929705,228.06639455782314,40,17,281,3,255
1132,35,435,225.32643990929705,228.06639455782314,40,12,417,3,400
1133,9,26,227.0679365079365,228.57723356009072,40,37,67,2,17
1134,9,78,227.0679365079365,229.2041723356009,40,37,115,2,69
1135,9,208,227.0679365079365,228.97197278911565,40,29,215,2,199
1136,9,207,227.0679365079365,229.0880725623583,40,27,216,2,198
1137,9,414,227.0679365079365,229.04163265306124,40,24,414,2,405
1138,9,424,227.0679365079365,229.13451247165534,40,20,424,2,415
1139,7,26,227.50911564625852,228.57723356009072,42,37,50,1,19
1140,7,78,227.50911564625852,229.2041723356009,42,37,102,2,71
1141,7,208,227.50911564625852,228.97197278911565,42,29,211,1,201
1142,7,207,227.50911564625852,229.0880725623583,42,27,211,2,200
1143,7,414,227.50911564625852,229.04163265306124,42,24,412,2,407
1144,7,424,227.50911564625852,229.13451247165534,42,20,423,2,417
1145,26,9,228.57723356009072,231.01532879818595,37,40,106,2,17
1146,26,8,228.57723356009072,231.17786848072564,37,41,113,3,18
1147,26,207,228.57723356009072,231.03854875283446,37,28,210,2,181
1148,26,208,228.57723356009072,231.08498866213154,37,27,212,3,182
1149,26,411,228.57723356009072,230.9688888888889,37,19,399,2,385
1150,26,416,228.57723356009072,231.08498866213154,37,17,405,3,390
1151,78,9,229.2041723356009,231.01532879818595,37,40,104,2,69
1152,78,8,229.2041723356009,231.17786848072564,37,41,110,2,70
1153,78,207,229.2041723356009,231.03854875283446,37,28,151,2,129
1154,78,208,229.2041723356009,231.08498866213154,37,27,153,2,130
1155,78,411,229.2041723356009,230.9688888888889,37,19,342,2,333
1156,78,416,229.2041723356009,231.08498866213154,37,17,348,2,338
1157,78,424,229.2041723356009,232.08344671201814,37,11,368,3,346
1158,9,52,231.01532879818595,232.45496598639457,40,38,75,1,43
1159,9,51,231.01532879818595,233.08190476190478,40,36,98,2,42
1160,9,289,231.01532879818595,232.33886621315193,40,21,286,1,280
1161,9,277,231.01532879818595,233.8946031746032,40,18,295,3,268
1162,9,424,231.01532879818595,232.08344671201814,40,11,418,1,415
1163,8,52,231.17786848072564,232.45496598639457,41,38,70,1,44
1164,8,51,231.17786848072564,233.08190476190478,41,36,93,2,43
1165,8,289,231.17786848072564,232.33886621315193,41,21,285,1,281
1166,8,277,231.17786848072564,233.8946031746032,41,18,293,3,269
1167,8,417,231.17786848072564,234.05714285714285,41,13,427,3,409
1168,8,417,231.17786848072564,234.0803628117914,41,11,428,3,409
1169,52,8,232.45496598639457,234.5447619047619,38,41,100,2,44
1170,52,7,232.45496598639457,235.078820861678,38,37,122,3,45
1171,52,277,232.45496598639457,233.8946031746032,38,18,233,1,225
1172,52,289,232.45496598639457,234.24290249433108,38,16,249,2,237
1173,52,417,232.45496598639457,234.05714285714285,38,13,371,2,365
1174,52,417,232.45496598639457,234.0803628117914,38,11,372,2,365
1175,51,8,233.08190476190478,234.5447619047619,36,41,76,1,43
1176,51,7,233.08190476190478,235.078820861678,36,37,97,2,44
1177,51,289,233.08190476190478,234.24290249433108,36,16,243,1,238
1178,51,365,233.08190476190478,236.00761904761904,36,15,338,3,314
1179,51,412,233.08190476190478,236.03083900226758,36,3,383,3,361
1180,8,26,234.5447619047619,236.33269841269842,41,38,79,2,18
1181,8,365,234.5447619047619,236.00761904761904,41,15,363,1,357
1182,8,207,234.5447619047619,236.44879818594106,41,23,215,2,199
1183,8,412,234.5447619047619,236.03083900226758,41,3,409,1,404
1184,8,412,234.5447619047619,236.402358276644,41,15,412,2,404
1185,7,26,235.078820861678,236.33269841269842,37,38,57,1,19
1186,7,23,235.078820861678,237.67945578231294,37,35,113,3,16
1187,7,207,235.078820861678,236.44879818594106,37,23,209,1,200
1188,7,209,235.078820861678,237.54013605442177,37,23,228,2,202
1189,7,412,235.078820861678,236.402358276644,37,15,409,1,405
1190,7,428,235.078820861678,237.8187755102041,37,13,437,3,421
1191,26,23,236.33269841269842,237.67945578231294,38,35,58,1,3
1192,26,8,236.33269841269842,238.5618140589569,38,41,98,2,18
1193,26,209,236.33269841269842,237.54013605442177,38,23,190,1,183
1194,26,404,236.33269841269842,238.5618140589569,38,18,390,2,378
1195,26,428,236.33269841269842,237.8187755102041,38,13,407,1,402
1196,26,435,236.33269841269842,238.5618140589569,38,10,420,2,409
1197,23,69,237.67945578231294,239.72281179138324,35,39,99,2,46
1198,23,34,237.67945578231294,240.25687074829932,35,38,112,3,11
1199,23,209,237.67945578231294,239.95501133786848,35,28,210,2,186
1200,23,209,237.67945578231294,240.11755102040817,35,30,214,2,186
1201,23,416,237.67945578231294,240.07111111111112,35,19,406,2,393
1202,23,417,237.67945578231294,240.11755102040817,35,25,408,2,394
1203,8,69,238.5618140589569,239.72281179138324,41,39,79,1,61
1204,8,34,238.5618140589569,240.25687074829932,41,38,77,2,26
1205,8,35,238.5618140589569,241.34820861678006,41,38,123,3,27
1206,8,209,238.5618140589569,239.95501133786848,41,28,210,1,201
1207,8,209,238.5618140589569,240.11755102040817,41,30,212,2,201
1208,8,277,238.5618140589569,241.32498866213152,41,21,294,3,269
1209,8,416,238.5618140589569,240.07111111111112,41,19,413,2,408
1210,8,417,238.5618140589569,240.11755102040817,41,25,414,2,409
1211,69,35,239.72281179138324,241.34820861678006,39,38,78,2,34
1212,69,277,239.72281179138324,241.32498866213152,39,21,219,2,208
1213,69,468,239.72281179138324,241.62684807256235,39,9,407,2,399
1214,69,411,239.72281179138324,242.32344671201815,39,5,360,3,342
1215,34,35,240.25687074829932,241.34820861678006,38,38,47,1,1
1216,34,8,240.25687074829932,242.85750566893424,38,42,115,3,26
1217,34,8,240.25687074829932,243.0897052154195,38,39,125,3,26
1218,34,277,240.25687074829932,241.32498866213152,38,21,247,1,243
1219,34,209,240.25687074829932,242.9039455782313,38,15,209,3,175
1220,34,468,240.25687074829932,241.62684807256235,38,9,438,1,434
1221,34,411,240.25687074829932,242.32344671201815,38,5,387,2,377
1222,35,8,241.34820861678006,242.85750566893424,38,42,70,2,27
1223,35,8,241.34820861678006,243.0897052154195,38,39,80,2,27
1224,35,209,241.34820861678006,242.9039455782313,38,15,186,2,174
1225,35,324,241.34820861678006,243.80952380952382,38,11,308,2,289
1226,35,325,241.34820861678006,244.27392290249435,38,12,316,3,290
1227,35,454,241.34820861678006,243.3683446712018,38,1,428,2,419
1228,8,13,242.85750566893424,245.06340136054422,42,30,95,2,5
1229,8,20,242.85750566893424,245.55102040816328,42,39,117,3,12
1230,8,325,242.85750566893424,244.27392290249435,42,12,323,1,317
1231,8,220,242.85750566893424,245.80643990929707,42,15,247,3,212
1232,8,454,242.85750566893424,244.66866213151928,42,1,453,2,446
1233,8,471,242.85750566893424,245.36526077097506,42,2,475,3,463
1234,8,13,243.0897052154195,245.06340136054422,39,30,85,2,5
1235,8,20,243.0897052154195,245.55102040816328,39,39,107,2,12
1236,8,325,243.0897052154195,244.27392290249435,39,12,321,1,317
1237,8,220,243.0897052154195,245.80643990929707,39,15,242,3,212
1238,8,454,243.0897052154195,244.66866213151928,39,1,451,2,446
1239,8,471,243.0897052154195,245.36526077097506,39,2,473,2,463
1240,13,20,245.06340136054422,246.34049886621315,30,39,55,1,7
1241,13,17,245.06340136054422,247.15319727891156,30,36,90,2,4
1242,13,222,245.06340136054422,246.08507936507937,30,17,214,1,209
1243,13,353,245.06340136054422,247.31573696145125,30,15,354,2,340
1244,13,425,245.06340136054422,247.3389569160998,30,3,423,2,412
1245,20,17,245.55102040816328,247.15319727891156,39,36,69,2,3
1246,20,353,245.55102040816328,247.31573696145125,39,15,342,2,333
1247,20,425,245.55102040816328,247.3389569160998,39,3,412,2,405
1248,20,26,246.34049886621315,248.61605442176872,39,31,98,2,6
1249,17,26,247.15319727891156,248.61605442176872,36,31,64,1,9
1250,17,20,247.15319727891156,249.70739229024943,36,40,110,3,3
1251,17,218,247.15319727891156,249.96281179138322,36,13,235,3,201
1252,17,435,247.15319727891156,249.98603174603176,36,16,435,3,418
1253,26,20,248.61605442176872,249.70739229024943,31,40,47,1,6
1254,26,23,248.61605442176872,251.07736961451246,31,39,106,2,3
1255,26,218,248.61605442176872,249.96281179138322,31,13,201,1,192
1256,26,217,248.61605442176872,250.42721088435374,31,15,206,2,191
1257,26,435,248.61605442176872,249.98603174603176,31,16,413,1,409
1258,26,435,248.61605442176872,250.1950113378685,31,11,415,2,409
1259,26,512,248.61605442176872,251.100589569161,31,11,498,2,486
1260,20,23,249.70739229024943,251.07736961451246,40,39,59,1,3
1261,20,23,249.70739229024943,251.8204081632653,40,40,91,2,3
1262,20,17,249.70739229024943,252.2615873015873,40,37,110,3,3
1263,20,258,249.70739229024943,251.86684807256236,40,15,256,2,238
1264,20,248,249.70739229024943,252.47056689342404,40,14,257,3,228
1265,20,512,249.70739229024943,251.100589569161,40,11,496,1,492
1266,23,17,251.07736961451246,252.2615873015873,39,37,51,1,6
1267,23,248,251.07736961451246,252.47056689342404,39,14,233,1,225
1268,23,251,251.07736961451246,253.1439455782313,39,13,245,2,228
1269,23,487,251.07736961451246,253.0742857142857,39,2,472,2,464
1270,23,479,251.07736961451246,253.70122448979592,39,9,470,3,456
1271,23,21,251.8204081632653,254.07274376417234,40,39,97,2,2
1272,23,8,251.8204081632653,254.63002267573697,40,43,122,3,15
1273,23,251,251.8204081632653,253.1439455782313,40,13,235,1,228
1274,23,227,251.8204081632653,254.09596371882085,40,9,226,2,204
1275,23,487,251.8204081632653,253.0742857142857,40,2,467,1,464
1276,23,479,251.8204081632653,253.70122448979592,40,9,463,2,456
1277,23,411,251.8204081632653,254.35138321995464,40,2,403,3,388
1278,17,21,252.2615873015873,254.07274376417234,37,39,78,2,4
1279,17,8,252.2615873015873,254.63002267573697,37,43,102,2,9
1280,17,6,252.2615873015873,255.117641723356,37,37,123,3,11
1281,17,227,252.2615873015873,254.09596371882085,37,9,224,2,210
1282,17,479,252.2615873015873,253.70122448979592,37,9,466,1,462
1283,17,411,252.2615873015873,254.35138321995464,37,2,404,2,394
1284,21,6,254.07274376417234,255.117641723356,39,37,47,1,15
1285,21,26,254.07274376417234,256.441179138322,39,31,102,2,5
1286,21,334,254.07274376417234,255.62848072562358,39,0,320,2,313
1287,8,26,254.63002267573697,256.441179138322,43,31,80,2,18
1288,8,226,254.63002267573697,257.0681179138322,43,10,242,2,218
1289,8,211,254.63002267573697,257.11455782312925,43,12,229,2,203
1290,6,26,255.117641723356,256.441179138322,37,31,60,1,20
1291,6,26,255.117641723356,257.811156462585,37,32,118,3,20
1292,6,226,255.117641723356,257.0681179138322,37,10,235,2,220
1293,6,211,255.117641723356,257.11455782312925,37,12,222,2,205
1294,26,25,256.441179138322,258.25233560090703,31,32,78,2,1
1295,26,223,256.441179138322,258.3916553287982,31,8,214,2,197
1296,26,210,256.441179138322,259.1811337868481,31,9,219,3,184
1297,26,21,257.811156462585,259.6455328798186,32,30,79,2,5
1298,26,23,257.811156462585,260.3421315192744,32,30,109,3,3
1299,26,210,257.811156462585,259.1811337868481,32,9,193,1,184
1300,26,248,257.811156462585,260.2956916099773,32,14,246,2,222
1301,25,21,258.25233560090703,259.6455328798186,32,30,60,1,4
1302,25,23,258.25233560090703,260.3421315192744,32,30,90,2,2
1303,25,13,258.25233560090703,261.0851700680272,32,23,123,3,12
1304,25,248,258.25233560090703,260.2956916099773,32,14,240,2,223
1305,21,13,259.6455328798186,261.0851700680272,30,23,63,1,8
1306,23,17,260.3421315192744,262.68734693877553,30,23,101,2,6
1307,23,26,260.3421315192744,263.31428571428575,30,23,128,3,3
1308,13,17,261.0851700680272,262.68734693877553,23,23,69,2,4
1309,13,26,261.0851700680272,263.31428571428575,23,23,97,2,13
1310,17,20,262.68734693877553,265.40408163265306,23,26,117,3,3
1311,26,17,263.31428571428575,264.7074829931973,23,25,61,1,9
1312,26,20,263.31428571428575,265.40408163265306,23,26,90,2,6
1313,17,19,264.7074829931973,266.30965986394557,25,25,69,2,2
1314,17,15,264.7074829931973,267.0991383219955,25,22,103,2,2
1315,20,15,265.40408163265306,267.0991383219955,26,22,73,2,5
1316,19,20,266.30965986394557,268.6316553287982,25,24,100,2,1
1317,19,21,266.30965986394557,269.1889342403628,25,23,124,3,2
1318,15,20,267.0991383219955,268.6316553287982,22,24,66,2,5
1319,15,21,267.0991383219955,269.1889342403628,22,23,90,2,6
1320,20,17,268.6316553287982,270.16417233560094,24,21,66,2,3
1321,21,20,269.1889342403628,271.3251700680272,23,25,92,2,1
1322,21,17,269.1889342403628,272.16108843537415,23,24,128,3,4
1323,17,20,270.16417233560094,271.3251700680272,21,25,50,1,3
1324,17,26,270.16417233560094,273.11310657596374,21,26,127,3,9
1325,20,26,271.3251700680272,273.11310657596374,25,26,77,2,6
1326,17,15,272.16108843537415,274.9474829931973,24,24,120,3,2
1327,26,15,273.11310657596374,274.9474829931973,26,24,80,2,11
1328,26,17,273.11310657596374,275.3654421768708,26,25,97,2,9
1329,15,13,274.9474829931973,276.10848072562356,24,24,50,1,2
1330,15,13,274.9474829931973,277.15337868480725,24,19,95,2,2
1331,17,13,275.3654421768708,277.15337868480725,25,19,77,2,4
1332,13,17,276.10848072562356,279.0574149659864,24,20,127,3,4
1333,13,17,277.15337868480725,279.0574149659864,19,20,82,2,4
1334,13,23,277.15337868480725,279.3128344671202,19,23,94,2,10
1335,17,20,279.0574149659864,281.0775510204082,20,15,87,2,3
1336,17,20,279.0574149659864,281.7044897959184,20,16,114,3,3
1337,23,20,279.3128344671202,281.0775510204082,23,15,76,2,3
1338,23,20,279.3128344671202,281.7044897959184,23,16,103,2,3
1339,212,26,8.777142857142858,10.611519274376418,4,24,202,2,186
1340,212,13,8.777142857142858,11.633197278911565,4,29,234,3,199
1341,212,20,10.7740589569161,12.79419501133787,5,29,211,2,192
1342,212,20,10.7740589569161,13.699773242630386,5,27,230,3,192
1343,212,232,10.7740589569161,12.027936507936507,5,4,58,1,20
1344,212,248,10.7740589569161,13.444353741496599,5,14,121,3,36
1345,232,20,12.027936507936507,13.699773242630386,4,27,224,2,212
1346,232,20,12.027936507936507,14.001632653061225,4,22,228,2,212
1347,232,248,12.027936507936507,13.444353741496599,4,14,63,1,16
1348,232,437,12.027936507936507,13.978412698412699,4,1,222,2,205
1349,232,437,12.027936507936507,14.001632653061225,4,2,222,2,205
1350,248,9,13.444353741496599,15.789569160997733,14,35,259,2,239
1351,248,17,13.444353741496599,15.998548752834468,14,30,256,3,231
1352,248,206,13.444353741496599,15.928888888888888,14,3,115,2,42
1353,248,207,13.444353741496599,16.416507936507937,14,8,134,3,41
1354,206,9,15.928888888888888,17.670385487528346,3,35,211,2,197
1355,206,9,15.928888888888888,18.274104308390022,3,31,221,2,197
1356,206,207,15.928888888888888,18.36698412698413,3,10,105,2,1
1357,207,9,16.416507936507937,17.670385487528346,8,35,205,1,198
1358,207,9,16.416507936507937,18.274104308390022,8,31,214,2,198
1359,207,206,16.416507936507937,17.87936507936508,8,7,63,1,1
1360,206,13,17.87936507936508,19.87628117913832,7,34,211,2,193
1361,206,13,17.87936507936508,20.108480725623583,7,35,216,2,193
1362,206,246,17.87936507936508,19.574421768707484,7,9,83,2,40
1363,206,306,17.87936507936508,20.038820861678005,7,12,137,2,100
1364,207,13,18.36698412698413,19.87628117913832,10,34,205,2,194
1365,207,13,18.36698412698413,20.108480725623583,10,35,208,2,194
1366,207,246,18.36698412698413,19.574421768707484,10,9,65,1,39
1367,207,306,18.36698412698413,20.038820861678005,10,12,122,2,99
1368,207,248,18.36698412698413,21.292698412698414,10,14,133,3,41
1369,246,9,19.574421768707484,21.73387755102041,9,35,255,2,237
1370,246,248,19.574421768707484,21.292698412698414,9,14,74,2,2
1371,306,9,20.038820861678005,21.73387755102041,12,35,306,2,297
1372,306,17,20.038820861678005,22.96453514739229,12,31,315,3,289
1373,306,248,20.038820861678005,21.292698412698414,12,14,79,1,58
1374,306,206,20.038820861678005,22.825215419501134,12,3,156,3,100
1375,248,17,21.292698412698414,22.96453514739229,14,31,242,2,231
1376,248,20,21.292698412698414,23.986213151927437,14,37,256,3,228
1377,248,20,21.292698412698414,24.009433106575965,14,38,256,3,228
1378,248,206,21.292698412698414,22.825215419501134,14,3,78,2,42
1379,248,305,21.292698412698414,23.84689342403628,14,13,124,3,57
1380,248,440,21.292698412698414,23.173514739229024,14,11,208,2,192
1381,248,688,21.292698412698414,23.196734693877552,14,5,448,2,440
1382,206,20,22.825215419501134,23.986213151927437,3,37,193,1,186
1383,206,20,22.825215419501134,24.009433106575965,3,38,193,1,186
1384,206,305,22.825215419501134,23.84689342403628,3,13,108,1,99
1385,206,229,22.825215419501134,24.752471655328797,3,14,86,2,23
1386,206,428,22.825215419501134,24.822131519274375,3,5,238,2,222
1387,305,20,23.84689342403628,25.843809523809526,13,39,298,2,285
1388,305,20,23.84689342403628,26.029569160997735,13,37,300,2,285
1389,305,259,23.84689342403628,25.98312925170068,13,18,103,2,46
1390,305,259,23.84689342403628,26.006349206349206,13,15,104,2,46
1391,305,439,23.84689342403628,25.93668934240363,13,6,161,2,134
1392,305,419,23.84689342403628,26.610068027210886,13,7,165,3,114
1393,305,654,23.84689342403628,26.563628117913833,13,8,368,3,349
1394,229,20,24.752471655328797,25.843809523809526,14,39,214,1,209
1395,229,20,24.752471655328797,26.029569160997735,14,37,216,1,209
1396,229,80,24.752471655328797,27.028027210884353,14,32,178,2,149
1397,229,259,24.752471655328797,25.98312925170068,14,18,61,1,30
1398,229,259,24.752471655328797,26.006349206349206,14,15,62,1,30
1399,229,254,24.752471655328797,27.00480725623583,14,6,100,2,25
1400,229,439,24.752471655328797,25.93668934240363,14,6,216,1,210
1401,229,419,24.752471655328797,26.610068027210886,14,7,206,2,190
1402,229,480,24.752471655328797,27.46920634920635,14,3,277,3,251
1403,229,654,24.752471655328797,26.563628117913833,14,8,432,2,425
1404,259,80,25.98312925170068,27.028027210884353,18,32,185,1,179
1405,259,17,25.98312925170068,28.606984126984127,18,34,267,3,242
1406,259,254,25.98312925170068,27.00480725623583,18,6,44,1,5
1407,259,480,25.98312925170068,27.46920634920635,18,3,230,1,221
1408,259,80,26.006349206349206,27.028027210884353,15,32,184,1,179
1409,259,17,26.006349206349206,28.606984126984127,15,34,267,3,242
1410,259,480,26.006349206349206,27.46920634920635,15,3,230,1,221
1411,254,17,27.00480725623583,28.606984126984127,6,34,247,2,237
1412,254,17,27.00480725623583,29.071383219954647,6,34,253,2,237
1413,274,20,31.857777777777777,33.94757369614513,10,36,269,2,254
1414,274,26,31.857777777777777,34.365532879818595,10,38,270,3,248
1415,274,261,31.857777777777777,33.90113378684807,10,13,89,2,13
1416,274,205,31.857777777777777,34.202993197278914,10,16,122,2,69
1417,274,453,31.857777777777777,32.97233560090703,10,7,185,1,179
1418,274,412,31.857777777777777,32.995555555555555,10,6,146,1,138
1419,274,410,31.857777777777777,34.73705215419501,10,1,184,3,136
1420,274,627,31.857777777777777,32.97233560090703,10,2,356,1,353
1421,274,636,31.857777777777777,32.995555555555555,10,0,365,1,362
1422,211,20,32.298956916099776,33.94757369614513,23,36,204,2,191
1423,211,26,32.298956916099776,34.365532879818595,23,38,205,2,185
1424,211,261,32.298956916099776,33.90113378684807,23,13,85,2,50
1425,211,205,32.298956916099776,34.202993197278914,23,16,82,2,6
1426,211,410,32.298956916099776,34.73705215419501,23,1,225,2,199
1427,261,15,33.90113378684807,35.619410430839004,13,35,257,2,246
1428,261,20,33.90113378684807,36.78040816326531,13,36,271,3,241
1429,261,222,33.90113378684807,35.50331065759637,13,4,79,2,39
1430,205,15,34.202993197278914,35.619410430839004,16,35,200,1,190
1431,205,20,34.202993197278914,36.78040816326531,16,36,216,3,185
1432,205,21,34.202993197278914,37.105487528344675,16,37,222,3,184
1433,205,222,34.202993197278914,35.50331065759637,16,4,59,1,17
1434,205,248,34.202993197278914,36.96616780045352,16,14,127,3,43
1435,205,328,34.202993197278914,37.01260770975057,16,11,173,3,123
1436,222,20,35.50331065759637,36.78040816326531,4,36,209,1,202
1437,222,21,35.50331065759637,37.105487528344675,4,37,213,2,201
1438,222,248,35.50331065759637,36.96616780045352,4,14,68,1,26
1439,222,328,35.50331065759637,37.01260770975057,4,11,124,2,106
1440,248,26,36.96616780045352,38.98630385487528,14,39,238,2,222
1441,248,26,36.96616780045352,39.00952380952381,14,39,239,2,222
1442,248,311,36.96616780045352,38.98630385487528,14,18,107,2,63
1443,248,312,36.96616780045352,39.19528344671202,14,20,115,2,64
1444,248,466,36.96616780045352,38.98630385487528,14,3,235,2,218
1445,248,443,36.96616780045352,39.172063492063494,14,12,217,2,195
1446,328,26,37.01260770975057,38.98630385487528,11,39,314,2,302
1447,328,26,37.01260770975057,39.00952380952381,11,39,314,2,302
1448,328,311,37.01260770975057,38.98630385487528,11,18,87,2,17
1449,328,312,37.01260770975057,39.19528344671202,11,20,95,2,16
1450,328,466,37.01260770975057,38.98630385487528,11,3,162,2,138
1451,328,443,37.01260770975057,39.172063492063494,11,12,148,2,115
1452,328,818,37.01260770975057,39.91510204081633,11,8,506,3,490
1453,311,29,38.98630385487528,40.26340136054422,18,40,287,1,282
1454,311,26,38.98630385487528,41.517278911564624,18,39,305,3,285
1455,311,243,38.98630385487528,40.47238095238095,18,18,93,1,68
1456,311,231,38.98630385487528,41.703038548752836,18,14,142,3,80
1457,311,611,38.98630385487528,40.40272108843538,18,7,306,1,300
1458,311,468,38.98630385487528,41.517278911564624,18,6,191,3,157
1459,311,703,38.98630385487528,40.40272108843538,18,9,397,1,392
1460,311,684,38.98630385487528,41.21541950113379,18,12,385,2,373
1461,312,29,39.19528344671202,40.26340136054422,20,40,287,1,283
1462,312,26,39.19528344671202,41.517278911564624,20,39,303,2,286
1463,312,243,39.19528344671202,40.47238095238095,20,18,88,1,69
1464,312,231,39.19528344671202,41.703038548752836,20,14,135,3,81
1465,312,611,39.19528344671202,40.40272108843538,20,7,303,1,299
1466,312,468,39.19528344671202,41.517278911564624,20,6,185,2,156
1467,312,703,39.19528344671202,40.40272108843538,20,9,394,1,391
1468,312,684,39.19528344671202,41.21541950113379,20,12,382,2,372
1469,243,26,40.47238095238095,41.517278911564624,18,39,222,1,217
1470,243,31,40.47238095238095,42.26031746031746,18,40,226,2,212
1471,243,231,40.47238095238095,41.703038548752836,18,14,54,1,12
1472,243,275,40.47238095238095,42.49251700680272,18,12,93,2,32
1473,243,468,40.47238095238095,41.517278911564624,18,6,229,1,225
1474,243,586,40.47238095238095,42.399637188208615,18,7,353,2,343
1475,243,641,40.47238095238095,42.399637188208615,18,11,407,2,398
1476,231,23,41.703038548752836,43.97859410430839,14,35,230,2,208
1477,231,210,41.703038548752836,43.83927437641724,14,13,94,2,21
1478,231,410,41.703038548752836,43.932154195011336,14,8,203,2,179
1479,231,437,41.703038548752836,44.39655328798186,14,3,236,3,206
1480,231,718,41.703038548752836,44.39655328798186,14,5,501,3,487
1481,275,23,42.49251700680272,43.97859410430839,12,35,260,1,252
1482,275,21,42.49251700680272,44.74485260770975,12,36,272,2,254
1483,275,21,42.49251700680272,45.093151927437646,12,36,278,3,254
1484,275,210,42.49251700680272,43.83927437641724,12,13,87,1,65
1485,275,248,42.49251700680272,44.7912925170068,12,13,103,2,27
1486,275,278,42.49251700680272,45.00027210884354,12,4,108,3,3
1487,275,410,42.49251700680272,43.932154195011336,12,8,149,1,135
1488,275,437,42.49251700680272,44.39655328798186,12,3,182,2,162
1489,275,437,42.49251700680272,45.34857142857143,12,1,203,3,162
1490,275,718,42.49251700680272,44.39655328798186,12,5,451,2,443
1491,210,21,43.83927437641724,45.093151927437646,13,36,197,1,189
1492,210,278,43.83927437641724,45.00027210884354,13,4,84,1,68
1493,210,437,43.83927437641724,45.34857142857143,13,1,236,2,227
1494,248,25,44.7912925170068,46.9275283446712,13,34,241,2,223
1495,248,51,44.7912925170068,47.64734693877551,13,38,232,3,197
1496,248,285,44.7912925170068,46.88108843537415,13,4,97,2,37
1497,248,231,44.7912925170068,47.34548752834467,13,13,111,3,17
1498,248,417,44.7912925170068,46.97396825396825,13,0,193,2,169
1499,248,419,44.7912925170068,47.113287981859415,13,7,198,2,171
1500,278,25,45.00027210884354,46.9275283446712,4,34,266,2,253
1501,278,51,45.00027210884354,47.64734693877551,4,38,254,3,227
1502,278,285,45.00027210884354,46.88108843537415,4,4,81,2,7
1503,278,231,45.00027210884354,47.34548752834467,4,13,111,2,47
1504,278,417,45.00027210884354,46.97396825396825,4,0,163,2,139
1505,278,419,45.00027210884354,47.113287981859415,4,7,168,2,141
1506,285,25,46.88108843537415,48.970884353741496,4,37,275,2,260
1507,285,26,46.88108843537415,49.04054421768708,4,37,275,2,259
1508,285,309,46.88108843537415,48.36716553287982,4,12,68,1,24
1509,285,435,46.88108843537415,48.06530612244898,4,9,158,1,150
1510,231,25,47.34548752834467,48.970884353741496,13,37,218,2,206
1511,231,26,47.34548752834467,49.04054421768708,13,37,218,2,205
1512,231,31,47.34548752834467,50.29442176870749,13,37,237,3,200
1513,231,309,47.34548752834467,48.36716553287982,13,12,90,1,78
1514,231,215,47.34548752834467,49.99256235827664,13,21,115,3,16
1515,231,218,47.34548752834467,50.31764172335601,13,20,129,3,13
1516,231,489,47.34548752834467,49.946122448979594,13,9,281,3,258
1517,309,31,48.36716553287982,50.29442176870749,12,37,290,2,278
1518,309,215,48.36716553287982,49.99256235827664,12,21,117,2,94
1519,309,218,48.36716553287982,50.31764172335601,12,20,124,2,91
1520,309,489,48.36716553287982,49.946122448979594,12,9,192,2,180
1521,309,498,48.36716553287982,50.340861678004536,12,12,207,2,189
1522,309,410,48.36716553287982,51.13034013605442,12,8,156,3,101
1523,309,749,48.36716553287982,50.5730612244898,12,4,450,2,440
1524,215,23,49.99256235827664,51.50185941043084,21,35,203,2,192
1525,215,21,49.99256235827664,52.61641723356009,21,36,225,3,194
1526,215,233,49.99256235827664,51.57151927437642,21,16,70,2,18
1527,215,248,49.99256235827664,52.63963718820862,21,12,119,3,33
1528,215,410,49.99256235827664,51.13034013605442,21,8,201,1,195
1529,215,584,49.99256235827664,52.61641723356009,21,0,386,3,369
1530,218,23,50.31764172335601,51.50185941043084,20,35,202,1,195
1531,218,21,50.31764172335601,52.61641723356009,20,36,220,2,197
1532,218,17,50.31764172335601,53.15047619047619,20,37,235,3,201
1533,218,233,50.31764172335601,51.57151927437642,20,16,56,1,15
1534,218,248,50.31764172335601,52.63963718820862,20,12,104,2,30
1535,218,584,50.31764172335601,52.61641723356009,20,0,379,2,366
1536,233,21,51.57151927437642,52.61641723356009,16,36,217,1,212
1537,233,17,51.57151927437642,53.15047619047619,16,37,226,2,216
1538,233,248,51.57151927437642,52.63963718820862,16,12,48,1,15
1539,233,213,51.57151927437642,54.497233560090706,16,9,128,3,20
1540,233,584,51.57151927437642,52.61641723356009,16,0,354,1,351
1541,233,488,51.57151927437642,54.381133786848075,16,2,282,3,255
1542,248,15,52.63963718820862,54.89197278911565,12,35,252,2,233
1543,248,213,52.63963718820862,54.497233560090706,12,9,87,2,35
1544,248,230,52.63963718820862,55.077732426303854,12,7,107,2,18
1545,248,488,52.63963718820862,54.381133786848075,12,2,251,2,240
1546,213,15,54.497233560090706,55.70467120181406,9,33,205,1,198
1547,213,18,54.497233560090706,56.33160997732426,9,35,210,2,195
1548,213,34,54.497233560090706,57.14430839002268,9,28,212,3,179
1549,213,248,54.497233560090706,56.540589569161,9,14,95,2,35
1550,213,437,54.497233560090706,57.09786848072562,9,2,250,3,224
1551,230,18,55.077732426303854,56.33160997732426,7,35,219,1,212
1552,230,34,55.077732426303854,57.14430839002268,7,28,215,2,196
1553,230,248,55.077732426303854,56.540589569161,7,14,66,1,18
1554,230,437,55.077732426303854,57.09786848072562,7,2,225,2,207
1555,248,26,56.540589569161,58.816145124716556,14,39,243,2,222
1556,248,26,56.540589569161,59.14122448979592,14,39,249,3,222
1557,248,206,56.540589569161,58.63038548752834,14,23,99,2,42
1558,248,412,56.540589569161,58.60716553287982,14,14,187,2,164
1559,248,616,56.540589569161,59.419863945578236,14,10,388,3,368
1560,206,76,58.63038548752834,60.998820861678006,23,37,165,2,130
1561,206,51,58.63038548752834,61.41678004535147,23,37,196,3,155
1562,206,230,58.63038548752834,59.65206349206349,23,25,50,1,24
1563,206,278,58.63038548752834,60.998820861678006,23,20,125,2,72
1564,206,220,58.63038548752834,61.532879818594104,23,18,126,3,14
1565,206,410,58.63038548752834,59.65206349206349,23,16,209,1,204
1566,206,448,58.63038548752834,60.557641723356014,23,4,256,2,242
1567,206,652,58.63038548752834,60.51120181405896,23,8,453,2,446
1568,230,76,59.65206349206349,60.998820861678006,25,37,165,1,154
1569,230,51,59.65206349206349,61.41678004535147,25,37,194,2,179
1570,230,278,59.65206349206349,60.998820861678006,25,20,75,1,48
1571,230,220,59.65206349206349,61.532879818594104,25,18,82,2,10
1572,230,410,59.65206349206349,61.74185941043084,25,5,201,2,180
1573,278,70,60.998820861678006,62.64743764172336,20,36,220,2,208
1574,278,26,60.998820861678006,63.64589569160998,20,36,277,3,252
1575,278,277,60.998820861678006,62.99573696145125,20,23,86,2,1
1576,278,217,60.998820861678006,63.87809523809524,20,26,138,3,61
1577,278,415,60.998820861678006,62.972517006802725,20,10,161,2,137
1578,278,410,60.998820861678006,63.715555555555554,20,19,176,3,132
1579,220,70,61.532879818594104,62.64743764172336,18,36,157,1,150
1580,220,26,61.532879818594104,63.64589569160998,18,36,214,2,194
1581,220,23,61.532879818594104,64.13351473922903,18,39,227,3,197
1582,220,277,61.532879818594104,62.99573696145125,18,23,85,1,57
1583,220,217,61.532879818594104,63.87809523809524,18,26,101,2,3
1584,220,297,61.532879818594104,64.24961451247165,18,21,140,3,77
1585,220,415,61.532879818594104,62.972517006802725,18,10,205,1,195
1586,220,410,61.532879818594104,63.715555555555554,18,19,212,2,190
1587,277,23,62.99573696145125,64.13351473922903,23,39,259,1,254
1588,277,24,62.99573696145125,65.7124716553288,23,37,279,3,253
1589,277,297,62.99573696145125,64.24961451247165,23,21,58,1,20
1590,277,232,62.99573696145125,65.34095238095239,23,14,111,2,45
1591,277,413,62.99573696145125,64.52825396825396,23,18,151,2,136
1592,277,465,62.99573696145125,65.75891156462585,23,7,222,3,188
1593,217,24,63.87809523809524,65.7124716553288,26,37,209,2,193
1594,217,17,63.87809523809524,66.52517006802721,26,37,230,3,200
1595,217,232,63.87809523809524,65.34095238095239,26,14,65,1,15
1596,217,245,63.87809523809524,66.29297052154195,26,11,108,2,28
1597,217,465,63.87809523809524,65.75891156462585,26,7,261,2,248
1598,217,417,63.87809523809524,66.38585034013606,26,7,227,3,200
1599,297,24,64.24961451247165,65.7124716553288,21,37,280,1,273
1600,297,17,64.24961451247165,66.52517006802721,21,37,297,2,280
1601,297,232,64.24961451247165,65.34095238095239,21,14,80,1,65
1602,297,245,64.24961451247165,66.29297052154195,21,11,102,2,52
1603,297,465,64.24961451247165,65.75891156462585,21,7,180,2,168
1604,297,417,64.24961451247165,66.38585034013606,21,7,151,2,120
1605,232,17,65.34095238095239,66.52517006802721,14,37,221,1,215
1606,232,26,65.34095238095239,67.98802721088435,14,36,235,3,206
1607,232,26,65.34095238095239,68.05768707482993,14,37,237,3,206
1608,232,387,65.34095238095239,67.98802721088435,14,18,192,3,155
1609,232,417,65.34095238095239,66.38585034013606,14,7,190,1,185
1610,232,412,65.34095238095239,67.98802721088435,14,16,213,3,180
1611,232,413,65.34095238095239,68.05768707482993,14,19,216,3,181
1612,245,26,66.29297052154195,67.98802721088435,11,36,231,2,219
1613,245,26,66.29297052154195,68.05768707482993,11,37,232,2,219
1614,245,387,66.29297052154195,67.98802721088435,11,18,160,2,142
1615,245,273,66.29297052154195,68.70784580498866,11,21,108,2,28
1616,245,412,66.29297052154195,67.98802721088435,11,16,182,2,167
1617,245,413,66.29297052154195,68.05768707482993,11,19,184,2,168
1618,245,621,66.29297052154195,68.89360544217688,11,3,392,3,376
1619,387,20,67.98802721088435,69.52054421768707,18,34,373,2,367
1620,387,26,67.98802721088435,70.5190022675737,18,36,377,3,361
1621,387,245,67.98802721088435,69.65986394557824,18,19,159,2,142
1622,387,206,67.98802721088435,70.31002267573696,18,22,207,2,181
1623,387,428,67.98802721088435,69.65986394557824,18,5,83,2,41
1624,387,420,67.98802721088435,70.0778231292517,18,8,96,2,33
1625,387,864,67.98802721088435,70.33324263038548,18,1,488,2,477
1626,273,26,68.70784580498866,70.5190022675737,21,36,259,2,247
1627,273,206,68.70784580498866,70.31002267573696,21,22,96,2,67
1628,273,420,68.70784580498866,70.0778231292517,21,8,158,1,147
1629,245,76,69.65986394557824,71.98185941043084,19,35,196,2,169
1630,245,277,69.65986394557824,71.72643990929706,19,19,95,2,32
1631,245,219,69.65986394557824,72.53913832199547,19,19,127,3,26
1632,245,432,69.65986394557824,72.00507936507937,19,14,213,2,187
1633,245,432,69.65986394557824,72.02829931972789,19,15,213,2,187
1634,206,76,70.31002267573696,71.98185941043084,22,35,149,2,130
1635,206,23,70.31002267573696,72.67845804988663,22,36,210,2,183
1636,206,277,70.31002267573696,71.72643990929706,22,19,94,1,71
1637,206,219,70.31002267573696,72.53913832199547,22,19,97,2,13
1638,206,205,70.31002267573696,73.07319727891156,22,13,119,3,1
1639,206,432,70.31002267573696,72.00507936507937,22,14,237,2,226
1640,206,432,70.31002267573696,72.02829931972789,22,15,238,2,226
1641,206,410,70.31002267573696,73.16607709750566,22,2,238,3,204
1642,277,21,71.72643990929706,73.83945578231292,19,35,272,2,256
1643,277,17,71.72643990929706,74.6985941043084,19,35,290,3,260
1644,277,205,71.72643990929706,73.07319727891156,19,13,92,1,72
1645,277,205,71.72643990929706,74.11809523809524,19,7,126,2,72
1646,277,410,71.72643990929706,73.16607709750566,19,2,147,1,133
1647,277,411,71.72643990929706,74.18775510204082,19,1,171,2,134
1648,277,756,71.72643990929706,72.79455782312925,19,0,481,1,479
1649,219,21,72.53913832199547,73.83945578231292,19,35,206,1,198
1650,219,17,72.53913832199547,74.6985941043084,19,35,222,2,202
1651,219,205,72.53913832199547,74.11809523809524,19,7,69,2,14
1652,219,411,72.53913832199547,74.18775510204082,19,1,205,2,192
1653,205,17,73.07319727891156,74.6985941043084,13,35,201,2,188
1654,205,26,73.07319727891156,75.7667120181406,13,35,213,3,179
1655,205,283,73.07319727891156,75.90603174603174,13,21,145,3,78
1656,205,411,73.07319727891156,74.18775510204082,13,1,212,1,206
1657,205,411,73.07319727891156,75.90603174603174,13,10,239,3,206
1658,205,424,73.07319727891156,76.0453514739229,13,9,254,3,219
1659,205,26,74.11809523809524,75.7667120181406,7,35,193,2,179
1660,205,26,74.11809523809524,76.3007709750567,7,34,202,2,179
1661,205,283,74.11809523809524,75.90603174603174,7,21,110,2,78
1662,205,206,74.11809523809524,76.55619047619048,7,22,105,2,1
1663,205,411,74.11809523809524,75.90603174603174,7,10,220,2,206
1664,205,424,74.11809523809524,76.0453514739229,7,9,234,2,219
1665,283,61,75.90603174603174,77.76362811791384,21,35,236,2,222
1666,283,101,75.90603174603174,78.66920634920635,21,36,217,3,182
1667,283,276,75.90603174603174,77.32244897959184,21,19,61,1,7
1668,283,302,75.90603174603174,78.83174603174604,21,16,127,3,19
1669,283,410,75.90603174603174,77.46176870748299,21,10,144,2,127
1670,283,553,75.90603174603174,78.0887074829932,21,5,286,2,270
1671,283,634,75.90603174603174,78.0887074829932,21,4,363,2,351
1672,206,61,76.55619047619048,77.76362811791384,22,35,154,1,145
1673,206,101,76.55619047619048,78.66920634920635,22,36,139,2,105
1674,206,34,76.55619047619048,79.20326530612245,22,36,206,3,172
1675,206,302,76.55619047619048,78.83174603174604,22,16,137,2,96
1676,206,553,76.55619047619048,78.0887074829932,22,5,353,2,347
1677,206,449,76.55619047619048,79.22648526077097,22,13,269,3,243
1678,206,634,76.55619047619048,78.0887074829932,22,4,433,2,428
1679,276,101,77.32244897959184,78.66920634920635,19,36,184,1,175
1680,276,34,77.32244897959184,79.20326530612245,19,36,255,2,242
1681,276,302,77.32244897959184,78.83174603174604,19,16,70,2,26
1682,276,206,77.32244897959184,79.27292517006804,19,22,109,2,70
1683,276,205,77.32244897959184,80.08562358276644,19,10,139,3,71
1684,276,449,77.32244897959184,79.22648526077097,19,13,191,2,173
1685,302,34,78.83174603174604,80.34104308390023,16,38,276,2,268
1686,302,26,78.83174603174604,81.64136054421769,16,38,301,3,276
1687,302,205,78.83174603174604,80.08562358276644,16,10,111,1,97
1688,302,267,78.83174603174604,81.08408163265307,16,10,103,2,35
1689,302,432,78.83174603174604,80.4107029478458,16,7,147,2,130
1690,302,537,78.83174603174604,81.06086167800454,16,12,254,2,235
1691,302,674,78.83174603174604,81.06086167800454,16,8,384,2,372
1692,206,34,79.27292517006804,80.34104308390023,22,38,178,1,172
1693,206,26,79.27292517006804,81.64136054421769,22,38,207,2,180
1694,206,267,79.27292517006804,81.08408163265307,22,10,99,2,61
1695,206,432,79.27292517006804,80.4107029478458,22,7,231,1,226
1696,206,537,79.27292517006804,81.06086167800454,22,12,340,2,331
1697,206,674,79.27292517006804,81.06086167800454,22,8,474,2,468
1698,205,26,80.08562358276644,81.64136054421769,10,38,191,2,179
1699,205,15,80.08562358276644,82.82557823129252,10,29,224,3,190
1700,267,15,81.08408163265307,82.82557823129252,10,29,263,2,252
1701,267,26,81.08408163265307,83.70793650793651,10,38,266,3,241
1702,267,26,81.08408163265307,84.03301587301587,10,35,272,3,241
1703,267,205,81.08408163265307,82.96489795918367,10,7,102,2,62
1704,267,205,81.08408163265307,84.00979591836735,10,25,140,3,62
1705,267,205,81.08408163265307,84.03301587301587,10,22,141,3,62
1706,267,410,81.08408163265307,83.98657596371882,10,15,190,3,143
1707,205,26,82.96489795918367,84.03301587301587,7,35,185,1,179
1708,205,24,82.96489795918367,85.79773242630385,7,37,218,3,181
1709,205,410,82.96489795918367,83.98657596371882,7,15,210,1,205
1710,205,428,82.96489795918367,84.17233560090703,7,16,229,1,223
1711,205,24,84.00979591836735,85.79773242630385,25,37,197,2,181
1712,205,26,84.00979591836735,86.1924716553288,25,35,202,2,179
1713,205,410,84.00979591836735,86.00671201814059,25,12,222,2,205
1714,205,410,84.00979591836735,86.05315192743764,25,13,223,2,205
1715,205,24,84.03301587301587,85.79773242630385,22,37,196,2,181
1716,205,26,84.03301587301587,86.1924716553288,22,35,202,2,179
1717,205,410,84.03301587301587,86.00671201814059,22,12,222,2,205
1718,205,410,84.03301587301587,86.05315192743764,22,13,223,2,205
1719,205,76,86.00671201814059,87.65532879818595,22,36,147,2,129
1720,205,26,86.00671201814059,88.02684807256236,22,34,199,2,179
1721,205,299,86.00671201814059,87.58566893424036,22,20,116,2,94
1722,205,269,86.00671201814059,88.88598639455782,22,14,140,3,64
1723,205,424,86.00671201814059,87.58566893424036,22,18,229,2,219
1724,205,414,86.00671201814059,88.88598639455782,22,7,243,3,209
1725,205,76,86.02993197278911,87.65532879818595,21,36,147,2,129
1726,205,26,86.02993197278911,88.02684807256236,21,34,199,2,179
1727,205,299,86.02993197278911,87.58566893424036,21,20,115,2,94
1728,205,269,86.02993197278911,88.88598639455782,21,14,139,3,64
1729,205,424,86.02993197278911,87.58566893424036,21,18,229,2,219
1730,205,414,86.02993197278911,88.88598639455782,21,7,243,3,209
1731,299,21,87.58566893424036,89.18784580498867,20,34,286,2,278
1732,299,19,87.58566893424036,90.0237641723356,20,31,299,2,280
1733,299,269,87.58566893424036,88.88598639455782,20,14,64,1,30
1734,299,289,87.58566893424036,89.2110657596372,20,13,71,2,10
1735,299,414,87.58566893424036,88.88598639455782,20,7,128,1,115
1736,299,418,87.58566893424036,89.07174603174603,20,6,135,1,119
1737,299,797,87.58566893424036,89.42004535147393,20,0,504,2,498
1738,269,19,88.88598639455782,90.0237641723356,14,31,255,1,250
1739,269,25,88.88598639455782,91.18476190476191,14,35,263,2,244
1740,269,205,88.88598639455782,90.83646258503401,14,9,106,2,64
1741,269,278,88.88598639455782,91.48662131519275,14,19,112,3,9
1742,269,431,88.88598639455782,91.4401814058957,14,19,196,3,162
1743,289,25,89.2110657596372,91.18476190476191,13,35,277,2,264
1744,289,205,89.2110657596372,90.83646258503401,13,9,109,2,84
1745,289,278,89.2110657596372,91.48662131519275,13,19,99,2,11
1746,289,431,89.2110657596372,91.4401814058957,13,19,171,2,142
1747,205,23,90.83646258503401,92.78693877551021,9,35,200,2,182
1748,205,31,90.83646258503401,93.71573696145126,9,38,214,3,174
1749,205,207,90.83646258503401,92.92625850340136,9,21,90,2,2
1750,205,284,90.83646258503401,93.042358276644,9,14,124,2,79
1751,205,415,90.83646258503401,92.92625850340136,9,16,228,2,210
1752,205,436,90.83646258503401,93.08879818594104,9,15,251,2,231
1753,205,699,90.83646258503401,93.27455782312926,9,12,505,2,494
1754,278,23,91.48662131519275,92.78693877551021,19,35,261,1,255
1755,278,31,91.48662131519275,93.71573696145126,19,38,265,2,247
1756,278,207,91.48662131519275,92.92625850340136,19,21,94,1,71
1757,278,284,91.48662131519275,93.042358276644,19,14,67,2,6
1758,278,415,91.48662131519275,92.92625850340136,19,16,150,1,137
1759,278,436,91.48662131519275,93.08879818594104,19,15,172,2,158
1760,278,699,91.48662131519275,93.27455782312926,19,12,428,2,421
1761,207,69,92.92625850340136,94.80707482993198,21,34,160,2,138
1762,207,34,92.92625850340136,95.22503401360544,21,36,199,2,173
1763,207,211,92.92625850340136,94.99283446712019,21,24,89,2,4
1764,207,243,92.92625850340136,95.29469387755103,21,23,108,2,36
1765,207,414,92.92625850340136,94.78385487528345,21,18,222,2,207
1766,207,418,92.92625850340136,95.15537414965986,21,19,232,2,211
1767,284,69,93.042358276644,94.80707482993198,14,34,228,2,215
1768,284,34,93.042358276644,95.22503401360544,14,36,267,2,250
1769,284,211,93.042358276644,94.99283446712019,14,24,111,2,73
1770,284,243,93.042358276644,95.29469387755103,14,23,105,2,41
1771,284,414,93.042358276644,94.78385487528345,14,18,150,2,130
1772,284,418,93.042358276644,95.15537414965986,14,19,162,2,134
1773,211,33,94.99283446712019,96.8736507936508,24,32,196,2,178
1774,211,23,94.99283446712019,97.82566893424037,24,38,224,3,188
1775,211,219,94.99283446712019,96.66467120181406,24,10,72,2,8
1776,211,212,94.99283446712019,97.500589569161,24,15,108,3,1
1777,211,415,94.99283446712019,96.71111111111111,24,6,217,2,204
1778,211,411,94.99283446712019,97.33804988662132,24,4,224,2,200
1779,243,33,95.29469387755103,96.8736507936508,23,32,221,2,210
1780,243,23,95.29469387755103,97.82566893424037,23,38,246,3,220
1781,243,23,95.29469387755103,98.26684807256235,23,36,255,3,220
1782,243,219,95.29469387755103,96.66467120181406,23,10,64,1,24
1783,243,212,95.29469387755103,97.500589569161,23,15,100,2,31
1784,243,415,95.29469387755103,96.71111111111111,23,6,182,1,172
1785,243,411,95.29469387755103,97.33804988662132,23,4,190,2,168
1786,219,23,96.66467120181406,97.82566893424037,10,38,202,1,196
1787,219,23,96.66467120181406,98.26684807256235,10,36,208,2,196
1788,219,324,96.66467120181406,98.82412698412699,10,10,140,2,105
1789,219,325,96.66467120181406,99.31174603174604,10,11,156,3,106
1790,212,16,97.500589569161,99.66004535147393,15,30,217,2,196
1791,212,324,97.500589569161,98.82412698412699,15,10,126,1,112
1792,212,325,97.500589569161,99.31174603174604,15,11,137,2,113
1793,324,21,98.82412698412699,100.68172335600907,10,36,313,2,303
1794,324,223,98.82412698412699,100.58884353741497,10,16,126,2,101
1795,324,360,98.82412698412699,101.5873015873016,10,9,124,3,36
1796,324,411,98.82412698412699,100.75138321995465,10,3,120,2,87
1797,324,810,98.82412698412699,100.24054421768707,10,0,490,1,486
1798,325,21,99.31174603174604,100.68172335600907,11,36,310,1,304
1799,325,9,99.31174603174604,101.93560090702948,11,35,336,3,316
1800,325,9,99.31174603174604,102.02848072562358,11,34,337,3,316
1801,325,223,99.31174603174604,100.58884353741497,11,16,116,1,102
1802,325,360,99.31174603174604,101.5873015873016,11,9,104,2,35
1803,325,411,99.31174603174604,100.75138321995465,11,3,106,1,86
1804,223,9,100.58884353741497,101.93560090702948,16,35,222,1,214
1805,223,9,100.58884353741497,102.02848072562358,16,34,223,1,214
1806,223,207,100.58884353741497,102.63219954648527,16,8,89,2,16
1807,223,655,100.58884353741497,103.49133786848073,16,2,450,3,432
1808,360,9,101.5873015873016,103.88607709750568,9,35,365,2,351
1809,360,207,101.5873015873016,102.63219954648527,9,8,159,1,153
1810,360,306,101.5873015873016,103.60743764172337,9,5,102,2,54
1811,360,207,101.5873015873016,104.55945578231292,9,10,199,3,153
1812,360,579,101.5873015873016,104.55945578231292,9,0,254,3,219
1813,360,655,101.5873015873016,103.49133786848073,9,2,306,2,295
1814,207,9,102.63219954648527,103.88607709750568,8,35,205,1,198
1815,207,20,102.63219954648527,104.69877551020409,8,37,207,2,187
1816,207,579,102.63219954648527,104.55945578231292,8,0,381,2,372
1817,207,511,102.63219954648527,105.04707482993197,8,0,321,2,304
1818,306,20,103.60743764172337,104.69877551020409,5,37,290,1,286
1819,306,23,103.60743764172337,105.85977324263038,5,39,299,2,283
1820,306,23,103.60743764172337,106.0455328798186,5,39,302,2,283
1821,306,245,103.60743764172337,105.79011337868481,5,9,112,2,61
1822,306,511,103.60743764172337,105.04707482993197,5,0,214,1,205
1823,207,23,104.55945578231292,105.85977324263038,10,39,192,1,184
1824,207,23,104.55945578231292,106.0455328798186,10,39,195,1,184
1825,207,20,104.55945578231292,107.04399092970522,10,34,215,2,187
1826,207,245,104.55945578231292,105.79011337868481,10,9,65,1,38
1827,207,306,104.55945578231292,106.25451247165533,10,11,123,2,99
1828,207,248,104.55945578231292,107.48517006802722,10,13,133,3,41
1829,245,20,105.79011337868481,107.04399092970522,9,34,231,1,225
1830,245,248,105.79011337868481,107.48517006802722,9,13,73,2,3
1831,245,271,105.79011337868481,108.08888888888889,9,11,102,2,26
1832,245,437,105.79011337868481,108.01922902494331,9,1,215,2,192
1833,245,437,105.79011337868481,108.04244897959184,9,3,215,2,192
1834,306,14,106.25451247165533,108.97124716553289,11,30,315,3,292
1835,306,248,106.25451247165533,107.48517006802722,11,13,79,1,58
1836,306,271,106.25451247165533,108.08888888888889,11,11,86,2,35
1837,306,437,106.25451247165533,108.01922902494331,11,1,151,2,131
1838,306,437,106.25451247165533,108.04244897959184,11,3,152,2,131
1839,248,14,107.48517006802722,108.97124716553289,13,30,243,1,234
1840,248,21,107.48517006802722,109.96970521541951,13,37,251,2,227
1841,248,20,107.48517006802722,110.15546485260771,13,38,255,3,228
1842,248,306,107.48517006802722,110.01614512471656,13,14,123,3,58
1843,248,223,107.48517006802722,110.29478458049887,13,24,124,3,25
1844,248,546,107.48517006802722,109.45886621315194,13,10,310,2,298
1845,248,465,107.48517006802722,110.3180045351474,13,10,249,3,217
1846,271,21,108.08888888888889,109.96970521541951,11,37,263,2,250
1847,271,20,108.08888888888889,110.15546485260771,11,38,266,2,251
1848,271,306,108.08888888888889,110.01614512471656,11,14,90,2,35
1849,271,223,108.08888888888889,110.29478458049887,11,24,106,2,48
1850,271,546,108.08888888888889,109.45886621315194,11,10,281,1,275
1851,271,465,108.08888888888889,110.3180045351474,11,10,216,2,194
1852,306,20,110.01614512471656,111.64154195011338,14,38,294,2,286
1853,306,20,110.01614512471656,112.24526077097507,14,36,302,2,286
1854,306,255,110.01614512471656,111.22358276643992,14,12,73,1,51
1855,306,220,110.01614512471656,112.26848072562359,14,19,130,2,86
1856,306,514,110.01614512471656,111.38612244897959,14,10,216,1,208
1857,306,432,110.01614512471656,112.82575963718821,14,8,175,3,126
1858,306,754,110.01614512471656,111.40934240362812,14,18,452,1,448
1859,306,804,110.01614512471656,112.77931972789116,14,2,512,3,498
1860,223,20,110.29478458049887,111.64154195011338,24,38,211,1,203
1861,223,20,110.29478458049887,112.24526077097507,24,36,220,2,203
1862,223,26,110.29478458049887,113.19727891156462,24,35,233,3,197
1863,223,220,110.29478458049887,112.26848072562359,24,19,85,2,3
1864,223,514,110.29478458049887,111.38612244897959,24,10,295,1,291
1865,223,432,110.29478458049887,112.82575963718821,24,8,236,3,209
1866,255,20,111.22358276643992,112.24526077097507,12,36,239,1,235
1867,255,26,111.22358276643992,113.19727891156462,12,35,244,2,229
1868,255,220,111.22358276643992,112.26848072562359,12,19,57,1,35
1869,255,401,111.22358276643992,113.35981859410431,12,11,173,2,146
1870,255,432,111.22358276643992,112.82575963718821,12,8,190,2,177
1871,255,423,111.22358276643992,113.35981859410431,12,9,192,2,168
1872,220,17,112.26848072562359,114.82267573696146,19,34,231,3,203
1873,220,19,112.26848072562359,115.24063492063492,19,34,238,3,201
1874,220,401,112.26848072562359,113.35981859410431,19,11,187,1,181
1875,220,282,112.26848072562359,114.52081632653062,19,4,115,2,62
1876,220,423,112.26848072562359,113.35981859410431,19,9,208,1,203
1877,401,17,113.35981859410431,114.82267573696146,11,34,389,1,384
1878,401,19,113.35981859410431,115.24063492063492,11,34,390,2,382
1879,401,282,113.35981859410431,114.52081632653062,11,4,129,1,119
1880,401,248,113.35981859410431,115.33351473922903,11,13,175,2,153
1881,401,437,113.35981859410431,115.86757369614513,11,2,114,3,36
1882,282,63,114.52081632653062,117.0053514739229,4,38,244,2,219
1883,282,226,114.52081632653062,116.74993197278911,4,10,111,2,56
1884,282,437,114.52081632653062,115.86757369614513,4,2,165,1,155
1885,282,450,114.52081632653062,116.77315192743764,4,0,194,2,168
1886,248,63,115.33351473922903,117.0053514739229,13,38,199,2,185
1887,248,21,115.33351473922903,117.980589569161,13,39,254,3,227
1888,248,226,115.33351473922903,116.74993197278911,13,10,65,1,22
1889,248,221,115.33351473922903,117.72517006802721,13,15,106,2,27
1890,248,450,115.33351473922903,116.77315192743764,13,0,211,1,202
1891,248,427,115.33351473922903,117.86448979591837,13,7,210,3,179
1892,248,427,115.33351473922903,118.07346938775511,13,9,214,3,179
1893,226,21,116.74993197278911,117.980589569161,10,39,212,1,205
1894,226,91,116.74993197278911,118.93260770975057,10,38,165,2,135
1895,226,21,116.74993197278911,119.6756462585034,10,38,241,3,205
1896,226,273,116.74993197278911,118.9558276643991,10,17,106,2,47
1897,226,285,116.74993197278911,119.53632653061224,10,18,134,3,59
1898,226,427,116.74993197278911,117.86448979591837,10,7,207,1,201
1899,226,427,116.74993197278911,118.07346938775511,10,9,209,1,201
1900,221,91,117.72517006802721,118.93260770975057,15,38,140,1,130
1901,221,21,117.72517006802721,119.6756462585034,15,38,217,2,200
1902,221,273,117.72517006802721,118.9558276643991,15,17,74,1,52
1903,221,285,117.72517006802721,119.53632653061224,15,18,101,2,64
1904,221,279,117.72517006802721,120.48834467120182,15,13,132,3,58
1905,221,499,117.72517006802721,119.90784580498867,15,4,293,2,278
1906,273,89,118.9558276643991,120.92952380952381,17,38,203,2,184
1907,273,15,118.9558276643991,121.6261224489796,17,33,282,3,258
1908,273,279,118.9558276643991,120.48834467120182,17,13,66,2,6
1909,273,231,118.9558276643991,121.64934240362813,17,9,123,3,42
1910,273,410,118.9558276643991,120.81342403628118,17,6,159,2,137
1911,273,555,118.9558276643991,121.11528344671203,17,8,297,2,282
1912,285,89,119.53632653061224,120.92952380952381,18,38,205,1,196
1913,285,15,119.53632653061224,121.6261224489796,18,33,285,2,270
1914,285,231,119.53632653061224,121.64934240362813,18,9,106,2,54
1915,285,410,119.53632653061224,120.81342403628118,18,6,137,1,125
1916,285,555,119.53632653061224,121.11528344671203,18,8,278,2,270
1917,285,415,119.53632653061224,122.2530612244898,18,4,175,3,130
1918,285,779,119.53632653061224,121.09206349206349,18,5,499,2,494
1919,279,15,120.48834467120182,121.6261224489796,13,33,269,1,264
1920,279,21,120.48834467120182,122.97287981859411,13,39,279,2,258
1921,279,21,120.48834467120182,123.1354195011338,13,39,282,3,258
1922,279,231,120.48834467120182,121.64934240362813,13,9,69,1,48
1923,279,208,120.48834467120182,122.67102040816327,13,18,118,2,71
1924,279,415,120.48834467120182,122.2530612244898,13,4,156,2,136
1925,279,414,120.48834467120182,123.1354195011338,13,4,177,3,135
1926,231,21,121.64934240362813,122.97287981859411,9,39,218,1,210
1927,231,21,121.64934240362813,123.1354195011338,9,39,220,1,210
1928,231,208,121.64934240362813,122.67102040816327,9,18,50,1,23
1929,231,207,121.64934240362813,123.5998185941043,9,20,87,2,24
1930,231,414,121.64934240362813,123.1354195011338,9,4,194,1,183
1931,208,25,122.67102040816327,125.0162358276644,18,32,209,2,183
1932,208,26,122.67102040816327,125.50385487528345,18,39,219,3,182
1933,208,226,122.67102040816327,125.0162358276644,18,23,103,2,18
1934,208,226,122.67102040816327,125.03945578231293,18,25,104,2,18
1935,208,453,122.67102040816327,125.0162358276644,18,8,265,2,245
1936,207,25,123.5998185941043,125.0162358276644,20,32,192,1,182
1937,207,26,123.5998185941043,125.50385487528345,20,39,199,2,181
1938,207,61,123.5998185941043,126.40943310657596,20,37,190,3,146
1939,207,226,123.5998185941043,125.0162358276644,20,23,64,1,19
1940,207,226,123.5998185941043,125.03945578231293,20,25,65,1,19
1941,207,274,123.5998185941043,126.27011337868481,20,28,133,3,67
1942,207,453,123.5998185941043,125.0162358276644,20,8,253,1,246
1943,207,411,123.5998185941043,125.80571428571429,20,16,225,2,204
1944,207,426,123.5998185941043,126.29333333333334,20,13,248,3,219
1945,207,623,123.5998185941043,126.01469387755103,20,4,429,2,416
1946,226,61,125.0162358276644,126.40943310657596,23,37,176,1,165
1947,226,26,125.0162358276644,127.54721088435375,23,36,228,3,200
1948,226,274,125.0162358276644,126.27011337868481,23,28,72,1,48
1949,226,209,125.0162358276644,127.84907029478458,23,20,123,3,17
1950,226,426,125.0162358276644,126.29333333333334,23,13,207,1,200
1951,226,61,125.03945578231293,126.40943310657596,25,37,175,1,165
1952,226,26,125.03945578231293,127.54721088435375,25,36,227,3,200
1953,226,274,125.03945578231293,126.27011337868481,25,28,72,1,48
1954,226,209,125.03945578231293,127.84907029478458,25,20,122,3,17
1955,226,426,125.03945578231293,126.29333333333334,25,13,207,1,200
1956,226,438,125.03945578231293,128.01160997732427,25,9,248,3,212
1957,226,685,125.03945578231293,128.01160997732427,25,10,477,3,459
1958,274,26,126.27011337868481,127.54721088435375,28,36,254,1,248
1959,274,102,126.27011337868481,128.89396825396827,28,38,206,3,172
1960,274,209,126.27011337868481,127.84907029478458,28,20,94,2,65
1961,274,207,126.27011337868481,128.220589569161,28,24,107,2,67
1962,274,438,126.27011337868481,128.01160997732427,28,9,180,2,164
1963,274,497,126.27011337868481,128.03482993197278,28,12,236,2,223
1964,274,685,126.27011337868481,128.01160997732427,28,10,418,2,411
1965,274,684,126.27011337868481,128.05804988662132,28,14,417,2,410
1966,209,102,127.84907029478458,128.89396825396827,20,38,116,1,107
1967,209,71,127.84907029478458,129.84598639455783,20,35,163,2,138
1968,209,297,127.84907029478458,129.91564625850341,20,16,125,2,88
1969,209,564,127.84907029478458,129.3119274376417,20,9,361,1,355
1970,209,593,127.84907029478458,130.07818594104307,20,5,396,2,384
1971,209,690,127.84907029478458,130.1014058956916,20,1,491,2,481
1972,207,71,128.220589569161,129.84598639455783,24,35,153,2,136
1973,207,20,128.220589569161,130.86766439909297,24,34,219,3,187
1974,207,20,128.220589569161,131.19274376417235,24,33,227,3,187
1975,207,297,128.220589569161,129.91564625850341,24,16,116,2,90
1976,207,248,128.220589569161,130.9837641723356,24,14,126,3,41
1977,207,328,128.220589569161,131.05342403628117,24,12,172,3,121
1978,207,564,128.220589569161,129.3119274376417,24,9,360,1,357
1979,207,593,128.220589569161,130.07818594104307,24,5,394,2,386
1980,207,690,128.220589569161,130.1014058956916,24,1,490,2,483
1981,297,20,129.91564625850341,131.19274376417235,16,33,282,1,277
1982,297,248,129.91564625850341,130.9837641723356,16,14,67,1,49
1983,297,328,129.91564625850341,131.05342403628117,16,12,58,1,31
1984,297,437,129.91564625850341,131.54104308390023,16,2,157,2,140
1985,248,88,130.9837641723356,133.0271201814059,14,33,183,2,160
1986,248,25,130.9837641723356,133.3986394557823,14,38,246,2,223
1987,248,371,130.9837641723356,133.0271201814059,14,11,151,2,123
1988,248,381,130.9837641723356,133.79337868480727,14,21,180,3,133
1989,248,426,130.9837641723356,133.70049886621317,14,20,213,3,178
1990,248,649,130.9837641723356,133.25931972789115,14,17,413,2,401
1991,328,88,131.05342403628117,133.0271201814059,12,33,255,2,240
1992,328,25,131.05342403628117,133.3986394557823,12,38,319,2,303
1993,328,371,131.05342403628117,133.0271201814059,12,11,95,2,43
1994,328,381,131.05342403628117,133.79337868480727,12,21,129,3,53
1995,328,426,131.05342403628117,133.70049886621317,12,20,150,3,98
1996,328,649,131.05342403628117,133.25931972789115,12,17,335,2,321
1997,371,31,133.0271201814059,134.23455782312925,11,39,344,1,340
1998,371,26,133.0271201814059,135.32589569161,11,40,359,2,345
1999,371,293,133.0271201814059,134.1184580498866,11,17,91,1,78
2000,371,285,133.0271201814059,135.6974149659864,11,11,144,3,86
2001,371,507,133.0271201814059,134.42031746031745,11,13,149,1,136
2002,371,784,133.0271201814059,134.39709750566894,11,11,417,1,413
2003,381,26,133.79337868480727,135.32589569161,21,40,361,2,355
2004,381,62,133.79337868480727,136.1618140589569,21,37,335,2,319
2005,381,285,133.79337868480727,135.6974149659864,21,11,126,2,96
2006,381,311,133.79337868480727,136.1618140589569,21,8,124,2,70
2007,293,26,134.1184580498866,135.32589569161,17,40,272,1,267
2008,293,62,134.1184580498866,136.1618140589569,17,37,247,2,231
2009,293,285,134.1184580498866,135.6974149659864,17,11,68,2,8
2010,293,311,134.1184580498866,136.1618140589569,17,8,90,2,18
2011,293,426,134.1184580498866,136.8584126984127,17,5,178,3,133
2012,293,411,134.1184580498866,137.09061224489795,17,10,174,3,118
2013,285,23,135.6974149659864,137.3924716553288,11,37,272,2,262
2014,285,20,135.6974149659864,138.59990929705216,11,36,293,3,265
2015,285,272,135.6974149659864,137.9961904761905,11,16,100,2,13
2016,285,205,135.6974149659864,138.04263038548754,11,15,129,2,80
2017,285,426,135.6974149659864,136.8584126984127,11,5,150,1,141
2018,285,411,135.6974149659864,137.09061224489795,11,10,140,1,126
2019,285,418,135.6974149659864,138.0890702947846,11,3,168,2,133
2020,311,23,136.1618140589569,137.3924716553288,8,37,293,1,288
2021,311,20,136.1618140589569,138.59990929705216,8,36,309,2,291
2022,311,272,136.1618140589569,137.9961904761905,8,16,88,2,39
2023,311,205,136.1618140589569,138.04263038548754,8,15,133,2,106
2024,311,369,136.1618140589569,139.11074829931974,8,7,140,3,58
2025,311,418,136.1618140589569,138.0890702947846,8,3,135,2,107
2026,272,17,137.9961904761905,139.36616780045352,16,37,262,1,255
2027,272,369,137.9961904761905,139.11074829931974,16,7,108,1,97
2028,272,205,137.9961904761905,140.50394557823128,16,8,127,3,67
2029,205,17,138.04263038548754,139.36616780045352,15,37,196,1,188
2030,205,15,138.04263038548754,141.01478458049885,15,34,229,3,190
2031,205,369,138.04263038548754,139.11074829931974,15,7,170,1,164
2032,369,15,139.11074829931974,141.01478458049885,7,34,363,2,354
2033,369,15,139.11074829931974,141.06122448979593,7,36,364,2,354
2034,369,205,139.11074829931974,140.50394557823128,7,8,175,1,164
2035,369,205,139.11074829931974,141.9203628117914,7,9,204,3,164
2036,205,20,140.50394557823128,142.8956009070295,8,38,212,2,185
2037,205,20,140.50394557823128,143.05814058956918,8,33,215,3,185
2038,205,248,140.50394557823128,142.7562811791383,8,14,106,2,43
2039,205,208,140.50394557823128,143.31356009070296,8,7,121,3,3
2040,205,437,140.50394557823128,143.1742403628118,8,4,259,3,232
2041,205,20,141.9203628117914,143.05814058956918,9,33,191,1,185
2042,205,208,141.9203628117914,143.31356009070296,9,7,60,1,3
2043,205,437,141.9203628117914,143.1742403628118,9,4,238,1,232
2044,205,662,141.9203628117914,144.75319727891156,9,10,473,3,457
2045,248,8,142.7562811791383,144.91573696145124,14,41,257,2,240
2046,248,7,142.7562811791383,145.12471655328798,14,41,262,2,241
2047,248,205,142.7562811791383,144.91573696145124,14,25,102,2,43
2048,248,411,142.7562811791383,144.91573696145124,14,18,188,2,163
2049,248,662,142.7562811791383,144.75319727891156,14,10,423,2,414
2050,208,8,143.31356009070296,144.91573696145124,7,41,212,2,200
2051,208,7,143.31356009070296,145.12471655328798,7,41,216,2,201
2052,208,205,143.31356009070296,144.91573696145124,7,25,69,2,3
2053,208,206,143.31356009070296,145.91419501133788,7,26,112,3,2
2054,208,257,143.31356009070296,146.07673469387754,7,19,129,3,49
2055,208,411,143.31356009070296,144.91573696145124,7,18,214,2,203
2056,208,411,143.31356009070296,145.89097505668934,7,14,231,3,203
2057,208,412,143.31356009070296,146.05351473922903,7,13,236,3,204
2058,208,662,143.31356009070296,144.75319727891156,7,10,458,1,454
2059,205,47,144.91573696145124,146.4714739229025,25,38,172,2,158
2060,205,78,144.91573696145124,147.19129251700681,25,40,160,2,127
2061,205,257,144.91573696145124,146.07673469387754,25,19,72,1,52
2062,205,208,144.91573696145124,147.77179138321995,25,15,123,3,3
2063,205,412,144.91573696145124,146.05351473922903,25,13,213,1,207
2064,205,411,144.91573696145124,147.05197278911564,25,8,226,2,206
2065,205,639,144.91573696145124,146.68045351473924,25,8,441,2,434
2066,205,697,144.91573696145124,147.35383219954647,25,3,503,2,492
2067,206,78,145.91419501133788,147.19129251700681,26,40,139,1,128
2068,206,8,145.91419501133788,148.81668934240363,26,42,234,3,198
2069,206,208,145.91419501133788,147.77179138321995,26,15,80,2,2
2070,206,288,145.91419501133788,148.81668934240363,26,17,149,3,82
2071,206,411,145.91419501133788,147.05197278911564,26,8,211,1,205
2072,206,413,145.91419501133788,148.72380952380954,26,11,240,3,207
2073,206,697,145.91419501133788,147.35383219954647,26,3,495,1,491
2074,257,78,146.07673469387754,147.19129251700681,19,40,185,1,179
2075,257,8,146.07673469387754,148.81668934240363,19,42,276,3,249
2076,257,208,146.07673469387754,147.77179138321995,19,15,88,2,49
2077,257,288,146.07673469387754,148.81668934240363,19,17,122,3,31
2078,257,413,146.07673469387754,148.72380952380954,19,11,193,3,156
2079,257,697,146.07673469387754,147.35383219954647,19,3,443,1,440
2080,208,8,147.77179138321995,148.81668934240363,15,42,205,1,200
2081,208,7,147.77179138321995,149.28108843537416,15,38,211,2,201
2082,208,23,147.77179138321995,150.34920634920636,15,37,216,3,185
2083,208,288,147.77179138321995,148.81668934240363,15,17,92,1,80
2084,208,215,147.77179138321995,150.02412698412698,15,26,97,2,7
2085,208,214,147.77179138321995,150.04734693877552,15,27,98,2,6
2086,208,413,147.77179138321995,149.79192743764173,15,24,223,2,205
2087,208,411,147.77179138321995,150.14022675736962,15,19,227,2,203
2088,288,23,148.81668934240363,150.34920634920636,17,37,273,2,265
2089,288,215,148.81668934240363,150.02412698412698,17,26,90,1,73
2090,288,214,148.81668934240363,150.04734693877552,17,27,91,1,74
2091,288,411,148.81668934240363,150.14022675736962,17,19,136,1,123
2092,288,677,148.81668934240363,151.57986394557824,17,1,407,3,389
2093,215,23,150.02412698412698,152.02104308390022,26,36,210,2,192
2094,215,9,150.02412698412698,152.67120181405895,26,41,235,3,206
2095,215,212,150.02412698412698,151.97460317460317,26,18,84,2,3
2096,215,310,150.02412698412698,152.39256235827665,26,13,139,2,95
2097,215,420,150.02412698412698,151.8120634920635,26,11,219,2,205
2098,215,435,150.02412698412698,152.6015419501134,26,10,246,3,220
2099,215,677,150.02412698412698,151.57986394557824,26,1,467,2,462
2100,214,23,150.04734693877552,152.02104308390022,27,36,209,2,191
2101,214,9,150.04734693877552,152.67120181405895,27,41,234,3,205
2102,214,212,150.04734693877552,151.97460317460317,27,18,83,2,2
2103,214,310,150.04734693877552,152.39256235827665,27,13,139,2,96
2104,214,420,150.04734693877552,151.8120634920635,27,11,220,2,206
2105,214,435,150.04734693877552,152.6015419501134,27,10,247,3,221
2106,214,677,150.04734693877552,151.57986394557824,27,1,468,2,463
2107,212,7,151.97460317460317,153.08916099773242,18,40,211,1,205
2108,212,26,151.97460317460317,154.08761904761906,18,39,207,2,186
2109,212,380,151.97460317460317,153.97151927437642,18,17,189,2,168
2110,212,210,151.97460317460317,154.83065759637188,18,22,123,3,2
2111,212,430,151.97460317460317,153.97151927437642,18,11,234,2,218
2112,212,428,151.97460317460317,154.15727891156462,18,15,236,2,216
2113,310,26,152.39256235827665,154.08761904761906,13,39,293,2,284
2114,310,380,152.39256235827665,153.97151927437642,13,17,98,2,70
2115,310,210,152.39256235827665,154.83065759637188,13,22,145,2,100
2116,310,430,152.39256235827665,153.97151927437642,13,11,138,2,120
2117,310,428,152.39256235827665,154.15727891156462,13,15,140,2,118
2118,310,630,152.39256235827665,155.03963718820862,13,4,340,3,320
2119,310,635,152.39256235827665,155.1092970521542,13,13,345,3,325
2120,380,21,153.97151927437642,155.5504761904762,17,38,365,2,359
2121,380,8,153.97151927437642,156.75791383219956,17,41,391,3,372
2122,380,223,153.97151927437642,155.80589569160998,17,25,176,2,157
2123,380,208,153.97151927437642,156.22385487528345,17,20,197,2,172
2124,380,447,153.97151927437642,155.6433560090703,17,14,98,2,67
2125,380,411,153.97151927437642,156.40961451247165,17,10,109,2,31
2126,380,630,153.97151927437642,155.03963718820862,17,4,254,1,250
2127,380,635,153.97151927437642,155.1092970521542,17,13,260,1,255
2128,380,876,153.97151927437642,156.47927437641724,17,3,508,3,496
2129,210,8,154.83065759637188,156.75791383219956,22,41,218,2,202
2130,210,25,154.83065759637188,157.80281179138322,22,38,225,3,185
2131,210,208,154.83065759637188,156.22385487528345,22,20,60,1,2
2132,210,411,154.83065759637188,156.40961451247165,22,10,212,2,201
2133,210,416,154.83065759637188,157.57061224489797,22,19,237,3,206
2134,210,648,154.83065759637188,157.45451247165533,22,5,452,3,438
2135,223,25,155.80589569160998,157.80281179138322,25,38,216,2,198
2136,223,228,155.80589569160998,157.91891156462586,25,23,91,2,5
2137,223,216,155.80589569160998,158.70839002267573,25,24,125,3,7
2138,223,416,155.80589569160998,157.57061224489797,25,19,207,2,193
2139,223,428,155.80589569160998,158.17433106575965,25,21,229,2,205
2140,223,648,155.80589569160998,157.45451247165533,25,5,431,2,425
2141,208,25,156.22385487528345,157.80281179138322,20,38,195,2,183
2142,208,23,156.22385487528345,158.82448979591837,20,39,216,3,185
2143,208,228,156.22385487528345,157.91891156462586,20,23,76,2,20
2144,208,216,156.22385487528345,158.70839002267573,20,24,107,2,8
2145,208,206,156.22385487528345,159.07990929705215,20,15,123,3,2
2146,208,416,156.22385487528345,157.57061224489797,20,19,216,1,208
2147,208,428,156.22385487528345,158.17433106575965,20,21,235,2,220
2148,208,460,156.22385487528345,159.05668934240364,20,5,280,3,252
2149,208,648,156.22385487528345,157.45451247165533,20,5,443,1,440
2150,208,678,156.22385487528345,158.96380952380952,20,6,485,3,470
2151,228,21,157.91891156462586,159.45142857142858,23,38,217,2,207
2152,228,9,157.91891156462586,160.56598639455783,23,42,247,3,219
2153,228,206,157.91891156462586,159.07990929705215,23,15,55,1,22
2154,228,206,157.91891156462586,160.8910657596372,23,9,130,3,22
2155,228,460,157.91891156462586,159.05668934240364,23,5,237,1,232
2156,228,678,157.91891156462586,158.96380952380952,23,6,452,1,450
2157,216,9,158.70839002267573,160.56598639455783,24,42,222,2,207
2158,216,7,158.70839002267573,161.0768253968254,24,37,233,2,209
2159,216,206,158.70839002267573,160.8910657596372,24,9,95,2,10
2160,216,427,158.70839002267573,161.56444444444446,24,7,244,3,211
2161,206,9,159.07990929705215,160.56598639455783,15,42,207,1,197
2162,206,7,159.07990929705215,161.0768253968254,15,37,217,2,199
2163,206,303,159.07990929705215,162.02884353741496,15,15,160,3,97
2164,206,427,159.07990929705215,161.56444444444446,15,7,246,2,221
2165,206,26,160.8910657596372,162.2378231292517,9,37,189,1,180
2166,206,69,160.8910657596372,163.3059410430839,9,37,172,2,137
2167,206,303,160.8910657596372,162.02884353741496,9,15,109,1,97
2168,206,237,160.8910657596372,162.2378231292517,9,20,66,1,31
2169,206,421,160.8910657596372,162.2378231292517,9,12,223,1,215
2170,206,431,160.8910657596372,163.63102040816327,9,10,254,3,225
2171,303,69,162.02884353741496,163.3059410430839,15,37,240,1,234
2172,303,7,162.02884353741496,164.79201814058956,15,41,319,3,296
2173,303,219,162.02884353741496,163.9328798185941,15,22,117,2,84
2174,303,272,162.02884353741496,164.04897959183674,15,19,92,2,31
2175,303,431,162.02884353741496,163.63102040816327,15,10,145,2,128
2176,303,420,162.02884353741496,164.76879818594105,15,17,166,3,117
2177,303,797,162.02884353741496,164.30439909297053,15,15,504,2,494
2178,237,69,162.2378231292517,163.3059410430839,20,37,174,1,168
2179,237,7,162.2378231292517,164.79201814058956,20,41,255,3,230
2180,237,219,162.2378231292517,163.9328798185941,20,22,75,2,18
2181,237,272,162.2378231292517,164.04897959183674,20,19,85,2,35
2182,237,431,162.2378231292517,163.63102040816327,20,10,203,1,194
2183,237,420,162.2378231292517,164.76879818594105,20,17,213,3,183
2184,237,418,162.2378231292517,165.14031746031748,20,18,220,3,181
2185,219,34,163.9328798185941,165.48861678004536,22,37,197,2,185
2186,219,14,163.9328798185941,166.16199546485262,22,37,226,2,205
2187,219,213,163.9328798185941,165.41895691609977,22,26,64,1,6
2188,219,208,163.9328798185941,166.48707482993197,22,18,111,3,11
2189,219,418,163.9328798185941,165.14031746031748,22,18,206,1,199
2190,219,601,163.9328798185941,166.6031746031746,22,5,399,3,382
2191,272,34,164.04897959183674,165.48861678004536,19,37,246,1,238
2192,272,14,164.04897959183674,166.16199546485262,19,37,274,2,258
2193,272,213,164.04897959183674,165.41895691609977,19,26,83,1,59
2194,272,208,164.04897959183674,166.48707482993197,19,18,123,2,64
2195,272,418,164.04897959183674,165.14031746031748,19,18,153,1,146
2196,272,601,164.04897959183674,166.6031746031746,19,5,347,3,329
2197,213,26,165.41895691609977,167.857052154195,26,38,214,2,187
2198,213,208,165.41895691609977,166.48707482993197,26,18,46,1,5
2199,213,366,165.41895691609977,167.20689342403628,26,14,171,2,153
2200,213,306,165.41895691609977,168.13569160997733,26,8,149,3,93
2201,213,601,165.41895691609977,166.6031746031746,26,5,391,1,388
2202,213,563,165.41895691609977,167.20689342403628,26,14,358,2,350
2203,213,626,165.41895691609977,167.20689342403628,26,8,420,2,413
2204,208,26,166.48707482993197,167.857052154195,18,38,191,1,182
2205,208,8,166.48707482993197,168.48399092970521,18,42,218,2,200
2206,208,306,166.48707482993197,168.13569160997733,18,8,121,2,98
2207,366,8,167.20689342403628,168.48399092970521,14,42,362,1,358
2208,366,25,167.20689342403628,169.99328798185942,14,37,361,3,341
2209,366,330,167.20689342403628,169.7843083900227,14,17,117,3,36
2210,366,413,167.20689342403628,170.03972789115647,14,10,131,3,47
2211,366,766,167.20689342403628,169.0877097505669,14,4,408,2,400
2212,306,25,168.13569160997733,169.99328798185942,8,37,292,2,281
2213,306,70,168.13569160997733,170.504126984127,8,37,257,2,236
2214,306,330,168.13569160997733,169.7843083900227,8,17,75,2,24
2215,306,222,168.13569160997733,170.3415873015873,8,28,127,2,84
2216,306,413,168.13569160997733,170.03972789115647,8,10,135,2,107
2217,306,428,168.13569160997733,170.27192743764172,8,21,153,2,122
2218,330,24,169.7843083900227,171.96698412698413,17,38,320,2,306
2219,330,8,169.7843083900227,172.40816326530611,17,41,341,3,322
2220,330,226,169.7843083900227,171.5025850340136,17,25,128,2,104
2221,330,226,169.7843083900227,172.12952380952382,17,22,145,2,104
2222,330,452,169.7843083900227,171.4793650793651,17,9,142,2,122
2223,330,418,169.7843083900227,172.2920634920635,17,9,139,3,88
2224,222,24,170.3415873015873,171.96698412698413,28,38,210,2,198
2225,222,8,170.3415873015873,172.40816326530611,28,41,232,2,214
2226,222,226,170.3415873015873,171.5025850340136,28,25,50,1,4
2227,222,226,170.3415873015873,172.12952380952382,28,22,77,2,4
2228,222,452,170.3415873015873,171.4793650793651,28,9,235,1,230
2229,222,418,170.3415873015873,172.2920634920635,28,9,213,2,196
2230,226,51,171.5025850340136,173.638820861678,25,36,198,2,175
2231,226,51,171.5025850340136,174.2657596371882,25,35,212,3,175
2232,226,283,171.5025850340136,173.6156009070295,25,19,107,2,57
2233,226,205,171.5025850340136,174.4515192743764,25,14,129,3,21
2234,226,411,171.5025850340136,173.59238095238095,25,8,206,2,185
2235,226,432,171.5025850340136,174.38185941043085,25,4,240,3,206
2236,226,51,172.12952380952382,173.638820861678,22,36,187,2,175
2237,226,51,172.12952380952382,174.2657596371882,22,35,198,2,175
2238,226,21,172.12952380952382,175.10167800453516,22,38,242,3,205
2239,226,283,172.12952380952382,173.6156009070295,22,19,86,1,57
2240,226,205,172.12952380952382,174.4515192743764,22,14,102,2,21
2241,226,411,172.12952380952382,173.59238095238095,22,8,195,1,185
2242,226,432,172.12952380952382,174.38185941043085,22,4,228,2,206
2243,226,657,172.12952380952382,174.89269841269842,22,1,447,3,431
2244,283,21,173.6156009070295,175.10167800453516,19,38,270,1,262
2245,283,8,173.6156009070295,176.4019954648526,19,43,300,3,275
2246,283,285,173.6156009070295,175.79827664399093,19,16,94,2,2
2247,283,427,173.6156009070295,175.21777777777777,19,6,160,2,144
2248,283,419,173.6156009070295,176.16979591836736,19,1,175,3,136
2249,283,657,173.6156009070295,174.89269841269842,19,1,378,1,374
2250,205,8,174.4515192743764,176.4019954648526,14,43,214,2,197
2251,205,25,174.4515192743764,177.3772335600907,14,38,220,3,180
2252,205,285,174.4515192743764,175.79827664399093,14,16,99,1,80
2253,205,419,174.4515192743764,176.16979591836736,14,1,226,2,214
2254,285,25,175.79827664399093,177.3772335600907,16,38,269,2,260
2255,285,205,175.79827664399093,177.02893424036282,16,10,96,1,80
2256,285,278,175.79827664399093,177.70231292517008,16,24,82,2,7
2257,285,207,175.79827664399093,178.77043083900227,16,27,150,3,78
2258,285,440,175.79827664399093,177.5397732426304,16,12,172,2,155
2259,285,432,175.79827664399093,178.1899319727891,16,12,179,2,147
2260,205,23,177.02893424036282,179.00263038548752,10,37,201,2,182
2261,205,207,177.02893424036282,178.77043083900227,10,27,75,2,2
2262,205,208,177.02893424036282,179.09551020408165,10,23,89,2,3
2263,205,432,177.02893424036282,178.1899319727891,10,12,232,1,227
2264,205,420,177.02893424036282,179.2580498866213,10,14,235,2,215
2265,205,677,177.02893424036282,179.46702947845804,10,10,484,2,472
2266,278,23,177.70231292517008,179.00263038548752,24,37,261,1,255
2267,278,9,177.70231292517008,180.0475283446712,24,39,287,2,269
2268,278,8,177.70231292517008,180.16362811791385,24,42,290,2,270
2269,278,207,177.70231292517008,178.77043083900227,24,27,85,1,71
2270,278,208,177.70231292517008,179.09551020408165,24,23,92,1,70
2271,278,420,177.70231292517008,179.2580498866213,24,14,157,2,142
2272,278,677,177.70231292517008,179.46702947845804,24,10,406,2,399
2273,207,9,178.77043083900227,180.0475283446712,27,39,205,1,198
2274,207,8,178.77043083900227,180.16362811791385,27,42,208,1,199
2275,207,34,178.77043083900227,181.39428571428573,27,39,207,3,173
2276,207,308,178.77043083900227,180.90666666666667,27,20,137,2,101
2277,207,210,178.77043083900227,181.3014058956916,27,30,109,3,3
2278,207,410,178.77043083900227,180.90666666666667,27,11,223,2,203
2279,207,411,178.77043083900227,181.23174603174604,27,20,230,2,204
2280,208,8,179.09551020408165,180.16362811791385,23,42,205,1,200
2281,208,34,179.09551020408165,181.39428571428573,23,39,200,2,174
2282,208,308,179.09551020408165,180.90666666666667,23,20,127,2,100
2283,208,210,179.09551020408165,181.3014058956916,23,30,95,2,2
2284,208,410,179.09551020408165,180.90666666666667,23,11,217,2,202
2285,208,411,179.09551020408165,181.23174603174604,23,20,223,2,203
2286,308,36,180.90666666666667,182.6249433106576,20,35,282,2,272
2287,308,246,180.90666666666667,182.9732426303855,20,10,108,2,62
2288,308,205,180.90666666666667,183.41442176870748,20,11,149,3,103
2289,308,419,180.90666666666667,182.8107029478458,20,5,138,2,111
2290,308,410,180.90666666666667,183.55374149659863,20,2,153,3,102
2291,308,796,180.90666666666667,182.92680272108845,20,8,496,2,488
2292,210,36,181.3014058956916,182.6249433106576,30,35,183,1,174
2293,210,8,181.3014058956916,184.0413605442177,30,41,234,3,202
2294,210,8,181.3014058956916,184.15746031746033,30,42,237,3,202
2295,210,246,181.3014058956916,182.9732426303855,30,10,80,2,36
2296,210,205,181.3014058956916,183.41442176870748,30,11,91,2,5
2297,210,419,181.3014058956916,182.8107029478458,30,5,219,2,209
2298,210,410,181.3014058956916,183.55374149659863,30,2,222,2,200
2299,246,8,182.9732426303855,184.0413605442177,10,41,242,1,238
2300,246,8,182.9732426303855,184.15746031746033,10,42,243,1,238
2301,246,5,182.9732426303855,185.06303854875284,10,35,257,2,241
2302,246,324,182.9732426303855,185.0165986394558,10,9,118,2,78
2303,246,325,182.9732426303855,185.50421768707483,10,11,135,3,79
2304,205,5,183.41442176870748,185.06303854875284,11,35,212,2,200
2305,205,324,183.41442176870748,185.0165986394558,11,9,138,2,119
2306,205,325,183.41442176870748,185.50421768707483,11,11,150,2,120
2307,324,21,185.0165986394558,186.9206349206349,9,41,314,2,303
2308,324,7,185.0165986394558,187.31537414965987,9,42,332,2,317
2309,324,230,185.0165986394558,186.78131519274376,9,20,121,2,94
2310,324,292,185.0165986394558,187.12961451247165,9,7,96,2,32
2311,324,493,185.0165986394558,186.47945578231293,9,2,180,1,169
2312,324,491,185.0165986394558,187.91909297052155,9,0,209,3,167
2313,325,21,185.50421768707483,186.9206349206349,11,41,310,1,304
2314,325,7,185.50421768707483,187.31537414965987,11,42,327,2,318
2315,325,9,185.50421768707483,188.22095238095238,11,35,337,3,316
2316,325,230,185.50421768707483,186.78131519274376,11,20,110,1,95
2317,325,292,185.50421768707483,187.12961451247165,11,7,77,2,33
2318,325,491,185.50421768707483,187.91909297052155,11,0,196,2,166
2319,230,9,186.78131519274376,188.22095238095238,20,35,230,1,221
2320,230,207,186.78131519274376,188.778231292517,20,9,89,2,23
2321,230,491,186.78131519274376,187.91909297052155,20,0,266,1,261
2322,292,9,187.12961451247165,188.22095238095238,7,35,287,1,283
2323,292,9,187.12961451247165,190.03210884353743,7,33,309,3,283
2324,292,207,187.12961451247165,188.778231292517,7,9,111,2,85
2325,292,206,187.12961451247165,189.89278911564625,7,5,147,3,86
2326,207,9,188.778231292517,190.03210884353743,9,33,205,1,198
2327,207,9,188.778231292517,190.12498866213153,9,35,206,1,198
2328,207,8,188.778231292517,191.5181859410431,9,42,231,3,199
2329,207,206,188.778231292517,189.89278911564625,9,5,48,1,1
2330,206,8,189.89278911564625,191.5181859410431,5,42,210,2,198
2331,206,6,189.89278911564625,192.14512471655328,5,38,222,2,200
2332,206,245,189.89278911564625,192.00580498866213,5,10,99,2,39
2333,206,306,189.89278911564625,192.44698412698412,5,12,149,3,100
2334,207,6,190.75192743764174,192.14512471655328,10,38,210,1,201
2335,207,245,190.75192743764174,192.00580498866213,10,10,66,1,38
2336,207,306,190.75192743764174,192.44698412698412,10,12,123,2,99
2337,207,248,190.75192743764174,193.70086167800454,10,14,133,3,41
2338,245,23,192.00580498866213,193.77052154195013,10,31,235,2,222
2339,245,8,192.00580498866213,194.88507936507938,10,42,267,3,237
2340,245,248,192.00580498866213,193.70086167800454,10,14,73,2,3
2341,245,232,192.00580498866213,194.67609977324264,10,10,116,3,13
2342,245,437,192.00580498866213,194.23492063492063,10,1,215,2,192
2343,306,23,192.44698412698412,193.77052154195013,12,31,289,1,283
2344,306,8,192.44698412698412,194.88507936507938,12,42,316,2,298
2345,306,7,192.44698412698412,195.16371882086167,12,42,321,3,299
2346,306,248,192.44698412698412,193.70086167800454,12,14,79,1,58
2347,306,232,192.44698412698412,194.67609977324264,12,10,121,2,74
2348,306,437,192.44698412698412,194.23492063492063,12,1,152,2,131
2349,248,8,193.70086167800454,194.88507936507938,14,42,245,1,240
2350,248,7,193.70086167800454,195.16371882086167,14,42,249,1,241
2351,248,9,193.70086167800454,196.0692970521542,14,35,260,2,239
2352,248,205,193.70086167800454,195.67455782312925,14,11,95,2,43
2353,248,246,193.70086167800454,196.30149659863946,14,7,112,3,2
2354,232,9,194.67609977324264,196.0692970521542,10,35,231,1,223
2355,232,246,194.67609977324264,196.30149659863946,10,7,71,2,14
2356,232,246,194.67609977324264,197.1374149659864,10,12,107,2,14
2357,232,410,194.67609977324264,196.83555555555557,10,7,201,2,178
2358,232,411,194.67609977324264,197.5089342403628,10,6,217,3,179
2359,205,9,195.67455782312925,197.92689342403628,11,35,219,2,196
2360,205,8,195.67455782312925,198.43773242630385,11,42,230,3,197
2361,205,246,195.67455782312925,197.1374149659864,11,12,75,1,41
2362,205,246,195.67455782312925,198.6467120181406,11,10,134,3,41
2363,205,410,195.67455782312925,196.83555555555557,11,7,211,1,205
2364,205,411,195.67455782312925,197.5089342403628,11,6,221,2,206
2365,205,411,195.67455782312925,198.06621315192743,11,3,230,2,206
2366,246,9,196.30149659863946,197.92689342403628,7,35,247,2,237
2367,246,8,196.30149659863946,198.43773242630385,7,42,255,2,238
2368,246,5,196.30149659863946,199.2039909297052,7,37,271,3,241
2369,246,411,196.30149659863946,197.5089342403628,7,6,173,1,165
2370,246,411,196.30149659863946,198.06621315192743,7,3,182,2,165
2371,246,411,196.30149659863946,199.15755102040816,7,6,206,3,165
2372,246,8,197.1374149659864,198.43773242630385,12,42,244,1,238
2373,246,5,197.1374149659864,199.2039909297052,12,37,257,2,241
2374,246,411,197.1374149659864,199.15755102040816,12,6,187,2,165
2375,246,13,198.6467120181406,200.31854875283446,10,35,244,2,233
2376,246,306,198.6467120181406,200.2721088435374,10,11,92,2,60
2377,246,248,198.6467120181406,201.52598639455783,10,14,124,3,2
2378,246,414,198.6467120181406,201.54920634920634,10,2,209,3,168
2379,246,734,198.6467120181406,201.03836734693877,10,0,499,2,488
2380,246,8,199.50585034013605,201.87428571428572,11,43,259,2,238
2381,246,7,199.50585034013605,202.08326530612246,11,41,264,3,239
2382,246,248,199.50585034013605,201.52598639455783,11,14,87,2,2
2383,246,206,199.50585034013605,202.45478458049888,11,14,133,3,40
2384,246,414,199.50585034013605,201.54920634920634,11,2,190,2,168
2385,246,734,199.50585034013605,201.03836734693877,11,0,492,2,488
2386,306,8,200.2721088435374,201.87428571428572,11,43,306,2,298
2387,306,7,200.2721088435374,202.08326530612246,11,41,309,2,299
2388,306,248,200.2721088435374,201.52598639455783,11,14,79,1,58
2389,306,206,200.2721088435374,202.45478458049888,11,14,137,2,100
2390,306,414,200.2721088435374,201.54920634920634,11,2,121,1,108
2391,306,411,200.2721088435374,202.64054421768708,11,1,146,2,105
2392,306,747,200.2721088435374,201.80462585034013,11,2,446,2,441
2393,248,8,201.52598639455783,203.77832199546486,14,41,259,2,240
2394,248,228,201.52598639455783,203.61578231292518,14,25,92,2,20
2395,248,411,201.52598639455783,202.64054421768708,14,1,170,1,163
2396,248,420,201.52598639455783,203.6390022675737,14,21,195,2,172
2397,248,726,201.52598639455783,203.49968253968254,14,9,485,2,478
2398,248,681,201.52598639455783,204.49814058956918,14,5,452,3,433
2399,206,8,202.45478458049888,203.77832199546486,14,41,206,1,198
2400,206,26,202.45478458049888,204.66068027210883,14,39,204,2,180
2401,206,228,202.45478458049888,203.61578231292518,14,25,55,1,22
2402,206,207,202.45478458049888,204.7071201814059,14,28,97,2,1
2403,206,420,202.45478458049888,203.6390022675737,14,21,220,1,214
2404,206,415,202.45478458049888,204.7071201814059,14,20,230,2,209
2405,206,681,202.45478458049888,204.49814058956918,14,5,483,2,475
2406,228,26,203.61578231292518,204.66068027210883,25,39,207,1,202
2407,228,78,203.61578231292518,206.0306575963719,25,38,183,2,150
2408,228,207,203.61578231292518,204.7071201814059,25,28,51,1,21
2409,228,277,203.61578231292518,205.84489795918367,25,23,108,2,49
2410,228,285,203.61578231292518,206.07709750566895,25,13,120,2,57
2411,228,415,203.61578231292518,204.7071201814059,25,20,193,1,187
2412,228,410,203.61578231292518,205.63591836734693,25,14,202,2,182
2413,228,546,203.61578231292518,206.23963718820863,25,9,337,3,318
2414,228,636,203.61578231292518,205.49659863945578,25,11,416,2,408
2415,207,78,204.7071201814059,206.0306575963719,28,38,141,1,129
2416,207,9,204.7071201814059,207.00589569161,28,40,221,2,198
2417,207,8,204.7071201814059,207.23809523809524,28,42,227,3,199
2418,207,277,204.7071201814059,205.84489795918367,28,23,85,1,70
2419,207,285,204.7071201814059,206.07709750566895,28,13,98,1,78
2420,207,546,204.7071201814059,206.23963718820863,28,9,345,2,339
2421,207,431,204.7071201814059,207.58639455782313,28,18,256,3,224
2422,277,9,205.84489795918367,207.00589569161,23,40,273,1,268
2423,277,8,205.84489795918367,207.23809523809524,23,42,276,1,269
2424,277,281,205.84489795918367,207.8418140589569,23,22,86,2,4
2425,277,431,205.84489795918367,207.58639455782313,23,18,171,2,154
2426,285,8,206.07709750566895,207.23809523809524,13,42,281,1,277
2427,285,23,206.07709750566895,209.0492517006803,13,39,292,3,262
2428,285,281,206.07709750566895,207.8418140589569,13,22,76,2,4
2429,285,232,206.07709750566895,208.9099319727891,13,27,133,3,53
2430,285,431,206.07709750566895,207.58639455782313,13,18,160,2,146
2431,285,417,206.07709750566895,208.93315192743765,13,22,180,3,132
2432,281,23,207.8418140589569,209.0492517006803,22,39,263,1,258
2433,281,23,207.8418140589569,209.0724716553288,22,39,263,1,258
2434,281,232,207.8418140589569,208.9099319727891,22,27,67,1,49
2435,281,296,207.8418140589569,209.28145124716553,22,24,64,1,15
2436,281,232,207.8418140589569,210.72108843537416,22,19,133,3,49
2437,281,417,207.8418140589569,208.93315192743765,22,22,144,1,136
2438,281,410,207.8418140589569,209.30467120181407,22,22,144,1,129
2439,281,410,207.8418140589569,210.65142857142857,22,10,177,3,129
2440,281,722,207.8418140589569,209.5136507936508,22,3,447,2,441
2441,281,738,207.8418140589569,210.39600907029478,22,1,470,3,457
2442,232,9,208.9099319727891,210.90684807256235,27,39,239,2,223
2443,232,7,208.9099319727891,211.44090702947847,27,42,250,3,225
2444,232,410,208.9099319727891,210.65142857142857,27,10,193,2,178
2445,232,459,208.9099319727891,211.39446712018142,27,10,251,2,227
2446,296,9,209.28145124716553,210.90684807256235,24,39,295,2,287
2447,296,7,209.28145124716553,211.44090702947847,24,42,304,2,289
2448,296,232,209.28145124716553,210.72108843537416,24,19,89,1,64
2449,296,275,209.28145124716553,212.0214058956916,24,22,120,3,21
2450,296,410,209.28145124716553,210.65142857142857,24,10,128,1,114
2451,296,459,209.28145124716553,211.39446712018142,24,10,187,2,163
2452,296,738,209.28145124716553,210.39600907029478,24,1,445,1,442
2453,296,778,209.28145124716553,211.39446712018142,24,12,491,2,482
2454,232,26,210.72108843537416,212.95020408163265,19,39,227,2,206
2455,232,51,210.72108843537416,213.67002267573696,19,38,221,3,181
2456,232,275,210.72108843537416,212.0214058956916,19,22,71,1,43
2457,232,307,210.72108843537416,213.01986394557824,19,19,124,2,75
2458,232,281,210.72108843537416,213.67002267573696,19,25,136,3,49
2459,232,410,210.72108843537416,212.9966439909297,19,20,203,2,178
2460,232,410,210.72108843537416,213.67002267573696,19,15,219,3,178
2461,275,51,212.0214058956916,213.67002267573696,22,38,235,2,224
2462,275,21,212.0214058956916,214.34340136054422,22,37,273,2,254
2463,275,281,212.0214058956916,213.67002267573696,22,25,71,2,6
2464,275,210,212.0214058956916,214.97034013605443,22,23,143,3,65
2465,275,410,212.0214058956916,213.67002267573696,22,15,153,2,135
2466,275,428,212.0214058956916,214.62204081632655,22,16,190,3,153
2467,275,617,212.0214058956916,213.83256235827665,22,6,351,2,342
2468,307,21,213.01986394557824,214.34340136054422,19,37,292,1,286
2469,307,8,213.01986394557824,215.36507936507937,19,42,316,2,299
2470,307,210,213.01986394557824,214.97034013605443,19,23,128,2,97
2471,307,206,213.01986394557824,215.22575963718822,19,26,139,2,101
2472,307,428,213.01986394557824,214.62204081632655,19,16,139,2,121
2473,307,411,213.01986394557824,215.22575963718822,19,17,141,2,104
2474,281,8,213.67002267573696,215.36507936507937,25,42,283,2,273
2475,281,210,213.67002267573696,214.97034013605443,25,23,90,1,71
2476,281,206,213.67002267573696,215.22575963718822,25,26,101,2,75
2477,281,411,213.67002267573696,215.22575963718822,25,17,146,2,130
2478,210,77,214.97034013605443,216.87437641723358,23,39,156,2,133
2479,210,23,214.97034013605443,217.6174149659864,23,38,219,3,187
2480,210,279,214.97034013605443,216.68861678004535,23,25,101,2,69
2481,210,212,214.97034013605443,217.50131519274376,23,26,109,3,2
2482,210,420,214.97034013605443,216.9904761904762,23,20,227,2,210
2483,210,417,214.97034013605443,217.38521541950115,23,18,232,2,207
2484,206,77,215.22575963718822,216.87437641723358,26,39,147,2,129
2485,206,23,215.22575963718822,217.6174149659864,26,38,210,2,183
2486,206,279,215.22575963718822,216.68861678004535,26,25,96,1,73
2487,206,212,215.22575963718822,217.50131519274376,26,26,98,2,6
2488,206,420,215.22575963718822,216.9904761904762,26,20,227,2,214
2489,206,417,215.22575963718822,217.38521541950115,26,18,231,2,211
2490,279,8,216.68861678004535,218.91773242630387,25,42,288,2,271
2491,279,7,216.68861678004535,219.08027210884353,25,40,291,2,272
2492,279,364,216.68861678004535,218.56943310657596,25,20,117,2,85
2493,279,249,216.68861678004535,219.19637188208617,25,11,112,3,30
2494,279,483,216.68861678004535,218.45333333333335,25,10,218,2,204
2495,279,471,216.68861678004535,219.19637188208617,25,5,220,3,192
2496,279,639,216.68861678004535,219.05705215419502,25,1,374,2,360
2497,212,8,217.50131519274376,218.91773242630387,26,42,213,1,204
2498,212,7,217.50131519274376,219.08027210884353,26,40,216,2,205
2499,212,91,217.50131519274376,220.31092970521541,26,38,171,3,121
2500,212,364,217.50131519274376,218.56943310657596,26,20,159,1,152
2501,212,249,217.50131519274376,219.19637188208617,26,11,82,2,37
2502,212,471,217.50131519274376,219.19637188208617,26,5,269,2,259
2503,212,410,217.50131519274376,220.35736961451246,26,10,233,3,198
2504,212,639,217.50131519274376,219.05705215419502,26,1,432,2,427
2505,364,91,218.56943310657596,220.31092970521541,20,38,283,2,273
2506,364,75,218.56943310657596,221.30938775510205,20,36,312,3,289
2507,364,231,218.56943310657596,220.98430839002268,20,21,169,2,133
2508,364,208,218.56943310657596,221.49514739229025,20,25,201,3,156
2509,364,410,218.56943310657596,220.35736961451246,20,10,90,2,46
2510,364,426,218.56943310657596,221.2861678004535,20,16,132,3,62
2511,249,91,219.19637188208617,220.31092970521541,11,38,165,1,158
2512,249,75,219.19637188208617,221.30938775510205,11,36,196,2,174
2513,249,231,219.19637188208617,220.98430839002268,11,21,79,2,18
2514,249,208,219.19637188208617,221.49514739229025,11,25,107,2,41
2515,249,410,219.19637188208617,220.35736961451246,11,10,169,1,161
2516,249,426,219.19637188208617,221.2861678004535,11,16,199,2,177
2517,231,7,220.98430839002268,223.0508843537415,21,41,241,2,224
2518,231,7,220.98430839002268,223.07410430839002,21,41,241,2,224
2519,231,248,220.98430839002268,222.6097052154195,21,24,72,2,17
2520,231,315,220.98430839002268,223.95646258503402,21,22,153,3,84
2521,231,433,220.98430839002268,222.6097052154195,21,13,214,2,202
2522,231,420,220.98430839002268,223.95646258503402,21,12,228,3,189
2523,208,7,221.49514739229025,223.0508843537415,25,41,212,2,201
2524,208,7,221.49514739229025,223.07410430839002,25,41,212,2,201
2525,208,34,221.49514739229025,224.2118820861678,25,39,210,3,174
2526,208,248,221.49514739229025,222.6097052154195,25,24,62,1,40
2527,208,315,221.49514739229025,223.95646258503402,25,22,151,2,107
2528,208,244,221.49514739229025,224.3047619047619,25,23,126,3,36
2529,208,433,221.49514739229025,222.6097052154195,25,13,230,1,225
2530,208,420,221.49514739229025,223.95646258503402,25,12,237,2,212
2531,208,419,221.49514739229025,224.32798185941044,25,7,244,3,211
2532,248,34,222.6097052154195,224.2118820861678,24,39,225,2,214
2533,248,35,222.6097052154195,225.32643990929705,24,40,243,3,213
2534,248,315,222.6097052154195,223.95646258503402,24,22,89,1,67
2535,248,244,222.6097052154195,224.3047619047619,24,23,73,2,4
2536,248,420,222.6097052154195,223.95646258503402,24,12,182,1,172
2537,248,419,222.6097052154195,224.32798185941044,24,7,186,2,171
2538,315,35,223.95646258503402,225.32643990929705,22,40,286,1,280
2539,315,212,223.95646258503402,225.65151927437643,22,20,126,2,103
2540,315,267,223.95646258503402,226.0694784580499,22,18,103,2,48
2541,315,507,223.95646258503402,226.04625850340136,22,17,212,2,192
2542,315,507,223.95646258503402,226.0694784580499,22,20,212,2,192
2543,315,620,223.95646258503402,226.02303854875285,22,11,318,2,305
2544,315,800,223.95646258503402,226.0926984126984,22,3,494,2,485
2545,244,35,224.3047619047619,225.32643990929705,23,40,214,1,209
2546,244,9,224.3047619047619,227.0679365079365,23,40,263,3,235
2547,244,212,224.3047619047619,225.65151927437643,23,20,66,1,32
2548,244,267,224.3047619047619,226.0694784580499,23,18,79,2,23
2549,244,507,224.3047619047619,226.04625850340136,23,17,273,2,263
2550,244,507,224.3047619047619,226.0694784580499,23,20,274,2,263
2551,244,620,224.3047619047619,226.02303854875285,23,11,383,2,376
2552,212,9,225.65151927437643,227.0679365079365,20,40,212,1,203
2553,212,7,225.65151927437643,227.50911564625852,20,42,220,2,205
2554,212,26,225.65151927437643,228.57723356009072,20,37,225,3,186
2555,212,290,225.65151927437643,228.06639455782314,20,17,130,2,78
2556,212,435,225.65151927437643,228.06639455782314,20,12,246,2,223
2557,212,616,225.65151927437643,227.8574149659864,20,3,415,2,404
2558,267,7,226.0694784580499,227.50911564625852,18,42,267,1,260
2559,267,26,226.0694784580499,228.57723356009072,18,37,264,3,241
2560,267,290,226.0694784580499,228.06639455782314,18,17,89,2,23
2561,267,208,226.0694784580499,228.97197278911565,18,29,138,3,59
2562,267,435,226.0694784580499,228.06639455782314,18,12,189,2,168
2563,267,414,226.0694784580499,229.04163265306124,18,24,195,3,147
2564,267,616,226.0694784580499,227.8574149659864,18,3,357,2,349
2565,290,78,228.06639455782314,229.2041723356009,17,37,218,1,212
2566,290,9,228.06639455782314,231.01532879818595,17,40,308,3,281
2567,290,207,228.06639455782314,229.0880725623583,17,27,94,1,83
2568,290,207,228.06639455782314,231.03854875283446,17,28,153,3,83
2569,290,424,228.06639455782314,229.13451247165534,17,20,142,1,134
2570,290,411,228.06639455782314,230.9688888888889,17,19,174,3,121
2571,290,768,228.06639455782314,230.9688888888889,17,0,494,3,478
2572,208,9,228.97197278911565,231.01532879818595,29,40,218,2,199
2573,208,8,228.97197278911565,231.17786848072564,29,41,221,2,200
2574,208,207,228.97197278911565,231.03854875283446,29,28,89,2,1
2575,208,411,228.97197278911565,230.9688888888889,29,19,220,2,203
2576,208,416,228.97197278911565,231.08498866213154,29,17,227,2,208
2577,207,9,229.0880725623583,231.01532879818595,27,40,215,2,198
2578,207,8,229.0880725623583,231.17786848072564,27,41,218,2,199
2579,207,208,229.0880725623583,231.08498866213154,27,27,86,2,1
2580,207,411,229.0880725623583,230.9688888888889,27,19,219,2,204
2581,207,416,229.0880725623583,231.08498866213154,27,17,226,2,209
2582,207,52,231.03854875283446,232.45496598639457,28,38,167,1,155
2583,207,51,231.03854875283446,233.08190476190478,28,36,179,2,156
2584,207,289,231.03854875283446,232.33886621315193,28,21,99,1,82
2585,207,277,231.03854875283446,233.8946031746032,28,18,142,3,70
2586,207,424,231.03854875283446,232.08344671201814,28,11,222,1,217
2587,208,52,231.08498866213154,232.45496598639457,27,38,167,1,156
2588,208,51,231.08498866213154,233.08190476190478,27,36,179,2,157
2589,208,289,231.08498866213154,232.33886621315193,27,21,97,1,81
2590,208,277,231.08498866213154,233.8946031746032,27,18,139,3,69
2591,208,417,231.08498866213154,234.05714285714285,27,13,245,3,209
2592,289,8,232.33886621315193,234.5447619047619,21,41,297,2,281
2593,289,7,232.33886621315193,235.078820861678,21,37,306,3,282
2594,289,277,232.33886621315193,233.8946031746032,21,18,68,2,12
2595,289,417,232.33886621315193,234.05714285714285,21,13,148,2,128
2596,289,417,232.33886621315193,234.0803628117914,21,11,148,2,128
2597,289,747,232.33886621315193,234.77696145124716,21,5,470,2,458
2598,277,7,233.8946031746032,235.078820861678,18,37,275,1,270
2599,277,26,233.8946031746032,236.33269841269842,18,38,272,2,251
2600,277,365,233.8946031746032,236.00761904761904,18,15,127,2,88
2601,277,207,233.8946031746032,236.44879818594106,18,23,130,3,70
2602,277,412,233.8946031746032,236.03083900226758,18,3,163,2,135
2603,277,412,233.8946031746032,236.402358276644,18,15,173,3,135
2604,289,26,234.24290249433108,236.33269841269842,16,38,278,2,263
2605,289,365,234.24290249433108,236.00761904761904,16,15,107,2,76
2606,289,207,234.24290249433108,236.44879818594106,16,23,125,2,82
2607,289,412,234.24290249433108,236.03083900226758,16,3,145,2,123
2608,289,412,234.24290249433108,236.402358276644,16,15,154,2,123
2609,365,23,236.00761904761904,237.67945578231294,15,35,349,2,342
2610,365,8,236.00761904761904,238.5618140589569,15,41,374,3,357
2611,365,209,236.00761904761904,237.54013605442177,15,23,169,2,156
2612,365,404,236.00761904761904,238.5618140589569,15,18,117,3,39
2613,365,428,236.00761904761904,237.8187755102041,15,13,100,2,63
2614,365,435,236.00761904761904,238.5618140589569,15,10,130,3,70
2615,365,781,236.00761904761904,238.23673469387757,15,9,427,2,416
2616,365,852,236.00761904761904,238.23673469387757,15,11,496,2,487
2617,207,23,236.44879818594106,237.67945578231294,23,35,191,1,184
2618,207,8,236.44879818594106,238.5618140589569,23,41,219,2,199
2619,207,209,236.44879818594106,237.54013605442177,23,23,47,1,2
2620,207,404,236.44879818594106,238.5618140589569,23,18,217,2,197
2621,207,428,236.44879818594106,237.8187755102041,23,13,229,1,221
2622,207,435,236.44879818594106,238.5618140589569,23,10,245,2,228
2623,209,8,237.54013605442177,238.5618140589569,23,41,206,1,201
2624,209,69,237.54013605442177,239.72281179138324,23,39,169,2,140
2625,209,34,237.54013605442177,240.25687074829932,23,38,211,3,175
2626,209,404,237.54013605442177,238.5618140589569,23,18,200,1,195
2627,209,435,237.54013605442177,238.5618140589569,23,10,230,1,226
2628,209,416,237.54013605442177,240.07111111111112,23,19,234,3,207
2629,209,417,237.54013605442177,240.11755102040817,23,25,236,3,208
2630,404,69,238.5618140589569,239.72281179138324,18,39,339,1,335
2631,404,34,238.5618140589569,240.25687074829932,18,38,377,2,370
2632,404,35,238.5618140589569,241.34820861678006,18,38,388,3,369
2633,404,209,238.5618140589569,239.95501133786848,18,28,204,1,195
2634,404,209,238.5618140589569,240.11755102040817,18,30,206,2,195
2635,404,277,238.5618140589569,241.32498866213152,18,21,174,3,127
2636,404,416,238.5618140589569,240.07111111111112,18,19,66,2,12
2637,404,417,238.5618140589569,240.11755102040817,18,25,68,2,13
2638,404,866,238.5618140589569,240.2336507936508,18,1,468,2,462
2639,209,35,239.95501133786848,241.34820861678006,28,38,184,1,174
2640,209,8,239.95501133786848,242.85750566893424,28,42,237,3,201
2641,209,277,239.95501133786848,241.32498866213152,28,21,90,1,68
2642,209,468,239.95501133786848,241.62684807256235,28,9,269,2,259
2643,209,411,239.95501133786848,242.32344671201815,28,5,226,2,202
2644,209,35,240.11755102040817,241.34820861678006,30,38,182,1,174
2645,209,8,240.11755102040817,242.85750566893424,30,42,233,3,201
2646,209,8,240.11755102040817,243.0897052154195,30,39,238,3,201
2647,209,277,240.11755102040817,241.32498866213152,30,21,86,1,68
2648,209,468,240.11755102040817,241.62684807256235,30,9,267,2,259
2649,209,411,240.11755102040817,242.32344671201815,30,5,223,2,202
2650,277,8,241.32498866213152,242.85750566893424,21,42,277,2,269
2651,277,8,241.32498866213152,243.0897052154195,21,39,280,2,269
2652,277,209,241.32498866213152,242.9039455782313,21,15,96,2,68
2653,277,324,241.32498866213152,243.80952380952382,21,11,117,2,47
2654,277,325,241.32498866213152,244.27392290249435,21,12,136,3,48
2655,277,454,241.32498866213152,243.3683446712018,21,1,198,2,177
2656,209,13,242.9039455782313,245.06340136054422,15,30,217,2,196
2657,209,20,242.9039455782313,245.55102040816328,15,39,221,3,189
2658,209,325,242.9039455782313,244.27392290249435,15,12,130,1,116
2659,209,220,242.9039455782313,245.80643990929707,15,15,125,3,11
2660,209,454,242.9039455782313,244.66866213151928,15,1,257,2,245
2661,209,471,242.9039455782313,245.36526077097506,15,2,283,2,262
2662,324,13,243.80952380952382,245.06340136054422,11,30,316,1,311
2663,324,20,243.80952380952382,245.55102040816328,11,39,313,2,304
2664,324,20,243.80952380952382,246.34049886621315,11,39,323,3,304
2665,324,220,243.80952380952382,245.80643990929707,11,15,135,2,104
2666,324,222,243.80952380952382,246.08507936507937,11,17,141,2,102
2667,324,471,243.80952380952382,245.36526077097506,11,2,162,2,147
2668,325,20,244.27392290249435,245.55102040816328,12,39,310,1,305
2669,325,20,244.27392290249435,246.34049886621315,12,39,318,2,305
2670,325,17,244.27392290249435,247.15319727891156,12,36,332,3,308
2671,325,220,244.27392290249435,245.80643990929707,12,15,124,2,105
2672,325,222,244.27392290249435,246.08507936507937,12,17,129,2,103
2673,325,471,244.27392290249435,245.36526077097506,12,2,153,1,146
2674,220,17,245.80643990929707,247.15319727891156,15,36,211,1,203
2675,220,26,245.80643990929707,248.61605442176872,15,31,229,3,194
2676,220,353,245.80643990929707,247.31573696145125,15,15,148,2,133
2677,220,425,245.80643990929707,247.3389569160998,15,3,215,2,205
2678,222,17,246.08507936507937,247.15319727891156,17,36,210,1,205
2679,222,26,246.08507936507937,248.61605442176872,17,31,224,3,196
2680,222,353,246.08507936507937,247.31573696145125,17,15,141,1,131
2681,222,425,246.08507936507937,247.3389569160998,17,3,210,1,203
2682,353,26,247.31573696145125,248.61605442176872,15,31,332,1,327
2683,353,20,247.31573696145125,249.70739229024943,15,40,349,2,333
2684,353,218,247.31573696145125,249.96281179138322,15,13,177,3,135
2685,353,435,247.31573696145125,249.98603174603176,15,16,141,3,82
2686,353,435,247.31573696145125,250.1950113378685,15,11,149,3,82
2687,218,23,249.96281179138322,251.07736961451246,13,39,201,1,195
2688,218,23,249.96281179138322,251.8204081632653,13,40,211,2,195
2689,218,17,249.96281179138322,252.2615873015873,13,37,224,2,201
2690,218,258,249.96281179138322,251.86684807256236,13,15,91,2,40
2691,218,248,249.96281179138322,252.47056689342404,13,14,112,3,30
2692,218,512,249.96281179138322,251.100589569161,13,11,298,1,294
2693,217,23,250.42721088435374,251.8204081632653,15,40,203,1,194
2694,217,17,250.42721088435374,252.2615873015873,15,37,215,2,200
2695,217,258,250.42721088435374,251.86684807256236,15,15,74,1,41
2696,217,248,250.42721088435374,252.47056689342404,15,14,93,2,31
2697,217,251,250.42721088435374,253.1439455782313,15,13,122,3,34
2698,217,487,250.42721088435374,253.0742857142857,15,2,293,3,270
2699,258,21,251.86684807256236,254.07274376417234,15,39,255,2,237
2700,258,8,251.86684807256236,254.63002267573697,15,43,277,3,250
2701,258,251,251.86684807256236,253.1439455782313,15,13,55,1,7
2702,258,227,251.86684807256236,254.09596371882085,15,9,101,2,31
2703,258,487,251.86684807256236,253.0742857142857,15,2,235,1,229
2704,258,479,251.86684807256236,253.70122448979592,15,9,235,2,221
2705,258,411,251.86684807256236,254.35138321995464,15,2,187,2,153
2706,248,21,252.47056689342404,254.07274376417234,14,39,237,2,227
2707,248,8,252.47056689342404,254.63002267573697,14,43,257,2,240
2708,248,6,252.47056689342404,255.117641723356,14,37,268,3,242
2709,248,227,252.47056689342404,254.09596371882085,14,9,73,2,21
2710,248,479,252.47056689342404,253.70122448979592,14,9,237,1,231
2711,248,411,252.47056689342404,254.35138321995464,14,2,182,2,163
2712,251,8,253.1439455782313,254.63002267573697,13,43,251,1,243
2713,251,6,253.1439455782313,255.117641723356,13,37,259,2,245
2714,251,334,253.1439455782313,255.62848072562358,13,0,135,2,83
2715,251,411,253.1439455782313,254.35138321995464,13,2,168,1,160
2716,227,6,254.09596371882085,255.117641723356,9,37,225,1,221
2717,227,26,254.09596371882085,256.441179138322,9,31,225,2,201
2718,227,334,254.09596371882085,255.62848072562358,9,0,126,2,107
2719,227,226,254.09596371882085,257.0681179138322,9,10,128,3,1
2720,334,26,255.62848072562358,257.811156462585,0,32,322,2,308
2721,334,25,255.62848072562358,258.25233560090703,0,32,329,3,309
2722,334,226,255.62848072562358,257.0681179138322,0,10,125,1,108
2723,334,211,255.62848072562358,257.11455782312925,0,12,139,1,123
2724,334,223,255.62848072562358,258.3916553287982,0,8,163,3,111
2725,226,25,257.0681179138322,258.25233560090703,10,32,207,1,201
2726,226,21,257.0681179138322,259.6455328798186,10,30,233,3,205
2727,226,223,257.0681179138322,258.3916553287982,10,8,57,1,3
2728,226,210,257.0681179138322,259.1811337868481,10,9,92,2,16
2729,211,25,257.11455782312925,258.25233560090703,12,32,192,1,186
2730,211,21,257.11455782312925,259.6455328798186,12,30,219,3,190
2731,211,223,257.11455782312925,258.3916553287982,12,8,56,1,12
2732,211,210,257.11455782312925,259.1811337868481,12,9,89,2,1
2733,223,21,258.3916553287982,259.6455328798186,8,30,209,1,202
2734,223,23,258.3916553287982,260.3421315192744,8,30,217,2,200
2735,223,13,258.3916553287982,261.0851700680272,8,23,240,3,210
2736,223,248,258.3916553287982,260.2956916099773,8,14,86,2,25
2737,210,23,259.1811337868481,260.3421315192744,9,30,194,1,187
2738,210,13,259.1811337868481,261.0851700680272,9,23,213,2,197
2739,210,248,259.1811337868481,260.2956916099773,9,14,61,1,38
2740,248,17,260.2956916099773,262.68734693877553,14,23,253,2,231
2741,437,9,13.978412698412699,15.789569160997733,1,35,435,2,428
2742,437,17,13.978412698412699,15.998548752834468,1,30,429,2,420
2743,437,206,13.978412698412699,15.928888888888888,1,3,246,2,231
2744,437,207,13.978412698412699,16.416507936507937,1,8,253,2,230
2745,437,9,14.001632653061225,15.789569160997733,2,35,435,2,428
2746,437,17,14.001632653061225,15.998548752834468,2,30,429,2,420
2747,437,206,14.001632653061225,15.928888888888888,2,3,245,2,231
2748,437,207,14.001632653061225,16.416507936507937,2,8,252,2,230
2749,440,20,23.173514739229024,25.843809523809526,11,39,435,3,420
2750,440,20,23.173514739229024,26.029569160997735,11,37,438,3,420
2751,440,229,23.173514739229024,24.752471655328797,11,14,222,2,211
2752,440,259,23.173514739229024,25.98312925170068,11,18,218,3,181
2753,440,259,23.173514739229024,26.006349206349206,11,15,218,3,181
2754,440,428,23.173514739229024,24.822131519274375,11,5,72,2,12
2755,440,439,23.173514739229024,25.93668934240363,11,6,119,3,1
2756,428,20,24.822131519274375,25.843809523809526,5,39,410,1,408
2757,428,20,24.822131519274375,26.029569160997735,5,37,411,1,408
2758,428,80,24.822131519274375,27.028027210884353,5,32,361,2,348
2759,428,259,24.822131519274375,25.98312925170068,5,18,176,1,169
2760,428,259,24.822131519274375,26.006349206349206,5,15,177,1,169
2761,428,254,24.822131519274375,27.00480725623583,5,6,198,2,174
2762,428,439,24.822131519274375,25.93668934240363,5,6,49,1,11
2763,428,419,24.822131519274375,26.610068027210886,5,7,78,2,9
2764,428,480,24.822131519274375,27.46920634920635,5,3,125,3,52
2765,428,654,24.822131519274375,26.563628117913833,5,8,238,2,226
2766,428,871,24.822131519274375,26.586848072562358,5,10,449,2,443
2767,428,852,24.822131519274375,27.492426303854877,5,7,439,3,424
2768,439,80,25.93668934240363,27.028027210884353,6,32,362,1,359
2769,439,17,25.93668934240363,28.606984126984127,6,34,437,3,422
2770,439,254,25.93668934240363,27.00480725623583,6,6,191,1,185
2771,439,480,25.93668934240363,27.46920634920635,6,3,78,2,41
2772,439,852,25.93668934240363,27.492426303854877,6,7,418,2,413
2773,419,17,26.610068027210886,28.606984126984127,7,34,411,2,402
2774,419,17,26.610068027210886,29.071383219954647,7,34,416,2,402
2775,480,17,27.46920634920635,28.606984126984127,3,34,466,1,463
2776,480,17,27.46920634920635,29.071383219954647,3,34,468,2,463
2777,480,20,27.46920634920635,30.162721088435376,3,22,474,3,460
2778,453,26,32.97233560090703,34.365532879818595,7,38,431,1,427
2779,453,15,32.97233560090703,35.619410430839004,7,35,453,3,438
2780,453,205,32.97233560090703,34.202993197278914,7,16,254,1,248
2781,453,222,32.97233560090703,35.50331065759637,7,4,255,3,231
2782,453,410,32.97233560090703,34.73705215419501,7,1,87,2,43
2783,412,26,32.995555555555555,34.365532879818595,6,38,390,1,386
2784,412,15,32.995555555555555,35.619410430839004,6,35,413,3,397
2785,412,205,32.995555555555555,34.202993197278914,6,16,213,1,207
2786,412,222,32.995555555555555,35.50331065759637,6,4,219,3,190
2787,412,410,32.995555555555555,34.73705215419501,6,1,75,2,2
2788,410,20,34.73705215419501,36.78040816326531,1,36,400,2,390
2789,410,21,34.73705215419501,37.105487528344675,1,37,402,2,389
2790,410,248,34.73705215419501,36.96616780045352,1,14,188,2,162
2791,410,328,34.73705215419501,37.01260770975057,1,11,128,2,82
2792,466,29,38.98630385487528,40.26340136054422,3,40,440,1,437
2793,466,26,38.98630385487528,41.517278911564624,3,39,453,3,440
2794,466,243,38.98630385487528,40.47238095238095,3,18,232,1,223
2795,466,231,38.98630385487528,41.703038548752836,3,14,263,3,235
2796,466,611,38.98630385487528,40.40272108843538,3,7,157,1,145
2797,466,468,38.98630385487528,41.517278911564624,3,6,109,3,2
2798,466,703,38.98630385487528,40.40272108843538,3,9,245,1,237
2799,466,684,38.98630385487528,41.21541950113379,3,12,238,2,218
2800,466,958,38.98630385487528,40.79746031746032,3,11,498,2,492
2801,443,29,39.172063492063494,40.26340136054422,12,40,417,1,414
2802,443,26,39.172063492063494,41.517278911564624,12,39,429,2,417
2803,443,243,39.172063492063494,40.47238095238095,12,18,208,1,200
2804,443,231,39.172063492063494,41.703038548752836,12,14,238,3,212
2805,443,611,39.172063492063494,40.40272108843538,12,7,176,1,168
2806,443,468,39.172063492063494,41.517278911564624,12,6,104,2,25
2807,443,703,39.172063492063494,40.40272108843538,12,9,265,1,260
2808,443,684,39.172063492063494,41.21541950113379,12,12,257,2,241
2809,611,231,40.40272108843538,41.703038548752836,7,14,384,1,380
2810,611,275,40.40272108843538,42.49251700680272,7,12,348,2,336
2811,611,468,40.40272108843538,41.517278911564624,7,6,151,1,143
2812,611,586,40.40272108843538,42.399637188208615,7,7,90,2,25
2813,611,641,40.40272108843538,42.399637188208615,7,11,91,2,30
2814,611,825,40.40272108843538,42.74793650793651,7,11,237,2,214
2815,468,23,41.517278911564624,43.97859410430839,6,35,457,2,445
2816,468,210,41.517278911564624,43.83927437641724,6,13,277,2,258
2817,468,410,41.517278911564624,43.932154195011336,6,8,119,2,58
2818,468,437,41.517278911564624,44.39655328798186,6,3,128,3,31
2819,468,718,41.517278911564624,44.39655328798186,6,5,279,3,250
2820,468,825,41.517278911564624,42.74793650793651,6,11,361,1,357
2821,468,832,41.517278911564624,44.39655328798186,6,7,385,3,364
2822,586,210,42.399637188208615,43.83927437641724,7,13,381,1,376
2823,586,248,42.399637188208615,44.7912925170068,7,13,353,2,338
2824,586,278,42.399637188208615,45.00027210884354,7,4,328,3,308
2825,586,410,42.399637188208615,43.932154195011336,7,8,188,2,176
2826,586,437,42.399637188208615,44.39655328798186,7,3,172,2,149
2827,586,437,42.399637188208615,45.34857142857143,7,1,196,3,149
2828,586,718,42.399637188208615,44.39655328798186,7,5,158,2,132
2829,586,832,42.399637188208615,44.39655328798186,7,7,261,2,246
2830,410,21,43.932154195011336,45.093151927437646,8,36,392,1,389
2831,410,278,43.932154195011336,45.00027210884354,8,4,140,1,132
2832,410,285,43.932154195011336,46.88108843537415,8,4,178,3,125
2833,410,437,43.932154195011336,45.34857142857143,8,1,67,1,27
2834,437,25,44.39655328798186,46.9275283446712,3,34,426,3,412
2835,437,285,44.39655328798186,46.88108843537415,3,4,186,2,152
2836,437,231,44.39655328798186,47.34548752834467,3,13,242,3,206
2837,437,417,44.39655328798186,46.97396825396825,3,0,113,3,20
2838,437,419,44.39655328798186,47.113287981859415,3,7,118,3,18
2839,437,789,44.39655328798186,47.06684807256236,3,8,370,3,352
2840,437,921,44.39655328798186,47.04362811791383,3,11,497,3,484
2841,437,25,45.34857142857143,46.9275283446712,1,34,418,2,412
2842,437,51,45.34857142857143,47.64734693877551,1,38,398,2,386
2843,437,285,45.34857142857143,46.88108843537415,1,4,166,2,152
2844,437,231,45.34857142857143,47.34548752834467,1,13,223,2,206
2845,437,417,45.34857142857143,46.97396825396825,1,0,73,2,20
2846,437,419,45.34857142857143,47.113287981859415,1,7,78,2,18
2847,437,435,45.34857142857143,48.06530612244898,1,9,117,3,2
2848,437,789,45.34857142857143,47.06684807256236,1,8,360,2,352
2849,437,921,45.34857142857143,47.04362811791383,1,11,489,2,484
2850,437,883,45.34857142857143,48.13496598639456,1,21,462,3,446
2851,417,25,46.97396825396825,48.970884353741496,0,37,401,2,392
2852,417,26,46.97396825396825,49.04054421768708,0,37,401,2,391
2853,417,309,46.97396825396825,48.36716553287982,0,12,124,1,108
2854,417,435,46.97396825396825,48.06530612244898,0,9,50,1,18
2855,417,489,46.97396825396825,49.946122448979594,0,9,147,3,72
2856,417,818,46.97396825396825,48.6225850340136,0,13,407,2,401
2857,417,883,46.97396825396825,48.13496598639456,0,21,469,1,466
2858,419,25,47.113287981859415,48.970884353741496,7,37,402,2,394
2859,419,26,47.113287981859415,49.04054421768708,7,37,402,2,393
2860,419,309,47.113287981859415,48.36716553287982,7,12,123,1,110
2861,419,215,47.113287981859415,49.99256235827664,7,21,239,3,204
2862,419,489,47.113287981859415,49.946122448979594,7,9,141,3,70
2863,419,818,47.113287981859415,48.6225850340136,7,13,404,2,399
2864,419,883,47.113287981859415,48.13496598639456,7,21,466,1,464
2865,435,31,48.06530612244898,50.29442176870749,9,37,415,2,404
2866,435,215,48.06530612244898,49.99256235827664,9,21,235,2,220
2867,435,218,48.06530612244898,50.31764172335601,9,20,238,2,217
2868,435,489,48.06530612244898,49.946122448979594,9,9,97,2,54
2869,435,498,48.06530612244898,50.340861678004536,9,12,117,2,63
2870,435,749,48.06530612244898,50.5730612244898,9,4,332,3,314
2871,489,23,49.946122448979594,51.50185941043084,9,35,471,2,466
2872,489,21,49.946122448979594,52.61641723356009,9,36,482,3,468
2873,489,233,49.946122448979594,51.57151927437642,9,16,265,2,256
2874,489,248,49.946122448979594,52.63963718820862,9,12,267,3,241
2875,489,410,49.946122448979594,51.13034013605442,9,8,94,1,79
2876,489,584,49.946122448979594,52.61641723356009,9,0,149,3,95
2877,489,818,49.946122448979594,51.08390022675737,9,6,333,1,329
2878,489,905,49.946122448979594,51.08390022675737,9,10,419,1,416
2879,498,23,50.340861678004536,51.50185941043084,12,35,478,1,475
2880,498,21,50.340861678004536,52.61641723356009,12,36,487,2,477
2881,498,17,50.340861678004536,53.15047619047619,12,37,496,3,481
2882,498,233,50.340861678004536,51.57151927437642,12,16,270,1,265
2883,498,248,50.340861678004536,52.63963718820862,12,12,269,2,250
2884,498,584,50.340861678004536,52.61641723356009,12,0,130,2,86
2885,410,21,51.13034013605442,52.61641723356009,8,36,394,1,389
2886,410,17,51.13034013605442,53.15047619047619,8,37,403,2,393
2887,410,248,51.13034013605442,52.63963718820862,8,12,175,2,162
2888,410,584,51.13034013605442,52.61641723356009,8,0,185,1,174
2889,584,213,52.61641723356009,54.497233560090706,0,9,380,2,371
2890,584,230,52.61641723356009,55.077732426303854,0,7,370,2,354
2891,584,488,52.61641723356009,54.381133786848075,0,2,122,2,96
2892,488,15,54.381133786848075,55.70467120181406,2,33,476,1,473
2893,488,18,54.381133786848075,56.33160997732426,2,35,477,2,470
2894,488,34,54.381133786848075,57.14430839002268,2,28,469,3,454
2895,488,248,54.381133786848075,56.540589569161,2,14,257,2,240
2896,488,437,54.381133786848075,57.09786848072562,2,2,128,3,51
2897,437,26,57.09786848072562,58.816145124716556,2,39,418,2,411
2898,437,26,57.09786848072562,59.14122448979592,2,39,420,2,411
2899,437,206,57.09786848072562,58.63038548752834,2,23,240,2,231
2900,437,230,57.09786848072562,59.65206349206349,2,25,234,3,207
2901,437,412,57.09786848072562,58.60716553287982,2,14,70,2,25
2902,437,410,57.09786848072562,59.65206349206349,2,16,113,3,27
2903,437,802,57.09786848072562,58.39818594104309,2,13,369,1,365
2904,437,616,57.09786848072562,59.419863945578236,2,10,205,2,179
2905,437,855,57.09786848072562,58.42140589569161,2,15,422,1,418
2906,437,902,57.09786848072562,59.466303854875285,2,11,476,2,465
2907,412,76,58.60716553287982,60.998820861678006,14,37,351,2,336
2908,412,51,58.60716553287982,61.41678004535147,14,37,381,3,361
2909,412,230,58.60716553287982,59.65206349206349,14,25,187,1,182
2910,412,278,58.60716553287982,60.998820861678006,14,20,169,2,134
2911,412,220,58.60716553287982,61.532879818594104,14,18,230,3,192
2912,412,410,58.60716553287982,59.65206349206349,14,16,45,1,2
2913,412,448,58.60716553287982,60.557641723356014,14,4,91,2,36
2914,412,652,58.60716553287982,60.51120181405896,14,8,254,2,240
2915,412,798,58.60716553287982,61.23102040816327,14,2,402,3,386
2916,412,845,58.60716553287982,60.53442176870748,14,8,441,2,433
2917,412,833,58.60716553287982,61.23102040816327,14,2,436,3,421
2918,410,76,59.65206349206349,60.998820861678006,16,37,339,1,334
2919,410,51,59.65206349206349,61.41678004535147,16,37,367,2,359
2920,410,278,59.65206349206349,60.998820861678006,16,20,144,1,132
2921,410,220,59.65206349206349,61.532879818594104,16,18,207,2,190
2922,410,798,59.65206349206349,61.23102040816327,16,2,394,2,388
2923,410,833,59.65206349206349,61.23102040816327,16,2,428,2,423
2924,448,70,60.557641723356014,62.64743764172336,4,36,389,2,378
2925,448,277,60.557641723356014,62.99573696145125,4,23,201,2,171
2926,448,410,60.557641723356014,61.74185941043084,4,5,64,1,38
2927,448,415,60.557641723356014,62.972517006802725,4,10,109,2,33
2928,410,26,61.74185941043084,63.64589569160998,5,36,393,2,384
2929,410,23,61.74185941043084,64.13351473922903,5,39,400,2,387
2930,410,277,61.74185941043084,62.99573696145125,5,23,144,1,133
2931,410,217,61.74185941043084,63.87809523809524,5,26,214,2,193
2932,410,297,61.74185941043084,64.24961451247165,5,21,156,3,113
2933,410,415,61.74185941043084,62.972517006802725,5,10,53,1,5
2934,410,413,61.74185941043084,64.52825396825396,5,18,120,3,3
2935,415,23,62.972517006802725,64.13351473922903,10,39,395,1,392
2936,415,24,62.972517006802725,65.7124716553288,10,37,408,3,391
2937,415,297,62.972517006802725,64.24961451247165,10,21,130,1,118
2938,415,232,62.972517006802725,65.34095238095239,10,14,210,2,183
2939,415,413,62.972517006802725,64.52825396825396,10,18,67,2,2
2940,415,465,62.972517006802725,65.75891156462585,10,7,130,3,50
2941,415,899,62.972517006802725,65.36417233560091,10,4,495,2,484
2942,410,24,63.715555555555554,65.7124716553288,19,37,395,2,386
2943,410,17,63.715555555555554,66.52517006802721,19,37,411,3,393
2944,410,232,63.715555555555554,65.34095238095239,19,14,191,2,178
2945,410,245,63.715555555555554,66.29297052154195,19,11,199,3,165
2946,410,465,63.715555555555554,65.75891156462585,19,7,104,2,55
2947,410,417,63.715555555555554,66.38585034013606,19,7,115,3,7
2948,410,899,63.715555555555554,65.36417233560091,19,4,494,2,489
2949,413,24,64.52825396825396,65.7124716553288,18,37,392,1,389
2950,413,17,64.52825396825396,66.52517006802721,18,37,405,2,396
2951,413,245,64.52825396825396,66.29297052154195,18,11,184,2,168
2952,413,465,64.52825396825396,65.75891156462585,18,7,74,1,52
2953,413,417,64.52825396825396,66.38585034013606,18,7,80,2,4
2954,465,26,65.75891156462585,67.98802721088435,7,36,449,2,439
2955,465,26,65.75891156462585,68.05768707482993,7,37,450,2,439
2956,465,387,65.75891156462585,67.98802721088435,7,18,124,2,78
2957,465,273,65.75891156462585,68.70784580498866,7,21,230,3,192
2958,465,412,65.75891156462585,67.98802721088435,7,16,110,2,53
2959,465,413,65.75891156462585,68.05768707482993,7,19,112,2,52
2960,417,26,66.38585034013606,67.98802721088435,7,36,397,2,391
2961,417,26,66.38585034013606,68.05768707482993,7,37,398,2,391
2962,417,387,66.38585034013606,67.98802721088435,7,18,75,2,30
2963,417,273,66.38585034013606,68.70784580498866,7,21,175,2,144
2964,417,412,66.38585034013606,67.98802721088435,7,16,69,2,5
2965,417,413,66.38585034013606,68.05768707482993,7,19,72,2,4
2966,417,621,66.38585034013606,68.89360544217688,7,3,231,3,204
2967,417,894,66.38585034013606,68.9168253968254,7,12,489,3,477
2968,412,20,67.98802721088435,69.52054421768707,16,34,398,2,392
2969,412,26,67.98802721088435,70.5190022675737,16,36,401,3,386
2970,412,245,67.98802721088435,69.65986394557824,16,19,182,2,167
2971,412,206,67.98802721088435,70.31002267573696,16,22,229,2,206
2972,412,428,67.98802721088435,69.65986394557824,16,5,74,2,16
2973,412,420,67.98802721088435,70.0778231292517,16,8,90,2,8
2974,412,864,67.98802721088435,70.33324263038548,16,1,463,2,452
2975,413,20,68.05768707482993,69.52054421768707,19,34,398,1,393
2976,413,26,68.05768707482993,70.5190022675737,19,36,401,2,387
2977,413,245,68.05768707482993,69.65986394557824,19,19,182,2,168
2978,413,206,68.05768707482993,70.31002267573696,19,22,229,2,207
2979,413,428,68.05768707482993,69.65986394557824,19,5,71,2,15
2980,413,420,68.05768707482993,70.0778231292517,19,8,87,2,7
2981,413,864,68.05768707482993,70.33324263038548,19,1,462,2,451
2982,428,76,69.65986394557824,71.98185941043084,5,35,366,2,352
2983,428,277,69.65986394557824,71.72643990929706,5,19,175,2,151
2984,428,219,69.65986394557824,72.53913832199547,5,19,243,3,209
2985,428,432,69.65986394557824,72.00507936507937,5,14,101,2,4
2986,428,432,69.65986394557824,72.02829931972789,5,15,102,2,4
2987,428,858,69.65986394557824,72.44625850340137,5,6,446,3,430
2988,420,76,70.0778231292517,71.98185941043084,8,35,354,2,344
2989,420,23,70.0778231292517,72.67845804988663,8,36,412,3,397
2990,420,277,70.0778231292517,71.72643990929706,8,19,160,2,143
2991,420,219,70.0778231292517,72.53913832199547,8,19,227,2,201
2992,420,432,70.0778231292517,72.00507936507937,8,14,84,2,12
2993,420,432,70.0778231292517,72.02829931972789,8,15,85,2,12
2994,420,756,70.0778231292517,72.79455782312925,8,0,356,3,336
2995,420,858,70.0778231292517,72.44625850340137,8,6,450,2,438
2996,432,21,72.00507936507937,73.83945578231292,14,35,419,2,411
2997,432,17,72.00507936507937,74.6985941043084,14,35,431,3,415
2998,432,205,72.00507936507937,73.07319727891156,14,13,232,1,227
2999,432,205,72.00507936507937,74.11809523809524,14,7,245,2,227
3000,432,410,72.00507936507937,73.16607709750566,14,2,55,1,22
3001,432,411,72.00507936507937,74.18775510204082,14,1,96,2,21
3002,432,21,72.02829931972789,73.83945578231292,15,35,418,2,411
3003,432,17,72.02829931972789,74.6985941043084,15,35,431,3,415
3004,432,205,72.02829931972789,73.07319727891156,15,13,231,1,227
3005,432,205,72.02829931972789,74.11809523809524,15,7,244,2,227
3006,432,410,72.02829931972789,73.16607709750566,15,2,54,1,22
3007,432,411,72.02829931972789,74.18775510204082,15,1,95,2,21
3008,410,17,73.16607709750566,74.6985941043084,2,35,399,2,393
3009,410,26,73.16607709750566,75.7667120181406,2,35,400,3,384
3010,410,283,73.16607709750566,75.90603174603174,2,21,173,3,127
3011,410,411,73.16607709750566,74.18775510204082,2,1,44,1,1
3012,410,411,73.16607709750566,75.90603174603174,2,10,118,3,1
3013,410,424,73.16607709750566,76.0453514739229,2,9,125,3,14
3014,411,26,74.18775510204082,75.7667120181406,1,35,391,2,385
3015,411,26,74.18775510204082,76.3007709750567,1,34,396,2,385
3016,411,283,74.18775510204082,75.90603174603174,1,21,148,2,128
3017,411,206,74.18775510204082,76.55619047619048,1,22,229,2,205
3018,411,424,74.18775510204082,76.0453514739229,1,9,81,2,13
3019,411,61,75.90603174603174,77.76362811791384,10,35,359,2,350
3020,411,101,75.90603174603174,78.66920634920635,10,36,332,3,310
3021,411,276,75.90603174603174,77.32244897959184,10,19,148,1,135
3022,411,302,75.90603174603174,78.83174603174604,10,16,167,3,109
3023,411,410,75.90603174603174,77.46176870748299,10,10,67,2,1
3024,411,553,75.90603174603174,78.0887074829932,10,5,170,2,142
3025,411,634,75.90603174603174,78.0887074829932,10,4,242,2,223
3026,411,887,75.90603174603174,78.06548752834468,10,11,485,2,476
3027,424,61,76.0453514739229,77.76362811791384,9,35,370,2,363
3028,424,101,76.0453514739229,78.66920634920635,9,36,342,3,323
3029,424,276,76.0453514739229,77.32244897959184,9,19,158,1,148
3030,424,302,76.0453514739229,78.83174603174604,9,16,171,3,122
3031,424,410,76.0453514739229,77.46176870748299,9,10,63,1,14
3032,424,553,76.0453514739229,78.0887074829932,9,5,156,2,129
3033,424,634,76.0453514739229,78.0887074829932,9,4,228,2,210
3034,424,887,76.0453514739229,78.06548752834468,9,11,471,2,463
3035,410,101,77.46176870748299,78.66920634920635,10,36,313,1,309
3036,410,34,77.46176870748299,79.20326530612245,10,36,383,2,376
3037,410,34,77.46176870748299,80.34104308390023,10,38,396,3,376
3038,410,302,77.46176870748299,78.83174603174604,10,16,123,1,108
3039,410,206,77.46176870748299,79.27292517006804,10,22,218,2,204
3040,410,205,77.46176870748299,80.08562358276644,10,10,234,3,205
3041,410,449,77.46176870748299,79.22648526077097,10,13,85,2,39
3042,410,432,77.46176870748299,80.4107029478458,10,7,129,3,22
3043,553,206,78.0887074829932,79.27292517006804,5,22,351,1,347
3044,553,205,78.0887074829932,80.08562358276644,5,10,358,2,348
3045,553,449,78.0887074829932,79.22648526077097,5,13,115,1,104
3046,553,432,78.0887074829932,80.4107029478458,5,7,157,2,121
3047,553,537,78.0887074829932,81.06086167800454,5,12,129,3,16
3048,553,817,78.0887074829932,80.45714285714286,5,12,283,2,264
3049,553,674,78.0887074829932,81.06086167800454,5,8,176,3,121
3050,553,868,78.0887074829932,80.45714285714286,5,17,331,2,315
3051,553,868,78.0887074829932,81.06086167800454,5,7,340,3,315
3052,449,34,79.22648526077097,80.34104308390023,13,38,418,1,415
3053,449,26,79.22648526077097,81.64136054421769,13,38,436,2,423
3054,449,267,79.22648526077097,81.08408163265307,13,10,199,2,182
3055,449,432,79.22648526077097,80.4107029478458,13,7,54,1,17
3056,449,537,79.22648526077097,81.06086167800454,13,12,118,2,88
3057,449,817,79.22648526077097,80.45714285714286,13,12,372,1,368
3058,449,674,79.22648526077097,81.06086167800454,13,8,238,2,225
3059,449,868,79.22648526077097,80.45714285714286,13,17,422,1,419
3060,449,868,79.22648526077097,81.06086167800454,13,7,426,2,419
3061,432,26,80.4107029478458,81.64136054421769,7,38,409,1,406
3062,432,15,80.4107029478458,82.82557823129252,7,29,430,2,417
3063,432,205,80.4107029478458,82.96489795918367,7,7,252,3,227
3064,432,892,80.4107029478458,82.8952380952381,7,7,472,2,460
3065,537,205,81.06086167800454,82.96489795918367,12,7,342,2,332
3066,537,205,81.06086167800454,84.00979591836735,12,25,355,3,332
3067,537,205,81.06086167800454,84.03301587301587,12,22,356,3,332
3068,537,410,81.06086167800454,83.98657596371882,12,15,179,3,127
3069,537,892,81.06086167800454,82.8952380952381,12,7,364,2,355
3070,410,24,83.98657596371882,85.79773242630385,15,37,394,2,386
3071,410,26,83.98657596371882,86.1924716553288,15,35,396,2,384
3072,410,205,83.98657596371882,86.00671201814059,15,22,223,2,205
3073,410,205,83.98657596371882,86.02993197278911,15,21,223,2,205
3074,410,870,83.98657596371882,85.1243537414966,15,1,463,1,460
3075,428,24,84.17233560090703,85.79773242630385,16,37,410,2,404
3076,428,26,84.17233560090703,86.1924716553288,16,35,411,2,402
3077,428,205,84.17233560090703,86.00671201814059,16,22,237,2,223
3078,428,205,84.17233560090703,86.02993197278911,16,21,237,2,223
3079,428,410,84.17233560090703,86.00671201814059,16,12,81,2,18
3080,428,410,84.17233560090703,86.05315192743764,16,13,83,2,18
3081,410,76,86.00671201814059,87.65532879818595,12,36,341,2,334
3082,410,26,86.00671201814059,88.02684807256236,12,34,394,2,384
3083,410,299,86.00671201814059,87.58566893424036,12,20,130,2,111
3084,410,269,86.00671201814059,88.88598639455782,12,14,188,3,141
3085,410,424,86.00671201814059,87.58566893424036,12,18,69,2,14
3086,410,414,86.00671201814059,88.88598639455782,12,7,124,3,4
3087,410,819,86.00671201814059,87.23736961451247,12,4,412,1,409
3088,410,909,86.00671201814059,87.260589569161,12,12,502,1,499
3089,410,76,86.05315192743764,87.65532879818595,13,36,341,2,334
3090,410,26,86.05315192743764,88.02684807256236,13,34,393,2,384
3091,410,299,86.05315192743764,87.58566893424036,13,20,129,2,111
3092,410,269,86.05315192743764,88.88598639455782,13,14,186,3,141
3093,410,424,86.05315192743764,87.58566893424036,13,18,67,2,14
3094,410,414,86.05315192743764,88.88598639455782,13,7,122,3,4
3095,410,819,86.05315192743764,87.23736961451247,13,4,412,1,409
3096,410,909,86.05315192743764,87.260589569161,13,12,502,1,499
3097,424,21,87.58566893424036,89.18784580498867,18,34,409,2,403
3098,424,19,87.58566893424036,90.0237641723356,18,31,418,2,405
3099,424,269,87.58566893424036,88.88598639455782,18,14,165,1,155
3100,424,289,87.58566893424036,89.2110657596372,18,13,152,2,135
3101,424,414,87.58566893424036,88.88598639455782,18,7,57,1,10
3102,424,418,87.58566893424036,89.07174603174603,18,6,64,1,6
3103,424,797,87.58566893424036,89.42004535147393,18,0,381,2,373
3104,424,858,87.58566893424036,89.81478458049887,18,1,444,2,434
3105,414,19,88.88598639455782,90.0237641723356,7,31,398,1,395
3106,414,25,88.88598639455782,91.18476190476191,7,35,401,2,389
3107,414,205,88.88598639455782,90.83646258503401,7,9,225,2,209
3108,414,278,88.88598639455782,91.48662131519275,7,19,176,3,136
3109,414,431,88.88598639455782,91.4401814058957,7,19,111,3,17
3110,414,887,88.88598639455782,91.4401814058957,7,2,486,3,473
3111,418,25,89.07174603174603,91.18476190476191,6,35,403,2,393
3112,418,205,89.07174603174603,90.83646258503401,6,9,226,2,213
3113,418,278,89.07174603174603,91.48662131519275,6,19,174,2,140
3114,418,431,89.07174603174603,91.4401814058957,6,19,103,2,13
3115,418,887,89.07174603174603,91.4401814058957,6,2,480,2,469
3116,431,23,91.4401814058957,92.78693877551021,19,35,412,1,408
3117,431,31,91.4401814058957,93.71573696145126,19,38,412,2,400
3118,431,207,91.4401814058957,92.92625850340136,19,21,233,1,224
3119,431,284,91.4401814058957,93.042358276644,19,14,162,2,147
3120,431,415,91.4401814058957,92.92625850340136,19,16,66,1,16
3121,431,436,91.4401814058957,93.08879818594104,19,15,71,2,5
3122,431,699,91.4401814058957,93.27455782312926,19,12,279,2,268
3123,431,863,91.4401814058957,92.62439909297052,19,0,435,1,432
3124,431,858,91.4401814058957,93.25133786848073,19,15,434,2,427
3125,415,69,92.92625850340136,94.80707482993198,16,34,355,2,346
3126,415,34,92.92625850340136,95.22503401360544,16,36,394,2,381
3127,415,211,92.92625850340136,94.99283446712019,16,24,223,2,204
3128,415,243,92.92625850340136,95.29469387755103,16,23,200,2,172
3129,415,414,92.92625850340136,94.78385487528345,16,18,80,2,1
3130,415,418,92.92625850340136,95.15537414965986,16,19,96,2,3
3131,415,892,92.92625850340136,95.24825396825398,16,3,487,2,477
3132,436,69,93.08879818594104,94.80707482993198,15,34,374,2,367
3133,436,34,93.08879818594104,95.22503401360544,15,36,412,2,402
3134,436,211,93.08879818594104,94.99283446712019,15,24,239,2,225
3135,436,243,93.08879818594104,95.29469387755103,15,23,215,2,193
3136,436,414,93.08879818594104,94.78385487528345,15,18,76,2,22
3137,436,418,93.08879818594104,95.15537414965986,15,19,91,2,18
3138,436,892,93.08879818594104,95.24825396825398,15,3,465,2,456
3139,414,33,94.78385487528345,96.8736507936508,18,32,391,2,381
3140,414,219,94.78385487528345,96.66467120181406,18,10,211,2,195
3141,414,212,94.78385487528345,97.500589569161,18,15,233,3,202
3142,414,415,94.78385487528345,96.71111111111111,18,6,83,2,1
3143,414,411,94.78385487528345,97.33804988662132,18,4,110,3,3
3144,418,33,95.15537414965986,96.8736507936508,19,32,392,2,385
3145,418,23,95.15537414965986,97.82566893424037,19,38,411,3,395
3146,418,219,95.15537414965986,96.66467120181406,19,10,209,2,199
3147,418,212,95.15537414965986,97.500589569161,19,15,229,2,206
3148,418,415,95.15537414965986,96.71111111111111,19,6,67,2,3
3149,418,411,95.15537414965986,97.33804988662132,19,4,94,2,7
3150,415,23,96.71111111111111,97.82566893424037,6,38,395,1,392
3151,415,23,96.71111111111111,98.26684807256235,6,36,398,2,392
3152,415,16,96.71111111111111,99.66004535147393,6,30,419,3,399
3153,415,324,96.71111111111111,98.82412698412699,6,10,129,2,91
3154,415,325,96.71111111111111,99.31174603174604,6,11,144,3,90
3155,415,777,96.71111111111111,99.66004535147393,6,2,384,3,362
3156,411,16,97.33804988662132,99.66004535147393,4,30,407,2,395
3157,411,324,97.33804988662132,98.82412698412699,4,10,108,1,87
3158,411,325,97.33804988662132,99.31174603174604,4,11,121,2,86
3159,411,777,97.33804988662132,99.66004535147393,4,2,379,2,366
3160,411,810,97.33804988662132,100.24054421768707,4,0,418,3,399
3161,411,9,100.75138321995465,101.93560090702948,3,35,405,1,402
3162,411,9,100.75138321995465,102.02848072562358,3,34,406,1,402
3163,411,207,100.75138321995465,102.63219954648527,3,8,219,2,204
3164,411,306,100.75138321995465,103.60743764172337,3,5,162,3,105
3165,411,757,100.75138321995465,102.30712018140589,3,1,352,2,346
3166,411,655,100.75138321995465,103.49133786848073,3,2,271,3,244
3167,579,245,104.55945578231292,105.79011337868481,0,9,338,1,334
3168,579,306,104.55945578231292,106.25451247165533,0,11,283,2,273
3169,579,248,104.55945578231292,107.48517006802722,0,13,354,3,331
3170,511,20,105.04707482993197,107.04399092970522,0,34,498,2,491
3171,511,306,105.04707482993197,106.25451247165533,0,11,211,1,205
3172,511,248,105.04707482993197,107.48517006802722,0,13,283,2,263
3173,511,437,105.04707482993197,108.01922902494331,0,1,148,3,74
3174,437,21,108.01922902494331,109.96970521541951,1,37,424,2,416
3175,437,20,108.01922902494331,110.15546485260771,1,38,427,2,417
3176,437,306,108.01922902494331,110.01614512471656,1,14,157,2,131
3177,437,223,108.01922902494331,110.29478458049887,1,24,235,2,214
3178,437,546,108.01922902494331,109.45886621315194,1,10,125,1,109
3179,437,465,108.01922902494331,110.3180045351474,1,10,103,2,28
3180,437,791,108.01922902494331,109.45886621315194,1,5,359,1,354
3181,437,839,108.01922902494331,109.48208616780046,1,4,407,1,402
3182,437,910,108.01922902494331,110.3180045351474,1,1,483,2,473
3183,437,21,108.04244897959184,109.96970521541951,3,37,424,2,416
3184,437,20,108.04244897959184,110.15546485260771,3,38,427,2,417
3185,437,306,108.04244897959184,110.01614512471656,3,14,156,2,131
3186,437,223,108.04244897959184,110.29478458049887,3,24,235,2,214
3187,437,546,108.04244897959184,109.45886621315194,3,10,125,1,109
3188,437,465,108.04244897959184,110.3180045351474,3,10,102,2,28
3189,437,791,108.04244897959184,109.45886621315194,3,5,359,1,354
3190,437,839,108.04244897959184,109.48208616780046,3,4,407,1,402
3191,437,910,108.04244897959184,110.3180045351474,3,1,483,2,473
3192,546,255,109.45886621315194,111.22358276643992,10,12,301,2,291
3193,546,220,109.45886621315194,112.26848072562359,10,19,348,3,326
3194,546,514,109.45886621315194,111.38612244897959,10,10,89,2,32
3195,546,754,109.45886621315194,111.40934240362812,10,18,224,2,208
3196,546,946,109.45886621315194,111.40934240362812,10,19,409,2,400
3197,465,20,110.3180045351474,111.64154195011338,10,38,449,1,445
3198,465,20,110.3180045351474,112.24526077097507,10,36,453,2,445
3199,465,26,110.3180045351474,113.19727891156462,10,35,456,3,439
3200,465,220,110.3180045351474,112.26848072562359,10,19,259,2,245
3201,465,514,110.3180045351474,111.38612244897959,10,10,67,1,49
3202,465,432,110.3180045351474,112.82575963718821,10,8,113,3,33
3203,465,754,110.3180045351474,111.40934240362812,10,18,293,1,289
3204,465,804,110.3180045351474,112.77931972789116,10,2,355,2,339
3205,465,946,110.3180045351474,111.40934240362812,10,19,483,1,481
3206,465,944,110.3180045351474,112.77931972789116,10,12,491,2,479
3207,514,26,111.38612244897959,113.19727891156462,10,35,494,2,488
3208,514,401,111.38612244897959,113.35981859410431,10,11,141,2,113
3209,514,432,111.38612244897959,112.82575963718821,10,8,103,1,82
3210,514,423,111.38612244897959,113.35981859410431,10,9,125,2,91
3211,514,804,111.38612244897959,112.77931972789116,10,2,296,1,290
3212,514,771,111.38612244897959,113.35981859410431,10,2,271,2,257
3213,514,944,111.38612244897959,112.77931972789116,10,12,434,1,430
3214,514,878,111.38612244897959,113.38303854875284,10,3,374,2,364
3215,432,17,112.82575963718821,114.82267573696146,8,34,424,2,415
3216,432,19,112.82575963718821,115.24063492063492,8,34,426,2,413
3217,432,282,112.82575963718821,114.52081632653062,8,4,167,2,150
3218,432,248,112.82575963718821,115.33351473922903,8,13,213,3,184
3219,423,17,113.35981859410431,114.82267573696146,9,34,411,1,406
3220,423,19,113.35981859410431,115.24063492063492,9,34,412,2,404
3221,423,282,113.35981859410431,114.52081632653062,9,4,150,1,141
3222,423,248,113.35981859410431,115.33351473922903,9,13,195,2,175
3223,423,437,113.35981859410431,115.86757369614513,9,2,109,3,14
3224,437,63,115.86757369614513,117.0053514739229,2,38,377,1,374
3225,437,21,115.86757369614513,117.980589569161,2,39,426,2,416
3226,437,221,115.86757369614513,117.72517006802721,2,15,230,2,216
3227,437,427,115.86757369614513,117.86448979591837,2,7,87,2,10
3228,437,427,115.86757369614513,118.07346938775511,2,9,96,2,10
3229,437,812,115.86757369614513,117.539410430839,2,11,382,2,375
3230,437,817,115.86757369614513,118.72362811791383,2,3,399,3,380
3231,437,914,115.86757369614513,117.58585034013606,2,11,483,2,477
3232,437,820,115.86757369614513,118.72362811791383,2,1,402,3,383
3233,450,21,116.77315192743764,117.980589569161,0,39,432,1,429
3234,450,91,116.77315192743764,118.93260770975057,0,38,371,2,359
3235,450,21,116.77315192743764,119.6756462585034,0,38,447,3,429
3236,450,273,116.77315192743764,118.9558276643991,0,17,200,2,177
3237,450,285,116.77315192743764,119.53632653061224,0,18,203,3,165
3238,450,427,116.77315192743764,117.86448979591837,0,7,52,1,23
3239,450,427,116.77315192743764,118.07346938775511,0,9,61,1,23
3240,450,817,116.77315192743764,118.72362811791383,0,3,376,2,367
3241,450,820,116.77315192743764,118.72362811791383,0,1,379,2,370
3242,427,91,117.86448979591837,118.93260770975057,7,38,339,1,336
3243,427,21,117.86448979591837,119.6756462585034,7,38,413,2,406
3244,427,273,117.86448979591837,118.9558276643991,7,17,161,1,154
3245,427,285,117.86448979591837,119.53632653061224,7,18,159,2,142
3246,427,279,117.86448979591837,120.48834467120182,7,13,186,3,148
3247,427,499,117.86448979591837,119.90784580498867,7,4,114,2,72
3248,427,410,117.86448979591837,120.81342403628118,7,6,128,3,17
3249,427,21,118.07346938775511,119.6756462585034,9,38,412,2,406
3250,427,89,118.07346938775511,120.92952380952381,9,38,360,3,338
3251,427,285,118.07346938775511,119.53632653061224,9,18,155,1,142
3252,427,279,118.07346938775511,120.48834467120182,9,13,181,2,148
3253,427,499,118.07346938775511,119.90784580498867,9,4,107,2,72
3254,427,410,118.07346938775511,120.81342403628118,9,6,119,3,17
3255,499,89,119.90784580498867,120.92952380952381,4,38,412,1,410
3256,499,15,119.90784580498867,121.6261224489796,4,33,490,2,484
3257,499,231,119.90784580498867,121.64934240362813,4,9,278,2,268
3258,499,208,119.90784580498867,122.67102040816327,4,18,314,3,291
3259,499,555,119.90784580498867,121.11528344671203,4,8,76,1,56
3260,499,415,119.90784580498867,122.2530612244898,4,4,131,2,84
3261,499,779,119.90784580498867,121.09206349206349,4,5,285,1,280
3262,499,893,119.90784580498867,121.11528344671203,4,6,397,1,394
3263,410,21,120.81342403628118,122.97287981859411,6,39,400,2,389
3264,410,21,120.81342403628118,123.1354195011338,6,39,402,2,389
3265,410,208,120.81342403628118,122.67102040816327,6,18,217,2,202
3266,410,207,120.81342403628118,123.5998185941043,6,20,236,3,203
3267,410,415,120.81342403628118,122.2530612244898,6,4,62,1,5
3268,410,414,120.81342403628118,123.1354195011338,6,4,100,2,4
3269,555,208,121.11528344671203,122.67102040816327,8,18,353,2,347
3270,555,207,121.11528344671203,123.5998185941043,8,20,364,2,348
3271,555,415,121.11528344671203,122.2530612244898,8,4,148,1,140
3272,555,414,121.11528344671203,123.1354195011338,8,4,166,2,141
3273,415,25,122.2530612244898,125.0162358276644,4,32,408,3,390
3274,415,207,122.2530612244898,123.5998185941043,4,20,216,1,208
3275,415,226,122.2530612244898,125.0162358276644,4,23,223,3,189
3276,415,226,122.2530612244898,125.03945578231293,4,25,224,3,189
3277,415,453,122.2530612244898,125.0162358276644,4,8,125,3,38
3278,415,876,122.2530612244898,124.96979591836735,4,4,476,3,461
3279,414,25,123.1354195011338,125.0162358276644,4,32,397,2,389
3280,414,26,123.1354195011338,125.50385487528345,4,39,401,2,388
3281,414,226,123.1354195011338,125.0162358276644,4,23,205,2,188
3282,414,226,123.1354195011338,125.03945578231293,4,25,205,2,188
3283,414,453,123.1354195011338,125.0162358276644,4,8,90,2,39
3284,414,411,123.1354195011338,125.80571428571429,4,16,115,3,3
3285,414,623,123.1354195011338,126.01469387755103,4,4,243,3,209
3286,414,782,123.1354195011338,126.03791383219955,4,3,389,3,368
3287,414,876,123.1354195011338,124.96979591836735,4,4,469,2,462
3288,414,847,123.1354195011338,126.01469387755103,4,7,450,3,433
3289,414,849,123.1354195011338,126.03791383219955,4,5,453,3,435
3290,453,61,125.0162358276644,126.40943310657596,8,37,397,1,392
3291,453,26,125.0162358276644,127.54721088435375,8,36,441,3,427
3292,453,274,125.0162358276644,126.27011337868481,8,28,187,1,179
3293,453,209,125.0162358276644,127.84907029478458,8,20,273,3,244
3294,453,426,125.0162358276644,126.29333333333334,8,13,61,1,27
3295,453,782,125.0162358276644,126.03791383219955,8,3,332,1,329
3296,453,849,125.0162358276644,126.03791383219955,8,5,398,1,396
3297,453,883,125.0162358276644,127.77941043083901,8,5,446,3,430
3298,411,26,125.80571428571429,127.54721088435375,16,36,392,2,385
3299,411,209,125.80571428571429,127.84907029478458,16,20,220,2,202
3300,411,207,125.80571428571429,128.220589569161,16,24,229,2,204
3301,411,438,125.80571428571429,128.01160997732427,16,9,99,2,27
3302,411,497,125.80571428571429,128.03482993197278,16,12,129,2,86
3303,411,685,125.80571428571429,128.01160997732427,16,10,290,2,274
3304,411,684,125.80571428571429,128.05804988662132,16,14,290,2,273
3305,411,883,125.80571428571429,127.77941043083901,16,5,480,2,472
3306,411,864,125.80571428571429,128.52244897959184,16,16,468,3,453
3307,426,26,126.29333333333334,127.54721088435375,13,36,404,1,400
3308,426,102,126.29333333333334,128.89396825396827,13,38,343,3,324
3309,426,209,126.29333333333334,127.84907029478458,13,20,227,2,217
3310,426,207,126.29333333333334,128.220589569161,13,24,234,2,219
3311,426,438,126.29333333333334,128.01160997732427,13,9,75,2,12
3312,426,497,126.29333333333334,128.03482993197278,13,12,103,2,71
3313,426,685,126.29333333333334,128.01160997732427,13,10,269,2,259
3314,426,684,126.29333333333334,128.05804988662132,13,14,269,2,258
3315,426,883,126.29333333333334,127.77941043083901,13,5,461,1,457
3316,426,864,126.29333333333334,128.52244897959184,13,16,448,2,438
3317,438,71,128.01160997732427,129.84598639455783,9,35,375,2,367
3318,438,20,128.01160997732427,130.86766439909297,9,34,436,3,418
3319,438,297,128.01160997732427,129.91564625850341,9,16,163,2,141
3320,438,248,128.01160997732427,130.9837641723356,9,14,229,3,190
3321,438,564,128.01160997732427,129.3119274376417,9,9,138,1,126
3322,438,593,128.01160997732427,130.07818594104307,9,5,179,2,155
3323,438,763,128.01160997732427,129.3583673469388,9,6,330,1,325
3324,438,690,128.01160997732427,130.1014058956916,9,1,268,2,252
3325,497,71,128.03482993197278,129.84598639455783,12,35,433,2,426
3326,497,20,128.03482993197278,130.86766439909297,12,34,492,3,477
3327,497,297,128.03482993197278,129.91564625850341,12,16,216,2,200
3328,497,248,128.03482993197278,130.9837641723356,12,14,280,3,249
3329,497,564,128.03482993197278,129.3119274376417,12,9,87,1,67
3330,497,593,128.03482993197278,130.07818594104307,12,5,130,2,96
3331,497,763,128.03482993197278,129.3583673469388,12,6,272,1,266
3332,497,690,128.03482993197278,130.1014058956916,12,1,213,2,193
3333,497,953,128.03482993197278,129.33514739229025,12,19,459,1,456
3334,564,248,129.3119274376417,130.9837641723356,9,14,324,2,316
3335,564,328,129.3119274376417,131.05342403628117,9,12,248,2,236
3336,564,437,129.3119274376417,131.54104308390023,9,2,159,2,127
3337,593,371,130.07818594104307,133.0271201814059,5,11,256,3,222
3338,593,437,130.07818594104307,131.54104308390023,5,2,168,1,156
3339,437,88,131.54104308390023,133.0271201814059,2,33,355,1,349
3340,437,25,131.54104308390023,133.3986394557823,2,38,420,2,412
3341,437,31,131.54104308390023,134.23455782312925,2,39,422,3,406
3342,437,371,131.54104308390023,133.0271201814059,2,11,92,1,66
3343,437,381,131.54104308390023,133.79337868480727,2,21,112,2,56
3344,437,293,131.54104308390023,134.1184580498866,2,17,182,3,144
3345,437,426,131.54104308390023,133.70049886621317,2,20,94,2,11
3346,437,507,131.54104308390023,134.42031746031745,2,13,142,3,70
3347,437,649,131.54104308390023,133.25931972789115,2,17,225,2,212
3348,437,784,131.54104308390023,134.39709750566894,2,11,368,3,347
3349,426,26,133.70049886621317,135.32589569161,20,40,406,2,400
3350,426,62,133.70049886621317,136.1618140589569,20,37,379,2,364
3351,426,285,133.70049886621317,135.6974149659864,20,11,165,2,141
3352,426,311,133.70049886621317,136.1618140589569,20,8,156,2,115
3353,426,882,133.70049886621317,135.11691609977325,20,1,460,1,456
3354,507,62,134.42031746031745,136.1618140589569,13,37,451,2,445
3355,507,23,134.42031746031745,137.3924716553288,13,37,501,3,484
3356,507,285,134.42031746031745,135.6974149659864,13,11,229,1,222
3357,507,311,134.42031746031745,136.1618140589569,13,8,210,2,196
3358,507,426,134.42031746031745,136.8584126984127,13,5,133,2,81
3359,507,411,134.42031746031745,137.09061224489795,13,10,150,3,96
3360,507,817,134.42031746031745,136.81197278911566,13,2,327,2,310
3361,507,812,134.42031746031745,137.09061224489795,13,3,326,3,305
3362,507,865,134.42031746031745,136.81197278911566,13,8,373,2,358
3363,507,881,134.42031746031745,137.09061224489795,13,5,391,3,374
3364,426,20,136.8584126984127,138.59990929705216,5,36,413,2,406
3365,426,17,136.8584126984127,139.36616780045352,5,37,423,3,409
3366,426,272,136.8584126984127,137.9961904761905,5,16,162,1,154
3367,426,205,136.8584126984127,138.04263038548754,5,15,227,1,221
3368,426,369,136.8584126984127,139.11074829931974,5,7,113,2,57
3369,426,418,136.8584126984127,138.0890702947846,5,3,54,1,8
3370,411,20,137.09061224489795,138.59990929705216,10,36,396,2,391
3371,411,17,137.09061224489795,139.36616780045352,10,37,406,2,394
3372,411,369,137.09061224489795,139.11074829931974,10,7,97,2,42
3373,418,17,138.0890702947846,139.36616780045352,3,37,405,1,401
3374,418,15,138.0890702947846,141.01478458049885,3,34,422,3,403
3375,418,15,138.0890702947846,141.06122448979593,3,36,423,3,403
3376,418,369,138.0890702947846,139.11074829931974,3,7,66,1,49
3377,418,205,138.0890702947846,140.50394557823128,3,8,237,2,213
3378,437,8,143.1742403628118,144.91573696145124,4,41,436,2,429
3379,437,7,143.1742403628118,145.12471655328798,4,41,438,2,430
3380,437,205,143.1742403628118,144.91573696145124,4,25,244,2,232
3381,437,206,143.1742403628118,145.91419501133788,4,26,259,3,231
3382,437,257,143.1742403628118,146.07673469387754,4,19,219,3,180
3383,437,411,143.1742403628118,144.91573696145124,4,18,79,2,26
3384,437,411,143.1742403628118,145.89097505668934,4,14,120,3,26
3385,437,412,143.1742403628118,146.05351473922903,4,13,126,3,25
3386,437,662,143.1742403628118,144.75319727891156,4,10,235,2,225
3387,437,811,143.1742403628118,145.7516553287982,4,9,390,3,374
3388,437,920,143.1742403628118,144.72997732426305,4,15,488,2,483
3389,437,885,143.1742403628118,145.7516553287982,4,16,462,3,448
3390,411,47,144.91573696145124,146.4714739229025,18,38,370,2,364
3391,411,78,144.91573696145124,147.19129251700681,18,40,347,2,333
3392,411,257,144.91573696145124,146.07673469387754,18,19,162,1,154
3393,411,208,144.91573696145124,147.77179138321995,18,15,237,3,203
3394,411,412,144.91573696145124,146.05351473922903,18,13,49,1,1
3395,411,639,144.91573696145124,146.68045351473924,18,8,240,2,228
3396,411,697,144.91573696145124,147.35383219954647,18,3,305,2,286
3397,411,866,144.91573696145124,146.6572335600907,18,10,461,2,455
3398,411,78,145.89097505668934,147.19129251700681,14,40,338,1,333
3399,411,8,145.89097505668934,148.81668934240363,14,42,422,3,403
3400,411,208,145.89097505668934,147.77179138321995,14,15,219,2,203
3401,411,288,145.89097505668934,148.81668934240363,14,17,176,3,123
3402,411,413,145.89097505668934,148.72380952380954,14,11,122,3,2
3403,411,697,145.89097505668934,147.35383219954647,14,3,293,1,286
3404,412,78,146.05351473922903,147.19129251700681,13,40,338,1,334
3405,412,8,146.05351473922903,148.81668934240363,13,42,421,3,404
3406,412,208,146.05351473922903,147.77179138321995,13,15,217,2,204
3407,412,288,146.05351473922903,148.81668934240363,13,17,172,3,124
3408,412,413,146.05351473922903,148.72380952380954,13,11,115,3,1
3409,412,697,146.05351473922903,147.35383219954647,13,3,290,1,285
3410,411,8,147.05197278911564,148.81668934240363,8,42,410,2,403
3411,411,7,147.05197278911564,149.28108843537416,8,38,415,2,404
3412,411,288,147.05197278911564,148.81668934240363,8,17,145,2,123
3413,411,215,147.05197278911564,150.02412698412698,8,26,234,3,196
3414,411,413,147.05197278911564,148.72380952380954,8,11,72,2,2
3415,411,413,147.05197278911564,149.79192743764173,8,24,118,3,2
3416,411,816,147.05197278911564,149.83836734693878,8,0,422,3,405
3417,411,863,147.05197278911564,149.88480725623583,8,8,468,3,452
3418,413,23,148.72380952380954,150.34920634920636,11,37,396,2,390
3419,413,215,148.72380952380954,150.02412698412698,11,26,206,1,198
3420,413,214,148.72380952380954,150.04734693877552,11,27,207,1,199
3421,413,411,148.72380952380954,150.14022675736962,11,19,61,1,2
3422,413,816,148.72380952380954,149.83836734693878,11,0,406,1,403
3423,413,677,148.72380952380954,151.57986394557824,11,1,291,3,264
3424,413,863,148.72380952380954,149.88480725623583,11,8,453,1,450
3425,413,23,149.79192743764173,152.02104308390022,24,36,402,2,390
3426,413,9,149.79192743764173,152.67120181405895,24,41,423,3,404
3427,413,212,149.79192743764173,151.97460317460317,24,18,222,2,201
3428,413,310,149.79192743764173,152.39256235827665,24,13,152,3,103
3429,413,420,149.79192743764173,151.8120634920635,24,11,87,2,7
3430,413,435,149.79192743764173,152.6015419501134,24,10,123,3,22
3431,413,677,149.79192743764173,151.57986394557824,24,1,275,2,264
3432,411,23,150.14022675736962,152.02104308390022,19,36,396,2,388
3433,411,9,150.14022675736962,152.67120181405895,19,41,417,3,402
3434,411,7,150.14022675736962,153.08916099773242,19,40,423,3,404
3435,411,212,150.14022675736962,151.97460317460317,19,18,214,2,199
3436,411,310,150.14022675736962,152.39256235827665,19,13,140,2,101
3437,411,420,150.14022675736962,151.8120634920635,19,11,73,2,9
3438,411,435,150.14022675736962,152.6015419501134,19,10,109,2,24
3439,411,677,150.14022675736962,151.57986394557824,19,1,273,1,266
3440,420,7,151.8120634920635,153.08916099773242,11,40,417,1,413
3441,420,26,151.8120634920635,154.08761904761906,11,39,406,2,394
3442,420,380,151.8120634920635,153.97151927437642,11,17,101,2,40
3443,420,430,151.8120634920635,153.97151927437642,11,11,94,2,10
3444,420,428,151.8120634920635,154.15727891156462,11,15,101,2,8
3445,420,910,151.8120634920635,153.97151927437642,11,0,499,2,490
3446,435,26,152.6015419501134,154.08761904761906,10,39,414,1,409
3447,435,21,152.6015419501134,155.5504761904762,10,38,433,3,414
3448,435,380,152.6015419501134,153.97151927437642,10,17,81,1,55
3449,435,210,152.6015419501134,154.83065759637188,10,22,245,2,225
3450,435,430,152.6015419501134,153.97151927437642,10,11,59,1,5
3451,435,428,152.6015419501134,154.15727891156462,10,15,67,2,7
3452,435,630,152.6015419501134,155.03963718820862,10,4,221,2,195
3453,435,635,152.6015419501134,155.1092970521542,10,13,227,3,200
3454,435,910,152.6015419501134,153.97151927437642,10,0,479,1,475
3455,435,903,152.6015419501134,155.08607709750567,10,13,480,2,468
3456,430,21,153.97151927437642,155.5504761904762,11,38,415,2,409
3457,430,8,153.97151927437642,156.75791383219956,11,41,439,3,422
3458,430,223,153.97151927437642,155.80589569160998,11,25,222,2,207
3459,430,208,153.97151927437642,156.22385487528345,11,20,242,2,222
3460,430,447,153.97151927437642,155.6433560090703,11,14,74,2,17
3461,430,411,153.97151927437642,156.40961451247165,11,10,107,2,19
3462,430,630,153.97151927437642,155.03963718820862,11,4,205,1,200
3463,430,635,153.97151927437642,155.1092970521542,11,13,211,1,205
3464,430,903,153.97151927437642,155.08607709750567,11,13,475,1,473
3465,430,876,153.97151927437642,156.47927437641724,11,3,459,3,446
3466,428,21,154.15727891156462,155.5504761904762,15,38,411,1,407
3467,428,8,154.15727891156462,156.75791383219956,15,41,435,3,420
3468,428,223,154.15727891156462,155.80589569160998,15,25,217,2,205
3469,428,208,154.15727891156462,156.22385487528345,15,20,237,2,220
3470,428,447,154.15727891156462,155.6433560090703,15,14,67,1,19
3471,428,411,154.15727891156462,156.40961451247165,15,10,98,2,17
3472,428,876,154.15727891156462,156.47927437641724,15,3,459,2,448
3473,447,8,155.6433560090703,156.75791383219956,14,41,442,1,439
3474,447,25,155.6433560090703,157.80281179138322,14,38,432,2,422
3475,447,228,155.6433560090703,157.91891156462586,14,23,240,2,219
3476,447,416,155.6433560090703,157.57061224489797,14,19,89,2,31
3477,447,428,155.6433560090703,158.17433106575965,14,21,111,3,19
3478,447,648,155.6433560090703,157.45451247165533,14,5,216,2,201
3479,447,903,155.6433560090703,157.45451247165533,14,8,463,2,456
3480,411,25,156.40961451247165,157.80281179138322,10,38,391,1,386
3481,411,23,156.40961451247165,158.82448979591837,10,39,402,2,388
3482,411,228,156.40961451247165,157.91891156462586,10,23,194,2,183
3483,411,216,156.40961451247165,158.70839002267573,10,24,219,2,195
3484,411,206,156.40961451247165,159.07990929705215,10,15,235,3,205
3485,411,416,156.40961451247165,157.57061224489797,10,19,50,1,5
3486,411,428,156.40961451247165,158.17433106575965,10,21,78,2,17
3487,411,460,156.40961451247165,159.05668934240364,10,5,124,3,49
3488,411,648,156.40961451247165,157.45451247165533,10,5,241,1,237
3489,411,678,156.40961451247165,158.96380952380952,10,6,289,3,267
3490,411,903,156.40961451247165,157.45451247165533,10,8,494,1,492
3491,416,23,157.57061224489797,158.82448979591837,19,39,397,1,393
3492,416,21,157.57061224489797,159.45142857142858,19,38,403,2,395
3493,416,216,157.57061224489797,158.70839002267573,19,24,206,1,200
3494,416,206,157.57061224489797,159.07990929705215,19,15,220,2,210
3495,416,460,157.57061224489797,159.05668934240364,19,5,78,1,44
3496,416,678,157.57061224489797,158.96380952380952,19,6,269,1,262
3497,428,21,158.17433106575965,159.45142857142858,21,38,411,1,407
3498,428,9,158.17433106575965,160.56598639455783,21,42,431,2,419
3499,428,7,158.17433106575965,161.0768253968254,21,37,439,3,421
3500,428,206,158.17433106575965,160.8910657596372,21,9,251,3,222
3501,460,9,159.05668934240364,160.56598639455783,5,42,456,2,451
3502,460,7,159.05668934240364,161.0768253968254,5,37,461,2,453
3503,460,206,159.05668934240364,160.8910657596372,5,9,266,2,254
3504,460,303,159.05668934240364,162.02884353741496,5,15,203,3,157
3505,460,427,159.05668934240364,161.56444444444446,5,7,113,3,33
3506,427,69,161.56444444444446,163.3059410430839,7,37,366,2,358
3507,427,219,161.56444444444446,163.9328798185941,7,22,232,2,208
3508,427,272,161.56444444444446,164.04897959183674,7,19,188,2,155
3509,427,431,161.56444444444446,163.63102040816327,7,10,89,2,4
3510,427,818,161.56444444444446,162.98086167800454,7,0,396,1,391
3511,427,797,161.56444444444446,164.30439909297053,7,15,388,3,370
3512,427,863,161.56444444444446,163.63102040816327,7,1,445,2,436
3513,427,849,161.56444444444446,164.30439909297053,7,22,438,3,422
3514,421,69,162.2378231292517,163.3059410430839,12,37,355,1,352
3515,421,7,162.2378231292517,164.79201814058956,12,41,428,3,414
3516,421,219,162.2378231292517,163.9328798185941,12,22,215,2,202
3517,421,272,162.2378231292517,164.04897959183674,12,19,168,2,149
3518,421,431,162.2378231292517,163.63102040816327,12,10,61,1,10
3519,421,420,162.2378231292517,164.76879818594105,12,17,109,3,1
3520,421,418,162.2378231292517,165.14031746031748,12,18,125,3,3
3521,421,797,162.2378231292517,164.30439909297053,12,15,386,2,376
3522,421,863,162.2378231292517,163.63102040816327,12,1,446,1,442
3523,421,849,162.2378231292517,164.30439909297053,12,22,437,2,428
3524,431,7,163.63102040816327,164.79201814058956,10,41,427,1,424
3525,431,34,163.63102040816327,165.48861678004536,10,37,405,2,397
3526,431,14,163.63102040816327,166.16199546485262,10,37,431,3,417
3527,431,213,163.63102040816327,165.41895691609977,10,26,231,2,218
3528,431,208,163.63102040816327,166.48707482993197,10,18,255,3,223
3529,431,420,163.63102040816327,164.76879818594105,10,17,50,1,11
3530,431,418,163.63102040816327,165.14031746031748,10,18,66,2,13
3531,431,601,163.63102040816327,166.6031746031746,10,5,213,3,170
3532,431,819,163.63102040816327,166.6031746031746,10,11,409,3,388
3533,431,915,163.63102040816327,165.23319727891158,10,4,489,2,484
3534,420,14,164.76879818594105,166.16199546485262,17,37,410,1,406
3535,420,208,164.76879818594105,166.48707482993197,17,18,225,2,212
3536,420,366,164.76879818594105,167.20689342403628,17,14,118,2,54
3537,420,601,164.76879818594105,166.6031746031746,17,5,197,2,181
3538,420,563,164.76879818594105,167.20689342403628,17,14,177,2,143
3539,420,819,164.76879818594105,166.6031746031746,17,11,407,2,399
3540,420,626,164.76879818594105,167.20689342403628,17,8,231,2,206
3541,420,868,164.76879818594105,167.25333333333333,17,3,461,2,448
3542,418,14,165.14031746031748,166.16199546485262,18,37,406,1,404
3543,418,26,165.14031746031748,167.857052154195,18,38,409,3,392
3544,418,208,165.14031746031748,166.48707482993197,18,18,218,1,210
3545,418,366,165.14031746031748,167.20689342403628,18,14,103,2,52
3546,418,601,165.14031746031748,166.6031746031746,18,5,194,1,183
3547,418,563,165.14031746031748,167.20689342403628,18,14,170,2,145
3548,418,819,165.14031746031748,166.6031746031746,18,11,406,1,401
3549,418,626,165.14031746031748,167.20689342403628,18,8,226,2,208
3550,418,868,165.14031746031748,167.25333333333333,18,3,459,2,450
3551,601,306,166.6031746031746,168.13569160997733,5,8,302,2,295
3552,601,766,166.6031746031746,169.0877097505669,5,4,197,2,165
3553,563,330,167.20689342403628,169.7843083900227,14,17,258,3,233
3554,563,413,167.20689342403628,170.03972789115647,14,10,193,3,150
3555,563,766,167.20689342403628,169.0877097505669,14,4,219,2,203
3556,563,867,167.20689342403628,169.83074829931974,14,7,324,3,304
3557,413,24,170.03972789115647,171.96698412698413,10,38,398,2,389
3558,413,8,170.03972789115647,172.40816326530611,10,41,418,2,405
3559,413,226,170.03972789115647,171.5025850340136,10,25,197,1,187
3560,413,226,170.03972789115647,172.12952380952382,10,22,208,2,187
3561,413,452,170.03972789115647,171.4793650793651,10,9,73,1,39
3562,413,418,170.03972789115647,172.2920634920635,10,9,97,2,5
3563,413,863,170.03972789115647,171.38648526077097,10,9,454,1,450
3564,413,874,170.03972789115647,172.17596371882087,10,5,470,2,461
3565,428,24,170.27192743764172,171.96698412698413,21,38,411,2,404
3566,428,8,170.27192743764172,172.40816326530611,21,41,430,2,420
3567,428,226,170.27192743764172,171.5025850340136,21,25,209,1,202
3568,428,226,170.27192743764172,172.12952380952382,21,22,217,2,202
3569,428,452,170.27192743764172,171.4793650793651,21,9,57,1,24
3570,428,418,170.27192743764172,172.2920634920635,21,9,88,2,10
3571,428,863,170.27192743764172,171.38648526077097,21,9,438,1,435
3572,428,874,170.27192743764172,172.17596371882087,21,5,453,2,446
3573,452,51,171.4793650793651,173.638820861678,9,36,412,2,401
3574,452,51,171.4793650793651,174.2657596371882,9,35,419,3,401
3575,452,283,171.4793650793651,173.6156009070295,9,19,192,2,169
3576,452,205,171.4793650793651,174.4515192743764,9,14,278,3,247
3577,452,411,171.4793650793651,173.59238095238095,9,8,100,2,41
3578,452,432,171.4793650793651,174.38185941043085,9,4,127,3,20
3579,452,812,171.4793650793651,173.4530612244898,9,7,370,2,360
3580,452,876,171.4793650793651,173.4530612244898,9,8,432,2,424
3581,452,864,171.4793650793651,174.4282993197279,9,1,431,3,412
3582,418,51,172.2920634920635,173.638820861678,9,36,372,1,367
3583,418,51,172.2920634920635,174.2657596371882,9,35,377,2,367
3584,418,21,172.2920634920635,175.10167800453516,9,38,415,3,397
3585,418,283,172.2920634920635,173.6156009070295,9,19,147,1,135
3586,418,205,172.2920634920635,174.4515192743764,9,14,232,2,213
3587,418,411,172.2920634920635,173.59238095238095,9,8,56,1,7
3588,418,432,172.2920634920635,174.38185941043085,9,4,91,2,14
3589,418,427,172.2920634920635,175.21777777777777,9,6,126,3,9
3590,418,812,172.2920634920635,173.4530612244898,9,7,397,1,394
3591,418,657,172.2920634920635,174.89269841269842,9,1,264,3,239
3592,418,876,172.2920634920635,173.4530612244898,9,8,461,1,458
3593,418,864,172.2920634920635,174.4282993197279,9,1,455,2,446
3594,411,21,173.59238095238095,175.10167800453516,8,38,395,2,390
3595,411,8,173.59238095238095,176.4019954648526,8,43,421,3,403
3596,411,285,173.59238095238095,175.79827664399093,8,16,158,2,126
3597,411,427,173.59238095238095,175.21777777777777,8,6,72,2,16
3598,411,419,173.59238095238095,176.16979591836736,8,1,111,3,8
3599,411,657,173.59238095238095,174.89269841269842,8,1,252,1,246
3600,411,806,173.59238095238095,175.96081632653062,8,20,408,2,395
3601,432,8,174.38185941043085,176.4019954648526,4,43,433,2,424
3602,432,285,174.38185941043085,175.79827664399093,4,16,159,1,147
3603,432,205,174.38185941043085,177.02893424036282,4,10,254,3,227
3604,432,419,174.38185941043085,176.16979591836736,4,1,78,2,13
3605,432,806,174.38185941043085,175.96081632653062,4,20,380,2,374
3606,427,8,175.21777777777777,176.4019954648526,6,43,422,1,419
3607,427,25,175.21777777777777,177.3772335600907,6,38,413,2,402
3608,427,205,175.21777777777777,177.02893424036282,6,10,235,2,222
3609,427,278,175.21777777777777,177.70231292517008,6,24,183,2,149
3610,427,440,175.21777777777777,177.5397732426304,6,12,101,2,13
3611,427,432,175.21777777777777,178.1899319727891,6,12,128,3,5
3612,427,863,175.21777777777777,177.67909297052154,6,3,449,2,436
3613,427,840,175.21777777777777,178.1899319727891,6,4,432,3,413
3614,419,25,176.16979591836736,177.3772335600907,1,38,397,1,394
3615,419,23,176.16979591836736,179.00263038548752,1,37,414,3,396
3616,419,278,176.16979591836736,177.70231292517008,1,24,156,2,141
3617,419,207,176.16979591836736,178.77043083900227,1,27,240,3,212
3618,419,208,176.16979591836736,179.09551020408165,1,23,246,3,211
3619,419,440,176.16979591836736,177.5397732426304,1,12,63,1,21
3620,419,432,176.16979591836736,178.1899319727891,1,12,88,2,13
3621,419,863,176.16979591836736,177.67909297052154,1,3,449,2,444
3622,419,840,176.16979591836736,178.1899319727891,1,4,430,2,421
3623,440,23,177.5397732426304,179.00263038548752,12,37,422,1,417
3624,440,9,177.5397732426304,180.0475283446712,12,39,444,3,431
3625,440,8,177.5397732426304,180.16362811791385,12,42,447,3,432
3626,440,207,177.5397732426304,178.77043083900227,12,27,239,1,233
3627,440,208,177.5397732426304,179.09551020408165,12,23,241,2,232
3628,440,420,177.5397732426304,179.2580498866213,12,14,77,2,20
3629,440,677,177.5397732426304,179.46702947845804,12,10,251,2,237
3630,440,878,177.5397732426304,179.46702947845804,12,15,446,2,438
3631,432,9,178.1899319727891,180.0475283446712,12,39,430,2,423
3632,432,8,178.1899319727891,180.16362811791385,12,42,432,2,424
3633,432,308,178.1899319727891,180.90666666666667,12,20,170,3,124
3634,432,420,178.1899319727891,179.2580498866213,12,14,48,1,12
3635,432,410,178.1899319727891,180.90666666666667,12,11,119,3,22
3636,432,677,178.1899319727891,179.46702947845804,12,10,251,1,245
3637,432,878,178.1899319727891,179.46702947845804,12,15,449,1,446
3638,420,34,179.2580498866213,181.39428571428573,14,39,397,2,386
3639,420,308,179.2580498866213,180.90666666666667,14,20,133,2,112
3640,420,210,179.2580498866213,181.3014058956916,14,30,228,2,210
3641,420,410,179.2580498866213,180.90666666666667,14,11,72,2,10
3642,420,411,179.2580498866213,181.23174603174604,14,20,85,2,9
3643,420,878,179.2580498866213,181.44072562358278,14,5,468,2,458
3644,410,36,180.90666666666667,182.6249433106576,11,35,381,2,374
3645,410,246,180.90666666666667,182.9732426303855,11,10,187,2,164
3646,410,205,180.90666666666667,183.41442176870748,11,11,232,3,205
3647,410,419,180.90666666666667,182.8107029478458,11,5,82,2,9
3648,410,796,180.90666666666667,182.92680272108845,11,8,396,2,386
3649,411,36,181.23174603174604,182.6249433106576,20,35,380,1,375
3650,411,8,181.23174603174604,184.0413605442177,20,41,421,3,403
3651,411,8,181.23174603174604,184.15746031746033,20,42,422,3,403
3652,411,246,181.23174603174604,182.9732426303855,20,10,181,2,165
3653,411,205,181.23174603174604,183.41442176870748,20,11,226,2,206
3654,411,419,181.23174603174604,182.8107029478458,20,5,68,2,8
3655,411,410,181.23174603174604,183.55374149659863,20,2,100,2,1
3656,411,796,181.23174603174604,182.92680272108845,20,8,392,2,385
3657,419,8,182.8107029478458,184.0413605442177,5,41,414,1,411
3658,419,8,182.8107029478458,184.15746031746033,5,42,415,1,411
3659,419,5,182.8107029478458,185.06303854875284,5,35,425,2,414
3660,419,324,182.8107029478458,185.0165986394558,5,9,134,2,95
3661,419,325,182.8107029478458,185.50421768707483,5,11,149,3,94
3662,410,5,183.55374149659863,185.06303854875284,2,35,410,2,405
3663,410,324,183.55374149659863,185.0165986394558,2,9,107,1,86
3664,410,325,183.55374149659863,185.50421768707483,2,11,120,2,85
3665,410,493,183.55374149659863,186.47945578231293,2,2,151,3,83
3666,493,9,186.47945578231293,188.22095238095238,2,35,490,2,484
3667,493,207,186.47945578231293,188.778231292517,2,9,303,2,286
3668,493,491,186.47945578231293,187.91909297052155,2,0,62,1,2
3669,491,9,187.91909297052155,190.03210884353743,0,33,491,2,482
3670,491,9,187.91909297052155,190.12498866213153,0,35,491,2,482
3671,491,206,187.91909297052155,189.89278911564625,0,5,297,2,285
3672,491,207,187.91909297052155,190.75192743764174,0,10,309,3,284
3673,437,9,194.23492063492063,196.0692970521542,1,35,435,2,428
3674,437,205,194.23492063492063,195.67455782312925,1,11,240,1,232
3675,437,246,194.23492063492063,196.30149659863946,1,7,211,2,191
3676,437,246,194.23492063492063,197.1374149659864,1,12,228,3,191
3677,437,410,194.23492063492063,196.83555555555557,1,7,115,3,27
3678,410,9,196.83555555555557,197.92689342403628,7,35,404,1,401
3679,410,8,196.83555555555557,198.43773242630385,7,42,408,2,402
3680,410,5,196.83555555555557,199.2039909297052,7,37,418,2,405
3681,410,246,196.83555555555557,198.6467120181406,7,10,182,2,164
3682,410,246,196.83555555555557,199.50585034013605,7,11,200,3,164
3683,410,411,196.83555555555557,198.06621315192743,7,3,53,1,1
3684,410,411,196.83555555555557,199.15755102040816,7,6,100,2,1
3685,411,5,197.5089342403628,199.2039909297052,6,37,413,2,406
3686,411,13,197.5089342403628,200.31854875283446,6,35,416,3,398
3687,411,246,197.5089342403628,198.6467120181406,6,10,172,1,165
3688,411,246,197.5089342403628,199.50585034013605,6,11,186,2,165
3689,411,306,197.5089342403628,200.2721088435374,6,11,159,3,105
3690,411,5,198.06621315192743,199.2039909297052,3,37,409,1,406
3691,411,13,198.06621315192743,200.31854875283446,3,35,410,2,398
3692,411,246,198.06621315192743,199.50585034013605,3,11,176,1,165
3693,411,306,198.06621315192743,200.2721088435374,3,11,142,2,105
3694,411,734,198.06621315192743,201.03836734693877,3,0,347,3,323
3695,411,13,199.15755102040816,200.31854875283446,6,35,401,1,398
3696,411,8,199.15755102040816,201.87428571428572,6,43,420,3,403
3697,411,7,199.15755102040816,202.08326530612246,6,41,423,3,404
3698,411,306,199.15755102040816,200.2721088435374,6,11,115,1,105
3699,411,248,199.15755102040816,201.52598639455783,6,14,192,2,163
3700,411,414,199.15755102040816,201.54920634920634,6,2,103,2,3
3701,411,734,199.15755102040816,201.03836734693877,6,0,333,2,323
3702,411,747,199.15755102040816,201.80462585034013,6,2,355,3,336
3703,414,8,201.54920634920634,203.77832199546486,2,41,417,2,406
3704,414,228,201.54920634920634,203.61578231292518,2,25,206,2,186
3705,414,411,201.54920634920634,202.64054421768708,2,1,47,1,3
3706,414,420,201.54920634920634,203.6390022675737,2,21,90,2,6
3707,414,726,201.54920634920634,203.49968253968254,2,9,323,2,312
3708,414,681,201.54920634920634,204.49814058956918,2,5,296,3,267
3709,414,902,201.54920634920634,202.75664399092972,2,0,491,1,488
3710,414,910,201.54920634920634,203.49968253968254,2,6,503,2,496
3711,411,8,202.64054421768708,203.77832199546486,1,41,406,1,403
3712,411,26,202.64054421768708,204.66068027210883,1,39,395,2,385
3713,411,207,202.64054421768708,204.7071201814059,1,28,223,2,204
3714,411,415,202.64054421768708,204.7071201814059,1,20,89,2,4
3715,411,681,202.64054421768708,204.49814058956918,1,5,282,2,270
3716,411,636,202.64054421768708,205.49659863945578,1,11,256,3,225
3717,420,26,203.6390022675737,204.66068027210883,21,39,396,1,394
3718,420,78,203.6390022675737,206.0306575963719,21,38,357,2,342
3719,420,207,203.6390022675737,204.7071201814059,21,28,218,1,213
3720,420,277,203.6390022675737,205.84489795918367,21,23,172,2,143
3721,420,285,203.6390022675737,206.07709750566895,21,13,171,2,135
3722,420,415,203.6390022675737,204.7071201814059,21,20,46,1,5
3723,420,410,203.6390022675737,205.63591836734693,21,14,87,2,10
3724,420,546,203.6390022675737,206.23963718820863,21,9,169,3,126
3725,420,636,203.6390022675737,205.49659863945578,21,11,230,2,216
3726,420,818,203.6390022675737,206.23963718820863,21,7,413,3,398
3727,420,835,203.6390022675737,206.23963718820863,21,4,430,3,415
3728,415,78,204.7071201814059,206.0306575963719,20,38,342,1,337
3729,415,9,204.7071201814059,207.00589569161,20,40,418,2,406
3730,415,8,204.7071201814059,207.23809523809524,20,42,421,3,407
3731,415,277,204.7071201814059,205.84489795918367,20,23,146,1,138
3732,415,285,204.7071201814059,206.07709750566895,20,13,143,1,130
3733,415,546,204.7071201814059,206.23963718820863,20,9,147,2,131
3734,415,431,204.7071201814059,207.58639455782313,20,18,125,3,16
3735,415,818,204.7071201814059,206.23963718820863,20,7,408,2,403
3736,415,835,204.7071201814059,206.23963718820863,20,4,425,2,420
3737,410,9,205.63591836734693,207.00589569161,14,40,405,1,401
3738,410,8,205.63591836734693,207.23809523809524,14,42,408,2,402
3739,410,281,205.63591836734693,207.8418140589569,14,22,160,2,129
3740,410,431,205.63591836734693,207.58639455782313,14,18,87,2,21
3741,546,281,206.23963718820863,207.8418140589569,9,22,274,2,265
3742,546,232,206.23963718820863,208.9099319727891,9,27,334,3,314
3743,546,431,206.23963718820863,207.58639455782313,9,18,129,1,115
3744,546,417,206.23963718820863,208.93315192743765,9,22,173,3,129
3745,546,810,206.23963718820863,208.9099319727891,9,3,288,3,264
3746,546,926,206.23963718820863,208.9099319727891,9,10,397,3,380
3747,546,845,206.23963718820863,209.21179138321995,9,10,325,3,299
3748,431,23,207.58639455782313,209.0492517006803,18,39,413,1,408
3749,431,23,207.58639455782313,209.0724716553288,18,39,413,1,408
3750,431,232,207.58639455782313,208.9099319727891,18,27,207,1,199
3751,431,296,207.58639455782313,209.28145124716553,18,24,153,2,135
3752,431,417,207.58639455782313,208.93315192743765,18,22,60,1,14
3753,431,410,207.58639455782313,209.30467120181407,18,22,77,2,21
3754,431,810,207.58639455782313,208.9099319727891,18,3,383,1,379
3755,431,722,207.58639455782313,209.5136507936508,18,3,303,2,291
3756,431,738,207.58639455782313,210.39600907029478,18,1,330,3,307
3757,431,926,207.58639455782313,208.9099319727891,18,10,498,1,495
3758,431,845,207.58639455782313,209.21179138321995,18,10,420,2,414
3759,431,868,207.58639455782313,210.39600907029478,18,14,453,3,437
3760,417,9,208.93315192743765,210.90684807256235,22,39,417,2,408
3761,417,7,208.93315192743765,211.44090702947847,22,42,424,3,410
3762,417,232,208.93315192743765,210.72108843537416,22,19,200,2,185
3763,417,410,208.93315192743765,210.65142857142857,22,10,74,2,7
3764,417,459,208.93315192743765,211.39446712018142,22,10,114,2,42
3765,417,738,208.93315192743765,210.39600907029478,22,1,327,1,321
3766,417,778,208.93315192743765,211.39446712018142,22,12,376,2,361
3767,417,868,208.93315192743765,210.39600907029478,22,14,455,1,451
3768,417,865,208.93315192743765,211.41768707482993,22,12,461,2,448
3769,410,9,209.30467120181407,210.90684807256235,22,39,407,2,401
3770,410,7,209.30467120181407,211.44090702947847,22,42,413,2,403
3771,410,232,209.30467120181407,210.72108843537416,22,19,188,1,178
3772,410,275,209.30467120181407,212.0214058956916,22,22,179,3,135
3773,410,459,209.30467120181407,211.39446712018142,22,10,102,2,49
3774,410,738,209.30467120181407,210.39600907029478,22,1,331,1,328
3775,410,778,209.30467120181407,211.39446712018142,22,12,379,2,368
3776,410,868,209.30467120181407,210.39600907029478,22,14,460,1,458
3777,410,865,209.30467120181407,211.41768707482993,22,12,464,2,455
3778,410,26,210.65142857142857,212.95020408163265,10,39,397,2,384
3779,410,275,210.65142857142857,212.0214058956916,10,22,147,1,135
3780,410,307,210.65142857142857,213.01986394557824,10,19,145,2,103
3781,410,906,210.65142857142857,212.78766439909296,10,0,504,2,496
3782,459,26,211.39446712018142,212.95020408163265,10,39,438,2,433
3783,459,51,211.39446712018142,213.67002267573696,10,38,420,2,408
3784,459,21,211.39446712018142,214.34340136054422,10,37,456,3,438
3785,459,307,211.39446712018142,213.01986394557824,10,19,167,2,152
3786,459,281,211.39446712018142,213.67002267573696,10,25,203,2,178
3787,459,410,211.39446712018142,212.9966439909297,10,20,85,2,49
3788,459,410,211.39446712018142,213.67002267573696,10,15,110,2,49
3789,459,617,211.39446712018142,213.83256235827665,10,6,190,2,158
3790,459,906,211.39446712018142,212.78766439909296,10,0,451,1,447
3791,459,863,211.39446712018142,213.8557823129252,10,11,418,2,404
3792,410,21,212.9966439909297,214.34340136054422,20,37,393,1,389
3793,410,8,212.9966439909297,215.36507936507937,20,42,415,2,402
3794,410,210,212.9966439909297,214.97034013605443,20,23,217,2,200
3795,410,206,212.9966439909297,215.22575963718822,20,26,225,2,204
3796,410,428,212.9966439909297,214.62204081632655,20,16,72,2,18
3797,410,411,212.9966439909297,215.22575963718822,20,17,96,2,1
3798,410,810,212.9966439909297,214.45950113378686,20,4,405,1,400
3799,410,819,212.9966439909297,215.7365986394558,20,5,426,3,409
3800,410,850,212.9966439909297,214.43628117913832,20,14,444,1,440
3801,410,820,212.9966439909297,215.7365986394558,20,3,427,3,410
3802,410,8,213.67002267573696,215.36507936507937,15,42,409,2,402
3803,410,210,213.67002267573696,214.97034013605443,15,23,208,1,200
3804,410,206,213.67002267573696,215.22575963718822,15,26,215,2,204
3805,410,411,213.67002267573696,215.22575963718822,15,17,67,2,1
3806,410,819,213.67002267573696,215.7365986394558,15,5,419,2,409
3807,410,820,213.67002267573696,215.7365986394558,15,3,420,2,410
3808,428,77,214.62204081632655,216.87437641723358,16,39,364,2,351
3809,428,279,214.62204081632655,216.68861678004535,16,25,174,2,149
3810,428,212,214.62204081632655,217.50131519274376,16,26,249,3,216
3811,428,420,214.62204081632655,216.9904761904762,16,20,102,2,8
3812,428,417,214.62204081632655,217.38521541950115,16,18,120,3,11
3813,428,819,214.62204081632655,215.7365986394558,16,5,394,1,391
3814,428,812,214.62204081632655,216.68861678004535,16,2,394,2,384
3815,428,810,214.62204081632655,217.4548752834467,16,1,401,3,382
3816,428,820,214.62204081632655,215.7365986394558,16,3,395,1,392
3817,428,889,214.62204081632655,216.68861678004535,16,12,470,2,461
3818,428,846,214.62204081632655,217.4316553287982,16,6,435,3,418
3819,411,77,215.22575963718822,216.87437641723358,17,39,341,2,334
3820,411,23,215.22575963718822,217.6174149659864,17,38,401,2,388
3821,411,279,215.22575963718822,216.68861678004535,17,25,146,1,132
3822,411,212,215.22575963718822,217.50131519274376,17,26,222,2,199
3823,411,420,215.22575963718822,216.9904761904762,17,20,77,2,9
3824,411,417,215.22575963718822,217.38521541950115,17,18,93,2,6
3825,411,812,215.22575963718822,216.68861678004535,17,2,406,1,401
3826,411,810,215.22575963718822,217.4548752834467,17,1,410,2,399
3827,411,889,215.22575963718822,216.68861678004535,17,12,482,1,478
3828,411,846,215.22575963718822,217.4316553287982,17,6,445,2,435
3829,420,8,216.9904761904762,218.91773242630387,20,42,420,2,412
3830,420,7,216.9904761904762,219.08027210884353,20,40,423,2,413
3831,420,364,216.9904761904762,218.56943310657596,20,20,88,2,56
3832,420,249,216.9904761904762,219.19637188208617,20,11,196,2,171
3833,420,483,216.9904761904762,218.45333333333335,20,10,89,1,63
3834,420,471,216.9904761904762,219.19637188208617,20,5,108,2,51
3835,420,639,216.9904761904762,219.05705215419502,20,1,236,2,219
3836,420,849,216.9904761904762,218.56943310657596,20,2,434,2,429
3837,417,8,217.38521541950115,218.91773242630387,18,42,414,2,409
3838,417,7,217.38521541950115,219.08027210884353,18,40,416,2,410
3839,417,91,217.38521541950115,220.31092970521541,18,38,350,3,326
3840,417,364,217.38521541950115,218.56943310657596,18,20,74,1,53
3841,417,249,217.38521541950115,219.19637188208617,18,11,185,2,168
3842,417,483,217.38521541950115,218.45333333333335,18,10,80,1,66
3843,417,471,217.38521541950115,219.19637188208617,18,5,95,2,54
3844,417,410,217.38521541950115,220.35736961451246,18,10,128,3,7
3845,417,639,217.38521541950115,219.05705215419502,18,1,233,2,222
3846,417,849,217.38521541950115,218.56943310657596,18,2,435,1,432
3847,483,91,218.45333333333335,220.31092970521541,10,38,400,2,392
3848,483,75,218.45333333333335,221.30938775510205,10,36,426,3,408
3849,483,231,218.45333333333335,220.98430839002268,10,21,275,3,252
3850,483,410,218.45333333333335,220.35736961451246,10,10,110,2,73
3851,483,426,218.45333333333335,221.2861678004535,10,16,135,3,57
3852,483,899,218.45333333333335,221.00752834467121,10,1,430,3,416
3853,471,91,219.19637188208617,220.31092970521541,5,38,383,1,380
3854,471,75,219.19637188208617,221.30938775510205,5,36,406,2,396
3855,471,231,219.19637188208617,220.98430839002268,5,21,252,2,240
3856,471,208,219.19637188208617,221.49514739229025,5,25,281,2,263
3857,471,410,219.19637188208617,220.35736961451246,5,10,79,1,61
3858,471,426,219.19637188208617,221.2861678004535,5,16,101,2,45
3859,471,899,219.19637188208617,221.00752834467121,5,1,435,2,428
3860,410,7,220.35736961451246,223.0508843537415,10,41,419,3,403
3861,410,7,220.35736961451246,223.07410430839002,10,41,420,3,403
3862,410,208,220.35736961451246,221.49514739229025,10,25,208,1,202
3863,410,248,220.35736961451246,222.6097052154195,10,24,189,2,162
3864,410,433,220.35736961451246,222.6097052154195,10,13,100,2,23
3865,410,817,220.35736961451246,223.0508843537415,10,7,423,3,407
3866,410,856,220.35736961451246,223.02766439909297,10,9,461,3,446
3867,426,7,221.2861678004535,223.0508843537415,16,41,426,2,419
3868,426,7,221.2861678004535,223.07410430839002,16,41,426,2,419
3869,426,34,221.2861678004535,224.2118820861678,16,39,412,3,392
3870,426,248,221.2861678004535,222.6097052154195,16,24,187,1,178
3871,426,315,221.2861678004535,223.95646258503402,16,22,160,3,111
3872,426,433,221.2861678004535,222.6097052154195,16,13,57,1,7
3873,426,420,221.2861678004535,223.95646258503402,16,12,115,3,6
3874,426,817,221.2861678004535,223.0508843537415,16,7,398,2,391
3875,426,856,221.2861678004535,223.02766439909297,16,9,436,2,430
3876,433,34,222.6097052154195,224.2118820861678,13,39,405,2,399
3877,433,35,222.6097052154195,225.32643990929705,13,40,415,3,398
3878,433,315,222.6097052154195,223.95646258503402,13,22,131,1,118
3879,433,244,222.6097052154195,224.3047619047619,13,23,203,2,189
3880,433,420,222.6097052154195,223.95646258503402,13,12,59,1,13
3881,433,419,222.6097052154195,224.32798185941044,13,7,75,2,14
3882,433,865,222.6097052154195,225.4657596371882,13,14,449,3,432
3883,420,35,223.95646258503402,225.32643990929705,12,40,389,1,385
3884,420,212,223.95646258503402,225.65151927437643,12,20,220,2,208
3885,420,267,223.95646258503402,226.0694784580499,12,18,178,2,153
3886,420,507,223.95646258503402,226.04625850340136,12,17,125,2,87
3887,420,507,223.95646258503402,226.0694784580499,12,20,126,2,87
3888,420,620,223.95646258503402,226.02303854875285,12,11,219,2,200
3889,420,800,223.95646258503402,226.0926984126984,12,3,391,2,380
3890,420,865,223.95646258503402,225.4657596371882,12,14,450,2,445
3891,420,858,223.95646258503402,226.0694784580499,12,4,447,2,438
3892,419,9,224.32798185941044,227.0679365079365,7,40,427,3,410
3893,419,212,224.32798185941044,225.65151927437643,7,20,215,1,207
3894,419,267,224.32798185941044,226.0694784580499,7,18,169,2,152
3895,419,507,224.32798185941044,226.04625850340136,7,17,115,2,88
3896,419,507,224.32798185941044,226.0694784580499,7,20,116,2,88
3897,419,620,224.32798185941044,226.02303854875285,7,11,214,2,201
3898,419,800,224.32798185941044,226.0926984126984,7,3,389,2,381
3899,419,865,224.32798185941044,225.4657596371882,7,14,449,1,446
3900,419,858,224.32798185941044,226.0694784580499,7,4,445,2,439
3901,507,9,226.04625850340136,227.0679365079365,17,40,500,1,498
3902,507,26,226.04625850340136,228.57723356009072,17,37,493,3,481
3903,507,290,226.04625850340136,228.06639455782314,17,17,234,2,217
3904,507,208,226.04625850340136,228.97197278911565,17,29,324,3,299
3905,507,435,226.04625850340136,228.06639455782314,17,12,113,2,72
3906,507,616,226.04625850340136,227.8574149659864,17,3,134,2,109
3907,507,836,226.04625850340136,227.8574149659864,17,6,338,2,329
3908,507,889,226.04625850340136,228.94875283446711,17,4,402,3,382
3909,507,26,226.0694784580499,228.57723356009072,20,37,493,3,481
3910,507,290,226.0694784580499,228.06639455782314,20,17,233,2,217
3911,507,208,226.0694784580499,228.97197278911565,20,29,324,3,299
3912,507,435,226.0694784580499,228.06639455782314,20,12,112,2,72
3913,507,414,226.0694784580499,229.04163265306124,20,24,158,3,93
3914,507,616,226.0694784580499,227.8574149659864,20,3,133,2,109
3915,507,836,226.0694784580499,227.8574149659864,20,6,338,2,329
3916,507,889,226.0694784580499,228.94875283446711,20,4,402,3,382
3917,435,78,228.06639455782314,229.2041723356009,12,37,360,1,357
3918,435,9,228.06639455782314,231.01532879818595,12,40,445,3,426
3919,435,207,228.06639455782314,229.0880725623583,12,27,232,1,228
3920,435,207,228.06639455782314,231.03854875283446,12,28,261,3,228
3921,435,424,228.06639455782314,229.13451247165534,12,20,47,1,11
3922,435,411,228.06639455782314,230.9688888888889,12,19,127,3,24
3923,435,768,228.06639455782314,230.9688888888889,12,0,356,3,333
3924,435,868,228.06639455782314,230.0633106575964,12,3,441,2,433
3925,435,859,228.06639455782314,230.1561904761905,12,8,433,2,424
3926,414,9,229.04163265306124,231.01532879818595,24,40,414,2,405
3927,414,8,229.04163265306124,231.17786848072564,24,41,416,2,406
3928,414,207,229.04163265306124,231.03854875283446,24,28,224,2,207
3929,414,208,229.04163265306124,231.08498866213154,24,27,224,2,206
3930,414,411,229.04163265306124,230.9688888888889,24,19,83,2,3
3931,414,416,229.04163265306124,231.08498866213154,24,17,88,2,2
3932,414,768,229.04163265306124,230.9688888888889,24,0,364,2,354
3933,414,868,229.04163265306124,230.0633106575964,24,3,456,1,454
3934,414,859,229.04163265306124,230.1561904761905,24,8,448,1,445
3935,424,9,229.13451247165534,231.01532879818595,20,40,423,2,415
3936,424,8,229.13451247165534,231.17786848072564,20,41,425,2,416
3937,424,207,229.13451247165534,231.03854875283446,20,28,232,2,217
3938,424,208,229.13451247165534,231.08498866213154,20,27,232,2,216
3939,424,411,229.13451247165534,230.9688888888889,20,19,80,2,13
3940,424,416,229.13451247165534,231.08498866213154,20,17,84,2,8
3941,424,768,229.13451247165534,230.9688888888889,20,0,353,2,344
3942,424,859,229.13451247165534,230.1561904761905,20,8,437,1,435
3943,424,884,229.13451247165534,232.0602267573696,20,1,477,3,460
3944,411,52,230.9688888888889,232.45496598639457,19,38,365,1,359
3945,411,51,230.9688888888889,233.08190476190478,19,36,371,2,360
3946,411,289,230.9688888888889,232.33886621315193,19,21,136,1,122
3947,411,277,230.9688888888889,233.8946031746032,19,18,184,3,134
3948,411,424,230.9688888888889,232.08344671201814,19,11,50,1,13
3949,411,817,230.9688888888889,232.19954648526078,19,7,409,1,406
3950,411,809,230.9688888888889,233.6391836734694,19,1,414,3,398
3951,411,884,230.9688888888889,232.0602267573696,19,1,475,1,473
3952,411,854,230.9688888888889,232.17632653061224,19,11,446,1,443
3953,411,851,230.9688888888889,233.6391836734694,19,4,455,3,440
3954,416,52,231.08498866213154,232.45496598639457,17,38,369,1,364
3955,416,51,231.08498866213154,233.08190476190478,17,36,375,2,365
3956,416,289,231.08498866213154,232.33886621315193,17,21,138,1,127
3957,416,277,231.08498866213154,233.8946031746032,17,18,184,3,139
3958,416,417,231.08498866213154,234.05714285714285,17,13,128,3,1
3959,416,817,231.08498866213154,232.19954648526078,17,7,404,1,401
3960,416,809,231.08498866213154,233.6391836734694,17,1,408,3,393
3961,416,854,231.08498866213154,232.17632653061224,17,11,441,1,438
3962,416,851,231.08498866213154,233.6391836734694,17,4,449,3,435
3963,424,8,232.08344671201814,234.5447619047619,11,41,429,2,416
3964,424,277,232.08344671201814,233.8946031746032,11,18,166,2,147
3965,424,289,232.08344671201814,234.24290249433108,11,16,164,2,135
3966,424,417,232.08344671201814,234.05714285714285,11,13,85,2,7
3967,424,417,232.08344671201814,234.0803628117914,11,11,86,2,7
3968,424,809,232.08344671201814,233.6391836734694,11,1,391,2,385
3969,424,747,232.08344671201814,234.77696145124716,11,5,343,3,323
3970,424,851,232.08344671201814,233.6391836734694,11,4,432,2,427
3971,424,917,232.08344671201814,234.8001814058957,11,10,507,3,493
3972,417,7,234.05714285714285,235.078820861678,13,37,412,1,410
3973,417,26,234.05714285714285,236.33269841269842,13,38,403,2,391
3974,417,365,234.05714285714285,236.00761904761904,13,15,99,2,52
3975,417,207,234.05714285714285,236.44879818594106,13,23,234,2,210
3976,417,412,234.05714285714285,236.03083900226758,13,3,85,2,5
3977,417,412,234.05714285714285,236.402358276644,13,15,101,2,5
3978,417,26,234.0803628117914,236.33269841269842,11,38,403,2,391
3979,417,365,234.0803628117914,236.00761904761904,11,15,98,2,52
3980,417,207,234.0803628117914,236.44879818594106,11,23,233,2,210
3981,417,412,234.0803628117914,236.03083900226758,11,3,84,2,5
3982,417,412,234.0803628117914,236.402358276644,11,15,100,2,5
3983,412,23,236.03083900226758,237.67945578231294,3,35,395,2,389
3984,412,8,236.03083900226758,238.5618140589569,3,41,418,3,404
3985,412,209,236.03083900226758,237.54013605442177,3,23,213,2,203
3986,412,404,236.03083900226758,238.5618140589569,3,18,109,3,8
3987,412,428,236.03083900226758,237.8187755102041,3,13,79,2,16
3988,412,435,236.03083900226758,238.5618140589569,3,10,111,3,23
3989,412,781,236.03083900226758,238.23673469387757,3,9,381,2,369
3990,412,852,236.03083900226758,238.23673469387757,3,11,450,2,440
3991,412,23,236.402358276644,237.67945578231294,15,35,393,1,389
3992,412,8,236.402358276644,238.5618140589569,15,41,415,2,404
3993,412,209,236.402358276644,237.54013605442177,15,23,209,1,203
3994,412,404,236.402358276644,238.5618140589569,15,18,93,2,8
3995,412,428,236.402358276644,237.8187755102041,15,13,63,1,16
3996,412,435,236.402358276644,238.5618140589569,15,10,96,2,23
3997,412,781,236.402358276644,238.23673469387757,15,9,377,2,369
3998,412,852,236.402358276644,238.23673469387757,15,11,447,2,440
3999,428,69,237.8187755102041,239.72281179138324,13,39,368,2,359
4000,428,34,237.8187755102041,240.25687074829932,13,38,408,2,394
4001,428,209,237.8187755102041,239.95501133786848,13,28,238,2,219
4002,428,209,237.8187755102041,240.11755102040817,13,30,240,2,219
4003,428,416,237.8187755102041,240.07111111111112,13,19,98,2,12
4004,428,417,237.8187755102041,240.11755102040817,13,25,100,2,11
4005,428,866,237.8187755102041,240.2336507936508,13,1,450,2,438
4006,435,69,238.5618140589569,239.72281179138324,10,39,369,1,366
4007,435,34,238.5618140589569,240.25687074829932,10,38,408,2,401
4008,435,35,238.5618140589569,241.34820861678006,10,38,418,3,400
4009,435,209,238.5618140589569,239.95501133786848,10,28,234,1,226
4010,435,209,238.5618140589569,240.11755102040817,10,30,236,2,226
4011,435,277,238.5618140589569,241.32498866213152,10,21,198,3,158
4012,435,416,238.5618140589569,240.07111111111112,10,19,68,2,19
4013,435,417,238.5618140589569,240.11755102040817,10,25,69,2,18
4014,435,866,238.5618140589569,240.2336507936508,10,1,437,2,431
4015,416,35,240.07111111111112,241.34820861678006,19,38,385,1,381
4016,416,8,240.07111111111112,242.85750566893424,19,42,425,3,408
4017,416,277,240.07111111111112,241.32498866213152,19,21,149,1,139
4018,416,209,240.07111111111112,242.9039455782313,19,15,240,3,207
4019,416,468,240.07111111111112,241.62684807256235,19,9,85,2,52
4020,416,411,240.07111111111112,242.32344671201815,19,5,97,2,5
4021,416,806,240.07111111111112,241.69650793650794,19,4,396,2,390
4022,417,35,240.11755102040817,241.34820861678006,25,38,386,1,382
4023,417,8,240.11755102040817,242.85750566893424,25,42,426,3,409
4024,417,8,240.11755102040817,243.0897052154195,25,39,429,3,409
4025,417,277,240.11755102040817,241.32498866213152,25,21,149,1,140
4026,417,209,240.11755102040817,242.9039455782313,25,15,240,3,208
4027,417,468,240.11755102040817,241.62684807256235,25,9,83,2,51
4028,417,411,240.11755102040817,242.32344671201815,25,5,95,2,6
4029,417,806,240.11755102040817,241.69650793650794,25,4,395,2,389
4030,468,8,241.62684807256235,242.85750566893424,9,42,463,1,460
4031,468,8,241.62684807256235,243.0897052154195,9,39,464,1,460
4032,468,209,241.62684807256235,242.9039455782313,9,15,265,1,259
4033,468,324,241.62684807256235,243.80952380952382,9,11,172,2,144
4034,468,325,241.62684807256235,244.27392290249435,9,12,183,3,143
4035,468,454,241.62684807256235,243.3683446712018,9,1,76,2,14
4036,411,13,242.32344671201815,245.06340136054422,5,30,415,3,398
4037,411,324,242.32344671201815,243.80952380952382,5,11,108,1,87
4038,411,325,242.32344671201815,244.27392290249435,5,12,120,2,86
4039,411,454,242.32344671201815,243.3683446712018,5,1,62,1,43
4040,411,454,242.32344671201815,244.66866213151928,5,1,110,2,43
4041,454,13,243.3683446712018,245.06340136054422,1,30,447,2,441
4042,454,20,243.3683446712018,245.55102040816328,1,39,444,2,434
4043,454,20,243.3683446712018,246.34049886621315,1,39,452,3,434
4044,454,220,243.3683446712018,245.80643990929707,1,15,256,2,234
4045,454,222,243.3683446712018,246.08507936507937,1,17,260,3,232
4046,454,471,243.3683446712018,245.36526077097506,1,2,88,2,17
4047,454,20,244.66866213151928,246.34049886621315,1,39,440,2,434
4048,454,17,244.66866213151928,247.15319727891156,1,36,450,2,437
4049,454,220,244.66866213151928,245.80643990929707,1,15,239,1,234
4050,454,222,244.66866213151928,246.08507936507937,1,17,240,1,232
4051,454,353,244.66866213151928,247.31573696145125,1,15,152,3,101
4052,454,425,244.66866213151928,247.3389569160998,1,3,119,3,29
4053,471,17,245.36526077097506,247.15319727891156,2,36,460,2,454
4054,471,353,245.36526077097506,247.31573696145125,2,15,145,2,118
4055,471,425,245.36526077097506,247.3389569160998,2,3,97,2,46
4056,425,26,247.3389569160998,248.61605442176872,3,31,403,1,399
4057,425,20,247.3389569160998,249.70739229024943,3,40,418,2,405
4058,425,218,247.3389569160998,249.96281179138322,3,13,236,3,207
4059,425,435,247.3389569160998,249.98603174603176,3,16,114,3,10
4060,425,435,247.3389569160998,250.1950113378685,3,11,123,3,10
4061,435,23,249.98603174603176,251.07736961451246,16,39,415,1,412
4062,435,23,249.98603174603176,251.8204081632653,16,40,420,2,412
4063,435,17,249.98603174603176,252.2615873015873,16,37,429,2,418
4064,435,258,249.98603174603176,251.86684807256236,16,15,195,2,177
4065,435,248,249.98603174603176,252.47056689342404,16,14,215,2,187
4066,435,512,249.98603174603176,251.100589569161,16,11,91,1,77
4067,435,23,250.1950113378685,251.8204081632653,11,40,418,2,412
4068,435,17,250.1950113378685,252.2615873015873,11,37,427,2,418
4069,435,258,250.1950113378685,251.86684807256236,11,15,191,2,177
4070,435,248,250.1950113378685,252.47056689342404,11,14,211,2,187
4071,435,251,250.1950113378685,253.1439455782313,11,13,224,3,184
4072,435,487,250.1950113378685,253.0742857142857,11,2,134,3,52
4073,512,17,251.100589569161,252.2615873015873,11,37,498,1,495
4074,512,21,251.100589569161,254.07274376417234,11,39,507,3,491
4075,512,248,251.100589569161,252.47056689342404,11,14,271,1,264
4076,512,251,251.100589569161,253.1439455782313,11,13,275,2,261
4077,512,487,251.100589569161,253.0742857142857,11,2,89,2,25
4078,512,479,251.100589569161,253.70122448979592,11,9,117,3,33
4079,487,8,253.0742857142857,254.63002267573697,2,43,484,2,479
4080,487,6,253.0742857142857,255.117641723356,2,37,489,2,481
4081,487,227,253.0742857142857,254.09596371882085,2,9,264,1,260
4082,487,334,253.0742857142857,255.62848072562358,2,0,188,3,153
4083,487,411,253.0742857142857,254.35138321995464,2,2,94,1,76
4084,479,6,253.70122448979592,255.117641723356,9,37,477,1,473
4085,479,26,253.70122448979592,256.441179138322,9,31,468,3,453
4086,479,334,253.70122448979592,255.62848072562358,9,0,167,2,145
4087,411,26,254.35138321995464,256.441179138322,2,31,395,2,385
4088,411,334,254.35138321995464,255.62848072562358,2,0,95,1,77
4089,411,226,254.35138321995464,257.0681179138322,2,10,219,3,185
4090,411,211,254.35138321995464,257.11455782312925,2,12,233,3,200
4091,688,229,23.196734693877552,24.752471655328797,5,14,464,2,459
4092,688,259,23.196734693877552,25.98312925170068,5,18,445,3,429
4093,688,259,23.196734693877552,26.006349206349206,5,15,446,3,429
4094,688,428,23.196734693877552,24.822131519274375,5,5,269,2,260
4095,688,439,23.196734693877552,25.93668934240363,5,6,276,3,249
4096,627,205,32.97233560090703,34.202993197278914,2,16,425,1,422
4097,627,222,32.97233560090703,35.50331065759637,2,4,419,3,405
4098,627,410,32.97233560090703,34.73705215419501,2,1,230,2,217
4099,636,205,32.995555555555555,34.202993197278914,0,16,434,1,431
4100,636,222,32.995555555555555,35.50331065759637,0,4,428,3,414
4101,636,410,32.995555555555555,34.73705215419501,0,1,238,2,226
4102,818,468,39.91510204081633,41.517278911564624,8,6,357,2,350
4103,818,586,39.91510204081633,42.399637188208615,8,7,255,2,232
4104,818,684,39.91510204081633,41.21541950113379,8,12,145,1,134
4105,818,641,39.91510204081633,42.399637188208615,8,11,207,2,177
4106,818,825,39.91510204081633,42.74793650793651,8,11,122,3,7
4107,703,231,40.40272108843538,41.703038548752836,9,14,475,1,472
4108,703,275,40.40272108843538,42.49251700680272,9,12,437,2,428
4109,703,468,40.40272108843538,41.517278911564624,9,6,240,1,235
4110,703,586,40.40272108843538,42.399637188208615,9,7,145,2,117
4111,703,641,40.40272108843538,42.399637188208615,9,11,106,2,62
4112,703,825,40.40272108843538,42.74793650793651,9,11,158,2,122
4113,684,275,41.21541950113379,42.49251700680272,12,12,413,1,409
4114,684,210,41.21541950113379,43.83927437641724,12,13,487,3,474
4115,684,586,41.21541950113379,42.399637188208615,12,7,110,1,98
4116,684,410,41.21541950113379,43.932154195011336,12,8,298,3,274
4117,684,641,41.21541950113379,42.399637188208615,12,11,67,1,43
4118,684,825,41.21541950113379,42.74793650793651,12,11,156,2,141
4119,641,210,42.399637188208615,43.83927437641724,11,13,435,1,431
4120,641,248,42.399637188208615,44.7912925170068,11,13,406,2,393
4121,641,278,42.399637188208615,45.00027210884354,11,4,380,3,363
4122,641,410,42.399637188208615,43.932154195011336,11,8,240,2,231
4123,641,437,42.399637188208615,44.39655328798186,11,3,221,2,204
4124,641,437,42.399637188208615,45.34857142857143,11,1,240,3,204
4125,641,718,42.399637188208615,44.39655328798186,11,5,115,2,77
4126,641,832,42.399637188208615,44.39655328798186,11,7,209,2,191
4127,718,285,44.39655328798186,46.88108843537415,5,4,446,2,433
4128,718,231,44.39655328798186,47.34548752834467,5,13,503,3,487
4129,718,417,44.39655328798186,46.97396825396825,5,0,321,3,301
4130,718,419,44.39655328798186,47.113287981859415,5,7,321,3,299
4131,718,789,44.39655328798186,47.06684807256236,5,8,135,3,71
4132,718,921,44.39655328798186,47.04362811791383,5,11,233,3,203
4133,789,309,47.06684807256236,48.36716553287982,8,12,483,1,480
4134,789,489,47.06684807256236,49.946122448979594,8,9,325,3,300
4135,789,818,47.06684807256236,48.6225850340136,8,13,73,2,29
4136,789,883,47.06684807256236,48.13496598639456,8,21,105,1,94
4137,818,489,48.6225850340136,49.946122448979594,13,9,334,1,329
4138,818,498,48.6225850340136,50.340861678004536,13,12,328,2,320
4139,818,410,48.6225850340136,51.13034013605442,13,8,422,3,408
4140,818,749,48.6225850340136,50.5730612244898,13,4,109,2,69
4141,818,958,48.6225850340136,50.59628117913832,13,8,164,2,140
4142,818,905,48.6225850340136,51.08390022675737,13,10,137,2,87
4143,749,584,50.5730612244898,52.61641723356009,4,0,187,2,165
4144,818,584,51.08390022675737,52.61641723356009,6,0,243,2,234
4145,802,410,58.39818594104309,59.65206349206349,13,16,396,1,392
4146,802,448,58.39818594104309,60.557641723356014,13,4,366,2,354
4147,802,616,58.39818594104309,59.419863945578236,13,10,191,1,186
4148,802,652,58.39818594104309,60.51120181405896,13,8,175,2,150
4149,802,798,58.39818594104309,61.23102040816327,13,2,122,3,4
4150,802,902,58.39818594104309,59.466303854875285,13,11,110,1,100
4151,802,845,58.39818594104309,60.53442176870748,13,8,102,2,43
4152,802,833,58.39818594104309,61.23102040816327,13,2,126,3,31
4153,616,278,59.419863945578236,60.998820861678006,10,20,345,2,338
4154,616,220,59.419863945578236,61.532879818594104,10,18,406,2,396
4155,616,448,59.419863945578236,60.557641723356014,10,4,175,1,168
4156,616,410,59.419863945578236,61.74185941043084,10,5,229,2,206
4157,616,652,59.419863945578236,60.51120181405896,10,8,59,1,36
4158,616,798,59.419863945578236,61.23102040816327,10,2,198,2,182
4159,616,845,59.419863945578236,60.53442176870748,10,8,234,1,229
4160,616,833,59.419863945578236,61.23102040816327,10,2,231,2,217
4161,652,220,60.51120181405896,61.532879818594104,8,18,434,1,432
4162,652,277,60.51120181405896,62.99573696145125,8,23,390,2,375
4163,652,410,60.51120181405896,61.74185941043084,8,5,248,1,242
4164,652,415,60.51120181405896,62.972517006802725,8,10,260,2,237
4165,798,415,61.23102040816327,62.972517006802725,2,10,390,2,383
4166,798,410,61.23102040816327,63.715555555555554,2,19,402,2,388
4167,621,206,68.89360544217688,70.31002267573696,3,22,419,1,415
4168,621,277,68.89360544217688,71.72643990929706,3,19,365,3,344
4169,621,420,68.89360544217688,70.0778231292517,3,8,207,1,201
4170,621,864,68.89360544217688,70.33324263038548,3,1,251,1,243
4171,756,411,72.79455782312925,74.18775510204082,0,1,350,1,345
4172,634,206,78.0887074829932,79.27292517006804,4,22,431,1,428
4173,634,205,78.0887074829932,80.08562358276644,4,10,438,2,429
4174,634,449,78.0887074829932,79.22648526077097,4,13,191,1,185
4175,634,432,78.0887074829932,80.4107029478458,4,7,225,2,202
4176,634,537,78.0887074829932,81.06086167800454,4,12,161,3,97
4177,634,817,78.0887074829932,80.45714285714286,4,12,210,2,183
4178,634,674,78.0887074829932,81.06086167800454,4,8,134,3,40
4179,634,868,78.0887074829932,80.45714285714286,4,17,255,2,234
4180,634,868,78.0887074829932,81.06086167800454,4,7,267,3,234
4181,817,892,80.45714285714286,82.8952380952381,12,7,129,2,75
4182,674,205,81.06086167800454,82.96489795918367,8,7,476,2,469
4183,674,205,81.06086167800454,84.00979591836735,8,25,486,3,469
4184,674,205,81.06086167800454,84.03301587301587,8,22,486,3,469
4185,674,410,81.06086167800454,83.98657596371882,8,15,293,3,264
4186,674,892,81.06086167800454,82.8952380952381,8,7,232,2,218
4187,819,414,87.23736961451247,88.88598639455782,4,7,411,2,405
4188,819,418,87.23736961451247,89.07174603174603,4,6,409,2,401
4189,819,797,87.23736961451247,89.42004535147393,4,0,97,2,22
4190,819,858,87.23736961451247,89.81478458049887,4,1,118,3,39
4191,797,431,89.42004535147393,91.4401814058957,0,19,376,2,366
4192,797,887,89.42004535147393,91.4401814058957,0,2,125,2,90
4193,699,211,93.27455782312926,94.99283446712019,12,24,494,2,488
4194,699,243,93.27455782312926,95.29469387755103,12,23,464,2,456
4195,699,414,93.27455782312926,94.78385487528345,12,18,292,2,285
4196,699,418,93.27455782312926,95.15537414965986,12,19,292,2,281
4197,699,892,93.27455782312926,95.24825396825398,12,3,211,2,193
4198,777,360,99.66004535147393,101.5873015873016,2,9,425,2,417
4199,777,411,99.66004535147393,100.75138321995465,2,3,369,1,366
4200,777,757,99.66004535147393,102.30712018140589,2,1,116,3,20
4201,777,837,99.66004535147393,101.51764172335601,2,0,100,2,60
4202,810,360,100.24054421768707,101.5873015873016,0,9,454,1,450
4203,810,757,100.24054421768707,102.30712018140589,0,1,104,2,53
4204,810,837,100.24054421768707,101.51764172335601,0,0,61,1,27
4205,757,306,102.30712018140589,103.60743764172337,1,5,454,1,451
4206,757,579,102.30712018140589,104.55945578231292,1,0,203,2,178
4207,757,511,102.30712018140589,105.04707482993197,1,0,273,3,246
4208,757,655,102.30712018140589,103.49133786848073,1,2,114,1,102
4209,655,207,103.49133786848073,104.55945578231292,2,10,450,1,448
4210,655,245,103.49133786848073,105.79011337868481,2,9,422,2,410
4211,655,306,103.49133786848073,106.25451247165533,2,11,369,3,349
4212,655,579,103.49133786848073,104.55945578231292,2,0,89,1,76
4213,655,511,103.49133786848073,105.04707482993197,2,0,159,2,144
4214,791,514,109.45886621315194,111.38612244897959,5,10,289,2,277
4215,791,754,109.45886621315194,111.40934240362812,5,18,92,2,37
4216,791,946,109.45886621315194,111.40934240362812,5,19,176,2,155
4217,754,401,111.40934240362812,113.35981859410431,18,11,363,2,353
4218,754,432,111.40934240362812,112.82575963718821,18,8,328,1,322
4219,754,423,111.40934240362812,113.35981859410431,18,9,341,2,331
4220,754,804,111.40934240362812,112.77931972789116,18,2,77,1,50
4221,754,771,111.40934240362812,113.35981859410431,18,2,86,2,17
4222,754,944,111.40934240362812,112.77931972789116,18,12,199,1,190
4223,754,878,111.40934240362812,113.38303854875284,18,3,150,2,124
4224,771,282,113.35981859410431,114.52081632653062,2,4,492,1,489
4225,771,437,113.35981859410431,115.86757369614513,2,2,351,3,334
4226,812,499,117.539410430839,119.90784580498867,11,4,329,2,313
4227,812,817,117.539410430839,118.72362811791383,11,3,51,1,5
4228,812,820,117.539410430839,118.72362811791383,11,1,52,1,8
4229,817,499,118.72362811791383,119.90784580498867,3,4,322,1,318
4230,817,410,118.72362811791383,120.81342403628118,3,6,417,2,407
4231,817,555,118.72362811791383,121.11528344671203,3,8,282,2,262
4232,817,779,118.72362811791383,121.09206349206349,3,5,109,2,38
4233,817,893,118.72362811791383,121.11528344671203,3,6,128,2,76
4234,779,415,121.09206349206349,122.2530612244898,5,4,367,1,364
4235,779,414,121.09206349206349,123.1354195011338,5,4,375,2,365
4236,623,209,126.01469387755103,127.84907029478458,4,20,421,2,414
4237,623,207,126.01469387755103,128.220589569161,4,24,427,2,416
4238,623,438,126.01469387755103,128.01160997732427,4,9,204,2,185
4239,623,497,126.01469387755103,128.03482993197278,4,12,153,2,126
4240,623,685,126.01469387755103,128.01160997732427,4,10,106,2,62
4241,623,684,126.01469387755103,128.05804988662132,4,14,107,2,61
4242,623,883,126.01469387755103,127.77941043083901,4,5,271,2,260
4243,623,864,126.01469387755103,128.52244897959184,4,16,264,3,241
4244,782,438,126.03791383219955,128.01160997732427,3,9,354,2,344
4245,782,497,126.03791383219955,128.03482993197278,3,12,298,2,285
4246,782,685,126.03791383219955,128.01160997732427,3,10,129,2,97
4247,782,684,126.03791383219955,128.05804988662132,3,14,131,2,98
4248,782,883,126.03791383219955,127.77941043083901,3,5,126,2,101
4249,782,864,126.03791383219955,128.52244897959184,3,16,135,2,82
4250,685,297,128.01160997732427,129.91564625850341,10,16,397,2,388
4251,685,248,128.01160997732427,130.9837641723356,10,14,455,3,437
4252,685,564,128.01160997732427,129.3119274376417,10,9,133,1,121
4253,685,593,128.01160997732427,130.07818594104307,10,5,128,2,92
4254,685,763,128.01160997732427,129.3583673469388,10,6,97,1,78
4255,685,690,128.01160997732427,130.1014058956916,10,1,90,2,5
4256,685,953,128.01160997732427,129.33514739229025,10,19,274,1,268
4257,684,297,128.05804988662132,129.91564625850341,14,16,395,2,387
4258,684,248,128.05804988662132,130.9837641723356,14,14,454,3,436
4259,684,564,128.05804988662132,129.3119274376417,14,9,132,1,120
4260,684,593,128.05804988662132,130.07818594104307,14,5,126,2,91
4261,684,763,128.05804988662132,129.3583673469388,14,6,97,1,79
4262,684,690,128.05804988662132,130.1014058956916,14,1,88,2,6
4263,684,953,128.05804988662132,129.33514739229025,14,19,275,1,269
4264,763,328,129.3583673469388,131.05342403628117,6,12,441,2,435
4265,763,437,129.3583673469388,131.54104308390023,6,2,339,2,326
4266,690,371,130.1014058956916,133.0271201814059,1,11,343,3,319
4267,690,437,130.1014058956916,131.54104308390023,1,2,260,1,253
4268,649,285,133.25931972789115,135.6974149659864,17,11,379,2,364
4269,649,311,133.25931972789115,136.1618140589569,17,8,360,3,338
4270,649,507,133.25931972789115,134.42031746031745,17,13,151,1,142
4271,649,784,133.25931972789115,134.39709750566894,17,11,144,1,135
4272,649,944,133.25931972789115,134.39709750566894,17,19,299,1,295
4273,649,882,133.25931972789115,135.11691609977325,17,1,246,2,233
4274,784,285,134.39709750566894,135.6974149659864,11,11,502,1,499
4275,784,311,134.39709750566894,136.1618140589569,11,8,479,2,473
4276,784,426,134.39709750566894,136.8584126984127,11,5,373,2,358
4277,784,411,134.39709750566894,137.09061224489795,11,10,391,3,373
4278,784,817,134.39709750566894,136.81197278911566,11,2,109,2,33
4279,784,812,134.39709750566894,137.09061224489795,11,3,119,3,28
4280,784,865,134.39709750566894,136.81197278911566,11,8,132,2,81
4281,784,881,134.39709750566894,137.09061224489795,11,5,151,3,97
4282,817,369,136.81197278911566,139.11074829931974,2,7,459,2,448
4283,817,418,136.81197278911566,138.0890702947846,2,3,403,1,399
4284,812,369,137.09061224489795,139.11074829931974,3,7,451,2,443
4285,662,206,144.75319727891156,145.91419501133788,10,26,459,1,456
4286,662,257,144.75319727891156,146.07673469387754,10,19,409,1,405
4287,662,411,144.75319727891156,145.89097505668934,10,14,256,1,251
4288,662,412,144.75319727891156,146.05351473922903,10,13,256,1,250
4289,662,411,144.75319727891156,147.05197278911564,10,8,270,2,251
4290,662,639,144.75319727891156,146.68045351473924,10,8,86,2,23
4291,662,697,144.75319727891156,147.35383219954647,10,3,117,3,35
4292,662,866,144.75319727891156,146.6572335600907,10,10,220,2,204
4293,662,928,144.75319727891156,147.377052154195,10,3,289,3,266
4294,811,411,145.7516553287982,147.05197278911564,9,8,404,1,400
4295,811,413,145.7516553287982,148.72380952380954,9,11,418,3,398
4296,811,697,145.7516553287982,147.35383219954647,9,3,133,2,114
4297,811,928,145.7516553287982,147.377052154195,9,3,136,2,117
4298,639,208,146.68045351473924,147.77179138321995,8,15,434,1,431
4299,639,288,146.68045351473924,148.81668934240363,8,17,363,2,351
4300,639,413,146.68045351473924,148.72380952380954,8,11,243,2,226
4301,639,931,146.68045351473924,148.81668934240363,8,1,306,2,292
4302,697,288,147.35383219954647,148.81668934240363,3,17,414,1,409
4303,697,215,147.35383219954647,150.02412698412698,3,26,496,3,482
4304,697,214,147.35383219954647,150.04734693877552,3,27,497,3,483
4305,697,413,147.35383219954647,148.72380952380954,3,11,290,1,284
4306,697,413,147.35383219954647,149.79192743764173,3,24,303,2,284
4307,697,411,147.35383219954647,150.14022675736962,3,19,310,3,286
4308,697,816,147.35383219954647,149.83836734693878,3,0,160,2,119
4309,697,931,147.35383219954647,148.81668934240363,3,1,242,1,234
4310,697,863,147.35383219954647,149.88480725623583,3,8,199,3,166
4311,697,925,147.35383219954647,150.09378684807257,3,3,257,3,228
4312,816,420,149.83836734693878,151.8120634920635,0,11,405,2,396
4313,816,435,149.83836734693878,152.6015419501134,0,10,399,3,381
4314,816,677,149.83836734693878,151.57986394557824,0,1,158,2,139
4315,677,380,151.57986394557824,153.97151927437642,1,17,314,2,297
4316,677,435,151.57986394557824,152.6015419501134,1,10,246,1,242
4317,677,430,151.57986394557824,153.97151927437642,1,11,268,2,247
4318,677,428,151.57986394557824,154.15727891156462,1,15,273,3,249
4319,677,910,151.57986394557824,153.97151927437642,1,0,255,2,233
4320,677,953,151.57986394557824,154.3198185941043,1,11,300,3,276
4321,630,208,155.03963718820862,156.22385487528345,4,20,425,1,422
4322,630,228,155.03963718820862,157.91891156462586,4,23,421,3,402
4323,630,411,155.03963718820862,156.40961451247165,4,10,227,1,219
4324,630,416,155.03963718820862,157.57061224489797,4,19,240,3,214
4325,630,648,155.03963718820862,157.45451247165533,4,5,106,2,18
4326,630,876,155.03963718820862,156.47927437641724,4,3,254,1,246
4327,630,903,155.03963718820862,157.45451247165533,4,8,292,2,273
4328,635,208,155.1092970521542,156.22385487528345,13,20,430,1,427
4329,635,228,155.1092970521542,157.91891156462586,13,23,425,3,407
4330,635,411,155.1092970521542,156.40961451247165,13,10,231,1,224
4331,635,416,155.1092970521542,157.57061224489797,13,19,243,2,219
4332,635,648,155.1092970521542,157.45451247165533,13,5,102,2,13
4333,635,876,155.1092970521542,156.47927437641724,13,3,248,1,241
4334,635,903,155.1092970521542,157.45451247165533,13,8,286,2,268
4335,648,216,157.45451247165533,158.70839002267573,5,24,435,1,432
4336,648,206,157.45451247165533,159.07990929705215,5,15,448,2,442
4337,648,460,157.45451247165533,159.05668934240364,5,5,200,2,188
4338,648,678,157.45451247165533,158.96380952380952,5,6,72,2,30
4339,648,955,157.45451247165533,158.940589569161,5,3,314,1,307
4340,678,206,158.96380952380952,160.8910657596372,6,9,479,2,472
4341,678,427,158.96380952380952,161.56444444444446,6,7,275,3,251
4342,818,420,162.98086167800454,164.76879818594105,0,17,405,2,398
4343,818,418,162.98086167800454,165.14031746031748,0,18,411,2,400
4344,818,797,162.98086167800454,164.30439909297053,0,15,61,1,21
4345,818,849,162.98086167800454,164.30439909297053,0,22,65,1,31
4346,818,915,162.98086167800454,165.23319727891158,0,4,137,2,97
4347,797,366,164.30439909297053,167.20689342403628,15,14,449,3,431
4348,797,601,164.30439909297053,166.6031746031746,15,5,220,2,196
4349,797,563,164.30439909297053,167.20689342403628,15,14,265,3,234
4350,797,819,164.30439909297053,166.6031746031746,15,11,101,2,22
4351,797,626,164.30439909297053,167.20689342403628,15,8,212,3,171
4352,797,951,164.30439909297053,166.64961451247166,15,19,184,2,154
4353,797,868,164.30439909297053,167.25333333333333,15,3,145,3,71
4354,819,766,166.6031746031746,169.0877097505669,11,4,119,2,53
4355,626,330,167.20689342403628,169.7843083900227,8,17,316,3,296
4356,626,413,167.20689342403628,170.03972789115647,8,10,245,3,213
4357,626,766,167.20689342403628,169.0877097505669,8,4,162,2,140
4358,626,867,167.20689342403628,169.83074829931974,8,7,266,3,241
4359,766,428,169.0877097505669,170.27192743764172,4,21,342,1,338
4360,766,452,169.0877097505669,171.4793650793651,4,9,330,2,314
4361,766,813,169.0877097505669,170.36480725623582,4,4,72,1,47
4362,766,882,169.0877097505669,170.27192743764172,4,8,127,1,116
4363,766,863,169.0877097505669,171.38648526077097,4,9,139,2,97
4364,813,452,170.36480725623582,171.4793650793651,4,9,364,1,361
4365,813,418,170.36480725623582,172.2920634920635,4,9,404,2,395
4366,813,863,170.36480725623582,171.38648526077097,4,9,67,1,50
4367,813,874,170.36480725623582,172.17596371882087,4,5,99,2,61
4368,812,427,173.4530612244898,175.21777777777777,7,6,392,2,385
4369,812,419,173.4530612244898,176.16979591836736,7,1,410,3,393
4370,812,657,173.4530612244898,174.89269841269842,7,1,167,1,155
4371,812,806,173.4530612244898,175.96081632653062,7,20,108,3,6
4372,812,945,173.4530612244898,175.98403628117913,7,20,172,3,133
4373,657,205,174.89269841269842,177.02893424036282,1,10,461,2,452
4374,657,278,174.89269841269842,177.70231292517008,1,24,398,3,379
4375,657,419,174.89269841269842,176.16979591836736,1,1,244,1,238
4376,657,440,174.89269841269842,177.5397732426304,1,12,245,3,217
4377,657,806,174.89269841269842,175.96081632653062,1,20,156,1,149
4378,657,945,174.89269841269842,175.98403628117913,1,20,292,1,288
4379,657,863,174.89269841269842,177.67909297052154,1,3,238,3,206
4380,806,440,175.96081632653062,177.5397732426304,20,12,372,2,366
4381,806,432,175.96081632653062,178.1899319727891,20,12,386,2,374
4382,806,863,175.96081632653062,177.67909297052154,20,3,93,2,57
4383,806,840,175.96081632653062,178.1899319727891,20,4,102,2,34
4384,677,308,179.46702947845804,180.90666666666667,10,20,374,1,369
4385,677,210,179.46702947845804,181.3014058956916,10,30,474,2,467
4386,677,410,179.46702947845804,180.90666666666667,10,11,274,1,267
4387,677,411,179.46702947845804,181.23174603174604,10,20,277,2,266
4388,677,878,179.46702947845804,181.44072562358278,10,5,218,2,201
4389,796,324,182.92680272108845,185.0165986394558,8,9,481,2,472
4390,796,325,182.92680272108845,185.50421768707483,8,11,484,3,471
4391,734,411,201.03836734693877,202.64054421768708,0,1,330,2,323
4392,734,420,201.03836734693877,203.6390022675737,0,21,333,3,314
4393,734,726,201.03836734693877,203.49968253968254,0,9,106,2,8
4394,734,902,201.03836734693877,202.75664399092972,0,0,184,2,168
4395,734,910,201.03836734693877,203.49968253968254,0,6,205,2,176
4396,747,420,201.80462585034013,203.6390022675737,2,21,336,2,327
4397,747,415,201.80462585034013,204.7071201814059,2,20,355,3,332
4398,747,726,201.80462585034013,203.49968253968254,2,9,76,2,21
4399,747,681,201.80462585034013,204.49814058956918,2,5,133,3,66
4400,747,910,201.80462585034013,203.49968253968254,2,6,179,2,163
4401,747,928,201.80462585034013,204.47492063492064,2,12,214,3,181
4402,726,277,203.49968253968254,205.84489795918367,9,23,460,2,449
4403,726,285,203.49968253968254,206.07709750566895,9,13,455,3,441
4404,726,415,203.49968253968254,204.7071201814059,9,20,315,1,311
4405,726,410,203.49968253968254,205.63591836734693,9,14,329,2,316
4406,726,546,203.49968253968254,206.23963718820863,9,9,215,3,180
4407,726,636,203.49968253968254,205.49659863945578,9,11,124,2,90
4408,726,818,203.49968253968254,206.23963718820863,9,7,150,3,92
4409,726,952,203.49968253968254,205.47337868480727,9,15,241,2,226
4410,726,835,203.49968253968254,206.23963718820863,9,4,161,3,109
4411,681,277,204.49814058956918,205.84489795918367,5,23,408,1,404
4412,681,285,204.49814058956918,206.07709750566895,5,13,402,2,396
4413,681,410,204.49814058956918,205.63591836734693,5,14,275,1,271
4414,681,546,204.49814058956918,206.23963718820863,5,9,154,2,135
4415,681,818,204.49814058956918,206.23963718820863,5,7,156,2,137
4416,681,835,204.49814058956918,206.23963718820863,5,4,171,2,154
4417,636,281,205.49659863945578,207.8418140589569,11,22,369,2,355
4418,636,431,205.49659863945578,207.58639455782313,11,18,224,2,205
4419,818,431,206.23963718820863,207.58639455782313,7,18,391,1,387
4420,818,417,206.23963718820863,208.93315192743765,7,22,417,3,401
4421,818,810,206.23963718820863,208.9099319727891,7,3,115,3,8
4422,818,926,206.23963718820863,208.9099319727891,7,10,158,3,108
4423,818,845,206.23963718820863,209.21179138321995,7,10,131,3,27
4424,810,410,208.9099319727891,210.65142857142857,3,10,407,2,400
4425,810,459,208.9099319727891,211.39446712018142,3,10,367,2,351
4426,810,738,208.9099319727891,210.39600907029478,3,1,96,1,72
4427,810,778,208.9099319727891,211.39446712018142,3,12,112,2,32
4428,810,868,208.9099319727891,210.39600907029478,3,14,86,1,58
4429,810,865,208.9099319727891,211.41768707482993,3,12,121,3,55
4430,722,232,209.5136507936508,210.72108843537416,3,19,493,1,490
4431,722,275,209.5136507936508,212.0214058956916,3,22,460,3,447
4432,722,410,209.5136507936508,210.65142857142857,3,10,316,1,312
4433,722,459,209.5136507936508,211.39446712018142,3,10,275,2,263
4434,722,778,209.5136507936508,211.39446712018142,3,12,98,2,56
4435,722,865,209.5136507936508,211.41768707482993,3,12,165,2,143
4436,738,275,210.39600907029478,212.0214058956916,1,22,468,2,463
4437,738,307,210.39600907029478,213.01986394557824,1,19,446,3,431
4438,738,410,210.39600907029478,212.9966439909297,1,20,347,3,328
4439,738,865,210.39600907029478,211.41768707482993,1,12,134,1,127
4440,738,906,210.39600907029478,212.78766439909296,1,0,197,2,168
4441,778,307,211.39446712018142,213.01986394557824,12,19,476,2,471
4442,778,281,211.39446712018142,213.67002267573696,12,25,507,2,497
4443,778,410,211.39446712018142,212.9966439909297,12,20,374,2,368
4444,778,410,211.39446712018142,213.67002267573696,12,15,381,2,368
4445,778,617,211.39446712018142,213.83256235827665,12,6,192,2,161
4446,778,906,211.39446712018142,212.78766439909296,12,0,141,1,128
4447,778,863,211.39446712018142,213.8557823129252,12,11,136,2,85
4448,617,210,213.83256235827665,214.97034013605443,6,23,410,1,407
4449,617,206,213.83256235827665,215.22575963718822,6,26,415,1,411
4450,617,279,213.83256235827665,216.68861678004535,6,25,360,3,338
4451,617,411,213.83256235827665,215.22575963718822,6,17,215,1,206
4452,617,819,213.83256235827665,215.7365986394558,6,5,218,2,202
4453,617,812,213.83256235827665,216.68861678004535,6,2,231,3,195
4454,617,820,213.83256235827665,215.7365986394558,6,3,219,2,203
4455,617,889,213.83256235827665,216.68861678004535,6,12,299,3,272
4456,810,420,214.45950113378686,216.9904761904762,4,20,405,3,390
4457,810,417,214.45950113378686,217.38521541950115,4,18,413,3,393
4458,810,819,214.45950113378686,215.7365986394558,4,5,56,1,9
4459,810,812,214.45950113378686,216.68861678004535,4,2,96,2,2
4460,810,820,214.45950113378686,215.7365986394558,4,3,56,1,10
4461,810,889,214.45950113378686,216.68861678004535,4,12,124,2,79
4462,810,846,214.45950113378686,217.4316553287982,4,6,133,3,36
4463,819,364,215.7365986394558,218.56943310657596,5,20,471,3,455
4464,819,420,215.7365986394558,216.9904761904762,5,20,403,1,399
4465,819,417,215.7365986394558,217.38521541950115,5,18,408,2,402
4466,819,483,215.7365986394558,218.45333333333335,5,10,356,3,336
4467,819,810,215.7365986394558,217.4548752834467,5,1,75,2,9
4468,819,846,215.7365986394558,217.4316553287982,5,6,78,2,27
4469,819,849,215.7365986394558,218.56943310657596,5,2,126,3,30
4470,812,364,216.68861678004535,218.56943310657596,2,20,455,2,448
4471,812,483,216.68861678004535,218.45333333333335,2,10,338,2,329
4472,812,471,216.68861678004535,219.19637188208617,2,5,358,3,341
4473,812,639,216.68861678004535,219.05705215419502,2,1,201,2,173
4474,812,849,216.68861678004535,218.56943310657596,2,2,89,2,37
4475,810,364,217.4548752834467,218.56943310657596,1,20,449,1,446
4476,810,471,217.4548752834467,219.19637188208617,1,5,347,2,339
4477,810,410,217.4548752834467,220.35736961451246,1,10,419,3,400
4478,810,639,217.4548752834467,219.05705215419502,1,1,184,2,171
4479,810,849,217.4548752834467,218.56943310657596,1,2,62,1,39
4480,639,231,219.05705215419502,220.98430839002268,1,21,416,2,408
4481,639,208,219.05705215419502,221.49514739229025,1,25,444,2,431
4482,639,410,219.05705215419502,220.35736961451246,1,10,236,1,229
4483,639,426,219.05705215419502,221.2861678004535,1,16,234,2,213
4484,639,899,219.05705215419502,221.00752834467121,1,1,273,2,260
4485,817,419,223.0508843537415,224.32798185941044,7,7,402,1,398
4486,817,620,223.0508843537415,226.02303854875285,7,11,235,3,197
4487,817,865,223.0508843537415,225.4657596371882,7,14,115,2,48
4488,620,290,226.02303854875285,228.06639455782314,11,17,342,2,330
4489,620,208,226.02303854875285,228.97197278911565,11,29,431,3,412
4490,620,435,226.02303854875285,228.06639455782314,11,12,205,2,185
4491,620,616,226.02303854875285,227.8574149659864,11,3,79,2,4
4492,620,836,226.02303854875285,227.8574149659864,11,6,230,2,216
4493,620,889,226.02303854875285,228.94875283446711,11,4,297,3,269
4494,800,435,226.0926984126984,228.06639455782314,3,12,375,2,365
4495,800,414,226.0926984126984,229.04163265306124,3,24,406,3,386
4496,800,616,226.0926984126984,227.8574149659864,3,3,199,2,184
4497,800,836,226.0926984126984,227.8574149659864,3,6,84,2,36
4498,800,889,226.0926984126984,228.94875283446711,3,4,152,3,89
4499,616,208,227.8574149659864,228.97197278911565,3,29,411,1,408
4500,616,207,227.8574149659864,229.0880725623583,3,27,412,1,409
4501,616,414,227.8574149659864,229.04163265306124,3,24,208,1,202
4502,616,424,227.8574149659864,229.13451247165534,3,20,200,1,192
4503,616,889,227.8574149659864,228.94875283446711,3,4,277,1,273
4504,616,868,227.8574149659864,230.0633106575964,3,3,269,2,252
4505,616,859,227.8574149659864,230.1561904761905,3,8,262,2,243
4506,768,289,230.9688888888889,232.33886621315193,0,21,483,1,479
4507,768,277,230.9688888888889,233.8946031746032,0,18,507,3,491
4508,768,424,230.9688888888889,232.08344671201814,0,11,347,1,344
4509,768,817,230.9688888888889,232.19954648526078,0,7,72,1,49
4510,768,809,230.9688888888889,233.6391836734694,0,1,122,3,41
4511,768,884,230.9688888888889,232.0602267573696,0,1,125,1,116
4512,768,854,230.9688888888889,232.17632653061224,0,11,100,1,86
4513,768,851,230.9688888888889,233.6391836734694,0,4,142,3,83
4514,817,417,232.19954648526078,234.05714285714285,7,13,408,2,400
4515,817,417,232.19954648526078,234.0803628117914,7,11,408,2,400
4516,817,809,232.19954648526078,233.6391836734694,7,1,63,1,8
4517,817,747,232.19954648526078,234.77696145124716,7,5,131,3,70
4518,817,851,232.19954648526078,233.6391836734694,7,4,71,1,34
4519,817,917,232.19954648526078,234.8001814058957,7,10,150,3,100
4520,809,365,233.6391836734694,236.00761904761904,1,15,456,2,444
4521,809,412,233.6391836734694,236.03083900226758,1,3,410,2,397
4522,809,412,233.6391836734694,236.402358276644,1,15,414,3,397
4523,809,747,233.6391836734694,234.77696145124716,1,5,79,1,62
4524,809,917,233.6391836734694,234.8001814058957,1,10,119,1,108
4525,747,365,234.77696145124716,236.00761904761904,5,15,386,1,382
4526,747,412,234.77696145124716,236.03083900226758,5,3,339,1,335
4527,747,412,234.77696145124716,236.402358276644,5,15,342,2,335
4528,781,416,238.23673469387757,240.07111111111112,9,19,373,2,365
4529,781,417,238.23673469387757,240.11755102040817,9,25,373,2,364
4530,781,866,238.23673469387757,240.2336507936508,9,1,121,2,85
4531,806,324,241.69650793650794,243.80952380952382,4,11,491,2,482
4532,806,325,241.69650793650794,244.27392290249435,4,12,494,3,481
4533,806,454,241.69650793650794,243.3683446712018,4,1,359,2,352
4534,806,454,241.69650793650794,244.66866213151928,4,1,375,3,352
4535,946,611,38.98630385487528,40.40272108843538,0,7,341,1,335
4536,946,468,38.98630385487528,41.517278911564624,0,6,490,3,478
4537,946,703,38.98630385487528,40.40272108843538,0,9,251,1,243
4538,946,684,38.98630385487528,41.21541950113379,0,12,279,2,262
4539,946,958,38.98630385487528,40.79746031746032,0,11,79,2,12
4540,905,468,39.91510204081633,41.517278911564624,14,6,442,2,437
4541,905,586,39.91510204081633,42.399637188208615,14,7,336,2,319
4542,905,684,39.91510204081633,41.21541950113379,14,12,228,1,221
4543,905,641,39.91510204081633,42.399637188208615,14,11,285,2,264
4544,905,825,39.91510204081633,42.74793650793651,14,11,146,3,80
4545,958,586,40.79746031746032,42.399637188208615,11,7,378,2,372
4546,958,641,40.79746031746032,42.399637188208615,11,11,324,2,317
4547,958,825,40.79746031746032,42.74793650793651,11,11,157,2,133
4548,825,410,42.74793650793651,43.932154195011336,11,8,418,1,415
4549,825,437,42.74793650793651,44.39655328798186,11,3,394,2,388
4550,825,437,42.74793650793651,45.34857142857143,11,1,404,3,388
4551,825,718,42.74793650793651,44.39655328798186,11,5,128,2,107
4552,825,832,42.74793650793651,44.39655328798186,11,7,71,2,7
4553,832,417,44.39655328798186,46.97396825396825,7,0,430,3,415
4554,832,419,44.39655328798186,47.113287981859415,7,7,429,3,413
4555,832,789,44.39655328798186,47.06684807256236,7,8,123,3,43
4556,832,921,44.39655328798186,47.04362811791383,7,11,145,3,89
4557,921,435,47.04362811791383,48.06530612244898,11,9,488,1,486
4558,921,489,47.04362811791383,49.946122448979594,11,9,450,3,432
4559,921,818,47.04362811791383,48.6225850340136,11,13,123,2,103
4560,921,883,47.04362811791383,48.13496598639456,11,21,60,1,38
4561,883,489,48.13496598639456,49.946122448979594,21,9,402,2,394
4562,883,498,48.13496598639456,50.340861678004536,21,12,397,2,385
4563,883,749,48.13496598639456,50.5730612244898,21,4,170,2,134
4564,883,818,48.13496598639456,51.08390022675737,21,6,143,3,65
4565,883,958,48.13496598639456,50.59628117913832,21,8,130,2,75
4566,883,905,48.13496598639456,51.08390022675737,21,10,129,3,22
4567,958,584,50.59628117913832,52.61641723356009,8,0,384,2,374
4568,905,584,51.08390022675737,52.61641723356009,10,0,328,2,321
4569,855,410,58.42140589569161,59.65206349206349,15,16,448,1,445
4570,855,448,58.42140589569161,60.557641723356014,15,4,417,2,407
4571,855,652,58.42140589569161,60.51120181405896,15,8,222,2,203
4572,855,798,58.42140589569161,61.23102040816327,15,2,134,3,57
4573,855,902,58.42140589569161,59.466303854875285,15,11,65,1,47
4574,855,845,58.42140589569161,60.53442176870748,15,8,92,2,10
4575,855,833,58.42140589569161,61.23102040816327,15,2,123,3,22
4576,902,448,59.466303854875285,60.557641723356014,11,4,456,1,454
4577,902,410,59.466303854875285,61.74185941043084,11,5,502,2,492
4578,902,652,59.466303854875285,60.51120181405896,11,8,254,1,250
4579,902,798,59.466303854875285,61.23102040816327,11,2,129,2,104
4580,902,845,59.466303854875285,60.53442176870748,11,8,73,1,57
4581,902,833,59.466303854875285,61.23102040816327,11,2,103,2,69
4582,845,410,60.53442176870748,61.74185941043084,8,5,438,1,435
4583,845,415,60.53442176870748,62.972517006802725,8,10,443,2,430
4584,833,415,61.23102040816327,62.972517006802725,2,10,425,2,418
4585,833,410,61.23102040816327,63.715555555555554,2,19,436,2,423
4586,899,417,65.36417233560091,66.38585034013606,4,7,484,1,482
4587,899,412,65.36417233560091,67.98802721088435,4,16,500,3,487
4588,899,413,65.36417233560091,68.05768707482993,4,19,500,3,486
4589,918,621,66.36263038548753,68.89360544217688,0,3,316,3,297
4590,918,894,66.36263038548753,68.9168253968254,0,12,113,3,24
4591,894,420,68.9168253968254,70.0778231292517,12,8,477,1,474
4592,894,864,68.9168253968254,70.33324263038548,12,1,68,1,30
4593,864,432,70.33324263038548,72.00507936507937,1,14,438,2,432
4594,864,432,70.33324263038548,72.02829931972789,1,15,438,2,432
4595,864,410,70.33324263038548,73.16607709750566,1,2,470,3,454
4596,864,756,70.33324263038548,72.79455782312925,1,0,151,2,108
4597,864,858,70.33324263038548,72.44625850340137,1,6,91,2,6
4598,858,411,72.44625850340137,74.18775510204082,6,1,453,2,447
4599,887,449,78.06548752834468,79.22648526077097,11,13,441,1,438
4600,887,432,78.06548752834468,80.4107029478458,11,7,466,2,455
4601,887,817,78.06548752834468,80.45714285714286,11,12,125,2,70
4602,887,868,78.06548752834468,80.45714285714286,11,17,105,2,19
4603,868,892,80.45714285714286,82.8952380952381,17,7,108,2,24
4604,868,410,81.06086167800454,83.98657596371882,7,15,475,3,458
4605,868,892,81.06086167800454,82.8952380952381,7,7,83,2,24
4606,892,410,82.8952380952381,83.98657596371882,7,15,484,1,482
4607,892,428,82.8952380952381,84.17233560090703,7,16,467,1,464
4608,892,870,82.8952380952381,85.1243537414966,7,1,98,2,22
4609,870,424,85.1243537414966,87.58566893424036,1,18,458,2,446
4610,870,819,85.1243537414966,87.23736961451247,1,4,104,2,51
4611,870,909,85.1243537414966,87.260589569161,1,12,100,2,39
4612,909,414,87.260589569161,88.88598639455782,12,7,500,2,495
4613,909,418,87.260589569161,89.07174603174603,12,6,497,2,491
4614,909,797,87.260589569161,89.42004535147393,12,0,146,2,112
4615,909,858,87.260589569161,89.81478458049887,12,1,121,3,51
4616,858,431,89.81478458049887,91.4401814058957,1,19,433,2,427
4617,858,887,89.81478458049887,91.4401814058957,1,2,76,2,29
4618,858,863,89.81478458049887,92.62439909297052,1,0,121,3,5
4619,887,415,91.4401814058957,92.92625850340136,2,16,476,1,472
4620,887,436,91.4401814058957,93.08879818594104,2,15,457,2,451
4621,887,699,91.4401814058957,93.27455782312926,2,12,204,2,188
4622,887,863,91.4401814058957,92.62439909297052,2,0,56,1,24
4623,887,858,91.4401814058957,93.25133786848073,2,15,83,2,29
4624,863,414,92.62439909297052,94.78385487528345,0,18,459,2,449
4625,863,418,92.62439909297052,95.15537414965986,0,19,458,3,445
4626,863,892,92.62439909297052,95.24825396825398,0,3,117,3,29
4627,858,414,93.25133786848073,94.78385487528345,15,18,449,2,444
4628,858,418,93.25133786848073,95.15537414965986,15,19,448,2,440
4629,858,892,93.25133786848073,95.24825396825398,15,3,92,2,34
4630,892,415,95.24825396825398,96.71111111111111,3,6,481,1,477
4631,892,411,95.24825396825398,97.33804988662132,3,4,489,2,481
4632,892,940,95.24825396825398,96.75755102040817,3,5,81,2,48
4633,940,777,96.75755102040817,99.66004535147393,5,2,205,3,163
4634,865,757,100.40308390022676,102.30712018140589,1,1,136,2,108
4635,865,837,100.40308390022676,101.51764172335601,1,0,56,1,28
4636,837,655,101.51764172335601,103.49133786848073,0,2,201,2,182
4637,839,514,109.48208616780046,111.38612244897959,4,10,335,2,325
4638,839,754,109.48208616780046,111.40934240362812,4,18,119,2,85
4639,839,946,109.48208616780046,111.40934240362812,4,19,135,2,107
4640,910,514,110.3180045351474,111.38612244897959,1,10,399,1,396
4641,910,432,110.3180045351474,112.82575963718821,1,8,490,3,478
4642,910,754,110.3180045351474,111.40934240362812,1,18,163,1,156
4643,910,804,110.3180045351474,112.77931972789116,1,2,150,2,106
4644,910,946,110.3180045351474,111.40934240362812,1,19,59,1,36
4645,910,944,110.3180045351474,112.77931972789116,1,12,111,2,34
4646,946,804,111.40934240362812,112.77931972789116,19,2,154,1,142
4647,946,771,111.40934240362812,113.35981859410431,19,2,194,2,175
4648,946,944,111.40934240362812,112.77931972789116,19,12,59,1,2
4649,946,878,111.40934240362812,113.38303854875284,19,3,109,2,68
4650,878,437,113.38303854875284,115.86757369614513,3,2,454,2,441
4651,914,499,117.58585034013606,119.90784580498867,11,4,427,2,415
4652,914,817,117.58585034013606,118.72362811791383,11,3,109,1,97
4653,914,820,117.58585034013606,118.72362811791383,11,1,106,1,94
4654,820,499,118.72362811791383,119.90784580498867,1,4,325,1,321
4655,820,410,118.72362811791383,120.81342403628118,1,6,420,2,410
4656,820,555,118.72362811791383,121.11528344671203,1,8,284,2,265
4657,820,779,118.72362811791383,121.09206349206349,1,5,110,2,41
4658,820,893,118.72362811791383,121.11528344671203,1,6,126,2,73
4659,893,415,121.11528344671203,122.2530612244898,6,4,481,1,478
4660,893,414,121.11528344671203,123.1354195011338,6,4,487,2,479
4661,876,426,124.96979591836735,126.29333333333334,4,13,454,1,450
4662,876,623,124.96979591836735,126.01469387755103,4,4,257,1,253
4663,876,782,124.96979591836735,126.03791383219955,4,3,105,1,94
4664,876,847,124.96979591836735,126.01469387755103,4,7,54,1,29
4665,876,849,124.96979591836735,126.03791383219955,4,5,53,1,27
4666,876,883,124.96979591836735,127.77941043083901,4,5,121,3,7
4667,847,438,126.01469387755103,128.01160997732427,7,9,418,2,409
4668,847,497,126.01469387755103,128.03482993197278,7,12,361,2,350
4669,847,685,126.01469387755103,128.01160997732427,7,10,183,2,162
4670,847,684,126.01469387755103,128.05804988662132,7,14,185,2,163
4671,847,883,126.01469387755103,127.77941043083901,7,5,84,2,36
4672,847,864,126.01469387755103,128.52244897959184,7,16,109,3,17
4673,849,438,126.03791383219955,128.01160997732427,5,9,420,2,411
4674,849,497,126.03791383219955,128.03482993197278,5,12,362,2,352
4675,849,685,126.03791383219955,128.01160997732427,5,10,185,2,164
4676,849,684,126.03791383219955,128.05804988662132,5,14,187,2,165
4677,849,883,126.03791383219955,127.77941043083901,5,5,82,2,34
4678,849,864,126.03791383219955,128.52244897959184,5,16,108,2,15
4679,883,564,127.77941043083901,129.3119274376417,5,9,326,2,319
4680,883,593,127.77941043083901,130.07818594104307,5,5,306,2,290
4681,883,763,127.77941043083901,129.3583673469388,5,6,138,2,120
4682,883,690,127.77941043083901,130.1014058956916,5,1,217,2,193
4683,883,953,127.77941043083901,129.33514739229025,5,19,97,2,70
4684,864,593,128.52244897959184,130.07818594104307,16,5,279,2,271
4685,864,690,128.52244897959184,130.1014058956916,16,1,187,2,174
4686,944,817,134.39709750566894,136.81197278911566,19,2,164,2,127
4687,944,812,134.39709750566894,137.09061224489795,19,3,176,3,132
4688,944,865,134.39709750566894,136.81197278911566,19,8,131,2,79
4689,944,881,134.39709750566894,137.09061224489795,19,5,132,3,63
4690,882,426,135.11691609977325,136.8584126984127,1,5,462,2,456
4691,882,411,135.11691609977325,137.09061224489795,1,10,479,2,471
4692,882,418,135.11691609977325,138.0890702947846,1,3,481,3,464
4693,882,817,135.11691609977325,136.81197278911566,1,2,98,2,65
4694,882,812,135.11691609977325,137.09061224489795,1,3,110,2,70
4695,882,865,135.11691609977325,136.81197278911566,1,8,75,2,17
4696,882,881,135.11691609977325,137.09061224489795,1,5,85,2,1
4697,865,369,136.81197278911566,139.11074829931974,8,7,506,2,496
4698,865,418,136.81197278911566,138.0890702947846,8,3,450,1,447
4699,920,811,144.72997732426305,145.7516553287982,15,9,118,1,109
4700,920,639,144.72997732426305,146.68045351473924,15,8,293,2,281
4701,920,697,144.72997732426305,147.35383219954647,15,3,250,3,223
4702,920,885,144.72997732426305,145.7516553287982,15,16,56,1,35
4703,920,866,144.72997732426305,146.6572335600907,15,10,99,2,54
4704,920,928,144.72997732426305,147.377052154195,15,3,114,3,8
4705,885,411,145.7516553287982,147.05197278911564,16,8,477,1,474
4706,885,413,145.7516553287982,148.72380952380954,16,11,489,3,472
4707,885,697,145.7516553287982,147.35383219954647,16,3,200,2,188
4708,885,928,145.7516553287982,147.377052154195,16,3,82,2,43
4709,866,413,146.6572335600907,148.72380952380954,10,11,462,2,453
4710,866,931,146.6572335600907,148.81668934240363,10,1,113,2,65
4711,928,816,147.377052154195,149.83836734693878,3,0,154,2,112
4712,928,931,147.377052154195,148.81668934240363,3,1,62,1,3
4713,928,863,147.377052154195,149.88480725623583,3,8,126,3,65
4714,928,925,147.377052154195,150.09378684807257,3,3,117,3,3
4715,931,816,148.81668934240363,149.83836734693878,1,0,123,1,115
4716,931,677,148.81668934240363,151.57986394557824,1,1,280,3,254
4717,931,863,148.81668934240363,149.88480725623583,1,8,82,1,68
4718,931,925,148.81668934240363,150.09378684807257,1,3,55,1,6
4719,863,420,149.88480725623583,151.8120634920635,8,11,451,2,443
4720,863,435,149.88480725623583,152.6015419501134,8,10,444,3,428
4721,863,677,149.88480725623583,151.57986394557824,8,1,200,2,186
4722,925,435,150.09378684807257,152.6015419501134,3,10,502,3,490
4723,925,677,150.09378684807257,151.57986394557824,3,1,256,1,248
4724,910,447,153.97151927437642,155.6433560090703,0,14,469,2,463
4725,910,411,153.97151927437642,156.40961451247165,0,10,510,2,499
4726,910,630,153.97151927437642,155.03963718820862,0,4,284,1,280
4727,910,635,153.97151927437642,155.1092970521542,0,13,279,1,275
4728,910,903,153.97151927437642,155.08607709750567,0,13,49,1,7
4729,910,876,153.97151927437642,156.47927437641724,0,3,113,3,34
4730,953,876,154.3198185941043,156.47927437641724,11,3,121,2,77
4731,903,411,155.08607709750567,156.40961451247165,13,10,495,1,492
4732,903,416,155.08607709750567,157.57061224489797,13,19,499,2,487
4733,903,648,155.08607709750567,157.45451247165533,13,5,275,2,255
4734,903,876,155.08607709750567,156.47927437641724,13,3,66,1,27
4735,876,416,156.47927437641724,157.57061224489797,3,19,462,1,460
4736,876,428,156.47927437641724,158.17433106575965,3,21,454,2,448
4737,876,460,156.47927437641724,159.05668934240364,3,5,431,3,416
4738,876,678,156.47927437641724,158.96380952380952,3,6,225,2,198
4739,876,955,156.47927437641724,158.940589569161,3,3,132,2,79
4740,903,460,157.45451247165533,159.05668934240364,8,5,448,2,443
4741,903,678,157.45451247165533,158.96380952380952,8,6,234,2,225
4742,903,955,157.45451247165533,158.940589569161,8,3,82,1,52
4743,863,420,163.63102040816327,164.76879818594105,1,17,446,1,443
4744,863,418,163.63102040816327,165.14031746031748,1,18,450,2,445
4745,863,601,163.63102040816327,166.6031746031746,1,5,292,3,262
4746,863,819,163.63102040816327,166.6031746031746,1,11,135,3,44
4747,863,915,163.63102040816327,165.23319727891158,1,4,86,2,52
4748,849,366,164.30439909297053,167.20689342403628,22,14,499,3,483
4749,849,601,164.30439909297053,166.6031746031746,22,5,267,2,248
4750,849,563,164.30439909297053,167.20689342403628,22,14,312,3,286
4751,849,819,164.30439909297053,166.6031746031746,22,11,103,2,30
4752,849,626,164.30439909297053,167.20689342403628,22,8,256,3,223
4753,849,951,164.30439909297053,166.64961451247166,22,19,144,2,102
4754,849,868,164.30439909297053,167.25333333333333,22,3,128,3,19
4755,915,601,165.23319727891158,166.6031746031746,4,5,319,1,314
4756,915,563,165.23319727891158,167.20689342403628,4,14,362,2,352
4757,915,819,165.23319727891158,166.6031746031746,4,11,113,1,96
4758,915,626,165.23319727891158,167.20689342403628,4,8,301,2,289
4759,915,951,165.23319727891158,166.64961451247166,4,19,71,1,36
4760,915,868,165.23319727891158,167.25333333333333,4,3,99,2,47
4761,951,766,166.64961451247166,169.0877097505669,19,4,213,2,185
4762,868,413,167.25333333333333,170.03972789115647,3,10,471,3,455
4763,868,766,167.25333333333333,169.0877097505669,3,4,129,2,102
4764,868,867,167.25333333333333,169.83074829931974,3,7,111,3,1
4765,867,452,169.83074829931974,171.4793650793651,7,9,421,2,415
4766,867,418,169.83074829931974,172.2920634920635,7,9,461,2,449
4767,867,863,169.83074829931974,171.38648526077097,7,9,67,2,4
4768,867,874,169.83074829931974,172.17596371882087,7,5,101,2,7
4769,882,452,170.27192743764172,171.4793650793651,8,9,433,1,430
4770,882,418,170.27192743764172,172.2920634920635,8,9,472,2,464
4771,882,863,170.27192743764172,171.38648526077097,8,9,52,1,19
4772,882,874,170.27192743764172,172.17596371882087,8,5,82,2,8
4773,863,411,171.38648526077097,173.59238095238095,9,8,462,2,452
4774,863,812,171.38648526077097,173.4530612244898,9,7,103,2,51
4775,863,876,171.38648526077097,173.4530612244898,9,8,90,2,13
4776,874,411,172.17596371882087,173.59238095238095,5,8,467,1,463
4777,874,432,172.17596371882087,174.38185941043085,5,4,452,2,442
4778,874,812,172.17596371882087,173.4530612244898,5,7,83,1,62
4779,874,657,172.17596371882087,174.89269841269842,5,1,247,3,217
4780,874,876,172.17596371882087,173.4530612244898,5,8,55,1,2
4781,874,864,172.17596371882087,174.4282993197279,5,1,98,2,10
4782,876,427,173.4530612244898,175.21777777777777,8,6,455,2,449
4783,876,419,173.4530612244898,176.16979591836736,8,1,472,3,457
4784,876,657,173.4530612244898,174.89269841269842,8,1,228,1,219
4785,876,806,173.4530612244898,175.96081632653062,8,20,129,3,70
4786,876,945,173.4530612244898,175.98403628117913,8,20,129,3,69
4787,864,419,174.4282993197279,176.16979591836736,1,1,451,2,445
4788,864,806,174.4282993197279,175.96081632653062,1,20,88,2,58
4789,864,945,174.4282993197279,175.98403628117913,1,20,105,2,81
4790,945,863,175.98403628117913,177.67909297052154,20,3,110,2,82
4791,945,840,175.98403628117913,178.1899319727891,20,4,142,2,105
4792,863,420,177.67909297052154,179.2580498866213,3,14,448,2,443
4793,863,677,177.67909297052154,179.46702947845804,3,10,201,2,186
4794,863,878,177.67909297052154,179.46702947845804,3,15,78,2,15
4795,840,420,178.1899319727891,179.2580498866213,4,14,423,1,420
4796,840,410,178.1899319727891,180.90666666666667,4,11,446,3,430
4797,840,677,178.1899319727891,179.46702947845804,4,10,172,1,163
4798,840,878,178.1899319727891,179.46702947845804,4,15,67,1,38
4799,878,410,179.46702947845804,180.90666666666667,15,11,472,1,468
4800,878,411,179.46702947845804,181.23174603174604,15,20,473,2,467
4801,878,419,181.44072562358278,182.8107029478458,5,5,463,1,459
4802,878,410,181.44072562358278,183.55374149659863,5,2,477,2,468
4803,878,796,181.44072562358278,182.92680272108845,5,8,104,1,82
4804,878,914,181.44072562358278,182.95002267573696,5,12,74,2,36
4805,902,415,202.75664399092972,204.7071201814059,0,20,494,2,487
4806,902,410,202.75664399092972,205.63591836734693,0,14,507,3,492
4807,902,681,202.75664399092972,204.49814058956918,0,5,233,2,221
4808,902,636,202.75664399092972,205.49659863945578,0,11,291,3,266
4809,902,928,202.75664399092972,204.47492063492064,0,12,78,2,26
4810,902,952,202.75664399092972,205.47337868480727,0,15,127,3,50
4811,910,415,203.49968253968254,204.7071201814059,6,20,498,1,495
4812,910,546,203.49968253968254,206.23963718820863,6,9,383,3,364
4813,910,636,203.49968253968254,205.49659863945578,6,11,287,2,274
4814,910,818,203.49968253968254,206.23963718820863,6,7,150,3,92
4815,910,952,203.49968253968254,205.47337868480727,6,15,95,2,42
4816,910,835,203.49968253968254,206.23963718820863,6,4,140,3,75
4817,928,546,204.47492063492064,206.23963718820863,12,9,389,2,382
4818,928,636,204.47492063492064,205.49659863945578,12,11,295,1,292
4819,928,818,204.47492063492064,206.23963718820863,12,7,134,2,110
4820,928,835,204.47492063492064,206.23963718820863,12,4,120,2,93
4821,835,431,206.23963718820863,207.58639455782313,4,18,408,1,404
4822,835,417,206.23963718820863,208.93315192743765,4,22,434,3,418
4823,835,810,206.23963718820863,208.9099319727891,4,3,118,3,25
4824,835,926,206.23963718820863,208.9099319727891,4,10,147,3,91
4825,835,845,206.23963718820863,209.21179138321995,4,10,128,3,10
4826,926,459,208.9099319727891,211.39446712018142,10,10,479,2,467
4827,926,738,208.9099319727891,210.39600907029478,10,1,199,1,188
4828,926,778,208.9099319727891,211.39446712018142,10,12,183,2,148
4829,926,868,208.9099319727891,210.39600907029478,10,14,86,1,58
4830,926,865,208.9099319727891,211.41768707482993,10,12,124,3,61
4831,845,410,209.21179138321995,210.65142857142857,10,10,439,1,435
4832,845,459,209.21179138321995,211.39446712018142,10,10,397,2,386
4833,845,738,209.21179138321995,210.39600907029478,10,1,119,1,107
4834,845,778,209.21179138321995,211.39446712018142,10,12,115,2,67
4835,845,868,209.21179138321995,210.39600907029478,10,14,56,1,23
4836,845,865,209.21179138321995,211.41768707482993,10,12,97,2,20
4837,868,410,210.39600907029478,212.9966439909297,14,20,471,3,458
4838,868,865,210.39600907029478,211.41768707482993,14,12,44,1,3
4839,868,906,210.39600907029478,212.78766439909296,14,0,110,2,38
4840,865,410,211.41768707482993,212.9966439909297,12,20,460,2,455
4841,865,410,211.41768707482993,213.67002267573696,12,15,465,2,455
4842,865,617,211.41768707482993,213.83256235827665,12,6,269,2,248
4843,865,906,211.41768707482993,212.78766439909296,12,0,72,1,41
4844,865,863,211.41768707482993,213.8557823129252,12,11,105,2,2
4845,906,428,212.78766439909296,214.62204081632655,0,16,484,2,478
4846,906,411,212.78766439909296,215.22575963718822,0,17,506,2,495
4847,906,617,212.78766439909296,213.83256235827665,0,6,292,1,289
4848,906,810,212.78766439909296,214.45950113378686,0,4,120,2,96
4849,906,819,212.78766439909296,215.7365986394558,0,5,154,3,87
4850,906,863,212.78766439909296,213.8557823129252,0,11,63,1,43
4851,906,850,212.78766439909296,214.43628117913832,0,14,90,2,56
4852,906,820,212.78766439909296,215.7365986394558,0,3,153,3,86
4853,863,411,213.8557823129252,215.22575963718822,11,17,456,1,452
4854,863,819,213.8557823129252,215.7365986394558,11,5,92,2,44
4855,863,812,213.8557823129252,216.68861678004535,11,2,132,3,51
4856,863,820,213.8557823129252,215.7365986394558,11,3,92,2,43
4857,863,889,213.8557823129252,216.68861678004535,11,12,125,3,26
4858,850,420,214.43628117913832,216.9904761904762,14,20,444,3,430
4859,850,417,214.43628117913832,217.38521541950115,14,18,451,3,433
4860,850,819,214.43628117913832,215.7365986394558,14,5,64,1,31
4861,850,812,214.43628117913832,216.68861678004535,14,2,104,2,38
4862,850,820,214.43628117913832,215.7365986394558,14,3,64,1,30
4863,850,889,214.43628117913832,216.68861678004535,14,12,105,2,39
4864,820,364,215.7365986394558,218.56943310657596,3,20,472,3,456
4865,820,420,215.7365986394558,216.9904761904762,3,20,404,1,400
4866,820,417,215.7365986394558,217.38521541950115,3,18,409,2,403
4867,820,483,215.7365986394558,218.45333333333335,3,10,357,3,337
4868,820,810,215.7365986394558,217.4548752834467,3,1,75,2,10
4869,820,846,215.7365986394558,217.4316553287982,3,6,77,2,26
4870,820,849,215.7365986394558,218.56943310657596,3,2,125,3,29
4871,889,483,216.68861678004535,218.45333333333335,12,10,413,2,406
4872,889,471,216.68861678004535,219.19637188208617,12,5,432,3,418
4873,889,639,216.68861678004535,219.05705215419502,12,1,270,2,250
4874,889,849,216.68861678004535,218.56943310657596,12,2,90,2,40
4875,846,364,217.4316553287982,218.56943310657596,6,20,484,1,482
4876,846,483,217.4316553287982,218.45333333333335,6,10,366,1,363
4877,846,471,217.4316553287982,219.19637188208617,6,5,383,2,375
4878,846,410,217.4316553287982,220.35736961451246,6,10,454,3,436
4879,846,639,217.4316553287982,219.05705215419502,6,1,219,2,207
4880,846,849,217.4316553287982,218.56943310657596,6,2,49,1,3
4881,849,410,218.56943310657596,220.35736961451246,2,10,446,2,439
4882,849,426,218.56943310657596,221.2861678004535,2,16,439,3,423
4883,849,899,218.56943310657596,221.00752834467121,2,1,116,2,50
4884,899,433,221.00752834467121,222.6097052154195,1,13,471,2,466
4885,899,420,221.00752834467121,223.95646258503402,1,12,496,3,479
4886,899,817,221.00752834467121,223.0508843537415,1,7,120,2,82
4887,899,856,221.00752834467121,223.02766439909297,1,9,97,2,43
4888,856,419,223.02766439909297,224.32798185941044,9,7,441,1,437
4889,856,865,223.02766439909297,225.4657596371882,9,14,105,2,9
4890,865,435,225.4657596371882,228.06639455782314,14,12,444,3,430
4891,865,616,225.4657596371882,227.8574149659864,14,3,269,2,249
4892,865,836,225.4657596371882,227.8574149659864,14,6,107,2,29
4893,858,435,226.0694784580499,228.06639455782314,4,12,432,2,423
4894,858,414,226.0694784580499,229.04163265306124,4,24,462,3,444
4895,858,616,226.0694784580499,227.8574149659864,4,3,254,2,242
4896,858,836,226.0694784580499,227.8574149659864,4,6,80,2,22
4897,858,889,226.0694784580499,228.94875283446711,4,4,128,3,31
4898,836,414,227.8574149659864,229.04163265306124,6,24,425,1,422
4899,836,424,227.8574149659864,229.13451247165534,6,20,416,1,412
4900,836,889,227.8574149659864,228.94875283446711,6,4,71,1,53
4901,836,868,227.8574149659864,230.0633106575964,6,3,100,2,32
4902,836,859,227.8574149659864,230.1561904761905,6,8,102,2,23
4903,889,411,228.94875283446711,230.9688888888889,4,19,486,2,478
4904,889,416,228.94875283446711,231.08498866213154,4,17,482,2,473
4905,889,768,228.94875283446711,230.9688888888889,4,0,149,2,121
4906,889,868,228.94875283446711,230.0633106575964,4,3,52,1,21
4907,889,859,228.94875283446711,230.1561904761905,4,8,60,1,30
4908,868,416,230.0633106575964,231.08498866213154,3,17,454,1,452
4909,868,424,230.0633106575964,232.08344671201814,3,11,452,2,444
4910,868,817,230.0633106575964,232.19954648526078,3,7,105,2,51
4911,868,884,230.0633106575964,232.0602267573696,3,1,87,2,16
4912,868,854,230.0633106575964,232.17632653061224,3,11,92,2,14
4913,859,424,230.1561904761905,232.08344671201814,8,11,443,2,435
4914,859,817,230.1561904761905,232.19954648526078,8,7,98,2,42
4915,859,884,230.1561904761905,232.0602267573696,8,1,86,2,25
4916,859,854,230.1561904761905,232.17632653061224,8,11,87,2,5
4917,884,417,232.0602267573696,234.05714285714285,1,13,475,2,467
4918,884,417,232.0602267573696,234.0803628117914,1,11,475,2,467
4919,884,809,232.0602267573696,233.6391836734694,1,1,101,2,75
4920,884,747,232.0602267573696,234.77696145124716,1,5,180,3,137
4921,884,851,232.0602267573696,233.6391836734694,1,4,76,2,33
4922,884,917,232.0602267573696,234.8001814058957,1,10,123,3,33
4923,854,417,232.17632653061224,234.05714285714285,11,13,444,2,437
4924,854,417,232.17632653061224,234.0803628117914,11,11,445,2,437
4925,854,809,232.17632653061224,233.6391836734694,11,1,77,1,45
4926,854,747,232.17632653061224,234.77696145124716,11,5,155,3,107
4927,854,851,232.17632653061224,233.6391836734694,11,4,63,1,3
4928,854,917,232.17632653061224,234.8001814058957,11,10,129,3,63
4929,851,365,233.6391836734694,236.00761904761904,4,15,497,2,486
4930,851,412,233.6391836734694,236.03083900226758,4,3,451,2,439
4931,851,412,233.6391836734694,236.402358276644,4,15,455,3,439
4932,851,747,233.6391836734694,234.77696145124716,4,5,115,1,104
4933,851,917,233.6391836734694,234.8001814058957,4,10,83,1,66
4934,852,416,238.23673469387757,240.07111111111112,11,19,443,2,436
4935,852,417,238.23673469387757,240.11755102040817,11,25,442,2,435
4936,852,866,238.23673469387757,240.2336507936508,11,1,87,2,14
4937,866,468,240.2336507936508,241.62684807256235,1,9,402,1,398
4938,866,411,240.2336507936508,242.32344671201815,1,5,464,2,455
4939,866,806,240.2336507936508,241.69650793650794,1,4,87,1,60
4940,866,923,240.2336507936508,241.6500680272109,1,16,83,1,57
4941,923,454,241.6500680272109,243.3683446712018,16,1,475,2,469
