,f0,f1,t0,t1,dB0,dB1,dist,utime,ufreq
0,26,15,0.8591383219954649,2.391655328798186,31,30,67,2,11
1,26,205,0.8591383219954649,2.1130158730158732,31,8,187,1,179
2,13,15,1.3003174603174603,2.391655328798186,26,30,47,1,2
3,13,15,1.3003174603174603,3.900952380952381,26,33,112,3,2
4,13,207,1.3003174603174603,3.900952380952381,26,12,224,3,194
5,15,9,2.391655328798186,4.760090702947846,30,32,102,2,6
6,15,207,2.391655328798186,3.900952380952381,30,12,203,2,192
7,15,231,2.391655328798186,4.295691609977324,30,10,231,2,216
8,15,8,3.900952380952381,5.897868480725624,33,31,86,2,7
9,15,8,3.900952380952381,6.315827664399093,33,30,104,2,7
10,15,277,3.900952380952381,5.874648526077098,33,12,275,2,262
11,15,471,3.900952380952381,5.851428571428571,33,2,464,2,456
12,15,415,3.900952380952381,6.292607709750567,33,3,413,2,400
13,9,8,4.760090702947846,5.897868480725624,32,31,49,1,1
14,9,8,4.760090702947846,6.315827664399093,32,30,67,2,1
15,9,8,4.760090702947846,6.989206349206349,32,30,96,2,1
16,9,277,4.760090702947846,5.874648526077098,32,12,272,1,268
17,9,277,4.760090702947846,6.9195464852607715,32,14,284,2,268
18,9,277,4.760090702947846,7.383945578231293,32,12,291,3,268
19,9,471,4.760090702947846,5.851428571428571,32,2,464,1,462
20,9,415,4.760090702947846,6.292607709750567,32,3,411,2,406
21,8,13,5.897868480725624,8.266303854875284,31,31,102,2,5
22,8,277,5.897868480725624,6.9195464852607715,31,14,273,1,269
23,8,277,5.897868480725624,7.383945578231293,31,12,277,1,269
24,8,205,5.897868480725624,8.219863945578231,31,12,221,2,197
25,8,13,6.315827664399093,8.266303854875284,30,31,84,2,5
26,8,277,6.315827664399093,7.383945578231293,30,12,273,1,269
27,8,205,6.315827664399093,8.219863945578231,30,12,213,2,197
28,8,13,6.989206349206349,8.266303854875284,30,31,55,1,5
29,8,14,6.989206349206349,9.775600907029478,30,31,120,3,6
30,8,205,6.989206349206349,8.219863945578231,30,12,204,1,197
31,8,232,6.989206349206349,9.752380952380953,30,10,254,3,224
32,13,14,8.266303854875284,9.775600907029478,31,31,65,2,1
33,13,14,8.266303854875284,10.448979591836736,31,32,94,2,1
34,13,232,8.266303854875284,9.752380952380953,31,10,228,1,219
35,13,206,8.266303854875284,10.843718820861678,31,11,223,3,193
36,14,9,9.775600907029478,11.72607709750567,31,33,84,2,5
37,14,9,9.775600907029478,12.585215419501134,31,31,121,3,5
38,14,206,9.775600907029478,10.843718820861678,31,11,197,1,192
39,14,270,9.775600907029478,11.284897959183674,31,13,264,2,256
40,14,9,10.448979591836736,11.72607709750567,32,33,55,1,5
41,14,9,10.448979591836736,12.585215419501134,32,31,92,2,5
42,14,8,10.448979591836736,13.281814058956916,32,31,122,3,6
43,14,212,10.448979591836736,12.84063492063492,32,10,223,2,198
44,14,415,10.448979591836736,13.235374149659863,32,4,419,3,401
45,9,8,11.72607709750567,13.281814058956916,33,31,67,2,1
46,9,24,11.72607709750567,14.55891156462585,33,34,123,3,15
47,9,212,11.72607709750567,12.84063492063492,33,10,209,1,203
48,9,222,11.72607709750567,13.955192743764172,33,15,234,2,213
49,9,277,11.72607709750567,14.303492063492063,33,11,290,3,268
50,9,415,11.72607709750567,13.235374149659863,33,4,411,2,406
51,9,24,12.585215419501134,14.55891156462585,31,34,86,2,15
52,9,222,12.585215419501134,13.955192743764172,31,15,221,1,213
53,9,277,12.585215419501134,14.303492063492063,31,11,278,2,268
54,9,437,12.585215419501134,15.301950113378686,31,4,444,3,428
55,8,24,13.281814058956916,14.55891156462585,31,34,57,1,16
56,8,25,13.281814058956916,15.836009070294786,31,31,111,3,17
57,8,26,13.281814058956916,16.091428571428573,31,31,122,3,18
58,8,277,13.281814058956916,14.303492063492063,31,11,273,1,269
59,8,206,13.281814058956916,15.603809523809524,31,9,222,2,198
60,8,205,13.281814058956916,16.04498866213152,31,10,230,3,197
61,8,437,13.281814058956916,15.301950113378686,31,4,438,2,429
62,24,25,14.55891156462585,15.836009070294786,34,31,55,1,1
63,24,26,14.55891156462585,16.091428571428573,34,31,66,2,2
64,24,206,14.55891156462585,15.603809523809524,34,9,187,1,182
65,24,205,14.55891156462585,16.04498866213152,34,10,192,1,181
66,24,437,14.55891156462585,17.46140589569161,34,8,432,3,413
67,25,14,15.836009070294786,17.76326530612245,31,32,84,2,11
68,25,10,15.836009070294786,18.204444444444444,31,33,103,2,15
69,25,237,15.836009070294786,17.716825396825396,31,16,227,2,212
70,25,230,15.836009070294786,18.36698412698413,31,8,232,3,205
71,25,437,15.836009070294786,17.46140589569161,31,8,418,2,412
72,25,480,15.836009070294786,18.599183673469387,31,6,470,3,455
73,26,14,16.091428571428573,17.76326530612245,31,32,73,2,12
74,26,10,16.091428571428573,18.204444444444444,31,33,92,2,16
75,26,237,16.091428571428573,17.716825396825396,31,16,222,2,211
76,26,230,16.091428571428573,18.36698412698413,31,8,226,2,204
77,26,437,16.091428571428573,17.46140589569161,31,8,415,1,411
78,26,480,16.091428571428573,18.599183673469387,31,6,467,3,454
79,14,5,17.76326530612245,19.551201814058956,32,29,78,2,9
80,14,219,17.76326530612245,19.156462585034014,32,10,214,1,205
81,14,511,17.76326530612245,19.156462585034014,32,4,501,1,497
82,14,494,17.76326530612245,20.48,32,5,494,3,480
83,10,5,18.204444444444444,19.551201814058956,33,29,58,1,5
84,10,49,18.204444444444444,20.89795918367347,33,30,122,3,39
85,10,319,18.204444444444444,20.82829931972789,33,10,329,3,309
86,10,494,18.204444444444444,20.48,33,5,494,2,484
87,5,49,19.551201814058956,20.89795918367347,29,30,73,1,44
88,5,8,19.551201814058956,21.24625850340136,29,30,73,2,3
89,5,319,19.551201814058956,20.82829931972789,29,10,319,1,314
90,5,245,19.551201814058956,21.966077097505668,29,19,262,2,240
91,5,246,19.551201814058956,22.360816326530614,29,23,270,3,241
92,5,493,19.551201814058956,21.91963718820862,29,8,499,2,488
93,5,490,19.551201814058956,22.058956916099774,29,7,497,3,485
94,49,12,20.89795918367347,22.96453514739229,30,31,96,2,37
95,49,12,20.89795918367347,22.98775510204082,30,31,97,2,37
96,49,245,20.89795918367347,21.966077097505668,30,19,201,1,196
97,49,246,20.89795918367347,22.360816326530614,30,23,207,1,197
98,49,271,20.89795918367347,23.84689342403628,30,10,256,3,222
99,49,493,20.89795918367347,21.91963718820862,30,8,446,1,444
100,49,490,20.89795918367347,22.058956916099774,30,7,444,1,441
101,49,521,20.89795918367347,23.08063492063492,30,10,481,2,472
102,8,12,21.24625850340136,22.96453514739229,30,31,74,2,4
103,8,12,21.24625850340136,22.98775510204082,30,31,75,2,4
104,8,246,21.24625850340136,22.360816326530614,30,23,243,1,238
105,8,271,21.24625850340136,23.84689342403628,30,10,286,3,263
106,12,21,22.96453514739229,24.61315192743764,31,31,72,2,9
107,12,10,22.96453514739229,25.58839002267574,31,31,113,3,2
108,12,231,22.96453514739229,24.63637188208617,31,15,231,2,219
109,12,221,22.96453514739229,25.332970521541952,31,12,233,2,209
110,12,460,22.96453514739229,25.541950113378686,31,8,462,3,448
111,12,21,22.98775510204082,24.61315192743764,31,31,71,2,9
112,12,10,22.98775510204082,25.58839002267574,31,31,112,3,2
113,12,231,22.98775510204082,24.63637188208617,31,15,230,2,219
114,12,221,22.98775510204082,25.332970521541952,31,12,232,2,209
115,12,460,22.98775510204082,25.541950113378686,31,8,461,3,448
116,21,23,24.61315192743764,26.540408163265308,31,32,83,2,2
117,21,218,24.61315192743764,26.122448979591837,31,13,207,2,197
118,21,449,24.61315192743764,26.28498866213152,31,4,434,2,428
119,10,16,25.58839002267574,27.631746031746033,31,33,88,2,6
120,10,277,25.58839002267574,27.794285714285714,31,8,283,2,267
121,10,277,25.58839002267574,28.23546485260771,31,9,290,3,267
122,23,16,26.540408163265308,27.631746031746033,32,33,48,1,7
123,23,6,26.540408163265308,28.65342403628118,32,32,93,2,17
124,23,6,26.540408163265308,29.094603174603176,32,32,111,3,17
125,23,277,26.540408163265308,27.794285714285714,32,8,260,1,254
126,23,277,26.540408163265308,28.23546485260771,32,9,264,2,254
127,23,410,26.540408163265308,29.071383219954647,32,3,402,3,387
128,16,6,27.631746031746033,28.65342403628118,33,32,45,1,10
129,16,6,27.631746031746033,29.094603174603176,33,32,64,1,10
130,16,6,27.631746031746033,30.394920634920634,33,32,119,3,10
131,16,231,27.631746031746033,29.95374149659864,33,12,237,2,215
132,16,410,27.631746031746033,29.071383219954647,33,3,399,1,394
133,6,231,28.65342403628118,29.95374149659864,32,12,232,1,225
134,6,219,28.65342403628118,30.743219954648527,32,14,231,2,213
135,6,219,28.65342403628118,31.277278911564625,32,13,241,3,213
136,6,219,29.094603174603176,30.743219954648527,32,14,225,2,213
137,6,219,29.094603174603176,31.277278911564625,32,13,233,2,213
138,6,205,30.394920634920634,32.55437641723356,32,10,220,2,199
139,6,410,30.394920634920634,32.995555555555555,32,6,419,3,404
140,6,205,31.2540589569161,32.55437641723356,31,10,207,1,199
141,6,231,31.2540589569161,33.436734693877554,31,12,244,2,225
142,6,219,31.2540589569161,34.08689342403628,31,14,245,3,213
143,6,410,31.2540589569161,32.995555555555555,31,6,411,2,404
144,6,231,32.13641723356009,33.436734693877554,32,12,232,1,225
145,6,219,32.13641723356009,34.08689342403628,32,14,229,2,213
146,6,418,32.13641723356009,34.76027210884354,32,2,427,3,412
147,6,219,33.436734693877554,35.45687074829932,32,13,230,2,213
148,6,418,33.436734693877554,34.76027210884354,32,2,416,1,412
149,6,219,34.29587301587301,35.45687074829932,32,13,219,1,213
150,6,206,34.29587301587301,36.501768707482995,32,14,221,2,200
151,6,232,34.29587301587301,37.05904761904762,32,13,255,3,226
152,6,465,34.29587301587301,37.03582766439909,32,3,474,3,459
153,6,232,35.619410430839004,37.05904761904762,31,13,234,1,226
154,6,465,35.619410430839004,37.03582766439909,31,3,463,1,459
155,6,368,36.47854875283447,38.98630385487528,31,18,378,3,362
156,6,367,36.47854875283447,39.00952380952381,31,17,377,3,361
157,6,368,37.77886621315193,38.98630385487528,31,18,366,1,362
158,6,367,37.77886621315193,39.00952380952381,31,17,365,1,361
159,6,232,37.77886621315193,40.14730158730159,31,15,248,2,226
160,6,464,37.77886621315193,39.68290249433107,31,7,465,2,458
161,6,463,37.77886621315193,40.542040816326534,31,9,472,3,457
162,6,232,38.22004535147392,40.14730158730159,31,15,241,2,226
163,6,464,38.22004535147392,39.68290249433107,31,7,462,1,458
164,6,463,38.22004535147392,40.542040816326534,31,9,468,2,457
165,6,48,39.96154195011338,42.74793650793651,32,33,127,3,42
166,6,231,39.96154195011338,41.77269841269841,32,21,238,2,225
167,6,217,39.96154195011338,42.237097505668935,32,20,233,2,211
168,6,48,40.820680272108845,42.74793650793651,32,33,93,2,42
169,6,217,40.820680272108845,42.237097505668935,32,20,220,1,211
170,6,317,40.820680272108845,43.18911564625851,32,14,327,2,311
171,6,48,41.26185941043084,42.74793650793651,31,33,77,1,42
172,6,51,41.26185941043084,43.90893424036281,31,33,123,3,45
173,6,317,41.26185941043084,43.18911564625851,31,14,322,2,311
174,6,484,41.26185941043084,43.86249433106576,31,11,491,3,478
175,48,51,42.74793650793651,43.90893424036281,33,33,50,1,3
176,48,6,42.74793650793651,44.74485260770975,33,31,96,2,42
177,48,6,42.74793650793651,45.60399092970522,33,32,130,3,42
178,48,243,42.74793650793651,44.30367346938775,33,11,206,2,195
179,48,220,42.74793650793651,45.46467120181406,33,11,208,3,172
180,48,484,42.74793650793651,43.86249433106576,33,11,439,1,436
181,48,515,42.74793650793651,45.41823129251701,33,8,481,3,467
182,51,6,43.90893424036281,45.60399092970522,33,32,86,2,45
183,51,22,43.90893424036281,46.09160997732426,33,32,98,2,29
184,51,220,43.90893424036281,45.46467120181406,33,11,182,2,169
185,51,515,43.90893424036281,45.41823129251701,33,8,469,2,464
186,6,22,44.74485260770975,46.09160997732426,31,32,60,1,16
187,6,209,44.74485260770975,46.95074829931973,31,16,224,2,203
188,6,241,44.74485260770975,47.3687074829932,31,14,261,3,235
189,6,501,44.74485260770975,47.484807256235825,31,8,509,3,495
190,6,209,45.60399092970522,46.95074829931973,32,16,211,1,203
191,6,241,45.60399092970522,47.3687074829932,32,14,247,2,235
192,6,501,45.60399092970522,47.484807256235825,32,8,502,2,495
193,22,6,46.09160997732426,47.34548752834467,32,31,56,1,16
194,22,6,46.09160997732426,48.22784580498866,32,32,93,2,16
195,22,241,46.09160997732426,47.3687074829932,32,14,226,1,219
196,22,277,46.09160997732426,48.66902494331066,32,12,278,3,255
197,22,501,46.09160997732426,47.484807256235825,32,8,483,1,479
198,22,510,46.09160997732426,48.761904761904766,32,10,501,3,488
199,6,73,47.34548752834467,49.87646258503401,31,33,128,3,67
200,6,74,47.34548752834467,50.062222222222225,31,33,135,3,68
201,6,277,47.34548752834467,48.66902494331066,31,12,277,1,271
202,6,225,47.34548752834467,49.179863945578234,31,11,233,2,219
203,6,73,48.22784580498866,49.87646258503401,32,33,98,2,67
204,6,74,48.22784580498866,50.062222222222225,32,33,104,2,68
205,6,227,48.22784580498866,50.944580498866216,32,13,250,3,221
206,6,421,48.22784580498866,50.92136054421769,32,9,431,3,415
207,73,6,49.87646258503401,51.710839002267576,33,31,104,2,67
208,73,6,49.87646258503401,52.128798185941044,33,32,118,2,67
209,73,227,49.87646258503401,50.944580498866216,33,13,161,1,154
210,73,236,49.87646258503401,51.478639455782314,33,11,177,2,163
211,73,215,49.87646258503401,52.848616780045354,33,16,191,3,142
212,73,421,49.87646258503401,50.92136054421769,33,9,351,1,348
213,73,526,49.87646258503401,51.06068027210885,33,9,456,1,453
214,73,556,49.87646258503401,52.68607709750567,33,4,498,3,483
215,74,6,50.062222222222225,51.710839002267576,33,31,98,2,68
216,74,6,50.062222222222225,52.128798185941044,33,32,112,2,68
217,74,236,50.062222222222225,51.478639455782314,33,11,173,1,162
218,74,215,50.062222222222225,52.848616780045354,33,16,185,3,141
219,74,556,50.062222222222225,52.68607709750567,33,4,495,3,482
220,6,19,51.710839002267576,53.84707482993198,31,31,93,2,13
221,6,44,51.710839002267576,54.543673469387755,31,31,128,3,38
222,6,215,51.710839002267576,52.848616780045354,31,16,215,1,209
223,6,229,51.710839002267576,53.173696145124715,31,13,232,1,223
224,6,242,51.710839002267576,54.19537414965986,31,12,259,2,236
225,6,484,51.710839002267576,53.498775510204084,31,7,484,2,478
226,6,19,52.128798185941044,53.84707482993198,32,31,75,2,13
227,6,44,52.128798185941044,54.543673469387755,32,31,111,2,38
228,6,229,52.128798185941044,53.173696145124715,32,13,227,1,223
229,6,242,52.128798185941044,54.19537414965986,32,12,252,2,236
230,6,484,52.128798185941044,53.498775510204084,32,7,482,1,478
231,19,30,53.84707482993198,55.51891156462585,31,31,73,2,11
232,19,65,53.84707482993198,56.65668934240363,31,33,129,3,46
233,19,260,53.84707482993198,55.843990929705214,31,19,256,2,241
234,19,227,53.84707482993198,56.14585034013606,31,13,230,2,208
235,19,512,53.84707482993198,54.9384126984127,31,6,495,1,493
236,44,65,54.543673469387755,56.65668934240363,31,33,93,2,21
237,44,65,54.543673469387755,57.02820861678005,31,33,109,2,21
238,44,260,54.543673469387755,55.843990929705214,31,19,223,1,216
239,44,227,54.543673469387755,56.14585034013606,31,13,196,2,183
240,44,520,54.543673469387755,55.867210884353746,31,10,479,1,476
241,44,519,54.543673469387755,56.14585034013606,31,5,480,2,475
242,30,65,55.51891156462585,56.65668934240363,31,33,60,1,35
243,30,65,55.51891156462585,57.02820861678005,31,33,74,2,35
244,30,29,55.51891156462585,58.02666666666667,31,31,108,3,1
245,30,245,55.51891156462585,57.74802721088435,31,17,235,2,215
246,30,232,55.51891156462585,58.28208616780046,31,30,234,3,202
247,30,482,55.51891156462585,57.95700680272109,31,7,464,2,452
248,30,519,55.51891156462585,58.42140589569161,31,12,505,3,489
249,65,29,56.65668934240363,58.02666666666667,33,31,69,1,36
250,65,245,56.65668934240363,57.74802721088435,33,17,186,1,180
251,65,232,56.65668934240363,58.28208616780046,33,30,181,2,167
252,65,264,56.65668934240363,59.419863945578236,33,12,232,3,199
253,65,482,56.65668934240363,57.95700680272109,33,7,421,1,417
254,65,519,56.65668934240363,58.42140589569161,33,12,460,2,454
255,65,473,56.65668934240363,59.582403628117916,33,5,427,3,408
256,65,6,57.02820861678005,59.953922902494334,33,31,139,3,59
257,65,232,57.02820861678005,58.28208616780046,33,30,176,1,167
258,65,264,57.02820861678005,59.419863945578236,33,12,224,2,199
259,65,519,57.02820861678005,58.42140589569161,33,12,458,1,454
260,65,473,57.02820861678005,59.582403628117916,33,5,423,3,408
261,29,6,58.02666666666667,59.953922902494334,31,31,86,2,23
262,29,58,58.02666666666667,60.070022675736965,31,31,93,2,29
263,29,264,58.02666666666667,59.419863945578236,31,12,243,1,235
264,29,234,58.02666666666667,60.20934240362812,31,11,226,2,205
265,29,473,58.02666666666667,59.582403628117916,31,5,449,2,444
266,6,219,59.953922902494334,61.78829931972789,31,16,227,2,213
267,6,244,59.953922902494334,62.62421768707483,31,14,264,3,238
268,58,6,60.070022675736965,61.25424036281179,31,31,73,1,52
269,58,6,60.070022675736965,62.99573696145125,31,30,136,3,52
270,58,219,60.070022675736965,61.78829931972789,31,16,177,2,161
271,58,244,60.070022675736965,62.62421768707483,31,14,216,3,186
272,58,510,60.070022675736965,61.811519274376415,31,8,458,2,452
273,6,244,61.25424036281179,62.62421768707483,31,14,245,1,238
274,6,242,61.25424036281179,63.25115646258504,31,18,251,2,236
275,6,226,61.25424036281179,64.17995464852608,31,9,254,3,220
276,6,226,62.99573696145125,64.17995464852608,30,9,226,1,220
277,6,261,62.99573696145125,65.24807256235827,30,10,273,2,255
278,6,261,63.85487528344672,65.24807256235827,30,10,262,1,255
279,6,253,63.85487528344672,66.71092970521542,30,11,276,3,247
280,6,253,64.29605442176872,66.71092970521542,31,11,268,2,247
281,6,253,65.59637188208617,66.71092970521542,31,11,252,1,247
282,6,277,65.59637188208617,67.38430839002268,31,11,282,2,271
283,6,475,65.59637188208617,67.47718820861678,31,7,476,2,469
284,6,226,66.45551020408163,68.82394557823129,30,13,242,2,220
285,6,475,66.45551020408163,67.47718820861678,30,7,471,1,469
286,6,467,66.45551020408163,68.82394557823129,30,8,472,2,461
287,6,226,67.77904761904762,68.82394557823129,31,13,225,1,220
288,6,219,67.77904761904762,69.93850340136055,31,16,232,2,213
289,6,256,67.77904761904762,70.54222222222222,31,28,277,3,250
290,6,467,67.77904761904762,68.82394557823129,31,8,463,1,461
291,6,219,68.22022675736962,69.93850340136055,31,16,225,2,213
292,6,256,68.22022675736962,70.54222222222222,31,28,269,2,250
293,6,5,69.52054421768707,71.26204081632653,30,34,75,2,1
294,6,256,69.52054421768707,70.54222222222222,30,28,254,1,250
295,6,237,69.52054421768707,71.63356009070294,30,20,248,2,231
296,6,205,70.82086167800453,72.60879818594104,35,19,213,2,199
297,6,257,70.82086167800453,73.30539682539683,35,23,273,2,251
298,6,484,70.82086167800453,72.95709750566894,35,9,487,2,478
299,6,486,70.82086167800453,73.04997732426304,35,7,490,2,480
300,5,6,71.26204081632653,72.56235827664399,34,36,56,1,1
301,5,6,71.26204081632653,73.44471655328799,34,34,94,2,1
302,5,205,71.26204081632653,72.60879818594104,34,19,208,1,200
303,5,257,71.26204081632653,73.30539682539683,34,23,267,2,252
304,5,484,71.26204081632653,72.95709750566894,34,9,485,2,479
305,5,486,71.26204081632653,73.04997732426304,34,7,487,2,481
306,6,5,72.56235827664399,74.30385487528345,36,34,75,2,1
307,6,233,72.56235827664399,74.32707482993197,36,21,239,2,227
308,6,243,72.56235827664399,75.20943310657597,36,20,263,3,237
309,6,488,72.56235827664399,75.20943310657597,36,11,495,3,482
310,6,243,73.44471655328799,75.20943310657597,34,20,249,2,237
311,6,488,73.44471655328799,75.20943310657597,34,11,488,2,482
312,6,497,73.44471655328799,76.16145124716553,34,10,505,3,491
313,5,6,74.30385487528345,76.90448979591837,34,35,112,3,1
314,5,307,74.30385487528345,76.92770975056689,34,16,322,3,302
315,5,497,74.30385487528345,76.16145124716553,34,10,498,2,492
316,6,307,75.16299319727891,76.92770975056689,35,16,310,2,301
317,6,225,75.16299319727891,77.53142857142858,35,30,242,2,219
318,6,58,76.90448979591837,78.99428571428571,35,36,104,2,52
319,6,58,76.90448979591837,79.01750566893425,35,36,105,2,52
320,6,227,76.90448979591837,78.25124716553289,35,23,228,1,221
321,6,450,76.90448979591837,79.62122448979592,35,15,459,3,444
322,6,58,77.34566893424036,78.99428571428571,34,36,88,2,52
323,6,58,77.34566893424036,79.01750566893425,34,36,89,2,52
324,6,240,77.34566893424036,79.92308390022676,34,29,259,3,234
325,6,242,77.34566893424036,80.0391836734694,34,30,263,3,236
326,6,450,77.34566893424036,79.62122448979592,34,15,455,2,444
327,58,5,78.99428571428571,80.38748299319728,36,35,80,1,53
328,58,242,78.99428571428571,80.0391836734694,36,30,189,1,184
329,58,225,78.99428571428571,81.75746031746031,36,24,205,3,167
330,58,516,78.99428571428571,80.92154195011338,36,16,465,2,458
331,58,485,78.99428571428571,81.87356009070295,36,14,445,3,427
332,58,5,79.01750566893425,80.38748299319728,36,35,79,1,53
333,58,242,79.01750566893425,80.0391836734694,36,30,189,1,184
334,58,225,79.01750566893425,81.75746031746031,36,24,204,3,167
335,58,516,79.01750566893425,80.92154195011338,36,16,465,2,458
336,58,485,79.01750566893425,81.87356009070295,36,14,444,3,427
337,5,58,80.38748299319728,81.43238095238095,35,35,70,1,53
338,5,225,80.38748299319728,81.75746031746031,35,24,228,1,220
339,5,243,80.38748299319728,82.03609977324263,35,20,248,2,238
340,5,205,80.38748299319728,83.17387755102041,35,19,233,3,200
341,5,485,80.38748299319728,81.87356009070295,35,14,484,1,480
342,5,484,80.38748299319728,82.08253968253969,35,6,485,2,479
343,58,5,81.43238095238095,82.9881179138322,35,34,85,2,53
344,58,6,81.43238095238095,83.4292970521542,35,35,100,2,52
345,58,65,81.43238095238095,84.38131519274377,35,35,127,3,7
346,58,205,81.43238095238095,83.17387755102041,35,19,165,2,147
347,58,505,81.43238095238095,83.26675736961451,35,7,454,2,447
348,5,65,82.9881179138322,84.38131519274377,34,35,85,1,60
349,5,6,82.9881179138322,85.58875283446712,34,35,112,3,1
350,5,224,82.9881179138322,84.89215419501134,34,17,234,2,219
351,5,227,82.9881179138322,85.2172335600907,34,27,242,2,222
352,5,478,82.9881179138322,84.65995464852608,34,14,478,2,473
353,6,5,83.4292970521542,86.02993197278911,35,35,112,3,1
354,6,224,83.4292970521542,84.89215419501134,35,17,227,1,218
355,6,227,83.4292970521542,85.2172335600907,35,27,234,2,221
356,6,478,83.4292970521542,84.65995464852608,35,14,475,1,472
357,65,6,84.38131519274377,85.58875283446712,35,35,79,1,59
358,65,5,84.38131519274377,86.02993197278911,35,35,93,2,60
359,65,205,84.38131519274377,86.49433106575964,35,18,167,2,140
360,65,236,84.38131519274377,87.05160997732426,35,18,206,3,171
361,65,511,84.38131519274377,86.44789115646259,35,13,455,2,446
362,6,236,85.58875283446712,87.05160997732426,35,18,238,1,230
363,6,227,85.58875283446712,88.25904761904762,35,26,249,3,221
364,6,492,85.58875283446712,88.00362811791383,35,12,497,2,486
365,6,483,85.58875283446712,88.25904761904762,35,14,491,3,477
366,5,6,86.02993197278911,87.77142857142857,35,34,75,2,1
367,5,58,86.02993197278911,88.93242630385488,35,35,136,3,53
368,5,236,86.02993197278911,87.05160997732426,35,18,235,1,231
369,5,227,86.02993197278911,88.25904761904762,35,26,242,2,222
370,5,492,86.02993197278911,88.00362811791383,35,12,494,2,487
371,5,483,86.02993197278911,88.25904761904762,35,14,488,2,478
372,6,58,87.77142857142857,88.93242630385488,34,35,72,1,52
373,6,16,87.77142857142857,90.34884353741496,34,35,111,3,10
374,6,261,87.77142857142857,89.11818594104308,34,17,262,1,255
375,6,253,87.77142857142857,90.25596371882087,34,16,269,2,247
376,58,16,88.93242630385488,90.34884353741496,35,35,74,1,42
377,58,6,88.93242630385488,91.25442176870749,35,35,113,2,52
378,58,253,88.93242630385488,90.25596371882087,35,16,203,1,195
379,58,232,88.93242630385488,91.78848072562359,35,20,213,3,174
380,58,528,88.93242630385488,90.69714285714286,35,8,476,2,470
381,58,529,88.93242630385488,91.18476190476191,35,13,481,2,471
382,6,16,89.07174603174603,90.34884353741496,36,35,56,1,10
383,6,253,89.07174603174603,90.25596371882087,36,16,252,1,247
384,6,232,89.07174603174603,91.78848072562359,36,20,254,3,226
385,16,6,90.34884353741496,92.57795918367347,35,36,97,2,10
386,16,232,90.34884353741496,91.78848072562359,35,20,225,1,216
387,16,231,90.34884353741496,92.53151927437642,35,18,235,2,215
388,16,439,90.34884353741496,93.25133786848073,35,8,441,3,423
389,6,231,91.25442176870749,92.53151927437642,35,18,232,1,225
390,6,205,91.25442176870749,93.59963718820862,35,18,223,2,199
391,6,439,91.25442176870749,93.25133786848073,35,8,441,2,433
392,6,5,92.57795918367347,94.7374149659864,36,35,93,2,1
393,6,55,92.57795918367347,95.06249433106576,36,35,118,2,49
394,6,205,92.57795918367347,93.59963718820862,36,18,204,1,199
395,6,220,92.57795918367347,94.8302947845805,36,15,235,2,214
396,6,254,92.57795918367347,95.17859410430839,36,15,272,3,248
397,6,482,92.57795918367347,94.57487528344672,36,14,484,2,476
398,6,5,93.43709750566893,94.7374149659864,35,35,56,1,1
399,6,55,93.43709750566893,95.06249433106576,35,35,85,2,49
400,6,220,93.43709750566893,94.8302947845805,35,15,222,1,214
401,6,254,93.43709750566893,95.17859410430839,35,15,259,2,248
402,6,353,93.43709750566893,96.20027210884354,35,17,367,3,347
403,6,482,93.43709750566893,94.57487528344672,35,14,479,1,476
404,5,6,94.7374149659864,96.89687074829932,35,35,93,2,1
405,5,353,94.7374149659864,96.20027210884354,35,17,354,1,348
406,5,232,94.7374149659864,97.500589569161,35,15,256,3,227
407,5,464,94.7374149659864,96.59501133786848,35,8,466,2,459
408,5,482,94.7374149659864,97.05941043083901,35,4,487,2,477
409,55,6,95.06249433106576,96.89687074829932,35,35,93,2,49
410,55,5,95.06249433106576,97.77922902494332,35,35,127,3,50
411,55,353,95.06249433106576,96.20027210884354,35,17,302,1,298
412,55,232,95.06249433106576,97.500589569161,35,15,206,2,177
413,55,464,95.06249433106576,96.59501133786848,35,8,414,2,409
414,55,482,95.06249433106576,97.05941043083901,35,4,436,2,427
415,6,216,96.89687074829932,98.82412698412699,35,18,226,2,210
416,6,216,96.89687074829932,99.56716553287983,35,16,239,3,210
417,6,488,96.89687074829932,98.47582766439909,35,7,487,2,482
418,6,429,96.89687074829932,99.6368253968254,35,15,439,3,423
419,5,6,97.77922902494332,99.52072562358276,35,31,75,2,1
420,5,216,97.77922902494332,98.82412698412699,35,18,216,1,211
421,5,216,97.77922902494332,99.56716553287983,35,16,225,2,211
422,5,429,97.77922902494332,99.6368253968254,35,15,431,2,424
423,5,431,97.77922902494332,100.0780045351474,35,12,437,2,426
424,6,216,98.2204081632653,99.56716553287983,35,16,218,1,210
425,6,343,98.2204081632653,100.84426303854876,35,20,355,3,337
426,6,343,98.2204081632653,101.03002267573696,35,19,358,3,337
427,6,429,98.2204081632653,99.6368253968254,35,15,427,1,423
428,6,431,98.2204081632653,100.0780045351474,35,12,432,2,425
429,6,343,99.52072562358276,100.84426303854876,31,20,342,1,337
430,6,343,99.52072562358276,101.03002267573696,31,19,343,2,337
431,6,339,99.52072562358276,102.35356009070296,31,19,355,3,333
432,6,412,99.52072562358276,101.72662131519274,31,12,417,2,406
433,6,339,100.82104308390024,102.35356009070296,31,19,339,2,333
434,6,340,100.82104308390024,103.72353741496599,31,21,357,3,334
435,6,7,101.70340136054422,104.28081632653061,30,30,111,3,1
436,6,340,101.70340136054422,103.72353741496599,30,21,345,2,334
437,6,7,102.1213605442177,104.28081632653061,31,30,93,2,1
438,6,340,102.1213605442177,103.72353741496599,31,21,341,2,334
439,6,254,102.1213605442177,104.79165532879819,31,16,273,3,248
440,6,254,103.42167800453515,104.79165532879819,31,16,255,1,248
441,6,309,103.42167800453515,105.74367346938776,31,19,319,2,303
442,7,6,104.28081632653061,105.6043537414966,30,31,57,1,1
443,7,6,104.28081632653061,106.90467120181407,30,31,113,3,1
444,7,309,104.28081632653061,105.74367346938776,30,19,309,1,302
445,7,309,104.28081632653061,106.62603174603174,30,20,318,2,302
446,7,433,104.28081632653061,106.53315192743764,30,11,437,2,426
447,7,459,104.28081632653061,107.25297052154195,30,14,470,3,452
448,6,309,105.6043537414966,106.62603174603174,31,20,306,1,303
449,6,337,105.6043537414966,107.99600907029479,31,15,347,2,331
450,6,459,105.6043537414966,107.25297052154195,31,14,459,2,453
451,6,426,105.6043537414966,108.32108843537415,31,12,436,3,420
452,6,10,106.90467120181407,109.50530612244899,31,32,112,3,4
453,6,337,106.90467120181407,107.99600907029479,31,15,334,1,331
454,6,307,106.90467120181407,108.8087074829932,31,21,312,2,301
455,6,308,106.90467120181407,109.62140589569161,31,26,324,3,302
456,6,426,106.90467120181407,108.32108843537415,31,12,424,1,420
457,6,10,107.34585034013605,109.50530612244899,30,32,93,2,4
458,6,307,107.34585034013605,108.8087074829932,30,21,308,1,301
459,6,308,107.34585034013605,109.62140589569161,30,26,318,2,302
460,6,10,108.20498866213153,109.50530612244899,31,32,56,1,4
461,6,41,108.20498866213153,110.6895238095238,31,31,113,2,35
462,6,308,108.20498866213153,109.62140589569161,31,26,308,1,302
463,6,307,108.20498866213153,110.89850340136054,31,20,323,3,301
464,10,41,109.50530612244899,110.6895238095238,32,31,60,1,31
465,10,48,109.50530612244899,111.92018140589569,32,31,111,2,38
466,10,307,109.50530612244899,110.89850340136054,32,20,303,1,297
467,10,307,109.50530612244899,111.78086167800454,32,17,313,2,297
468,10,244,109.50530612244899,112.08272108843538,32,15,259,3,234
469,41,48,110.6895238095238,111.92018140589569,31,31,53,1,7
470,41,73,110.6895238095238,112.75609977324264,31,31,95,2,32
471,41,307,110.6895238095238,111.78086167800454,31,17,270,1,266
472,41,244,110.6895238095238,112.08272108843538,31,15,212,1,203
473,41,462,110.6895238095238,113.01151927437643,31,8,433,2,421
474,41,462,110.6895238095238,113.05795918367347,31,9,433,2,421
475,48,43,111.92018140589569,113.7081179138322,31,32,77,2,5
476,48,14,111.92018140589569,114.89233560090703,31,32,132,3,34
477,48,261,111.92018140589569,113.89387755102041,31,14,229,2,213
478,48,245,111.92018140589569,114.35827664399093,31,13,223,2,197
479,48,462,111.92018140589569,113.01151927437643,31,8,417,1,414
480,48,462,111.92018140589569,113.05795918367347,31,9,417,1,414
481,48,497,111.92018140589569,114.03319727891157,31,3,458,2,449
482,73,14,112.75609977324264,114.89233560090703,31,32,109,2,59
483,73,261,112.75609977324264,113.89387755102041,31,14,194,1,188
484,73,245,112.75609977324264,114.35827664399093,31,13,185,2,172
485,73,269,112.75609977324264,115.65859410430839,31,10,232,3,196
486,73,497,112.75609977324264,114.03319727891157,31,3,428,1,424
487,43,14,113.7081179138322,114.89233560090703,32,32,59,1,29
488,43,44,113.7081179138322,115.79791383219955,32,32,90,2,1
489,43,38,113.7081179138322,116.28553287981859,32,31,111,3,5
490,43,269,113.7081179138322,115.65859410430839,32,10,241,2,226
491,43,269,113.7081179138322,116.09977324263039,32,12,248,2,226
492,43,532,113.7081179138322,115.82113378684808,32,5,497,2,489
493,43,496,113.7081179138322,116.51773242630385,32,5,469,3,453
494,14,38,114.89233560090703,116.28553287981859,32,31,65,1,24
495,14,269,114.89233560090703,116.09977324263039,32,12,260,1,255
496,14,269,114.89233560090703,117.56263038548754,32,14,280,3,255
497,14,496,114.89233560090703,116.51773242630385,32,5,487,2,482
498,44,49,115.79791383219955,118.02702947845805,32,32,96,2,5
499,44,48,115.79791383219955,118.46820861678005,32,31,115,3,4
500,44,269,115.79791383219955,117.56263038548754,32,14,237,2,225
501,44,270,115.79791383219955,118.25922902494331,32,10,250,2,226
502,44,516,115.79791383219955,117.8877097505669,32,7,481,2,472
503,38,49,116.28553287981859,118.02702947845805,31,32,76,2,11
504,38,48,116.28553287981859,118.46820861678005,31,31,95,2,10
505,38,269,116.28553287981859,117.56263038548754,31,14,237,1,231
506,38,270,116.28553287981859,118.25922902494331,31,10,247,2,232
507,38,516,116.28553287981859,117.8877097505669,31,7,483,2,478
508,38,533,116.28553287981859,119.25768707482993,31,7,511,3,495
509,49,52,118.02702947845805,120.2097052154195,32,31,94,2,3
510,49,268,118.02702947845805,119.97750566893424,32,14,235,2,219
511,49,270,118.02702947845805,120.6508843537415,32,11,248,3,221
512,49,533,118.02702947845805,119.25768707482993,32,7,487,1,484
513,49,539,118.02702947845805,120.53478458049887,32,8,502,3,490
514,48,49,118.46820861678005,119.72208616780046,31,31,54,1,1
515,48,52,118.46820861678005,120.2097052154195,31,31,75,2,4
516,48,5,118.46820861678005,121.2778231292517,31,28,128,3,43
517,48,268,118.46820861678005,119.97750566893424,31,14,229,2,220
518,48,270,118.46820861678005,120.6508843537415,31,11,241,2,222
519,48,242,118.46820861678005,121.16172335600908,31,13,226,3,194
520,48,539,118.46820861678005,120.53478458049887,31,8,499,2,491
521,48,545,118.46820861678005,121.39392290249434,31,6,513,3,497
522,49,5,119.72208616780046,121.2778231292517,31,28,80,2,44
523,49,242,119.72208616780046,121.16172335600908,31,13,203,1,193
524,49,230,119.72208616780046,122.11374149659864,31,13,208,2,181
525,49,545,119.72208616780046,121.39392290249434,31,6,501,2,496
526,49,479,119.72208616780046,122.50848072562358,31,6,446,3,430
527,52,5,120.2097052154195,121.2778231292517,31,28,66,1,47
528,52,19,120.2097052154195,122.99609977324263,31,32,124,3,33
529,52,230,120.2097052154195,122.11374149659864,31,13,196,2,178
530,52,269,120.2097052154195,123.04253968253968,31,12,249,3,217
531,52,545,120.2097052154195,121.39392290249434,31,6,496,1,493
532,52,479,120.2097052154195,122.50848072562358,31,6,438,2,427
533,5,19,121.2778231292517,122.99609977324263,28,32,75,2,14
534,5,20,121.2778231292517,123.55337868480726,28,33,99,2,15
535,5,269,121.2778231292517,123.04253968253968,28,12,275,2,264
536,5,247,121.2778231292517,124.18031746031747,28,13,272,3,242
537,5,479,121.2778231292517,122.50848072562358,28,6,477,1,474
538,19,44,122.99609977324263,124.50539682539683,32,32,70,2,25
539,19,247,122.99609977324263,124.18031746031747,32,13,234,1,228
540,19,257,122.99609977324263,125.92181405895691,32,19,269,3,238
541,19,516,122.99609977324263,124.06421768707483,32,5,499,1,497
542,19,499,122.99609977324263,125.6431746031746,32,11,493,3,480
543,20,12,123.55337868480726,126.01469387755103,33,31,106,2,8
544,20,65,123.55337868480726,126.4326530612245,33,34,132,3,45
545,20,257,123.55337868480726,125.92181405895691,33,19,258,2,237
546,20,206,123.55337868480726,126.45587301587302,33,16,224,3,186
547,20,499,123.55337868480726,125.6431746031746,33,11,487,2,479
548,44,12,124.50539682539683,126.01469387755103,32,31,72,2,32
549,44,65,124.50539682539683,126.4326530612245,32,34,86,2,21
550,44,6,124.50539682539683,127.33823129251701,32,35,128,3,38
551,44,257,124.50539682539683,125.92181405895691,32,19,222,1,213
552,44,206,124.50539682539683,126.45587301587302,32,16,182,2,162
553,44,499,124.50539682539683,125.6431746031746,32,11,458,1,455
554,44,480,124.50539682539683,126.89705215419501,32,8,448,2,436
555,12,6,126.01469387755103,127.33823129251701,31,35,57,1,6
556,12,7,126.01469387755103,128.19736961451247,31,33,94,2,5
557,12,233,126.01469387755103,128.03482993197278,31,22,238,2,221
558,12,232,126.01469387755103,128.17414965986396,31,27,239,2,220
559,12,495,126.01469387755103,128.03482993197278,31,13,491,2,483
560,65,7,126.4326530612245,128.19736961451247,34,33,96,2,58
561,65,233,126.4326530612245,128.03482993197278,34,22,182,2,168
562,65,232,126.4326530612245,128.17414965986396,34,27,183,2,167
563,65,495,126.4326530612245,128.03482993197278,34,13,436,2,430
564,65,519,126.4326530612245,128.10448979591837,34,15,460,2,454
565,6,58,127.33823129251701,129.75310657596373,35,33,116,2,52
566,6,232,127.33823129251701,129.96208616780046,35,16,253,3,226
567,6,452,127.33823129251701,129.49768707482994,35,12,456,2,446
568,7,58,128.19736961451247,129.75310657596373,33,33,84,2,51
569,7,11,128.19736961451247,130.3568253968254,33,32,93,2,4
570,7,232,128.19736961451247,129.96208616780046,33,16,237,2,225
571,7,231,128.19736961451247,130.91410430839002,33,21,253,3,224
572,7,452,128.19736961451247,129.49768707482994,33,12,449,1,445
573,58,24,129.75310657596373,131.5178231292517,33,32,83,2,34
574,58,231,129.75310657596373,130.91410430839002,33,21,180,1,173
575,58,235,129.75310657596373,131.44816326530614,33,15,191,2,177
576,58,437,129.75310657596373,131.65714285714287,33,12,388,2,379
577,58,479,129.75310657596373,132.12154195011337,33,12,433,2,421
578,11,24,130.3568253968254,131.5178231292517,32,32,52,1,13
579,11,48,130.3568253968254,132.84136054421768,32,33,113,2,37
580,11,49,130.3568253968254,133.2825396825397,32,33,132,3,38
581,11,235,130.3568253968254,131.44816326530614,32,15,229,1,224
582,11,239,130.3568253968254,132.9342403628118,32,16,254,3,228
583,11,437,130.3568253968254,131.65714285714287,32,12,430,1,426
584,11,479,130.3568253968254,132.12154195011337,32,12,474,2,468
585,24,48,131.5178231292517,132.84136054421768,32,33,62,1,24
586,24,49,131.5178231292517,133.2825396825397,32,33,80,2,25
587,24,239,131.5178231292517,132.9342403628118,32,16,223,1,215
588,24,206,131.5178231292517,133.67727891156463,32,16,204,2,182
589,24,480,131.5178231292517,133.83981859410432,32,12,467,2,456
590,48,7,132.84136054421768,134.7221768707483,33,32,91,2,41
591,48,14,132.84136054421768,135.58131519274377,33,34,123,3,34
592,48,349,132.84136054421768,134.67573696145126,33,17,311,2,301
593,48,355,132.84136054421768,135.65097505668933,33,15,330,3,307
594,48,480,132.84136054421768,135.60453514739228,33,11,448,3,432
595,49,7,133.2825396825397,134.7221768707483,33,32,75,1,42
596,49,14,133.2825396825397,135.58131519274377,33,34,105,2,35
597,49,349,133.2825396825397,134.67573696145126,33,17,306,1,300
598,49,355,133.2825396825397,135.65097505668933,33,15,323,2,306
599,49,480,133.2825396825397,135.60453514739228,33,11,442,2,431
600,7,44,134.7221768707483,136.74231292517007,32,35,95,2,37
601,7,33,134.7221768707483,137.27637188208618,32,33,113,3,26
602,7,291,134.7221768707483,137.0209523809524,32,16,301,2,284
603,7,434,134.7221768707483,136.27791383219954,32,10,432,2,427
604,14,44,135.58131519274377,136.74231292517007,34,35,58,1,30
605,14,33,135.58131519274377,137.27637188208618,34,33,75,2,19
606,14,38,135.58131519274377,138.06585034013605,34,33,110,2,24
607,14,291,135.58131519274377,137.0209523809524,34,16,284,1,277
608,14,268,135.58131519274377,137.9497505668934,34,18,274,2,254
609,14,230,135.58131519274377,138.2748299319728,34,16,245,3,216
610,14,480,135.58131519274377,137.9961904761905,34,13,477,2,466
611,14,459,135.58131519274377,138.34448979591838,34,6,461,3,445
612,44,38,136.74231292517007,138.06585034013605,35,33,57,1,6
613,44,268,136.74231292517007,137.9497505668934,35,18,230,1,224
614,44,230,136.74231292517007,138.2748299319728,35,16,197,2,186
615,44,480,136.74231292517007,137.9961904761905,35,13,439,1,436
616,44,459,136.74231292517007,138.34448979591838,35,6,421,2,415
617,33,6,137.27637188208618,139.94666666666666,33,33,118,3,27
618,33,223,137.27637188208618,140.0395464852608,33,29,224,3,190
619,33,223,137.27637188208618,140.0627664399093,33,29,225,3,190
620,33,459,137.27637188208618,138.34448979591838,33,6,428,1,426
621,33,510,137.27637188208618,140.0395464852608,33,13,492,3,477
622,33,511,137.27637188208618,140.08598639455784,33,16,493,3,478
623,38,6,138.06585034013605,139.94666666666666,33,33,87,2,32
624,38,66,138.06585034013605,140.64326530612246,33,36,114,3,28
625,38,223,138.06585034013605,140.0395464852608,33,29,204,2,185
626,38,223,138.06585034013605,140.0627664399093,33,29,204,2,185
627,38,510,138.06585034013605,140.0395464852608,33,13,480,2,472
628,38,511,138.06585034013605,140.08598639455784,33,16,481,2,473
629,6,59,139.94666666666666,141.54884353741497,33,35,87,2,53
630,6,239,139.94666666666666,141.20054421768708,33,18,239,1,233
631,6,256,139.94666666666666,142.918820861678,33,23,281,3,250
632,6,493,139.94666666666666,142.50086167800453,33,10,499,3,487
633,66,6,140.64326530612246,142.12934240362813,36,35,88,1,60
634,66,56,140.64326530612246,143.5457596371882,36,35,125,3,10
635,66,256,140.64326530612246,142.918820861678,36,23,214,2,190
636,66,493,140.64326530612246,142.50086167800453,36,10,434,2,427
637,59,56,141.54884353741497,143.5457596371882,35,35,86,2,3
638,59,256,141.54884353741497,142.918820861678,35,23,206,1,197
639,59,290,141.54884353741497,143.6386394557823,35,20,248,2,231
640,59,473,141.54884353741497,143.9637188208617,35,9,427,2,414
641,6,56,142.12934240362813,143.5457596371882,35,35,79,1,50
642,6,5,142.12934240362813,144.72997732426305,35,35,112,3,1
643,6,290,142.12934240362813,143.6386394557823,35,20,291,2,284
644,6,205,142.12934240362813,144.7764172335601,35,24,229,3,199
645,6,473,142.12934240362813,143.9637188208617,35,9,474,2,467
646,6,487,142.12934240362813,144.7764172335601,35,11,494,3,481
647,56,5,143.5457596371882,144.72997732426305,35,35,72,1,51
648,56,6,143.5457596371882,146.0302947845805,35,34,118,2,50
649,56,39,143.5457596371882,146.26249433106577,35,34,118,3,17
650,56,205,143.5457596371882,144.7764172335601,35,24,158,1,149
651,56,205,143.5457596371882,145.63555555555556,35,17,174,2,149
652,56,487,143.5457596371882,144.7764172335601,35,11,434,1,431
653,56,471,143.5457596371882,145.54267573696146,35,12,424,2,415
654,5,6,144.72997732426305,146.0302947845805,35,34,56,1,1
655,5,39,144.72997732426305,146.26249433106577,35,34,74,2,34
656,5,223,144.72997732426305,147.02875283446713,35,24,239,2,218
657,5,225,144.72997732426305,147.14485260770977,35,26,243,2,220
658,6,58,146.0302947845805,148.6077097505669,34,36,123,3,52
659,6,225,146.0302947845805,147.14485260770977,34,26,224,1,219
660,6,229,146.0302947845805,148.05043083900227,34,20,239,2,223
661,39,6,146.26249433106577,147.77179138321995,34,36,73,2,33
662,39,58,146.26249433106577,148.6077097505669,34,36,103,2,19
663,39,6,146.26249433106577,149.07210884353742,34,35,125,3,33
664,39,229,146.26249433106577,148.05043083900227,34,20,205,2,190
665,39,450,146.26249433106577,149.18820861678006,34,13,430,3,411
666,6,242,147.77179138321995,149.582947845805,36,26,249,2,236
667,6,450,147.77179138321995,149.18820861678006,36,13,448,1,444
668,58,205,148.6077097505669,150.90648526077098,36,21,177,2,147
669,58,227,148.6077097505669,151.32444444444445,36,27,206,3,169
670,58,463,148.6077097505669,151.41732426303855,36,13,423,3,405
671,6,58,149.07210884353742,150.95292517006803,35,36,96,2,52
672,6,58,149.07210884353742,151.09224489795918,35,37,101,2,52
673,6,205,149.07210884353742,150.90648526077098,35,21,214,2,199
674,6,227,149.07210884353742,151.32444444444445,35,27,241,2,221
675,6,463,149.07210884353742,151.41732426303855,35,13,468,2,457
676,58,6,150.95292517006803,152.99628117913832,36,34,102,2,52
677,58,205,150.95292517006803,152.57832199546485,36,18,163,2,147
678,58,307,150.95292517006803,153.4374603174603,36,20,271,2,249
679,58,496,150.95292517006803,152.92662131519273,36,4,446,2,438
680,58,6,151.09224489795918,152.99628117913832,37,34,97,2,52
681,58,64,151.09224489795918,153.94829931972788,37,35,123,3,6
682,58,205,151.09224489795918,152.57832199546485,37,18,160,1,147
683,58,307,151.09224489795918,153.4374603174603,37,20,269,2,249
684,58,496,151.09224489795918,152.92662131519273,37,4,445,2,438
685,58,423,151.09224489795918,154.041179138322,37,7,386,3,365
686,6,5,152.99628117913832,154.2965986394558,34,33,56,1,1
687,6,230,152.99628117913832,154.73777777777778,34,25,236,2,224
688,6,423,152.99628117913832,154.041179138322,34,7,419,1,417
689,6,486,152.99628117913832,154.90031746031747,34,14,487,2,480
690,64,5,153.94829931972788,156.03809523809525,35,35,108,2,59
691,64,5,153.94829931972788,156.47927437641724,35,34,124,3,59
692,64,205,153.94829931972788,156.03809523809525,35,20,167,2,141
693,64,236,153.94829931972788,156.57215419501134,35,22,206,3,172
694,64,563,153.94829931972788,155.9916553287982,35,14,507,2,499
695,64,520,153.94829931972788,156.6185941043084,35,9,470,3,456
696,5,205,154.2965986394558,156.03809523809525,33,20,214,2,200
697,5,236,154.2965986394558,156.57215419501134,33,22,251,2,231
698,5,6,156.03809523809525,157.7795918367347,35,35,75,2,1
699,5,6,156.03809523809525,158.19755102040816,35,35,93,2,1
700,5,205,156.03809523809525,157.8724716553288,35,31,215,2,200
701,5,237,156.03809523809525,158.26721088435374,35,24,251,2,232
702,5,6,156.47927437641724,157.7795918367347,34,35,56,1,1
703,5,6,156.47927437641724,158.19755102040816,34,35,74,2,1
704,5,205,156.47927437641724,157.8724716553288,34,31,209,1,200
705,5,237,156.47927437641724,158.26721088435374,34,24,244,2,232
706,6,47,157.7795918367347,159.84616780045351,35,35,98,2,41
707,6,205,157.7795918367347,159.68362811791383,35,18,215,2,199
708,6,246,157.7795918367347,160.47310657596373,35,15,267,3,240
709,6,47,158.19755102040816,159.84616780045351,35,35,82,2,41
710,6,205,158.19755102040816,159.68362811791383,35,18,209,1,199
711,6,246,158.19755102040816,160.47310657596373,35,15,259,2,240
712,47,6,159.84616780045351,161.2625850340136,35,34,73,1,41
713,47,6,159.84616780045351,162.12172335600908,35,36,106,2,41
714,47,263,159.84616780045351,161.91274376417235,35,20,234,2,216
715,47,506,159.84616780045351,162.0520634920635,35,10,469,2,459
716,47,510,159.84616780045351,162.09850340136055,35,11,473,2,463
717,6,263,160.8214058956916,161.91274376417235,35,20,261,1,257
718,6,255,160.8214058956916,162.98086167800454,35,17,266,2,249
719,6,205,160.8214058956916,163.16662131519274,35,19,223,2,199
720,6,255,161.2625850340136,162.98086167800454,34,17,260,2,249
721,6,205,161.2625850340136,163.16662131519274,34,19,215,2,199
722,6,5,162.12172335600908,164.30439909297053,36,34,94,2,1
723,6,205,162.12172335600908,163.16662131519274,36,19,204,1,199
724,6,205,162.12172335600908,164.79201814058956,36,16,230,3,199
725,6,205,163.42204081632653,164.79201814058956,35,16,208,1,199
726,6,205,163.42204081632653,165.67437641723356,35,14,221,2,199
727,5,6,164.30439909297053,166.04589569160999,34,35,75,2,1
728,5,6,164.30439909297053,166.90503401360544,34,34,112,3,1
729,5,205,164.30439909297053,165.67437641723356,34,14,209,1,200
730,5,205,164.30439909297053,166.5102947845805,34,19,221,2,200
731,5,456,164.30439909297053,166.9514739229025,34,8,465,3,451
732,6,5,166.04589569160999,167.78739229024944,35,36,75,2,1
733,6,13,166.04589569160999,168.22857142857143,35,29,94,2,7
734,6,295,166.04589569160999,167.69451247165534,35,19,298,2,289
735,6,474,166.04589569160999,168.50721088435375,35,7,480,2,468
736,6,13,166.90503401360544,168.22857142857143,34,29,57,1,7
737,6,51,166.90503401360544,169.11092970521543,34,26,105,2,45
738,6,308,166.90503401360544,169.04126984126984,34,15,316,2,302
739,6,231,166.90503401360544,169.3663492063492,34,14,249,2,225
740,6,474,166.90503401360544,168.50721088435375,34,7,473,2,468
741,6,473,166.90503401360544,169.3663492063492,34,7,479,2,467
742,5,51,167.78739229024944,169.11092970521543,36,26,73,1,46
743,5,308,167.78739229024944,169.04126984126984,36,15,308,1,303
744,5,231,167.78739229024944,169.3663492063492,36,14,236,2,226
745,5,233,167.78739229024944,170.17904761904762,36,15,250,2,228
746,5,473,167.78739229024944,169.3663492063492,36,7,473,2,468
747,5,472,167.78739229024944,170.75954648526078,36,7,484,3,467
748,13,16,168.22857142857143,170.80598639455783,29,26,111,3,3
749,13,231,168.22857142857143,169.3663492063492,29,14,223,1,218
750,13,233,168.22857142857143,170.17904761904762,29,15,235,2,220
751,13,473,168.22857142857143,169.3663492063492,29,7,463,1,460
752,13,472,168.22857142857143,170.75954648526078,29,7,472,3,459
753,13,464,168.22857142857143,171.10784580498867,29,4,468,3,451
754,51,16,169.11092970521543,170.80598639455783,26,26,81,2,35
755,51,13,169.11092970521543,171.27038548752836,26,32,100,2,38
756,51,233,169.11092970521543,170.17904761904762,26,15,188,1,182
757,51,311,169.11092970521543,171.34004535147392,26,15,277,2,260
758,51,472,169.11092970521543,170.75954648526078,26,7,427,2,421
759,51,464,169.11092970521543,171.10784580498867,26,4,422,2,413
760,16,51,170.80598639455783,172.10630385487528,26,31,66,1,35
761,16,232,170.80598639455783,172.87256235827664,26,15,234,2,216
762,16,465,170.80598639455783,172.80290249433108,26,3,457,2,449
763,13,16,171.27038548752836,173.22086167800452,32,28,84,2,3
764,13,232,171.27038548752836,172.87256235827664,32,15,230,2,219
765,13,231,171.27038548752836,173.8942403628118,32,17,246,3,218
766,13,465,171.27038548752836,172.80290249433108,32,3,457,2,452
767,13,464,171.27038548752836,173.94068027210884,32,3,465,3,451
768,51,16,172.10630385487528,173.22086167800452,31,28,59,1,35
769,51,26,172.10630385487528,174.79981859410432,31,28,119,3,25
770,51,231,172.10630385487528,173.8942403628118,31,17,196,2,180
771,51,232,172.10630385487528,174.38185941043085,31,15,206,2,181
772,51,464,172.10630385487528,173.94068027210884,31,3,420,2,413
773,51,457,172.10630385487528,174.73015873015873,31,4,421,3,406
774,16,26,173.22086167800452,174.79981859410432,28,28,69,2,10
775,16,26,173.22086167800452,175.35709750566895,28,31,93,2,10
776,16,51,173.22086167800452,176.07691609977326,28,29,128,3,35
777,16,232,173.22086167800452,174.38185941043085,28,15,222,1,216
778,16,232,173.22086167800452,175.19455782312926,28,14,232,2,216
779,16,457,173.22086167800452,174.73015873015873,28,4,446,2,441
780,16,416,173.22086167800452,175.17133786848072,28,2,409,2,400
781,26,51,174.79981859410432,176.07691609977326,28,29,60,1,25
782,26,16,174.79981859410432,177.12181405895691,28,29,100,2,10
783,26,232,174.79981859410432,176.26267573696146,28,13,215,1,206
784,26,289,174.79981859410432,177.3772335600907,28,13,285,3,263
785,26,473,174.79981859410432,176.70385487528344,28,5,454,2,447
786,26,16,175.35709750566895,177.12181405895691,31,29,77,2,10
787,26,289,175.35709750566895,177.3772335600907,31,13,277,2,263
788,26,314,175.35709750566895,178.21315192743765,31,12,313,3,288
789,26,473,175.35709750566895,176.70385487528344,31,5,451,1,447
790,26,464,175.35709750566895,178.05061224489796,31,3,453,3,438
791,26,464,175.35709750566895,178.0738321995465,31,5,453,3,438
792,51,16,176.07691609977326,177.12181405895691,29,29,57,1,35
793,51,14,176.07691609977326,178.4221315192744,29,29,108,2,37
794,51,289,176.07691609977326,177.3772335600907,29,13,244,1,238
795,51,314,176.07691609977326,178.21315192743765,29,12,279,2,263
796,51,464,176.07691609977326,178.05061224489796,29,3,422,2,413
797,51,464,176.07691609977326,178.0738321995465,29,5,422,2,413
798,16,14,177.12181405895691,178.4221315192744,29,29,56,1,2
799,16,14,177.12181405895691,179.5134693877551,29,28,103,2,2
800,16,314,177.12181405895691,178.21315192743765,29,12,302,1,298
801,16,239,177.12181405895691,179.420589569161,29,11,244,2,223
802,14,78,178.4221315192744,180.90666666666667,29,33,125,2,64
803,14,222,178.4221315192744,180.51192743764173,29,14,227,2,208
804,14,255,178.4221315192744,181.32462585034014,29,13,271,3,241
805,14,457,178.4221315192744,180.79056689342403,29,10,455,2,443
806,14,445,178.4221315192744,181.3014058956916,29,10,448,3,431
807,14,78,179.5134693877551,180.90666666666667,28,33,88,1,64
808,14,5,179.5134693877551,181.69614512471657,28,35,94,2,9
809,14,6,179.5134693877551,182.11410430839004,28,36,112,3,8
810,14,255,179.5134693877551,181.32462585034014,28,13,253,2,241
811,14,457,179.5134693877551,180.79056689342403,28,10,446,1,443
812,14,445,179.5134693877551,181.3014058956916,28,10,438,2,431
813,78,6,180.90666666666667,182.11410430839004,33,36,89,1,72
814,78,6,180.90666666666667,183.85560090702947,33,34,146,3,72
815,78,271,180.90666666666667,182.50884353741498,33,16,205,2,193
816,78,539,180.90666666666667,182.48562358276644,33,2,466,2,461
817,78,411,180.90666666666667,183.73950113378686,33,5,355,3,333
818,5,6,181.69614512471657,183.85560090702947,35,34,93,2,1
819,5,6,181.69614512471657,184.29678004535148,35,34,112,3,1
820,5,206,181.69614512471657,184.0413605442177,35,16,225,2,201
821,5,216,181.69614512471657,184.62185941043083,35,17,246,3,211
822,5,411,181.69614512471657,183.73950113378686,35,5,415,2,406
823,5,454,181.69614512471657,184.20390022675738,35,13,462,3,449
824,6,206,182.11410430839004,184.0413605442177,36,16,217,2,200
825,6,216,182.11410430839004,184.62185941043083,36,17,236,3,210
826,6,411,182.11410430839004,183.73950113378686,36,5,411,2,405
827,6,454,182.11410430839004,184.20390022675738,36,13,457,2,448
828,6,5,183.85560090702947,185.59709750566893,34,35,75,2,1
829,6,58,183.85560090702947,186.47945578231293,34,34,124,3,52
830,6,226,183.85560090702947,185.36489795918368,34,15,229,2,220
831,6,291,183.85560090702947,186.59555555555556,34,17,308,3,285
832,6,459,183.85560090702947,186.43301587301588,34,2,466,3,453
833,6,5,184.29678004535148,185.59709750566893,34,35,56,1,1
834,6,58,184.29678004535148,186.47945578231293,34,34,107,2,52
835,6,226,184.29678004535148,185.36489795918368,34,15,225,1,220
836,6,291,184.29678004535148,186.59555555555556,34,17,302,2,285
837,6,459,184.29678004535148,186.43301587301588,34,2,462,2,453
838,5,6,185.59709750566893,188.19773242630387,35,34,112,3,1
839,5,228,185.59709750566893,187.54757369614512,35,15,238,2,223
840,5,456,185.59709750566893,187.73333333333335,35,11,460,2,451
841,5,445,185.59709750566893,188.24417233560092,35,10,455,3,440
842,58,5,186.47945578231293,187.7797732426304,34,34,77,1,53
843,58,6,186.47945578231293,188.19773242630387,34,34,90,2,52
844,58,228,186.47945578231293,187.54757369614512,34,15,176,1,170
845,58,245,186.47945578231293,189.01043083900228,34,15,216,3,187
846,58,243,186.47945578231293,189.26585034013607,34,18,221,3,185
847,58,456,186.47945578231293,187.73333333333335,34,11,402,1,398
848,58,445,186.47945578231293,188.24417233560092,34,10,394,2,387
849,58,424,186.47945578231293,189.08009070294784,34,4,383,3,366
850,5,65,187.7797732426304,189.9160090702948,34,35,110,2,60
851,5,245,187.7797732426304,189.01043083900228,34,15,246,1,240
852,5,243,187.7797732426304,189.26585034013607,34,18,246,1,238
853,5,208,187.7797732426304,190.68226757369615,34,16,238,3,203
854,5,424,187.7797732426304,189.08009070294784,34,4,423,1,419
855,6,65,188.19773242630387,189.9160090702948,34,35,95,2,59
856,6,243,188.19773242630387,189.26585034013607,34,18,241,1,237
857,6,208,188.19773242630387,190.68226757369615,34,16,229,2,202
858,6,434,188.19773242630387,191.05378684807258,34,5,445,3,428
859,6,453,188.19773242630387,191.14666666666668,34,14,465,3,447
860,65,6,189.9160090702948,191.2627664399093,35,35,83,1,59
861,65,6,189.9160090702948,192.12190476190477,35,35,112,2,59
862,65,232,189.9160090702948,191.58784580498866,35,19,182,2,167
863,65,244,189.9160090702948,192.30766439909297,35,15,207,2,179
864,65,434,189.9160090702948,191.05378684807258,35,5,372,1,369
865,65,453,189.9160090702948,191.14666666666668,35,14,392,1,388
866,6,244,190.8215873015873,192.30766439909297,34,15,246,1,238
867,6,245,190.8215873015873,193.21324263038548,34,15,260,2,239
868,6,437,190.8215873015873,192.9578231292517,34,4,441,2,431
869,6,8,191.2627664399093,194.18848072562358,35,34,126,3,2
870,6,244,191.2627664399093,192.30766439909297,35,15,242,1,238
871,6,245,191.2627664399093,193.21324263038548,35,15,253,2,239
872,6,437,191.2627664399093,192.9578231292517,35,4,437,2,431
873,6,437,191.2627664399093,193.8401814058957,35,2,445,3,431
874,6,8,192.12190476190477,194.18848072562358,35,34,89,2,2
875,6,245,192.12190476190477,193.21324263038548,35,15,244,1,239
876,6,231,192.12190476190477,194.83863945578233,35,14,254,3,225
877,6,437,192.12190476190477,193.8401814058957,35,2,437,2,431
878,6,454,192.12190476190477,194.6296598639456,35,9,461,3,448
879,6,65,193.86340136054423,196.324716553288,35,36,121,2,59
880,6,224,193.86340136054423,195.76743764172335,35,29,233,2,218
881,8,6,194.18848072562358,196.04607709750567,34,34,80,2,2
882,8,65,194.18848072562358,196.324716553288,34,36,108,2,57
883,8,224,194.18848072562358,195.76743764172335,34,29,226,2,216
884,8,228,194.18848072562358,196.92843537414967,34,17,250,3,220
885,6,59,196.04607709750567,197.20707482993197,34,34,73,1,53
886,6,51,196.04607709750567,198.5538321995465,34,33,117,3,45
887,6,260,196.04607709750567,197.27673469387756,34,18,259,1,254
888,6,205,196.04607709750567,198.4609523809524,34,24,225,2,199
889,6,495,196.04607709750567,198.04299319727892,34,10,497,2,489
890,6,452,196.04607709750567,198.08943310657597,34,11,455,2,446
891,65,51,196.324716553288,198.5538321995465,36,33,97,2,14
892,65,205,196.324716553288,198.4609523809524,36,24,168,2,140
893,65,290,196.324716553288,199.2968707482993,36,22,259,3,225
894,65,495,196.324716553288,198.04299319727892,36,10,436,2,430
895,65,452,196.324716553288,198.08943310657597,36,11,394,2,387
896,59,51,197.20707482993197,198.5538321995465,34,33,59,1,8
897,59,57,197.20707482993197,199.38975056689344,34,34,94,2,2
898,59,205,197.20707482993197,198.4609523809524,34,24,156,1,146
899,59,290,197.20707482993197,199.2968707482993,34,22,248,2,231
900,59,473,197.20707482993197,199.6219501133787,34,10,427,2,414
901,51,73,198.5538321995465,200.75972789115647,33,35,98,2,22
902,51,205,198.5538321995465,200.4346485260771,33,24,174,2,154
903,51,205,198.5538321995465,201.29378684807256,33,16,194,3,154
904,51,473,198.5538321995465,199.6219501133787,33,10,424,1,422
905,51,488,198.5538321995465,200.4114285714286,33,13,444,2,437
906,51,487,198.5538321995465,201.3402267573696,33,13,452,3,436
907,57,73,199.38975056689344,200.75972789115647,34,35,61,1,16
908,57,36,199.38975056689344,201.82784580498867,34,33,107,2,21
909,57,205,199.38975056689344,200.4346485260771,34,24,155,1,148
910,57,205,199.38975056689344,201.29378684807256,34,16,169,2,148
911,57,488,199.38975056689344,200.4114285714286,34,13,433,1,431
912,57,487,199.38975056689344,201.3402267573696,34,13,438,2,430
913,73,36,200.75972789115647,201.82784580498867,35,33,59,1,37
914,73,6,200.75972789115647,202.98884353741497,35,34,117,2,67
915,73,65,200.75972789115647,203.52290249433108,35,34,119,3,8
916,73,225,200.75972789115647,202.73342403628118,35,26,174,2,152
917,73,517,200.75972789115647,202.61732426303854,35,14,451,2,444
918,36,6,201.82784580498867,202.98884353741497,33,34,58,1,30
919,36,65,201.82784580498867,203.52290249433108,33,34,79,2,29
920,36,57,201.82784580498867,204.2427210884354,33,35,106,2,21
921,36,227,201.82784580498867,203.84798185941042,33,20,210,2,191
922,6,57,202.98884353741497,204.2427210884354,34,35,74,1,51
923,6,52,202.98884353741497,205.38049886621314,34,33,113,2,46
924,6,205,202.98884353741497,204.82321995464852,34,21,214,2,199
925,6,242,202.98884353741497,205.241179138322,34,26,255,2,236
926,6,479,202.98884353741497,204.91609977324262,34,14,480,2,473
927,6,455,202.98884353741497,205.1482993197279,34,10,459,2,449
928,65,52,203.52290249433108,205.38049886621314,34,33,81,2,13
929,65,205,203.52290249433108,204.82321995464852,34,21,151,1,140
930,65,242,203.52290249433108,205.241179138322,34,26,192,2,177
931,65,479,203.52290249433108,204.91609977324262,34,14,418,1,414
932,65,455,203.52290249433108,205.1482993197279,34,10,396,2,390
933,57,52,204.2427210884354,205.38049886621314,35,33,49,1,5
934,57,205,204.2427210884354,206.88979591836735,35,22,187,3,148
935,57,245,204.2427210884354,207.07555555555555,35,17,224,3,188
936,57,469,204.2427210884354,207.05233560090704,35,16,429,3,412
937,57,448,204.2427210884354,207.0987755102041,35,14,410,3,391
938,52,57,205.38049886621314,206.58793650793652,33,36,52,1,5
939,52,72,205.38049886621314,207.79537414965986,33,33,106,2,20
940,52,205,205.38049886621314,206.88979591836735,33,22,166,2,153
941,52,245,205.38049886621314,207.07555555555555,33,17,206,2,193
942,52,469,205.38049886621314,207.05233560090704,33,16,423,2,417
943,52,448,205.38049886621314,207.0987755102041,33,14,403,2,396
944,57,72,206.58793650793652,207.79537414965986,36,33,54,1,15
945,57,39,206.58793650793652,208.84027210884355,36,35,99,2,18
946,57,205,206.58793650793652,208.37587301587303,36,19,167,2,148
947,57,456,206.58793650793652,208.60807256235827,36,8,408,2,399
948,72,39,207.79537414965986,208.84027210884355,33,35,56,1,33
949,72,64,207.79537414965986,209.6065306122449,33,35,78,2,8
950,72,254,207.79537414965986,209.9548299319728,33,19,204,2,182
951,72,222,207.79537414965986,210.46566893424037,33,25,189,3,150
952,72,497,207.79537414965986,209.81551020408165,33,12,434,2,425
953,72,487,207.79537414965986,210.55854875283447,33,13,432,3,415
954,39,64,208.84027210884355,210.8604081632653,35,35,91,2,25
955,39,14,208.84027210884355,211.5570068027211,35,35,120,3,25
956,39,254,208.84027210884355,209.9548299319728,35,19,220,1,215
957,39,222,208.84027210884355,210.46566893424037,35,25,196,2,183
958,39,220,208.84027210884355,211.30158730158732,35,22,210,2,181
959,39,487,208.84027210884355,210.55854875283447,35,13,454,2,448
960,64,14,209.6065306122449,211.5570068027211,35,35,98,2,50
961,64,220,209.6065306122449,211.30158730158732,35,22,172,2,156
962,64,236,209.6065306122449,212.23038548752834,35,25,206,3,172
963,64,455,209.6065306122449,212.11428571428573,35,9,406,3,391
964,64,58,210.8604081632653,212.9966439909297,35,35,92,2,6
965,64,10,210.8604081632653,213.83256235827665,35,33,139,3,54
966,64,236,210.8604081632653,212.23038548752834,35,25,182,1,172
967,64,205,210.8604081632653,213.5307029478458,35,31,182,3,141
968,64,455,210.8604081632653,212.11428571428573,35,9,395,1,391
969,14,58,211.5570068027211,212.9966439909297,35,35,76,1,44
970,14,10,211.5570068027211,213.83256235827665,35,33,98,2,4
971,14,51,211.5570068027211,214.11120181405897,35,34,116,3,37
972,14,205,211.5570068027211,213.5307029478458,35,31,209,2,191
973,58,51,212.9966439909297,214.11120181405897,35,34,49,1,7
974,58,47,212.9966439909297,215.50439909297052,35,34,109,3,11
975,58,240,212.9966439909297,215.04,35,18,202,2,182
976,58,205,212.9966439909297,215.34185941043086,35,17,178,2,147
977,58,530,212.9966439909297,215.06321995464853,35,10,480,2,472
978,10,47,213.83256235827665,215.50439909297052,33,34,81,2,37
979,10,240,213.83256235827665,215.04,33,18,236,1,230
980,10,205,213.83256235827665,215.34185941043086,33,17,206,2,195
981,10,247,213.83256235827665,216.13133786848073,33,16,257,2,237
982,51,47,214.11120181405897,215.50439909297052,34,34,60,1,4
983,51,48,214.11120181405897,217.06013605442178,34,34,127,3,3
984,51,205,214.11120181405897,215.34185941043086,34,17,163,1,154
985,51,247,214.11120181405897,216.13133786848073,34,16,214,2,196
986,51,525,214.11120181405897,215.99201814058958,34,10,481,2,474
987,51,526,214.11120181405897,216.22421768707483,34,11,484,2,475
988,47,48,215.50439909297052,217.06013605442178,34,34,67,2,1
989,47,43,215.50439909297052,218.05859410430838,34,35,110,3,4
990,47,43,215.50439909297052,218.22113378684807,34,35,117,3,4
991,47,263,215.50439909297052,217.57097505668935,34,21,234,2,216
992,47,526,215.50439909297052,218.45333333333335,34,10,496,3,479
993,48,43,217.06013605442178,218.22113378684807,34,35,50,1,5
994,48,68,217.06013605442178,219.54467120181405,34,30,109,2,20
995,48,232,217.06013605442178,219.01061224489797,34,15,202,2,184
996,48,312,217.06013605442178,219.80009070294784,34,14,289,3,264
997,48,526,217.06013605442178,218.45333333333335,34,10,482,1,478
998,48,523,217.06013605442178,219.33569160997732,34,12,485,2,475
999,43,68,218.05859410430838,219.54467120181405,35,30,69,1,25
1000,43,54,218.05859410430838,220.40380952380954,35,32,102,2,11
1001,43,312,218.05859410430838,219.80009070294784,35,14,279,2,269
1002,43,217,218.05859410430838,220.6360090702948,35,14,206,3,174
1003,43,523,218.05859410430838,219.33569160997732,35,12,483,1,480
1004,43,526,218.05859410430838,220.35736961451246,35,4,493,2,483
1005,43,68,218.22113378684807,219.54467120181405,35,30,62,1,25
1006,43,54,218.22113378684807,220.40380952380954,35,32,95,2,11
1007,43,312,218.22113378684807,219.80009070294784,35,14,277,2,269
1008,43,217,218.22113378684807,220.6360090702948,35,14,203,2,174
1009,43,523,218.22113378684807,219.33569160997732,35,12,482,1,480
1010,43,526,218.22113378684807,220.35736961451246,35,4,492,2,483
1011,68,38,219.54467120181405,221.47192743764174,30,33,88,2,30
1012,68,39,219.54467120181405,222.21496598639456,30,30,119,3,29
1013,68,217,219.54467120181405,220.6360090702948,30,14,156,1,149
1014,68,232,219.54467120181405,221.72734693877553,30,15,189,2,164
1015,68,329,219.54467120181405,222.14530612244897,30,12,284,3,261
1016,68,524,219.54467120181405,222.05242630385487,30,11,469,3,456
1017,68,525,219.54467120181405,222.2381859410431,30,8,471,3,457
1018,54,38,220.40380952380954,221.47192743764174,32,33,49,1,16
1019,54,39,220.40380952380954,222.21496598639456,32,30,79,2,15
1020,54,232,220.40380952380954,221.72734693877553,32,15,187,1,178
1021,54,329,220.40380952380954,222.14530612244897,32,12,285,2,275
1022,54,232,220.40380952380954,223.25986394557825,32,7,216,3,178
1023,54,524,220.40380952380954,222.05242630385487,32,11,475,2,470
1024,54,525,220.40380952380954,222.2381859410431,32,8,478,2,471
1025,38,33,221.47192743764174,223.91002267573697,33,20,105,2,5
1026,38,232,221.47192743764174,223.25986394557825,33,7,209,2,194
1027,39,33,222.21496598639456,223.91002267573697,30,20,73,2,6
1028,39,26,222.21496598639456,224.69950113378684,30,20,108,2,13
1029,39,232,222.21496598639456,223.25986394557825,30,7,198,1,193
1030,39,345,222.21496598639456,224.4673015873016,30,10,321,2,306
1031,39,349,222.21496598639456,225.1174603174603,30,10,334,3,310
1032,33,34,223.91002267573697,225.2103401360544,20,22,56,1,1
1033,33,51,223.91002267573697,226.53387755102042,20,17,114,3,18
1034,33,349,223.91002267573697,225.1174603174603,20,10,320,1,316
1035,33,358,223.91002267573697,226.53387755102042,20,9,344,3,325
1036,33,434,223.91002267573697,226.71963718820862,20,2,419,3,401
1037,26,51,224.69950113378684,226.53387755102042,20,17,83,2,25
1038,26,36,224.69950113378684,227.55555555555557,20,18,123,3,10
1039,26,358,224.69950113378684,226.53387755102042,20,9,341,2,332
1040,26,434,224.69950113378684,226.71963718820862,20,2,417,2,408
1041,34,51,225.2103401360544,226.53387755102042,22,17,59,1,17
1042,34,36,225.2103401360544,227.55555555555557,22,18,101,2,2
1043,34,358,225.2103401360544,226.53387755102042,22,9,329,1,324
1044,34,236,225.2103401360544,227.81097505668936,22,7,231,3,202
1045,34,434,225.2103401360544,226.71963718820862,22,2,405,2,400
1046,51,36,226.53387755102042,227.55555555555557,17,18,46,1,15
1047,51,44,226.53387755102042,228.27537414965988,17,19,75,2,7
1048,51,33,226.53387755102042,229.1112925170068,17,11,112,3,18
1049,51,236,226.53387755102042,227.81097505668936,17,7,193,1,185
1050,36,33,227.55555555555557,229.1112925170068,18,11,67,2,3
1051,44,33,228.27537414965988,230.8760090702948,19,17,113,3,11
1052,44,346,228.27537414965988,231.03854875283446,19,2,325,3,302
1053,33,26,229.1112925170068,231.71192743764172,11,16,112,3,7
1054,33,346,229.1112925170068,231.03854875283446,11,2,324,2,313
1055,33,345,229.1112925170068,231.41006802721088,11,6,327,2,312
1056,33,51,230.8760090702948,233.49986394557823,17,13,114,3,18
1057,33,357,230.8760090702948,232.87292517006804,17,3,335,2,324
1058,33,358,230.8760090702948,233.47664399092972,17,4,344,3,325
1059,26,51,231.71192743764172,233.49986394557823,16,13,81,2,25
1060,26,43,231.71192743764172,234.31256235827664,16,12,113,3,17
1061,26,357,231.71192743764172,232.87292517006804,16,3,335,1,331
1062,26,358,231.71192743764172,233.47664399092972,16,4,341,2,332
1063,33,51,232.1298866213152,233.49986394557823,18,13,62,1,18
1064,33,43,232.1298866213152,234.31256235827664,18,12,95,2,10
1065,33,358,232.1298866213152,233.47664399092972,18,4,330,1,325
1066,51,43,233.49986394557823,235.19492063492063,13,13,73,2,8
1067,43,33,235.19492063492063,237.8419954648526,13,5,114,3,10
1068,33,34,237.8419954648526,239.11909297052154,5,2,55,1,1
1069,236,15,0.8823582766439909,2.391655328798186,6,30,230,2,221
1070,236,205,0.8823582766439909,2.1130158730158732,6,8,61,1,31
1071,206,15,1.2770975056689342,2.391655328798186,11,30,197,1,191
1072,206,15,1.2770975056689342,3.900952380952381,11,33,222,3,191
1073,206,207,1.2770975056689342,3.900952380952381,11,12,113,3,1
1074,205,15,2.1130158730158732,3.900952380952381,8,33,205,2,190
1075,205,9,2.1130158730158732,4.760090702947846,8,32,227,3,196
1076,205,207,2.1130158730158732,3.900952380952381,8,12,77,2,2
1077,205,231,2.1130158730158732,4.295691609977324,8,10,98,2,26
1078,207,8,3.900952380952381,5.897868480725624,12,31,217,2,199
1079,207,8,3.900952380952381,6.315827664399093,12,30,225,2,199
1080,207,277,3.900952380952381,5.874648526077098,12,12,110,2,70
1081,207,471,3.900952380952381,5.851428571428571,12,2,277,2,264
1082,207,415,3.900952380952381,6.292607709750567,12,3,232,2,208
1083,231,8,4.295691609977324,5.897868480725624,10,31,233,2,223
1084,231,8,4.295691609977324,6.315827664399093,10,30,239,2,223
1085,231,8,4.295691609977324,6.989206349206349,10,30,251,3,223
1086,231,277,4.295691609977324,5.874648526077098,10,12,82,2,46
1087,231,277,4.295691609977324,6.9195464852607715,10,14,122,3,46
1088,231,471,4.295691609977324,5.851428571428571,10,2,249,2,240
1089,231,415,4.295691609977324,6.292607709750567,10,3,203,2,184
1090,277,8,5.874648526077098,6.989206349206349,12,30,273,1,269
1091,277,13,5.874648526077098,8.266303854875284,12,31,283,2,264
1092,277,205,5.874648526077098,8.219863945578231,12,12,124,2,72
1093,277,13,6.9195464852607715,8.266303854875284,14,31,270,1,264
1094,277,14,6.9195464852607715,9.775600907029478,14,31,290,3,263
1095,277,205,6.9195464852607715,8.219863945578231,14,12,91,1,72
1096,277,232,6.9195464852607715,9.752380952380953,14,10,130,3,45
1097,277,14,7.383945578231293,9.775600907029478,12,31,282,2,263
1098,277,232,7.383945578231293,9.752380952380953,12,10,111,2,45
1099,205,14,8.219863945578231,9.775600907029478,12,31,202,2,191
1100,205,14,8.219863945578231,10.448979591836736,12,32,214,2,191
1101,205,232,8.219863945578231,9.752380952380953,12,10,71,2,27
1102,205,206,8.219863945578231,10.843718820861678,12,11,113,3,1
1103,232,9,9.752380952380953,11.72607709750567,10,33,239,2,223
1104,232,9,9.752380952380953,12.585215419501134,10,31,254,3,223
1105,232,206,9.752380952380953,10.843718820861678,10,11,54,1,26
1106,232,270,9.752380952380953,11.284897959183674,10,13,76,2,38
1107,206,9,10.843718820861678,12.585215419501134,11,31,211,2,197
1108,206,8,10.843718820861678,13.281814058956916,11,31,224,2,198
1109,206,212,10.843718820861678,12.84063492063492,11,10,86,2,6
1110,206,415,10.843718820861678,13.235374149659863,11,4,233,2,209
1111,270,9,11.284897959183674,12.585215419501134,13,31,267,1,261
1112,270,8,11.284897959183674,13.281814058956916,13,31,276,2,262
1113,270,212,11.284897959183674,12.84063492063492,13,10,89,2,58
1114,270,222,11.284897959183674,13.955192743764172,13,15,125,3,48
1115,270,415,11.284897959183674,13.235374149659863,13,4,168,2,145
1116,270,520,11.284897959183674,14.09451247165533,13,7,278,3,250
1117,212,24,12.84063492063492,14.55891156462585,10,34,202,2,188
1118,212,222,12.84063492063492,13.955192743764172,10,15,49,1,10
1119,212,277,12.84063492063492,14.303492063492063,10,11,91,1,65
1120,212,206,12.84063492063492,15.603809523809524,10,9,119,3,6
1121,212,520,12.84063492063492,14.09451247165533,10,7,313,1,308
1122,212,437,12.84063492063492,15.301950113378686,10,4,249,2,225
1123,212,637,12.84063492063492,14.280272108843537,10,3,429,1,425
1124,222,25,13.955192743764172,15.836009070294786,15,31,213,2,197
1125,222,26,13.955192743764172,16.091428571428573,15,31,217,2,196
1126,222,206,13.955192743764172,15.603809523809524,15,9,73,2,16
1127,222,205,13.955192743764172,16.04498866213152,15,10,92,2,17
1128,222,437,13.955192743764172,15.301950113378686,15,4,223,1,215
1129,277,25,14.303492063492063,15.836009070294786,11,31,260,2,252
1130,277,26,14.303492063492063,16.091428571428573,11,31,263,2,251
1131,277,206,14.303492063492063,15.603809523809524,11,9,90,1,71
1132,277,205,14.303492063492063,16.04498866213152,11,10,104,2,72
1133,206,14,15.603809523809524,17.76326530612245,9,32,213,2,192
1134,206,10,15.603809523809524,18.204444444444444,9,33,226,3,196
1135,206,237,15.603809523809524,17.716825396825396,9,16,96,2,31
1136,206,230,15.603809523809524,18.36698412698413,9,8,121,3,24
1137,206,437,15.603809523809524,17.46140589569161,9,8,244,2,231
1138,205,14,16.04498866213152,17.76326530612245,10,32,205,2,191
1139,205,10,16.04498866213152,18.204444444444444,10,33,216,2,195
1140,205,237,16.04498866213152,17.716825396825396,10,16,79,2,32
1141,205,230,16.04498866213152,18.36698412698413,10,8,103,2,25
1142,205,437,16.04498866213152,17.46140589569161,10,8,240,1,232
1143,205,480,16.04498866213152,18.599183673469387,10,6,296,3,275
1144,205,699,16.04498866213152,18.599183673469387,10,3,506,3,494
1145,237,5,17.716825396825396,19.551201814058956,16,29,245,2,232
1146,237,219,17.716825396825396,19.156462585034014,16,10,65,1,18
1147,237,511,17.716825396825396,19.156462585034014,16,4,281,1,274
1148,237,494,17.716825396825396,20.48,16,5,283,3,257
1149,230,5,18.36698412698413,19.551201814058956,8,29,231,1,225
1150,230,49,18.36698412698413,20.89795918367347,8,30,211,3,181
1151,230,8,18.36698412698413,21.24625850340136,8,30,254,3,222
1152,230,319,18.36698412698413,20.82829931972789,8,10,138,2,89
1153,230,494,18.36698412698413,20.48,8,5,279,2,264
1154,219,49,19.156462585034014,20.89795918367347,10,30,186,2,170
1155,219,8,19.156462585034014,21.24625850340136,10,30,229,2,211
1156,219,319,19.156462585034014,20.82829931972789,10,10,123,2,100
1157,219,245,19.156462585034014,21.966077097505668,10,19,124,3,26
1158,219,494,19.156462585034014,20.48,10,5,281,1,275
1159,219,493,19.156462585034014,21.91963718820862,10,8,299,3,274
1160,219,490,19.156462585034014,22.058956916099774,10,7,298,3,271
1161,319,12,20.82829931972789,22.96453514739229,10,31,320,2,307
1162,319,12,20.82829931972789,22.98775510204082,10,31,321,2,307
1163,319,245,20.82829931972789,21.966077097505668,10,19,89,1,74
1164,319,246,20.82829931972789,22.360816326530614,10,23,98,2,73
1165,319,493,20.82829931972789,21.91963718820862,10,8,180,1,174
1166,319,490,20.82829931972789,22.058956916099774,10,7,179,1,171
1167,319,521,20.82829931972789,23.08063492063492,10,10,224,2,202
1168,245,12,21.966077097505668,22.98775510204082,19,31,237,1,233
1169,245,21,21.966077097505668,24.61315192743764,19,31,251,3,224
1170,245,271,21.966077097505668,23.84689342403628,19,10,85,2,26
1171,245,231,21.966077097505668,24.63637188208617,19,15,116,3,14
1172,245,521,21.966077097505668,23.08063492063492,19,10,280,1,276
1173,245,536,21.966077097505668,24.45061224489796,19,5,310,2,291
1174,245,696,21.966077097505668,24.380952380952383,19,9,463,2,451
1175,246,21,22.360816326530614,24.61315192743764,23,31,245,2,225
1176,246,271,22.360816326530614,23.84689342403628,23,10,69,1,25
1177,246,231,22.360816326530614,24.63637188208617,23,15,99,2,15
1178,246,221,22.360816326530614,25.332970521541952,23,12,130,3,25
1179,246,536,22.360816326530614,24.45061224489796,23,5,304,2,290
1180,246,696,22.360816326530614,24.380952380952383,23,9,458,2,450
1181,246,623,22.360816326530614,25.170430839002268,23,5,396,3,377
1182,271,10,23.84689342403628,25.58839002267574,10,31,272,2,261
1183,271,23,23.84689342403628,26.540408163265308,10,32,274,3,248
1184,271,221,23.84689342403628,25.332970521541952,10,12,81,1,50
1185,271,218,23.84689342403628,26.122448979591837,10,13,111,2,53
1186,271,460,23.84689342403628,25.541950113378686,10,8,203,2,189
1187,271,449,23.84689342403628,26.28498866213152,10,4,207,2,178
1188,271,623,23.84689342403628,25.170430839002268,10,5,357,1,352
1189,271,643,23.84689342403628,26.33142857142857,10,6,387,2,372
1190,231,23,24.63637188208617,26.540408163265308,15,32,224,2,208
1191,231,218,24.63637188208617,26.122448979591837,15,13,65,1,13
1192,231,449,24.63637188208617,26.28498866213152,15,4,229,2,218
1193,231,643,24.63637188208617,26.33142857142857,15,6,418,2,412
1194,221,23,25.332970521541952,26.540408163265308,12,32,205,1,198
1195,221,16,25.332970521541952,27.631746031746033,12,33,228,2,205
1196,221,277,25.332970521541952,27.794285714285714,12,8,120,2,56
1197,221,277,25.332970521541952,28.23546485260771,12,9,137,3,56
1198,218,16,26.122448979591837,27.631746031746033,13,33,212,2,202
1199,218,6,26.122448979591837,28.65342403628118,13,32,238,3,212
1200,218,6,26.122448979591837,29.094603174603176,13,32,248,3,212
1201,218,277,26.122448979591837,27.794285714285714,13,8,93,2,59
1202,218,277,26.122448979591837,28.23546485260771,13,9,108,2,59
1203,218,410,26.122448979591837,29.071383219954647,13,3,230,3,192
1204,277,6,27.794285714285714,29.094603174603176,8,32,277,1,271
1205,277,6,27.794285714285714,30.394920634920634,8,32,293,3,271
1206,277,231,27.794285714285714,29.95374149659864,8,12,104,2,46
1207,277,219,27.794285714285714,30.743219954648527,8,14,140,3,58
1208,277,410,27.794285714285714,29.071383219954647,8,3,144,1,133
1209,277,6,28.23546485260771,30.394920634920634,9,32,287,2,271
1210,277,231,28.23546485260771,29.95374149659864,9,12,87,2,46
1211,277,219,28.23546485260771,30.743219954648527,9,14,123,3,58
1212,231,6,29.95374149659864,31.2540589569161,12,31,232,1,225
1213,231,6,29.95374149659864,32.13641723356009,12,32,244,2,225
1214,231,219,29.95374149659864,31.277278911564625,12,13,58,1,12
1215,231,205,29.95374149659864,32.55437641723356,12,10,115,3,26
1216,219,6,30.743219954648527,32.13641723356009,14,32,221,1,213
1217,219,6,30.743219954648527,33.436734693877554,14,32,243,3,213
1218,219,205,30.743219954648527,32.55437641723356,14,10,79,2,14
1219,219,231,30.743219954648527,33.436734693877554,14,12,117,3,12
1220,219,410,30.743219954648527,32.995555555555555,14,6,214,2,191
1221,219,6,31.277278911564625,33.436734693877554,13,32,232,2,213
1222,219,205,31.277278911564625,32.55437641723356,13,10,57,1,14
1223,219,231,31.277278911564625,33.436734693877554,13,12,94,2,12
1224,219,410,31.277278911564625,32.995555555555555,13,6,205,2,191
1225,205,6,32.55437641723356,34.29587301587301,10,32,213,2,199
1226,205,219,32.55437641723356,34.08689342403628,10,14,67,2,14
1227,205,219,32.55437641723356,35.45687074829932,10,13,126,3,14
1228,205,418,32.55437641723356,34.76027210884354,10,2,233,2,213
1229,231,6,33.436734693877554,35.619410430839004,12,31,244,2,225
1230,231,219,33.436734693877554,35.45687074829932,12,13,88,2,12
1231,231,418,33.436734693877554,34.76027210884354,12,2,195,1,187
1232,219,6,34.08689342403628,35.619410430839004,14,31,223,2,213
1233,219,6,34.08689342403628,36.47854875283447,14,31,237,2,213
1234,219,206,34.08689342403628,36.501768707482995,14,14,105,2,13
1235,219,232,34.08689342403628,37.05904761904762,14,13,129,3,13
1236,219,465,34.08689342403628,37.03582766439909,14,3,277,3,246
1237,219,6,35.45687074829932,36.47854875283447,13,31,217,1,213
1238,219,6,35.45687074829932,37.77886621315193,13,31,235,2,213
1239,219,6,35.45687074829932,38.22004535147392,13,31,244,3,213
1240,219,206,35.45687074829932,36.501768707482995,13,14,47,1,13
1241,219,232,35.45687074829932,37.05904761904762,13,13,70,2,13
1242,219,465,35.45687074829932,37.03582766439909,13,3,255,2,246
1243,206,6,36.501768707482995,37.77886621315193,14,31,207,1,200
1244,206,6,36.501768707482995,38.22004535147392,14,31,213,2,200
1245,206,368,36.501768707482995,38.98630385487528,14,18,194,2,162
1246,206,367,36.501768707482995,39.00952380952381,14,17,194,3,161
1247,206,585,36.501768707482995,38.54512471655329,14,3,389,2,379
1248,206,616,36.501768707482995,39.3578231292517,14,5,428,3,410
1249,232,6,37.05904761904762,38.22004535147392,13,31,231,1,226
1250,232,6,37.05904761904762,39.96154195011338,13,32,258,3,226
1251,232,368,37.05904761904762,38.98630385487528,13,18,159,2,136
1252,232,367,37.05904761904762,39.00952380952381,13,17,159,2,135
1253,232,585,37.05904761904762,38.54512471655329,13,3,359,1,353
1254,232,464,37.05904761904762,39.68290249433107,13,7,258,3,232
1255,232,616,37.05904761904762,39.3578231292517,13,5,397,2,384
1256,368,6,38.98630385487528,40.820680272108845,18,32,371,2,362
1257,368,6,38.98630385487528,41.26185941043084,18,31,375,2,362
1258,368,232,38.98630385487528,40.14730158730159,18,15,145,1,136
1259,368,231,38.98630385487528,41.77269841269841,18,21,182,3,137
1260,368,463,38.98630385487528,40.542040816326534,18,9,116,2,95
1261,368,516,38.98630385487528,41.9352380952381,18,9,195,3,148
1262,368,617,38.98630385487528,40.51882086167801,18,3,258,2,249
1263,368,738,38.98630385487528,41.95845804988662,18,10,392,3,370
1264,367,6,39.00952380952381,40.820680272108845,17,32,369,2,361
1265,367,6,39.00952380952381,41.26185941043084,17,31,374,2,361
1266,367,232,39.00952380952381,40.14730158730159,17,15,144,1,135
1267,367,231,39.00952380952381,41.77269841269841,17,21,181,3,136
1268,367,463,39.00952380952381,40.542040816326534,17,9,116,2,96
1269,367,516,39.00952380952381,41.9352380952381,17,9,195,3,149
1270,367,617,39.00952380952381,40.51882086167801,17,3,258,2,250
1271,367,738,39.00952380952381,41.95845804988662,17,10,392,3,371
1272,232,6,40.14730158730159,41.26185941043084,15,31,231,1,226
1273,232,48,40.14730158730159,42.74793650793651,15,33,215,3,184
1274,232,231,40.14730158730159,41.77269841269841,15,21,70,2,1
1275,232,217,40.14730158730159,42.237097505668935,15,20,91,2,15
1276,232,516,40.14730158730159,41.9352380952381,15,9,294,2,284
1277,232,583,40.14730158730159,42.074557823129254,15,7,361,2,351
1278,232,657,40.14730158730159,42.09777777777778,15,7,433,2,425
1279,231,51,41.77269841269841,43.90893424036281,21,33,202,2,180
1280,231,6,41.77269841269841,44.74485260770975,21,31,259,3,225
1281,231,317,41.77269841269841,43.18911564625851,21,14,105,1,86
1282,231,243,41.77269841269841,44.30367346938775,21,11,110,3,12
1283,231,484,41.77269841269841,43.86249433106576,21,11,269,2,253
1284,217,51,42.237097505668935,43.90893424036281,20,33,181,2,166
1285,217,6,42.237097505668935,44.74485260770975,20,31,237,3,211
1286,217,243,42.237097505668935,44.30367346938775,20,11,93,2,26
1287,217,484,42.237097505668935,43.86249433106576,20,11,276,2,267
1288,217,580,42.237097505668935,44.90739229024943,20,9,381,3,363
1289,217,643,42.237097505668935,44.860952380952384,20,7,441,3,426
1290,317,6,43.18911564625851,44.74485260770975,14,31,318,2,311
1291,317,6,43.18911564625851,45.60399092970522,14,32,328,2,311
1292,317,22,43.18911564625851,46.09160997732426,14,32,320,3,295
1293,317,243,43.18911564625851,44.30367346938775,14,11,88,1,74
1294,317,220,43.18911564625851,45.46467120181406,14,11,138,2,97
1295,317,580,43.18911564625851,44.90739229024943,14,9,273,2,263
1296,317,515,43.18911564625851,45.41823129251701,14,8,220,2,198
1297,317,643,43.18911564625851,44.860952380952384,14,7,334,2,326
1298,317,648,43.18911564625851,45.39501133786848,14,4,344,2,331
1299,317,623,43.18911564625851,46.068390022675736,14,2,330,3,306
1300,243,6,44.30367346938775,45.60399092970522,11,32,244,1,237
1301,243,22,44.30367346938775,46.09160997732426,11,32,234,2,221
1302,243,220,44.30367346938775,45.46467120181406,11,11,55,1,23
1303,243,209,44.30367346938775,46.95074829931973,11,16,119,3,34
1304,243,515,44.30367346938775,45.41823129251701,11,8,276,1,272
1305,243,523,44.30367346938775,46.9275283446712,11,6,302,3,280
1306,243,648,44.30367346938775,45.39501133786848,11,4,408,1,405
1307,243,623,44.30367346938775,46.068390022675736,11,2,388,2,380
1308,220,6,45.46467120181406,47.34548752834467,11,31,229,2,214
1309,220,6,45.46467120181406,48.22784580498866,11,32,245,3,214
1310,220,209,45.46467120181406,46.95074829931973,11,16,65,1,11
1311,220,241,45.46467120181406,47.3687074829932,11,14,85,2,21
1312,220,523,45.46467120181406,46.9275283446712,11,6,309,1,303
1313,220,501,45.46467120181406,47.484807256235825,11,8,294,2,281
1314,220,641,45.46467120181406,47.50802721088436,11,7,430,2,421
1315,209,6,46.95074829931973,48.22784580498866,16,32,210,1,203
1316,209,73,46.95074829931973,49.87646258503401,16,33,185,3,136
1317,209,277,46.95074829931973,48.66902494331066,16,12,100,2,68
1318,209,225,46.95074829931973,49.179863945578234,16,11,97,2,16
1319,209,510,46.95074829931973,48.761904761904766,16,10,311,2,301
1320,209,601,46.95074829931973,49.179863945578234,16,6,404,2,392
1321,209,658,46.95074829931973,48.78512471655329,16,9,456,2,449
1322,209,639,46.95074829931973,49.179863945578234,16,4,441,2,430
1323,241,73,47.3687074829932,49.87646258503401,14,33,200,3,168
1324,241,74,47.3687074829932,50.062222222222225,14,33,203,3,167
1325,241,277,47.3687074829932,48.66902494331066,14,12,67,1,36
1326,241,225,47.3687074829932,49.179863945578234,14,11,80,2,16
1327,241,510,47.3687074829932,48.761904761904766,14,10,276,1,269
1328,241,601,47.3687074829932,49.179863945578234,14,6,368,2,360
1329,241,658,47.3687074829932,48.78512471655329,14,9,421,1,417
1330,241,639,47.3687074829932,49.179863945578234,14,4,406,2,398
1331,277,73,48.66902494331066,49.87646258503401,12,33,211,1,204
1332,277,74,48.66902494331066,50.062222222222225,12,33,212,1,203
1333,277,227,48.66902494331066,50.944580498866216,12,13,110,2,50
1334,277,236,48.66902494331066,51.478639455782314,12,11,128,3,41
1335,277,421,48.66902494331066,50.92136054421769,12,9,174,2,144
1336,277,526,48.66902494331066,51.06068027210885,12,9,269,2,249
1337,277,642,48.66902494331066,50.96780045351474,12,5,378,2,365
1338,277,615,48.66902494331066,51.06068027210885,12,2,353,2,338
1339,225,6,49.179863945578234,51.710839002267576,11,31,245,3,219
1340,225,6,49.179863945578234,52.128798185941044,11,32,253,3,219
1341,225,227,49.179863945578234,50.944580498866216,11,13,76,2,2
1342,225,236,49.179863945578234,51.478639455782314,11,11,100,2,11
1343,225,421,49.179863945578234,50.92136054421769,11,9,210,2,196
1344,225,526,49.179863945578234,51.06068027210885,11,9,312,2,301
1345,225,642,49.179863945578234,50.96780045351474,11,5,424,2,417
1346,225,615,49.179863945578234,51.06068027210885,11,2,398,2,390
1347,227,6,50.944580498866216,52.128798185941044,13,32,227,1,221
1348,227,19,50.944580498866216,53.84707482993198,13,31,243,3,208
1349,227,215,50.944580498866216,52.848616780045354,13,16,83,2,12
1350,227,229,50.944580498866216,53.173696145124715,13,13,96,2,2
1351,227,556,50.944580498866216,52.68607709750567,13,4,337,2,329
1352,227,484,50.944580498866216,53.498775510204084,13,7,280,3,257
1353,227,631,50.944580498866216,53.661315192743764,13,2,421,3,404
1354,236,19,51.478639455782314,53.84707482993198,11,31,240,2,217
1355,236,215,51.478639455782314,52.848616780045354,11,16,63,1,21
1356,236,229,51.478639455782314,53.173696145124715,11,13,73,2,7
1357,236,242,51.478639455782314,54.19537414965986,11,12,117,3,6
1358,236,556,51.478639455782314,52.68607709750567,11,4,324,1,320
1359,236,484,51.478639455782314,53.498775510204084,11,7,263,2,248
1360,236,631,51.478639455782314,53.661315192743764,11,2,406,2,395
1361,215,44,52.848616780045354,54.543673469387755,16,31,186,2,171
1362,215,30,52.848616780045354,55.51891156462585,16,31,218,3,185
1363,215,242,52.848616780045354,54.19537414965986,16,12,64,1,27
1364,215,512,52.848616780045354,54.9384126984127,16,6,310,2,297
1365,215,627,52.848616780045354,54.91519274376417,16,2,422,2,412
1366,229,44,53.173696145124715,54.543673469387755,13,31,194,1,185
1367,229,30,53.173696145124715,55.51891156462585,13,31,223,2,199
1368,229,242,53.173696145124715,54.19537414965986,13,12,46,1,13
1369,229,260,53.173696145124715,55.843990929705214,13,19,119,3,31
1370,229,227,53.173696145124715,56.14585034013606,13,13,128,3,2
1371,229,512,53.173696145124715,54.9384126984127,13,6,293,2,283
1372,229,520,53.173696145124715,55.867210884353746,13,10,313,3,291
1373,229,519,53.173696145124715,56.14585034013606,13,5,317,3,290
1374,229,627,53.173696145124715,54.91519274376417,13,2,405,2,398
1375,242,30,54.19537414965986,55.51891156462585,12,31,220,1,212
1376,242,65,54.19537414965986,56.65668934240363,12,33,206,2,177
1377,242,65,54.19537414965986,57.02820861678005,12,33,215,3,177
1378,242,260,54.19537414965986,55.843990929705214,12,19,73,2,18
1379,242,227,54.19537414965986,56.14585034013606,12,13,85,2,15
1380,242,520,54.19537414965986,55.867210884353746,12,10,287,2,278
1381,242,519,54.19537414965986,56.14585034013606,12,5,289,2,277
1382,260,65,55.843990929705214,57.02820861678005,19,33,202,1,195
1383,260,29,55.843990929705214,58.02666666666667,19,31,249,2,231
1384,260,245,55.843990929705214,57.74802721088435,19,17,83,2,15
1385,260,232,55.843990929705214,58.28208616780046,19,30,109,2,28
1386,260,482,55.843990929705214,57.95700680272109,19,7,240,2,222
1387,260,519,55.843990929705214,58.42140589569161,19,12,282,3,259
1388,260,709,55.843990929705214,57.95700680272109,19,2,458,2,449
1389,227,29,56.14585034013606,58.02666666666667,13,31,214,2,198
1390,227,245,56.14585034013606,57.74802721088435,13,17,71,2,18
1391,227,232,56.14585034013606,58.28208616780046,13,30,92,2,5
1392,227,482,56.14585034013606,57.95700680272109,13,7,267,2,255
1393,227,519,56.14585034013606,58.42140589569161,13,12,308,2,292
1394,227,709,56.14585034013606,57.95700680272109,13,2,488,2,482
1395,245,6,57.74802721088435,59.953922902494334,17,31,257,2,239
1396,245,58,57.74802721088435,60.070022675736965,17,31,212,2,187
1397,245,264,57.74802721088435,59.419863945578236,17,12,74,2,19
1398,245,234,57.74802721088435,60.20934240362812,17,11,107,2,11
1399,245,473,57.74802721088435,59.582403628117916,17,5,241,2,228
1400,245,599,57.74802721088435,60.46476190476191,17,5,373,3,354
1401,245,653,57.74802721088435,59.582403628117916,17,5,416,2,408
1402,245,685,57.74802721088435,60.48798185941043,17,9,456,3,440
1403,232,6,58.28208616780046,59.953922902494334,30,31,237,2,226
1404,232,58,58.28208616780046,60.070022675736965,30,31,190,2,174
1405,232,6,58.28208616780046,61.25424036281179,30,31,260,3,226
1406,232,264,58.28208616780046,59.419863945578236,30,12,59,1,32
1407,232,234,58.28208616780046,60.20934240362812,30,11,83,2,2
1408,232,473,58.28208616780046,59.582403628117916,30,5,247,1,241
1409,232,599,58.28208616780046,60.46476190476191,30,5,379,2,367
1410,232,653,58.28208616780046,59.582403628117916,30,5,425,1,421
1411,232,685,58.28208616780046,60.48798185941043,30,9,463,2,453
1412,232,653,58.28208616780046,61.13814058956916,30,6,439,3,421
1413,264,6,59.419863945578236,61.25424036281179,12,31,270,2,258
1414,264,219,59.419863945578236,61.78829931972789,12,16,111,2,45
1415,264,599,59.419863945578236,60.46476190476191,12,5,338,1,335
1416,264,510,59.419863945578236,61.811519274376415,12,8,267,2,246
1417,264,685,59.419863945578236,60.48798185941043,12,9,424,1,421
1418,264,653,59.419863945578236,61.13814058956916,12,6,396,2,389
1419,234,6,60.20934240362812,61.25424036281179,11,31,232,1,228
1420,234,6,60.20934240362812,62.99573696145125,11,30,258,3,228
1421,234,219,60.20934240362812,61.78829931972789,11,16,70,2,15
1422,234,244,60.20934240362812,62.62421768707483,11,14,104,2,10
1423,234,510,60.20934240362812,61.811519274376415,11,8,284,2,276
1424,234,611,60.20934240362812,62.415238095238095,11,8,389,2,377
1425,234,627,60.20934240362812,62.415238095238095,11,7,404,2,393
1426,219,6,61.78829931972789,62.99573696145125,16,30,219,1,213
1427,219,6,61.78829931972789,63.85487528344672,16,30,231,2,213
1428,219,6,61.78829931972789,64.29605442176872,16,31,239,3,213
1429,219,242,61.78829931972789,63.25115646258504,16,18,67,1,23
1430,219,226,61.78829931972789,64.17995464852608,16,9,103,2,7
1431,219,585,61.78829931972789,63.901315192743766,16,5,377,2,366
1432,219,537,61.78829931972789,64.57469387755103,16,10,340,3,318
1433,219,697,61.78829931972789,63.41369614512472,16,2,483,2,478
1434,244,6,62.62421768707483,63.85487528344672,14,30,244,1,238
1435,244,6,62.62421768707483,64.29605442176872,14,31,249,2,238
1436,244,6,62.62421768707483,65.59637188208617,14,31,270,3,238
1437,244,226,62.62421768707483,64.17995464852608,14,9,69,2,18
1438,244,261,62.62421768707483,65.24807256235827,14,10,114,3,17
1439,244,585,62.62421768707483,63.901315192743766,14,5,345,1,341
1440,244,537,62.62421768707483,64.57469387755103,14,10,305,2,293
1441,244,523,62.62421768707483,65.03909297052154,14,4,298,2,279
1442,244,683,62.62421768707483,64.78367346938775,14,5,449,2,439
1443,242,6,63.25115646258504,64.29605442176872,18,31,240,1,236
1444,242,6,63.25115646258504,65.59637188208617,18,31,257,2,236
1445,242,261,63.25115646258504,65.24807256235827,18,10,88,2,19
1446,242,537,63.25115646258504,64.57469387755103,18,10,300,1,295
1447,242,523,63.25115646258504,65.03909297052154,18,4,291,2,281
1448,242,683,63.25115646258504,64.78367346938775,18,5,446,2,441
1449,226,6,64.17995464852608,65.59637188208617,9,31,228,1,220
1450,226,6,64.17995464852608,66.45551020408163,9,30,241,2,220
1451,226,261,64.17995464852608,65.24807256235827,9,10,58,1,35
1452,226,253,64.17995464852608,66.71092970521542,9,11,112,3,27
1453,226,525,64.17995464852608,66.98956916099773,9,5,323,3,299
1454,261,6,65.24807256235827,66.45551020408163,10,30,260,1,255
1455,261,6,65.24807256235827,67.77904761904762,10,31,277,3,255
1456,261,6,65.24807256235827,68.22022675736962,10,31,285,3,255
1457,261,253,65.24807256235827,66.71092970521542,10,11,64,1,8
1458,261,277,65.24807256235827,67.38430839002268,10,11,93,2,16
1459,261,525,65.24807256235827,66.98956916099773,10,5,274,2,264
1460,261,475,65.24807256235827,67.47718820861678,10,7,235,2,214
1461,261,655,65.24807256235827,67.47718820861678,10,8,406,2,394
1462,253,6,66.71092970521542,67.77904761904762,11,31,251,1,247
1463,253,6,66.71092970521542,68.22022675736962,11,31,255,2,247
1464,253,6,66.71092970521542,69.52054421768707,11,30,275,3,247
1465,253,226,66.71092970521542,68.82394557823129,11,13,95,2,27
1466,253,467,66.71092970521542,68.82394557823129,11,8,233,2,214
1467,253,649,66.71092970521542,68.61496598639457,11,6,404,2,396
1468,277,6,67.38430839002268,69.52054421768707,11,30,286,2,271
1469,277,226,67.38430839002268,68.82394557823129,11,13,80,1,51
1470,277,219,67.38430839002268,69.93850340136055,11,16,124,3,58
1471,277,467,67.38430839002268,68.82394557823129,11,8,200,1,190
1472,277,649,67.38430839002268,68.61496598639457,11,6,376,1,372
1473,226,6,68.82394557823129,70.82086167800453,13,35,236,2,220
1474,226,5,68.82394557823129,71.26204081632653,13,34,245,2,221
1475,226,219,68.82394557823129,69.93850340136055,13,16,49,1,7
1476,226,256,68.82394557823129,70.54222222222222,13,28,80,2,30
1477,226,237,68.82394557823129,71.63356009070294,13,20,121,3,11
1478,226,512,68.82394557823129,70.54222222222222,13,16,295,2,286
1479,226,513,68.82394557823129,71.02984126984127,13,11,302,2,287
1480,226,632,68.82394557823129,71.4942403628118,13,9,422,3,406
1481,219,5,69.93850340136055,71.26204081632653,16,34,221,1,214
1482,219,6,69.93850340136055,72.56235827664399,16,36,241,3,213
1483,219,237,69.93850340136055,71.63356009070294,16,20,75,2,18
1484,219,205,69.93850340136055,72.60879818594104,16,19,116,3,14
1485,219,513,69.93850340136055,71.02984126984127,16,11,298,1,294
1486,219,632,69.93850340136055,71.4942403628118,16,9,418,2,413
1487,219,701,69.93850340136055,72.51591836734694,16,5,495,3,482
1488,256,6,70.54222222222222,72.56235827664399,28,36,265,2,250
1489,256,6,70.54222222222222,73.44471655328799,28,34,280,3,250
1490,256,237,70.54222222222222,71.63356009070294,28,20,51,1,19
1491,256,205,70.54222222222222,72.60879818594104,28,19,103,2,51
1492,256,257,70.54222222222222,73.30539682539683,28,23,119,3,1
1493,256,484,70.54222222222222,72.95709750566894,28,9,251,2,228
1494,256,486,70.54222222222222,73.04997732426304,28,7,254,3,230
1495,256,701,70.54222222222222,72.51591836734694,28,5,453,2,445
1496,237,6,71.63356009070294,73.44471655328799,20,34,244,2,231
1497,237,5,71.63356009070294,74.30385487528345,20,34,259,3,232
1498,237,257,71.63356009070294,73.30539682539683,20,23,75,2,20
1499,237,233,71.63356009070294,74.32707482993197,20,21,116,3,4
1500,237,484,71.63356009070294,72.95709750566894,20,9,253,1,247
1501,237,486,71.63356009070294,73.04997732426304,20,7,256,1,249
1502,237,668,71.63356009070294,73.93233560090704,20,2,442,2,431
1503,205,5,72.60879818594104,74.30385487528345,19,34,213,2,200
1504,205,6,72.60879818594104,75.16299319727891,19,35,227,3,199
1505,205,233,72.60879818594104,74.32707482993197,19,21,79,2,28
1506,205,243,72.60879818594104,75.20943310657597,19,20,118,3,38
1507,205,512,72.60879818594104,74.7914739229025,19,8,321,2,307
1508,205,488,72.60879818594104,75.20943310657597,19,11,304,3,283
1509,205,668,72.60879818594104,73.93233560090704,19,2,466,1,463
1510,257,6,73.30539682539683,75.16299319727891,23,35,263,2,251
1511,257,233,73.30539682539683,74.32707482993197,23,21,50,1,24
1512,257,243,73.30539682539683,75.20943310657597,23,20,83,2,14
1513,257,512,73.30539682539683,74.7914739229025,23,8,263,1,255
1514,257,488,73.30539682539683,75.20943310657597,23,11,245,2,231
1515,257,497,73.30539682539683,76.16145124716553,23,10,270,3,240
1516,257,665,73.30539682539683,75.9524716553288,23,4,424,3,408
1517,257,642,73.30539682539683,76.20789115646258,23,6,405,3,385
1518,233,6,74.32707482993197,76.90448979591837,21,35,253,3,227
1519,233,307,74.32707482993197,76.92770975056689,21,16,134,3,74
1520,233,497,74.32707482993197,76.16145124716553,21,10,276,2,264
1521,233,665,74.32707482993197,75.9524716553288,21,4,438,2,432
1522,233,642,74.32707482993197,76.20789115646258,21,6,417,2,409
1523,243,6,75.20943310657597,76.90448979591837,20,35,248,2,237
1524,243,6,75.20943310657597,77.34566893424036,20,34,254,2,237
1525,243,307,75.20943310657597,76.92770975056689,20,16,98,2,64
1526,243,225,75.20943310657597,77.53142857142858,20,30,102,2,18
1527,243,516,75.20943310657597,77.41532879818594,20,12,289,2,273
1528,307,58,76.92770975056689,78.99428571428571,16,36,264,2,249
1529,307,58,76.92770975056689,79.01750566893425,16,36,265,2,249
1530,307,227,76.92770975056689,78.25124716553289,16,23,98,1,80
1531,307,587,76.92770975056689,78.85496598639456,16,11,292,2,280
1532,307,450,76.92770975056689,79.62122448979592,16,15,184,3,143
1533,307,649,76.92770975056689,78.76208616780046,16,9,351,2,342
1534,307,635,76.92770975056689,79.64444444444445,16,9,348,3,328
1535,225,58,77.53142857142858,78.99428571428571,30,36,178,1,167
1536,225,58,77.53142857142858,79.01750566893425,30,36,179,1,167
1537,225,5,77.53142857142858,80.38748299319728,30,35,252,3,220
1538,225,240,77.53142857142858,79.92308390022676,30,29,104,2,15
1539,225,242,77.53142857142858,80.0391836734694,30,30,109,3,17
1540,225,587,77.53142857142858,78.85496598639456,30,11,366,1,362
1541,225,450,77.53142857142858,79.62122448979592,30,15,242,2,225
1542,225,649,77.53142857142858,78.76208616780046,30,9,427,1,424
1543,225,635,77.53142857142858,79.64444444444445,30,9,420,2,410
1544,227,5,78.25124716553289,80.38748299319728,23,35,240,2,222
1545,227,240,78.25124716553289,79.92308390022676,23,29,73,2,13
1546,227,242,78.25124716553289,80.0391836734694,23,30,78,2,15
1547,227,450,78.25124716553289,79.62122448979592,23,15,231,1,223
1548,227,516,78.25124716553289,80.92154195011338,23,16,311,3,289
1549,227,635,78.25124716553289,79.64444444444445,23,9,412,1,408
1550,227,679,78.25124716553289,80.89832199546485,23,8,466,3,452
1551,240,58,79.92308390022676,81.43238095238095,29,35,193,2,182
1552,240,225,79.92308390022676,81.75746031746031,29,24,80,2,15
1553,240,243,79.92308390022676,82.03609977324263,29,20,91,2,3
1554,240,485,79.92308390022676,81.87356009070295,29,14,259,2,245
1555,240,484,79.92308390022676,82.08253968253969,29,6,261,2,244
1556,240,622,79.92308390022676,81.85034013605443,29,9,391,2,382
1557,242,58,80.0391836734694,81.43238095238095,30,35,194,1,184
1558,242,5,80.0391836734694,82.9881179138322,30,34,269,3,237
1559,242,225,80.0391836734694,81.75746031746031,30,24,76,2,17
1560,242,243,80.0391836734694,82.03609977324263,30,20,86,2,1
1561,242,485,80.0391836734694,81.87356009070295,30,14,256,2,243
1562,242,484,80.0391836734694,82.08253968253969,30,6,258,2,242
1563,242,622,80.0391836734694,81.85034013605443,30,9,388,2,380
1564,225,5,81.75746031746031,82.9881179138322,24,34,226,1,220
1565,225,6,81.75746031746031,83.4292970521542,24,35,231,2,219
1566,225,65,81.75746031746031,84.38131519274377,24,35,196,3,160
1567,225,205,81.75746031746031,83.17387755102041,24,19,64,1,20
1568,225,505,81.75746031746031,83.26675736961451,24,7,287,2,280
1569,225,478,81.75746031746031,84.65995464852608,24,14,282,3,253
1570,225,632,81.75746031746031,84.65995464852608,24,11,426,3,407
1571,243,6,82.03609977324263,83.4292970521542,20,35,244,1,237
1572,243,65,82.03609977324263,84.38131519274377,20,35,205,2,178
1573,243,205,82.03609977324263,83.17387755102041,20,19,62,1,38
1574,243,224,82.03609977324263,84.89215419501134,20,17,124,3,19
1575,243,505,82.03609977324263,83.26675736961451,20,7,267,1,262
1576,243,478,82.03609977324263,84.65995464852608,20,14,261,3,235
1577,243,632,82.03609977324263,84.65995464852608,20,11,405,3,389
1578,205,65,83.17387755102041,84.38131519274377,19,35,149,1,140
1579,205,6,83.17387755102041,85.58875283446712,19,35,225,2,199
1580,205,5,83.17387755102041,86.02993197278911,19,35,235,3,200
1581,205,224,83.17387755102041,84.89215419501134,19,17,76,2,19
1582,205,227,83.17387755102041,85.2172335600907,19,27,91,2,22
1583,205,478,83.17387755102041,84.65995464852608,19,14,280,1,273
1584,205,552,83.17387755102041,85.14757369614513,19,11,357,2,347
1585,205,632,83.17387755102041,84.65995464852608,19,11,432,1,427
1586,205,632,83.17387755102041,85.33333333333333,19,9,437,2,427
1587,224,5,84.89215419501134,86.02993197278911,17,35,224,1,219
1588,224,6,84.89215419501134,87.77142857142857,17,34,251,3,218
1589,224,205,84.89215419501134,86.49433106575964,17,18,72,2,19
1590,224,236,84.89215419501134,87.05160997732426,17,18,94,2,12
1591,224,511,84.89215419501134,86.44789115646259,17,13,295,2,287
1592,224,648,84.89215419501134,86.44789115646259,17,7,429,2,424
1593,227,6,85.2172335600907,87.77142857142857,27,34,247,3,221
1594,227,205,85.2172335600907,86.49433106575964,27,18,59,1,22
1595,227,236,85.2172335600907,87.05160997732426,27,18,80,2,9
1596,227,511,85.2172335600907,86.44789115646259,27,13,289,1,284
1597,227,492,85.2172335600907,88.00362811791383,27,12,291,3,265
1598,227,648,85.2172335600907,86.44789115646259,27,7,424,1,421
1599,227,690,85.2172335600907,88.00362811791383,27,9,478,3,463
1600,227,644,85.2172335600907,88.07328798185941,27,11,435,3,417
1601,205,6,86.49433106575964,87.77142857142857,18,34,206,1,199
1602,205,58,86.49433106575964,88.93242630385488,18,35,181,2,147
1603,205,6,86.49433106575964,89.07174603174603,18,36,228,3,199
1604,205,227,86.49433106575964,88.25904761904762,18,26,79,2,22
1605,205,261,86.49433106575964,89.11818594104308,18,17,126,3,56
1606,205,492,86.49433106575964,88.00362811791383,18,12,294,2,287
1607,205,483,86.49433106575964,88.25904761904762,18,14,288,2,278
1608,205,599,86.49433106575964,89.39682539682539,18,11,413,3,394
1609,205,690,86.49433106575964,88.00362811791383,18,9,489,2,485
1610,205,644,86.49433106575964,88.07328798185941,18,11,444,2,439
1611,205,675,86.49433106575964,89.42004535147393,18,10,487,3,470
1612,236,58,87.05160997732426,88.93242630385488,18,35,196,2,178
1613,236,6,87.05160997732426,89.07174603174603,18,36,246,2,230
1614,236,227,87.05160997732426,88.25904761904762,18,26,53,1,9
1615,236,261,87.05160997732426,89.11818594104308,18,17,92,2,25
1616,236,483,87.05160997732426,88.25904761904762,18,14,252,1,247
1617,236,599,87.05160997732426,89.39682539682539,18,11,377,2,363
1618,236,644,87.05160997732426,88.07328798185941,18,11,410,1,408
1619,236,675,87.05160997732426,89.42004535147393,18,10,451,2,439
1620,227,16,88.25904761904762,90.34884353741496,26,35,229,2,211
1621,227,253,88.25904761904762,90.25596371882087,26,16,90,2,26
1622,227,599,88.25904761904762,89.39682539682539,26,11,375,1,372
1623,227,528,88.25904761904762,90.69714285714286,26,8,319,2,301
1624,227,529,88.25904761904762,91.18476190476191,26,13,327,3,302
1625,227,675,88.25904761904762,89.42004535147393,26,10,451,1,448
1626,227,616,88.25904761904762,91.18476190476191,26,3,409,3,389
1627,261,16,89.11818594104308,90.34884353741496,17,35,251,1,245
1628,261,6,89.11818594104308,91.25442176870749,17,35,271,2,255
1629,261,253,89.11818594104308,90.25596371882087,17,16,50,1,8
1630,261,232,89.11818594104308,91.78848072562359,17,20,119,3,29
1631,261,528,89.11818594104308,90.69714285714286,17,8,276,2,267
1632,261,529,89.11818594104308,91.18476190476191,17,13,282,2,268
1633,261,616,89.11818594104308,91.18476190476191,17,3,366,2,355
1634,253,6,90.25596371882087,92.57795918367347,16,36,266,2,247
1635,253,232,90.25596371882087,91.78848072562359,16,20,69,2,21
1636,253,231,90.25596371882087,92.53151927437642,16,18,100,2,22
1637,253,567,90.25596371882087,92.48507936507937,16,13,328,2,314
1638,253,647,90.25596371882087,92.48507936507937,16,11,406,2,394
1639,232,6,91.78848072562359,93.43709750566893,20,35,237,2,226
1640,232,5,91.78848072562359,94.7374149659864,20,35,260,3,227
1641,232,205,91.78848072562359,93.59963718820862,20,18,83,2,27
1642,232,439,91.78848072562359,93.25133786848073,20,8,216,1,207
1643,232,482,91.78848072562359,94.57487528344672,20,14,277,3,250
1644,232,664,91.78848072562359,94.57487528344672,20,13,448,3,432
1645,231,5,92.53151927437642,94.7374149659864,18,35,245,2,226
1646,231,55,92.53151927437642,95.06249433106576,18,35,207,3,176
1647,231,205,92.53151927437642,93.59963718820862,18,18,53,1,26
1648,231,220,92.53151927437642,94.8302947845805,18,15,100,2,11
1649,231,254,92.53151927437642,95.17859410430839,18,15,116,3,23
1650,231,482,92.53151927437642,94.57487528344672,18,14,266,2,251
1651,231,664,92.53151927437642,94.57487528344672,18,13,442,2,433
1652,205,5,93.59963718820862,94.7374149659864,18,35,206,1,200
1653,205,55,93.59963718820862,95.06249433106576,18,35,163,1,150
1654,205,220,93.59963718820862,94.8302947845805,18,15,55,1,15
1655,205,254,93.59963718820862,95.17859410430839,18,15,84,2,49
1656,205,353,93.59963718820862,96.20027210884354,18,17,186,3,148
1657,205,520,93.59963718820862,95.75909297052155,18,4,328,2,315
1658,220,6,94.8302947845805,96.89687074829932,15,35,232,2,214
1659,220,5,94.8302947845805,97.77922902494332,15,35,250,3,215
1660,220,353,94.8302947845805,96.20027210884354,15,17,145,1,133
1661,220,232,94.8302947845805,97.500589569161,15,15,116,3,12
1662,220,464,94.8302947845805,96.59501133786848,15,8,256,2,244
1663,220,482,94.8302947845805,97.05941043083901,15,4,279,2,262
1664,220,618,94.8302947845805,96.71111111111111,15,3,406,2,398
1665,254,6,95.17859410430839,96.89687074829932,15,35,259,2,248
1666,254,5,95.17859410430839,97.77922902494332,15,35,273,3,249
1667,254,353,95.17859410430839,96.20027210884354,15,17,108,1,99
1668,254,232,95.17859410430839,97.500589569161,15,15,102,2,22
1669,254,464,95.17859410430839,96.59501133786848,15,8,219,1,210
1670,254,482,95.17859410430839,97.05941043083901,15,4,242,2,228
1671,254,618,95.17859410430839,96.71111111111111,15,3,370,2,364
1672,353,5,96.20027210884354,97.77922902494332,17,35,355,2,348
1673,353,6,96.20027210884354,98.2204081632653,17,35,358,2,347
1674,353,232,96.20027210884354,97.500589569161,17,15,133,1,121
1675,353,216,96.20027210884354,98.82412698412699,17,18,178,3,137
1676,353,488,96.20027210884354,98.47582766439909,17,7,167,2,135
1677,232,6,97.500589569161,99.52072562358276,15,31,242,2,226
1678,232,216,97.500589569161,98.82412698412699,15,18,59,1,16
1679,232,216,97.500589569161,99.56716553287983,15,16,90,2,16
1680,232,429,97.500589569161,99.6368253968254,15,15,217,2,197
1681,232,431,97.500589569161,100.0780045351474,15,12,228,3,199
1682,216,6,98.82412698412699,100.82104308390024,18,31,227,2,210
1683,216,6,98.82412698412699,101.70340136054422,18,30,244,3,210
1684,216,343,98.82412698412699,100.84426303854876,18,20,154,2,127
1685,216,343,98.82412698412699,101.03002267573696,18,19,159,2,127
1686,216,431,98.82412698412699,100.0780045351474,18,12,222,1,215
1687,216,412,98.82412698412699,101.72662131519274,18,12,232,3,196
1688,216,6,99.56716553287983,100.82104308390024,16,31,217,1,210
1689,216,6,99.56716553287983,101.70340136054422,16,30,229,2,210
1690,216,6,99.56716553287983,102.1213605442177,16,31,237,3,210
1691,216,343,99.56716553287983,100.84426303854876,16,20,138,1,127
1692,216,343,99.56716553287983,101.03002267573696,16,19,142,1,127
1693,216,339,99.56716553287983,102.35356009070296,16,19,172,3,123
1694,216,412,99.56716553287983,101.72662131519274,16,12,217,2,196
1695,216,689,99.56716553287983,101.84272108843538,16,4,483,2,473
1696,343,6,100.84426303854876,102.1213605442177,20,31,341,1,337
1697,343,6,100.84426303854876,103.42167800453515,20,31,355,3,337
1698,343,339,100.84426303854876,102.35356009070296,20,19,65,2,4
1699,343,340,100.84426303854876,103.72353741496599,20,21,124,3,3
1700,343,519,100.84426303854876,102.91083900226758,20,11,197,2,176
1701,343,520,100.84426303854876,103.3752380952381,20,9,208,3,177
1702,343,689,100.84426303854876,102.72507936507937,20,2,355,2,346
1703,343,683,100.84426303854876,103.05015873015873,20,3,353,2,340
1704,343,825,100.84426303854876,102.63219954648527,20,4,488,2,482
1705,343,6,101.03002267573696,102.1213605442177,19,31,340,1,337
1706,343,6,101.03002267573696,103.42167800453515,19,31,352,2,337
1707,343,339,101.03002267573696,102.35356009070296,19,19,57,1,4
1708,343,340,101.03002267573696,103.72353741496599,19,21,116,3,3
1709,343,519,101.03002267573696,102.91083900226758,19,11,194,2,176
1710,343,520,101.03002267573696,103.3752380952381,19,9,204,2,177
1711,343,689,101.03002267573696,102.72507936507937,19,2,354,2,346
1712,343,683,101.03002267573696,103.05015873015873,19,3,351,2,340
1713,343,825,101.03002267573696,102.63219954648527,19,4,487,2,482
1714,339,6,102.35356009070296,103.42167800453515,19,31,336,1,333
1715,339,7,102.35356009070296,104.28081632653061,19,30,342,2,332
1716,339,340,102.35356009070296,103.72353741496599,19,21,59,1,1
1717,339,254,102.35356009070296,104.79165532879819,19,16,135,2,85
1718,339,520,102.35356009070296,103.3752380952381,19,9,186,1,181
1719,339,520,102.35356009070296,104.25759637188209,19,7,199,2,181
1720,339,733,102.35356009070296,104.32725623582766,19,4,403,2,394
1721,340,6,103.72353741496599,105.6043537414966,21,31,344,2,334
1722,340,254,103.72353741496599,104.79165532879819,21,16,98,1,86
1723,340,309,103.72353741496599,105.74367346938776,21,19,92,2,31
1724,340,309,103.72353741496599,106.62603174603174,21,20,129,3,31
1725,340,520,103.72353741496599,105.55791383219955,21,15,197,2,180
1726,340,433,103.72353741496599,106.53315192743764,21,11,153,3,93
1727,340,618,103.72353741496599,106.62603174603174,21,3,305,3,278
1728,254,6,104.79165532879819,106.90467120181407,16,31,264,2,248
1729,254,6,104.79165532879819,107.34585034013605,16,30,271,3,248
1730,254,309,104.79165532879819,106.62603174603174,16,20,96,2,55
1731,254,433,104.79165532879819,106.53315192743764,16,11,194,2,179
1732,254,459,104.79165532879819,107.25297052154195,16,14,231,2,205
1733,254,618,104.79165532879819,106.62603174603174,16,3,372,2,364
1734,254,625,104.79165532879819,107.64770975056689,16,2,391,3,371
1735,309,6,105.74367346938776,106.90467120181407,19,31,307,1,303
1736,309,6,105.74367346938776,107.34585034013605,19,30,311,2,303
1737,309,6,105.74367346938776,108.20498866213153,19,31,321,2,303
1738,309,337,105.74367346938776,107.99600907029479,19,15,101,2,28
1739,309,459,105.74367346938776,107.25297052154195,19,14,163,2,150
1740,309,426,105.74367346938776,108.32108843537415,19,12,161,3,117
1741,309,625,105.74367346938776,107.64770975056689,19,2,326,2,316
1742,309,6,106.62603174603174,108.20498866213153,20,31,311,2,303
1743,309,10,106.62603174603174,109.50530612244899,20,32,324,3,299
1744,309,337,106.62603174603174,107.99600907029479,20,15,65,1,28
1745,309,307,106.62603174603174,108.8087074829932,20,21,94,2,2
1746,309,426,106.62603174603174,108.32108843537415,20,12,138,2,117
1747,309,625,106.62603174603174,107.64770975056689,20,2,319,1,316
1748,337,10,107.99600907029479,109.50530612244899,15,32,333,2,327
1749,337,41,107.99600907029479,110.6895238095238,15,31,318,3,296
1750,337,308,107.99600907029479,109.62140589569161,15,26,76,2,29
1751,337,307,107.99600907029479,110.89850340136054,15,20,129,3,30
1752,337,518,107.99600907029479,109.8768253968254,15,10,198,2,181
1753,337,519,107.99600907029479,110.71274376417234,15,8,216,3,182
1754,337,615,107.99600907029479,109.69106575963718,15,6,287,2,278
1755,337,617,107.99600907029479,110.48054421768708,15,7,300,2,280
1756,307,41,108.8087074829932,110.6895238095238,21,31,278,2,266
1757,307,518,108.8087074829932,109.8768253968254,21,10,216,1,211
1758,307,519,108.8087074829932,110.71274376417234,21,8,227,2,212
1759,307,518,108.8087074829932,111.08426303854876,21,7,233,2,211
1760,307,617,108.8087074829932,110.48054421768708,21,7,318,2,310
1761,307,628,108.8087074829932,111.45578231292517,21,4,341,3,321
1762,308,41,109.62140589569161,110.6895238095238,26,31,271,1,267
1763,308,48,109.62140589569161,111.92018140589569,26,31,278,2,260
1764,308,307,109.62140589569161,110.89850340136054,26,20,55,1,1
1765,308,307,109.62140589569161,111.78086167800454,26,17,93,2,1
1766,308,244,109.62140589569161,112.08272108843538,26,15,124,2,64
1767,308,519,109.62140589569161,110.71274376417234,26,8,216,1,211
1768,308,518,109.62140589569161,111.08426303854876,26,7,219,1,210
1769,308,628,109.62140589569161,111.45578231292517,26,4,330,2,320
1770,307,48,110.89850340136054,111.92018140589569,20,31,263,1,259
1771,307,73,110.89850340136054,112.75609977324264,20,31,247,2,234
1772,307,43,110.89850340136054,113.7081179138322,20,32,290,3,264
1773,307,244,110.89850340136054,112.08272108843538,20,15,81,1,63
1774,307,462,110.89850340136054,113.01151927437643,20,8,180,2,155
1775,307,462,110.89850340136054,113.05795918367347,20,9,181,2,155
1776,307,615,110.89850340136054,112.66321995464853,20,4,317,2,308
1777,307,615,110.89850340136054,113.54557823129252,20,2,328,3,308
1778,307,43,111.78086167800454,113.7081179138322,17,32,277,2,264
1779,307,261,111.78086167800454,113.89387755102041,17,14,102,2,46
1780,307,245,111.78086167800454,114.35827664399093,17,13,127,3,62
1781,307,462,111.78086167800454,113.01151927437643,17,8,164,1,155
1782,307,462,111.78086167800454,113.05795918367347,17,9,164,1,155
1783,307,497,111.78086167800454,114.03319727891157,17,3,213,2,190
1784,307,615,111.78086167800454,113.54557823129252,17,2,317,2,308
1785,244,43,112.08272108843538,113.7081179138322,15,32,213,2,201
1786,244,14,112.08272108843538,114.89233560090703,15,32,260,3,230
1787,244,261,112.08272108843538,113.89387755102041,15,14,80,2,17
1788,244,245,112.08272108843538,114.35827664399093,15,13,98,2,1
1789,244,497,112.08272108843538,114.03319727891157,15,3,267,2,253
1790,244,615,112.08272108843538,113.54557823129252,15,2,376,1,371
1791,261,44,113.89387755102041,115.79791383219955,14,32,232,2,217
1792,261,38,113.89387755102041,116.28553287981859,14,31,246,2,223
1793,261,269,113.89387755102041,115.65859410430839,14,10,76,2,8
1794,261,269,113.89387755102041,116.09977324263039,14,12,95,2,8
1795,261,532,113.89387755102041,115.82113378684808,14,5,283,2,271
1796,261,496,113.89387755102041,116.51773242630385,14,5,261,3,235
1797,261,705,113.89387755102041,115.5657142857143,14,4,450,2,444
1798,261,721,113.89387755102041,116.19265306122449,14,7,471,2,460
1799,245,44,114.35827664399093,115.79791383219955,13,32,210,1,201
1800,245,38,114.35827664399093,116.28553287981859,13,31,223,2,207
1801,245,269,114.35827664399093,115.65859410430839,13,10,61,1,24
1802,245,269,114.35827664399093,116.09977324263039,13,12,79,2,24
1803,245,532,114.35827664399093,115.82113378684808,13,5,294,1,287
1804,245,496,114.35827664399093,116.51773242630385,13,5,268,2,251
1805,245,705,114.35827664399093,115.5657142857143,13,4,463,1,460
1806,245,721,114.35827664399093,116.19265306122449,13,7,483,2,476
1807,269,49,115.65859410430839,118.02702947845805,10,32,242,2,220
1808,269,48,115.65859410430839,118.46820861678005,10,31,252,3,221
1809,269,270,115.65859410430839,118.25922902494331,10,10,112,3,1
1810,269,516,115.65859410430839,117.8877097505669,10,7,265,2,247
1811,269,626,115.65859410430839,117.60907029478459,10,5,367,2,357
1812,269,49,116.09977324263039,118.02702947845805,12,32,235,2,220
1813,269,48,116.09977324263039,118.46820861678005,12,31,243,2,221
1814,269,270,116.09977324263039,118.25922902494331,12,10,93,2,1
1815,269,516,116.09977324263039,117.8877097505669,12,7,259,2,247
1816,269,579,116.09977324263039,118.93260770975057,12,6,333,3,310
1817,269,626,116.09977324263039,117.60907029478459,12,5,363,2,357
1818,269,49,117.56263038548754,119.72208616780046,14,31,239,2,220
1819,269,52,117.56263038548754,120.2097052154195,14,31,245,3,217
1820,269,268,117.56263038548754,119.97750566893424,14,14,104,2,1
1821,269,579,117.56263038548754,118.93260770975057,14,6,316,1,310
1822,269,533,117.56263038548754,119.25768707482993,14,7,274,2,264
1823,269,539,117.56263038548754,120.53478458049887,14,8,299,3,270
1824,269,656,117.56263038548754,120.51156462585034,14,3,407,3,387
1825,270,49,118.25922902494331,119.72208616780046,10,31,230,1,221
1826,270,52,118.25922902494331,120.2097052154195,10,31,234,2,218
1827,270,268,118.25922902494331,119.97750566893424,10,14,74,2,2
1828,270,242,118.25922902494331,121.16172335600908,10,13,128,3,28
1829,270,539,118.25922902494331,120.53478458049887,10,8,286,2,269
1830,270,656,118.25922902494331,120.51156462585034,10,3,398,2,386
1831,268,5,119.97750566893424,121.2778231292517,14,28,269,1,263
1832,268,242,119.97750566893424,121.16172335600908,14,13,57,1,26
1833,268,230,119.97750566893424,122.11374149659864,14,13,100,2,38
1834,268,545,119.97750566893424,121.39392290249434,14,6,284,1,277
1835,268,479,119.97750566893424,122.50848072562358,14,6,237,3,211
1836,268,639,119.97750566893424,121.41714285714286,14,4,376,1,371
1837,268,689,119.97750566893424,122.50848072562358,14,3,435,3,421
1838,270,19,120.6508843537415,122.99609977324263,11,32,271,2,251
1839,270,20,120.6508843537415,123.55337868480726,11,33,280,3,250
1840,270,230,120.6508843537415,122.11374149659864,11,13,75,1,40
1841,270,269,120.6508843537415,123.04253968253968,11,12,103,2,1
1842,270,479,120.6508843537415,122.50848072562358,11,6,224,2,209
1843,270,689,120.6508843537415,122.50848072562358,11,3,427,2,419
1844,242,19,121.16172335600908,122.99609977324263,13,32,237,2,223
1845,242,20,121.16172335600908,123.55337868480726,13,33,245,2,222
1846,242,269,121.16172335600908,123.04253968253968,13,12,85,2,27
1847,242,479,121.16172335600908,122.50848072562358,13,6,244,1,237
1848,242,540,121.16172335600908,123.92489795918368,13,5,321,3,298
1849,242,516,121.16172335600908,124.06421768707483,13,5,301,3,274
1850,242,689,121.16172335600908,122.50848072562358,13,3,451,1,447
1851,230,20,122.11374149659864,123.55337868480726,13,33,219,1,210
1852,230,44,122.11374149659864,124.50539682539683,13,32,213,2,186
1853,230,247,122.11374149659864,124.18031746031747,13,13,91,2,17
1854,230,540,122.11374149659864,123.92489795918368,13,5,320,2,310
1855,230,516,122.11374149659864,124.06421768707483,13,5,298,2,286
1856,269,44,123.04253968253968,124.50539682539683,12,32,234,1,225
1857,269,12,123.04253968253968,126.01469387755103,12,31,287,3,257
1858,269,247,123.04253968253968,124.18031746031747,12,13,54,1,22
1859,269,257,123.04253968253968,125.92181405895691,12,19,125,3,12
1860,269,516,123.04253968253968,124.06421768707483,12,5,251,1,247
1861,269,499,123.04253968253968,125.6431746031746,12,11,256,3,230
1862,247,12,124.18031746031747,126.01469387755103,13,31,248,2,235
1863,247,65,124.18031746031747,126.4326530612245,13,34,206,2,182
1864,247,257,124.18031746031747,125.92181405895691,13,19,76,2,10
1865,247,206,124.18031746031747,126.45587301587302,13,16,106,2,41
1866,247,499,124.18031746031747,125.6431746031746,13,11,260,1,252
1867,247,480,124.18031746031747,126.89705215419501,13,8,261,3,233
1868,257,6,125.92181405895691,127.33823129251701,19,35,258,1,251
1869,257,7,125.92181405895691,128.19736961451247,19,33,269,2,250
1870,257,233,125.92181405895691,128.03482993197278,19,22,94,2,24
1871,257,232,125.92181405895691,128.17414965986396,19,27,100,2,25
1872,257,495,125.92181405895691,128.03482993197278,19,13,255,2,238
1873,257,519,125.92181405895691,128.10448979591837,19,15,278,2,262
1874,257,754,125.92181405895691,128.19736961451247,19,2,507,2,497
1875,206,7,126.45587301587302,128.19736961451247,16,33,213,2,199
1876,206,233,126.45587301587302,128.03482993197278,16,22,73,2,27
1877,206,232,126.45587301587302,128.17414965986396,16,27,78,2,26
1878,206,495,126.45587301587302,128.03482993197278,16,13,297,2,289
1879,206,519,126.45587301587302,128.10448979591837,16,15,321,2,313
1880,233,58,128.03482993197278,129.75310657596373,22,33,190,2,175
1881,233,11,128.03482993197278,130.3568253968254,22,32,243,2,222
1882,233,232,128.03482993197278,129.96208616780046,22,16,83,2,1
1883,233,231,128.03482993197278,130.91410430839002,22,21,124,3,2
1884,233,452,128.03482993197278,129.49768707482994,22,12,228,1,219
1885,233,544,128.03482993197278,130.38004535147394,22,14,327,2,311
1886,232,58,128.17414965986396,129.75310657596373,27,33,187,2,174
1887,232,11,128.17414965986396,130.3568253968254,27,32,240,2,221
1888,232,231,128.17414965986396,130.91410430839002,27,21,118,3,1
1889,232,452,128.17414965986396,129.49768707482994,27,12,227,1,220
1890,232,544,128.17414965986396,130.38004535147394,27,14,326,2,312
1891,232,24,129.96208616780046,131.5178231292517,16,32,219,2,208
1892,232,48,129.96208616780046,132.84136054421768,16,33,222,3,184
1893,232,235,129.96208616780046,131.44816326530614,16,15,64,1,3
1894,232,239,129.96208616780046,132.9342403628118,16,16,128,3,7
1895,232,437,129.96208616780046,131.65714285714287,16,12,218,2,205
1896,232,479,129.96208616780046,132.12154195011337,16,12,264,2,247
1897,232,627,129.96208616780046,131.81968253968253,16,10,403,2,395
1898,231,48,130.91410430839002,132.84136054421768,21,33,201,2,183
1899,231,49,130.91410430839002,133.2825396825397,21,33,209,2,182
1900,231,239,130.91410430839002,132.9342403628118,21,16,87,2,8
1901,231,206,130.91410430839002,133.67727891156463,21,16,122,3,25
1902,231,479,130.91410430839002,132.12154195011337,21,12,253,1,248
1903,231,480,130.91410430839002,133.83981859410432,21,12,279,3,249
1904,231,673,130.91410430839002,132.95746031746032,21,5,451,2,442
1905,231,677,130.91410430839002,133.2128798185941,21,6,457,2,446
1906,235,48,131.44816326530614,132.84136054421768,15,33,196,1,187
1907,235,49,131.44816326530614,133.2825396825397,15,33,202,2,186
1908,235,239,131.44816326530614,132.9342403628118,15,16,64,1,4
1909,235,206,131.44816326530614,133.67727891156463,15,16,100,2,29
1910,235,480,131.44816326530614,133.83981859410432,15,12,266,2,245
1911,235,673,131.44816326530614,132.95746031746032,15,5,443,2,438
1912,235,677,131.44816326530614,133.2128798185941,15,6,448,2,442
1913,239,7,132.9342403628118,134.7221768707483,16,32,244,2,232
1914,239,14,132.9342403628118,135.58131519274377,16,34,252,3,225
1915,239,349,132.9342403628118,134.67573696145126,16,17,133,2,110
1916,239,355,132.9342403628118,135.65097505668933,16,15,165,3,116
1917,239,590,132.9342403628118,134.48997732426304,16,11,357,2,351
1918,239,480,132.9342403628118,135.60453514739228,16,11,267,3,241
1919,239,622,132.9342403628118,134.48997732426304,16,8,389,2,383
1920,206,7,133.67727891156463,134.7221768707483,16,32,204,1,199
1921,206,14,133.67727891156463,135.58131519274377,16,34,209,2,192
1922,206,355,133.67727891156463,135.65097505668933,16,15,172,2,149
1923,206,480,133.67727891156463,135.60453514739228,16,11,286,2,274
1924,206,434,133.67727891156463,136.27791383219954,16,10,254,3,228
1925,206,619,133.67727891156463,136.4172335600907,16,5,430,3,413
1926,349,44,134.67573696145126,136.74231292517007,17,35,318,2,305
1927,349,33,134.67573696145126,137.27637188208618,17,33,335,3,316
1928,349,291,134.67573696145126,137.0209523809524,17,16,116,2,58
1929,349,434,134.67573696145126,136.27791383219954,17,10,109,2,85
1930,349,619,134.67573696145126,136.4172335600907,17,5,280,2,270
1931,355,44,135.65097505668933,136.74231292517007,15,35,315,1,311
1932,355,33,135.65097505668933,137.27637188208618,15,33,330,2,322
1933,355,38,135.65097505668933,138.06585034013605,15,33,334,2,317
1934,355,291,135.65097505668933,137.0209523809524,15,16,87,1,64
1935,355,268,135.65097505668933,137.9497505668934,15,18,132,2,87
1936,355,230,135.65097505668933,138.2748299319728,15,16,169,3,125
1937,355,480,135.65097505668933,137.9961904761905,15,13,161,2,125
1938,355,459,135.65097505668933,138.34448979591838,15,6,156,3,104
1939,355,658,135.65097505668933,137.9497505668934,15,8,319,2,303
1940,291,38,137.0209523809524,138.06585034013605,16,33,257,1,253
1941,291,6,137.0209523809524,139.94666666666666,16,33,312,3,285
1942,291,230,137.0209523809524,138.2748299319728,16,16,81,1,61
1943,291,459,137.0209523809524,138.34448979591838,16,6,177,1,168
1944,268,6,137.9497505668934,139.94666666666666,18,33,276,2,262
1945,268,66,137.9497505668934,140.64326530612246,18,36,233,3,202
1946,268,223,137.9497505668934,140.0395464852608,18,29,101,2,45
1947,268,223,137.9497505668934,140.0627664399093,18,29,102,2,45
1948,268,510,137.9497505668934,140.0395464852608,18,13,258,2,242
1949,268,511,137.9497505668934,140.08598639455784,18,16,260,2,243
1950,268,765,137.9497505668934,140.0395464852608,18,8,505,2,497
1951,230,6,138.2748299319728,139.94666666666666,16,33,235,2,224
1952,230,66,138.2748299319728,140.64326530612246,16,36,193,2,164
1953,230,223,138.2748299319728,140.0395464852608,16,29,76,2,7
1954,230,223,138.2748299319728,140.0627664399093,16,29,77,2,7
1955,230,239,138.2748299319728,141.20054421768708,16,18,126,3,9
1956,230,510,138.2748299319728,140.0395464852608,16,13,290,2,280
1957,230,511,138.2748299319728,140.08598639455784,16,16,292,2,281
1958,230,507,138.2748299319728,141.1308843537415,16,11,303,3,277
1959,230,655,138.2748299319728,141.01478458049885,16,10,441,3,425
1960,223,59,140.0395464852608,141.54884353741497,29,35,176,2,164
1961,223,6,140.0395464852608,142.12934240362813,29,35,235,2,217
1962,223,239,140.0395464852608,141.20054421768708,29,18,52,1,16
1963,223,256,140.0395464852608,142.918820861678,29,23,128,3,33
1964,223,507,140.0395464852608,141.1308843537415,29,11,288,1,284
1965,223,493,140.0395464852608,142.50086167800453,29,10,290,2,270
1966,223,616,140.0395464852608,141.33986394557823,29,3,397,1,393
1967,223,701,140.0395464852608,142.08290249433108,29,8,486,2,478
1968,223,59,140.0627664399093,141.54884353741497,29,35,176,1,164
1969,223,6,140.0627664399093,142.12934240362813,29,35,235,2,217
1970,223,239,140.0627664399093,141.20054421768708,29,18,52,1,16
1971,223,256,140.0627664399093,142.918820861678,29,23,127,3,33
1972,223,507,140.0627664399093,141.1308843537415,29,11,288,1,284
1973,223,493,140.0627664399093,142.50086167800453,29,10,290,2,270
1974,223,616,140.0627664399093,141.33986394557823,29,3,397,1,393
1975,223,701,140.0627664399093,142.08290249433108,29,8,486,2,478
1976,239,56,141.20054421768708,143.5457596371882,18,35,209,2,183
1977,239,256,141.20054421768708,142.918820861678,18,23,76,2,17
1978,239,290,141.20054421768708,143.6386394557823,18,20,117,2,51
1979,239,493,141.20054421768708,142.50086167800453,18,10,260,1,254
1980,239,473,141.20054421768708,143.9637188208617,18,9,263,3,234
1981,239,668,141.20054421768708,143.49931972789116,18,4,440,2,429
1982,256,5,142.918820861678,144.72997732426305,23,35,263,2,251
1983,256,205,142.918820861678,144.7764172335601,23,24,95,2,51
1984,256,205,142.918820861678,145.63555555555556,23,17,128,3,51
1985,256,473,142.918820861678,143.9637188208617,23,9,222,1,217
1986,256,487,142.918820861678,144.7764172335601,23,11,244,2,231
1987,256,471,142.918820861678,145.54267573696146,23,12,243,3,215
1988,256,622,142.918820861678,144.24235827664398,23,4,370,1,366
1989,256,665,142.918820861678,145.6819954648526,23,12,426,3,409
1990,290,5,143.6386394557823,144.72997732426305,20,35,289,1,285
1991,290,6,143.6386394557823,146.0302947845805,20,34,302,2,284
1992,290,39,143.6386394557823,146.26249433106577,20,34,275,3,251
1993,290,205,143.6386394557823,144.7764172335601,20,24,98,1,85
1994,290,205,143.6386394557823,145.63555555555556,20,17,121,2,85
1995,290,487,143.6386394557823,144.7764172335601,20,11,203,1,197
1996,290,471,143.6386394557823,145.54267573696146,20,12,199,2,181
1997,290,665,143.6386394557823,145.6819954648526,20,12,385,2,375
1998,205,6,144.7764172335601,146.0302947845805,24,34,206,1,199
1999,205,39,144.7764172335601,146.26249433106577,24,34,178,1,166
2000,205,223,144.7764172335601,147.02875283446713,24,24,99,2,18
2001,205,225,144.7764172335601,147.14485260770977,24,26,104,2,20
2002,205,516,144.7764172335601,146.98231292517008,24,13,325,2,311
2003,205,6,145.63555555555556,147.77179138321995,17,36,219,2,199
2004,205,58,145.63555555555556,148.6077097505669,17,36,195,3,147
2005,205,223,145.63555555555556,147.02875283446713,17,24,63,1,18
2006,205,225,145.63555555555556,147.14485260770977,17,26,68,2,20
2007,205,229,145.63555555555556,148.05043083900227,17,20,107,2,24
2008,205,516,145.63555555555556,146.98231292517008,17,13,316,1,311
2009,205,576,145.63555555555556,148.00399092970522,17,9,385,2,371
2010,205,573,145.63555555555556,148.3522902494331,17,11,386,3,368
2011,205,621,145.63555555555556,147.84145124716554,17,7,427,2,416
2012,205,634,145.63555555555556,148.3522902494331,17,12,445,3,429
2013,223,58,147.02875283446713,148.6077097505669,24,36,178,2,165
2014,223,6,147.02875283446713,149.07210884353742,24,35,234,2,217
2015,223,229,147.02875283446713,148.05043083900227,24,20,44,1,6
2016,223,242,147.02875283446713,149.582947845805,24,26,112,3,19
2017,223,573,147.02875283446713,148.3522902494331,24,11,355,1,350
2018,223,450,147.02875283446713,149.18820861678006,24,13,245,2,227
2019,223,634,147.02875283446713,148.3522902494331,24,12,415,1,411
2020,223,642,147.02875283446713,149.25786848072562,24,9,430,2,419
2021,225,58,147.14485260770977,148.6077097505669,26,36,178,1,167
2022,225,6,147.14485260770977,149.07210884353742,26,35,234,2,219
2023,225,242,147.14485260770977,149.582947845805,26,26,106,2,17
2024,225,573,147.14485260770977,148.3522902494331,26,11,352,1,348
2025,225,450,147.14485260770977,149.18820861678006,26,13,242,2,225
2026,225,634,147.14485260770977,148.3522902494331,26,12,412,1,409
2027,225,642,147.14485260770977,149.25786848072562,26,9,427,2,417
2028,229,6,148.05043083900227,149.07210884353742,20,35,227,1,223
2029,229,58,148.05043083900227,150.95292517006803,20,36,212,3,171
2030,229,242,148.05043083900227,149.582947845805,20,26,67,2,13
2031,229,205,148.05043083900227,150.90648526077098,20,21,125,3,24
2032,229,450,148.05043083900227,149.18820861678006,20,13,226,1,221
2033,229,611,148.05043083900227,150.4885260770975,20,12,396,2,382
2034,229,642,148.05043083900227,149.25786848072562,20,9,416,1,413
2035,229,619,148.05043083900227,150.51174603174604,20,10,404,2,390
2036,242,58,149.582947845805,150.95292517006803,26,36,193,1,184
2037,242,58,149.582947845805,151.09224489795918,26,37,195,2,184
2038,242,205,149.582947845805,150.90648526077098,26,21,68,1,37
2039,242,227,149.582947845805,151.32444444444445,26,27,76,2,15
2040,242,463,149.582947845805,151.41732426303855,26,13,235,2,221
2041,242,646,149.582947845805,151.4405442176871,26,11,412,2,404
2042,205,6,150.90648526077098,152.99628117913832,21,34,218,2,199
2043,205,307,150.90648526077098,153.4374603174603,21,20,149,3,102
2044,205,496,150.90648526077098,152.92662131519273,21,4,304,2,291
2045,227,6,151.32444444444445,152.99628117913832,27,34,232,2,221
2046,227,64,151.32444444444445,153.94829931972788,27,35,198,3,163
2047,227,5,151.32444444444445,154.2965986394558,27,33,256,3,222
2048,227,205,151.32444444444445,152.57832199546485,27,18,58,1,22
2049,227,307,151.32444444444445,153.4374603174603,27,20,121,2,80
2050,227,496,151.32444444444445,152.92662131519273,27,4,278,2,269
2051,227,423,151.32444444444445,154.041179138322,27,7,228,3,196
2052,205,64,152.57832199546485,153.94829931972788,18,35,153,1,141
2053,205,5,152.57832199546485,154.2965986394558,18,33,213,2,200
2054,205,230,152.57832199546485,154.73777777777778,18,25,96,2,25
2055,205,423,152.57832199546485,154.041179138322,18,7,227,1,218
2056,205,486,152.57832199546485,154.90031746031747,18,14,298,2,281
2057,307,5,153.4374603174603,156.03809523809525,20,35,322,3,302
2058,307,230,153.4374603174603,154.73777777777778,20,25,95,1,77
2059,307,205,153.4374603174603,156.03809523809525,20,20,151,3,102
2060,307,486,153.4374603174603,154.90031746031747,20,14,190,1,179
2061,307,563,153.4374603174603,155.9916553287982,20,14,279,3,256
2062,307,654,153.4374603174603,156.0148752834467,20,8,364,3,347
2063,307,623,153.4374603174603,156.06131519274376,20,3,336,3,316
2064,230,5,154.73777777777778,156.03809523809525,25,35,232,1,225
2065,230,5,154.73777777777778,156.47927437641724,25,34,237,2,225
2066,230,205,154.73777777777778,156.03809523809525,25,20,61,1,25
2067,230,236,154.73777777777778,156.57215419501134,25,22,79,2,6
2068,230,563,154.73777777777778,155.9916553287982,25,14,337,1,333
2069,230,520,154.73777777777778,156.6185941043084,25,9,301,2,290
2070,230,572,154.73777777777778,157.70993197278912,25,15,365,3,342
2071,230,654,154.73777777777778,156.0148752834467,25,8,428,1,424
2072,230,623,154.73777777777778,156.06131519274376,25,3,397,1,393
2073,230,635,154.73777777777778,157.64027210884353,25,14,424,3,405
2074,205,6,156.03809523809525,157.7795918367347,20,35,213,2,199
2075,205,6,156.03809523809525,158.19755102040816,20,35,220,2,199
2076,205,237,156.03809523809525,158.26721088435374,20,24,101,2,32
2077,205,572,156.03809523809525,157.70993197278912,20,15,374,2,367
2078,205,520,156.03809523809525,158.33687074829933,20,12,330,2,315
2079,205,635,156.03809523809525,157.64027210884353,20,14,436,2,430
2080,205,667,156.03809523809525,158.3136507936508,20,4,472,2,462
2081,236,6,156.57215419501134,157.7795918367347,22,35,236,1,230
2082,236,6,156.57215419501134,158.19755102040816,22,35,240,2,230
2083,236,205,156.57215419501134,157.8724716553288,22,31,64,1,31
2084,236,237,156.57215419501134,158.26721088435374,22,24,73,2,1
2085,236,572,156.57215419501134,157.70993197278912,22,15,340,1,336
2086,236,520,156.57215419501134,158.33687074829933,22,12,294,2,284
2087,236,529,156.57215419501134,159.381768707483,22,9,317,3,293
2088,236,635,156.57215419501134,157.64027210884353,22,14,402,1,399
2089,236,667,156.57215419501134,158.3136507936508,22,4,437,2,431
2090,236,617,156.57215419501134,159.381768707483,22,3,400,3,381
2091,205,47,157.8724716553288,159.84616780045351,31,35,179,2,158
2092,205,6,157.8724716553288,160.8214058956916,31,35,236,3,199
2093,205,246,157.8724716553288,160.47310657596373,31,15,119,3,41
2094,205,529,157.8724716553288,159.381768707483,31,9,330,2,324
2095,205,617,157.8724716553288,159.381768707483,31,3,417,2,412
2096,205,619,157.8724716553288,160.77496598639456,31,3,432,3,414
2097,237,47,158.26721088435374,159.84616780045351,24,35,202,2,190
2098,237,6,158.26721088435374,160.8214058956916,24,35,256,3,231
2099,237,205,158.26721088435374,159.68362811791383,24,18,69,1,32
2100,237,246,158.26721088435374,160.47310657596373,24,15,95,2,9
2101,237,529,158.26721088435374,159.381768707483,24,9,296,1,292
2102,237,575,158.26721088435374,160.86784580498866,24,10,356,3,338
2103,237,617,158.26721088435374,159.381768707483,24,3,383,1,380
2104,237,619,158.26721088435374,160.77496598639456,24,3,397,3,382
2105,205,6,159.68362811791383,160.8214058956916,18,35,205,1,199
2106,205,6,159.68362811791383,161.2625850340136,18,34,210,2,199
2107,205,6,159.68362811791383,162.12172335600908,18,36,225,2,199
2108,205,263,159.68362811791383,161.91274376417235,18,20,112,2,58
2109,205,575,159.68362811791383,160.86784580498866,18,10,373,1,370
2110,205,506,159.68362811791383,162.0520634920635,18,10,318,2,301
2111,205,510,159.68362811791383,162.09850340136055,18,11,322,2,305
2112,205,619,159.68362811791383,160.77496598639456,18,3,417,1,414
2113,205,635,159.68362811791383,162.0520634920635,18,12,442,2,430
2114,205,630,159.68362811791383,162.09850340136055,18,12,438,2,425
2115,246,6,160.47310657596373,162.12172335600908,15,36,250,2,240
2116,246,6,160.47310657596373,163.42204081632653,15,35,272,3,240
2117,246,263,160.47310657596373,161.91274376417235,15,20,64,1,17
2118,246,255,160.47310657596373,162.98086167800454,15,17,108,3,9
2119,246,205,160.47310657596373,163.16662131519274,15,19,123,3,41
2120,246,506,160.47310657596373,162.0520634920635,15,10,269,2,260
2121,246,510,160.47310657596373,162.09850340136055,15,11,273,2,264
2122,246,528,160.47310657596373,163.25950113378684,15,8,306,3,282
2123,246,635,160.47310657596373,162.0520634920635,15,12,395,2,389
2124,246,630,160.47310657596373,162.09850340136055,15,12,390,2,384
2125,263,6,161.91274376417235,163.42204081632653,20,35,265,2,257
2126,263,5,161.91274376417235,164.30439909297053,20,34,278,2,258
2127,263,255,161.91274376417235,162.98086167800454,20,17,47,1,8
2128,263,205,161.91274376417235,163.16662131519274,20,19,79,1,58
2129,263,205,161.91274376417235,164.79201814058956,20,16,137,3,58
2130,263,528,161.91274376417235,163.25950113378684,20,8,271,1,265
2131,263,597,161.91274376417235,164.16507936507938,20,11,348,2,334
2132,263,654,161.91274376417235,163.72390022675737,20,3,399,2,391
2133,263,656,161.91274376417235,164.11863945578233,20,12,404,2,393
2134,255,5,162.98086167800454,164.30439909297053,17,34,256,1,250
2135,255,205,162.98086167800454,164.79201814058956,17,16,93,2,50
2136,255,205,162.98086167800454,165.67437641723356,17,14,126,3,50
2137,255,597,162.98086167800454,164.16507936507938,17,11,346,1,342
2138,255,594,162.98086167800454,165.90657596371884,17,8,362,3,339
2139,255,656,162.98086167800454,164.11863945578233,17,12,404,1,401
2140,205,5,163.16662131519274,164.30439909297053,19,34,206,1,200
2141,205,6,163.16662131519274,166.04589569160999,19,35,234,3,199
2142,205,594,163.16662131519274,165.90657596371884,19,8,407,3,389
2143,205,619,163.16662131519274,165.99945578231294,19,3,432,3,414
2144,205,6,164.79201814058956,166.04589569160999,16,35,206,1,199
2145,205,6,164.79201814058956,166.90503401360544,16,34,219,2,199
2146,205,295,164.79201814058956,167.69451247165534,16,19,154,3,90
2147,205,594,164.79201814058956,165.90657596371884,16,8,392,1,389
2148,205,456,164.79201814058956,166.9514739229025,16,8,268,2,251
2149,205,592,164.79201814058956,167.6712925170068,16,10,406,3,387
2150,205,619,164.79201814058956,165.99945578231294,16,3,417,1,414
2151,205,618,164.79201814058956,166.27809523809523,16,5,418,1,413
2152,205,6,165.67437641723356,166.90503401360544,14,34,206,1,199
2153,205,5,165.67437641723356,167.78739229024944,14,36,220,2,200
2154,205,13,165.67437641723356,168.22857142857143,14,29,221,3,192
2155,205,295,165.67437641723356,167.69451247165534,14,19,125,2,90
2156,205,456,165.67437641723356,166.9514739229025,14,8,257,1,251
2157,205,592,165.67437641723356,167.6712925170068,14,10,396,2,387
2158,205,474,165.67437641723356,168.50721088435375,14,7,295,3,269
2159,205,616,165.67437641723356,168.13569160997733,14,3,424,2,411
2160,205,5,166.5102947845805,167.78739229024944,19,36,207,1,200
2161,205,13,166.5102947845805,168.22857142857143,19,29,206,2,192
2162,205,51,166.5102947845805,169.11092970521543,19,26,190,3,154
2163,205,295,166.5102947845805,167.69451247165534,19,19,103,1,90
2164,205,308,166.5102947845805,169.04126984126984,19,15,150,3,103
2165,205,231,166.5102947845805,169.3663492063492,19,14,126,3,26
2166,205,592,166.5102947845805,167.6712925170068,19,10,390,1,387
2167,205,474,166.5102947845805,168.50721088435375,19,7,282,2,269
2168,205,473,166.5102947845805,169.3663492063492,19,7,295,3,268
2169,205,616,166.5102947845805,168.13569160997733,19,3,417,2,411
2170,205,696,166.5102947845805,169.34312925170067,19,3,506,3,491
2171,295,51,167.69451247165534,169.11092970521543,19,26,252,1,244
2172,295,308,167.69451247165534,169.04126984126984,19,15,59,1,13
2173,295,231,167.69451247165534,169.3663492063492,19,14,96,2,64
2174,295,233,167.69451247165534,170.17904761904762,19,15,124,2,62
2175,295,473,167.69451247165534,169.3663492063492,19,7,192,2,178
2176,295,696,167.69451247165534,169.34312925170067,19,3,407,2,401
2177,308,16,169.04126984126984,170.80598639455783,15,26,302,2,292
2178,308,13,169.04126984126984,171.27038548752836,15,32,310,2,295
2179,308,233,169.04126984126984,170.17904761904762,15,15,90,1,75
2180,308,311,169.04126984126984,171.34004535147392,15,15,99,2,3
2181,308,472,169.04126984126984,170.75954648526078,15,7,180,2,164
2182,308,464,169.04126984126984,171.10784580498867,15,4,180,2,156
2183,308,619,169.04126984126984,171.27038548752836,15,2,325,2,311
2184,231,16,169.3663492063492,170.80598639455783,14,26,224,1,215
2185,231,13,169.3663492063492,171.27038548752836,14,32,233,2,218
2186,231,51,169.3663492063492,172.10630385487528,14,31,215,3,180
2187,231,311,169.3663492063492,171.34004535147392,14,15,117,2,80
2188,231,472,169.3663492063492,170.75954648526078,14,7,248,1,241
2189,231,464,169.3663492063492,171.10784580498867,14,4,245,2,233
2190,231,619,169.3663492063492,171.27038548752836,14,2,397,2,388
2191,231,616,169.3663492063492,172.12952380952382,14,3,403,3,385
2192,233,13,170.17904761904762,171.27038548752836,15,32,225,1,220
2193,233,51,170.17904761904762,172.10630385487528,15,31,200,2,182
2194,233,311,170.17904761904762,171.34004535147392,15,15,93,1,78
2195,233,232,170.17904761904762,172.87256235827664,15,15,116,3,1
2196,233,465,170.17904761904762,172.80290249433108,15,3,258,3,232
2197,233,619,170.17904761904762,171.27038548752836,15,2,389,1,386
2198,233,616,170.17904761904762,172.12952380952382,15,3,392,2,383
2199,311,16,171.34004535147392,173.22086167800452,15,28,306,2,295
2200,311,232,171.34004535147392,172.87256235827664,15,15,103,2,79
2201,311,231,171.34004535147392,173.8942403628118,15,17,136,3,80
2202,311,465,171.34004535147392,172.80290249433108,15,3,166,1,154
2203,311,464,171.34004535147392,173.94068027210884,15,3,190,3,153
2204,232,26,172.87256235827664,174.79981859410432,15,28,222,2,206
2205,232,26,172.87256235827664,175.35709750566895,15,31,232,2,206
2206,232,231,172.87256235827664,173.8942403628118,15,17,44,1,1
2207,232,464,172.87256235827664,173.94068027210884,15,3,237,1,232
2208,232,457,172.87256235827664,174.73015873015873,15,4,239,2,225
2209,232,416,172.87256235827664,175.17133786848072,15,2,209,2,184
2210,231,26,173.8942403628118,175.35709750566895,17,31,214,1,205
2211,231,51,173.8942403628118,176.07691609977326,17,29,203,2,180
2212,231,232,173.8942403628118,175.19455782312926,17,14,56,1,1
2213,231,232,173.8942403628118,176.26267573696146,17,13,102,2,1
2214,231,416,173.8942403628118,175.17133786848072,17,2,193,1,185
2215,231,473,173.8942403628118,176.70385487528344,17,5,271,3,242
2216,232,51,174.38185941043085,176.07691609977326,15,29,195,2,181
2217,232,16,174.38185941043085,177.12181405895691,15,29,246,3,216
2218,232,473,174.38185941043085,176.70385487528344,15,5,261,2,241
2219,232,16,175.19455782312926,177.12181405895691,14,29,231,2,216
2220,232,289,175.19455782312926,177.3772335600907,14,13,110,2,57
2221,232,473,175.19455782312926,176.70385487528344,14,5,250,2,241
2222,232,464,175.19455782312926,178.05061224489796,14,3,263,3,232
2223,232,464,175.19455782312926,178.0738321995465,14,5,263,3,232
2224,232,14,176.26267573696146,178.4221315192744,13,29,237,2,218
2225,232,289,176.26267573696146,177.3772335600907,13,13,75,1,57
2226,232,314,176.26267573696146,178.21315192743765,13,12,117,2,82
2227,232,464,176.26267573696146,178.05061224489796,13,3,244,2,232
2228,232,464,176.26267573696146,178.0738321995465,13,5,245,2,232
2229,232,534,176.26267573696146,179.1419501133787,13,2,326,3,302
2230,232,618,176.26267573696146,178.23637188208616,13,4,395,2,386
2231,289,14,177.3772335600907,178.4221315192744,13,29,279,1,275
2232,289,14,177.3772335600907,179.5134693877551,13,28,290,2,275
2233,289,239,177.3772335600907,179.420589569161,13,11,101,2,50
2234,289,534,177.3772335600907,179.1419501133787,13,2,257,2,245
2235,314,14,178.21315192743765,179.5134693877551,12,28,305,1,300
2236,314,78,178.21315192743765,180.90666666666667,12,33,263,3,236
2237,314,239,178.21315192743765,179.420589569161,12,11,91,1,75
2238,314,222,178.21315192743765,180.51192743764173,12,14,135,2,92
2239,314,457,178.21315192743765,180.79056689342403,12,10,181,3,143
2240,314,615,178.21315192743765,180.67446712018142,12,3,319,2,301
2241,239,78,179.420589569161,180.90666666666667,11,33,173,1,161
2242,239,5,179.420589569161,181.69614512471657,11,35,254,2,234
2243,239,6,179.420589569161,182.11410430839004,11,36,260,3,233
2244,239,222,179.420589569161,180.51192743764173,11,14,50,1,17
2245,239,255,179.420589569161,181.32462585034014,11,13,84,2,16
2246,239,457,179.420589569161,180.79056689342403,11,10,226,1,218
2247,239,445,179.420589569161,181.3014058956916,11,10,221,2,206
2248,239,615,179.420589569161,180.67446712018142,11,3,380,1,376
2249,222,5,180.51192743764173,181.69614512471657,14,35,223,1,217
2250,222,6,180.51192743764173,182.11410430839004,14,36,227,2,216
2251,222,271,180.51192743764173,182.50884353741498,14,16,99,2,49
2252,222,539,180.51192743764173,182.48562358276644,14,2,328,2,317
2253,255,6,181.32462585034014,183.85560090702947,13,34,272,3,249
2254,255,6,181.32462585034014,184.29678004535148,13,34,280,3,249
2255,255,271,181.32462585034014,182.50884353741498,13,16,53,1,16
2256,255,206,181.32462585034014,184.0413605442177,13,16,127,3,49
2257,255,539,181.32462585034014,182.48562358276644,13,2,288,1,284
2258,255,411,181.32462585034014,183.73950113378686,13,5,187,2,156
2259,255,454,181.32462585034014,184.20390022675738,13,13,234,3,199
2260,271,6,182.50884353741498,183.85560090702947,16,34,271,1,265
2261,271,6,182.50884353741498,184.29678004535148,16,34,276,2,265
2262,271,206,182.50884353741498,184.0413605442177,16,16,93,2,65
2263,271,216,182.50884353741498,184.62185941043083,16,17,106,2,55
2264,271,226,182.50884353741498,185.36489795918368,16,15,131,3,45
2265,271,411,182.50884353741498,183.73950113378686,16,5,150,1,140
2266,271,454,182.50884353741498,184.20390022675738,16,13,197,2,183
2267,206,5,184.0413605442177,185.59709750566893,16,35,212,2,201
2268,206,58,184.0413605442177,186.47945578231293,16,34,181,2,148
2269,206,226,184.0413605442177,185.36489795918368,16,15,60,1,20
2270,206,291,184.0413605442177,186.59555555555556,16,17,139,3,85
2271,206,524,184.0413605442177,185.78285714285715,16,7,327,2,318
2272,206,459,184.0413605442177,186.43301587301588,16,2,273,2,253
2273,216,58,184.62185941043083,186.47945578231293,17,34,177,2,158
2274,216,291,184.62185941043083,186.59555555555556,17,17,113,2,75
2275,216,228,184.62185941043083,187.54757369614512,17,15,127,3,12
2276,216,524,184.62185941043083,185.78285714285715,17,7,312,1,308
2277,216,459,184.62185941043083,186.43301587301588,17,2,255,2,243
2278,226,58,185.36489795918368,186.47945578231293,15,34,175,1,168
2279,226,5,185.36489795918368,187.7797732426304,15,34,244,2,221
2280,226,6,185.36489795918368,188.19773242630387,15,34,252,3,220
2281,226,291,185.36489795918368,186.59555555555556,15,17,84,1,65
2282,226,228,185.36489795918368,187.54757369614512,15,15,94,2,2
2283,226,459,185.36489795918368,186.43301587301588,15,2,237,1,233
2284,226,456,185.36489795918368,187.73333333333335,15,11,252,2,230
2285,226,445,185.36489795918368,188.24417233560092,15,10,252,3,219
2286,291,5,186.59555555555556,187.7797732426304,17,34,291,1,286
2287,291,6,186.59555555555556,188.19773242630387,17,34,293,2,285
2288,291,245,186.59555555555556,189.01043083900228,17,15,114,2,46
2289,291,243,186.59555555555556,189.26585034013607,17,18,125,3,48
2290,291,456,186.59555555555556,187.73333333333335,17,11,172,1,165
2291,291,445,186.59555555555556,188.24417233560092,17,10,170,2,154
2292,291,424,186.59555555555556,189.08009070294784,17,4,171,2,133
2293,228,65,187.54757369614512,189.9160090702948,15,35,192,2,163
2294,228,245,187.54757369614512,189.01043083900228,15,15,65,1,17
2295,228,243,187.54757369614512,189.26585034013607,15,18,76,2,15
2296,228,424,187.54757369614512,189.08009070294784,15,4,207,2,196
2297,245,6,189.01043083900228,190.8215873015873,15,34,251,2,239
2298,245,6,189.01043083900228,191.2627664399093,15,35,258,2,239
2299,245,208,189.01043083900228,190.68226757369615,15,16,81,2,37
2300,245,232,189.01043083900228,191.58784580498866,15,19,112,3,13
2301,245,434,189.01043083900228,191.05378684807258,15,5,208,2,189
2302,245,453,189.01043083900228,191.14666666666668,15,14,227,2,208
2303,243,6,189.26585034013607,190.8215873015873,18,34,246,2,237
2304,243,6,189.26585034013607,191.2627664399093,18,35,252,2,237
2305,243,6,189.26585034013607,192.12190476190477,18,35,267,3,237
2306,243,208,189.26585034013607,190.68226757369615,18,16,70,1,35
2307,243,232,189.26585034013607,191.58784580498866,18,19,101,2,11
2308,243,434,189.26585034013607,191.05378684807258,18,5,206,2,191
2309,243,453,189.26585034013607,191.14666666666668,18,14,225,2,210
2310,208,6,190.68226757369615,192.12190476190477,16,35,211,1,202
2311,208,244,190.68226757369615,192.30766439909297,16,15,79,2,36
2312,208,245,190.68226757369615,193.21324263038548,16,15,115,3,37
2313,208,437,190.68226757369615,192.9578231292517,16,4,249,2,229
2314,232,6,191.58784580498866,193.86340136054423,19,35,246,2,226
2315,232,8,191.58784580498866,194.18848072562358,19,34,250,3,224
2316,232,245,191.58784580498866,193.21324263038548,19,15,71,2,13
2317,232,437,191.58784580498866,192.9578231292517,19,4,213,1,205
2318,232,437,191.58784580498866,193.8401814058957,19,2,227,2,205
2319,244,6,192.30766439909297,193.86340136054423,15,35,247,2,238
2320,244,8,192.30766439909297,194.18848072562358,15,34,250,2,236
2321,244,231,192.30766439909297,194.83863945578233,15,14,110,3,13
2322,244,437,192.30766439909297,193.8401814058957,15,2,204,2,193
2323,244,454,192.30766439909297,194.6296598639456,15,9,233,2,210
2324,245,6,193.21324263038548,196.04607709750567,15,34,268,3,239
2325,245,231,193.21324263038548,194.83863945578233,15,14,71,2,14
2326,245,224,193.21324263038548,195.76743764172335,15,29,112,3,21
2327,245,454,193.21324263038548,194.6296598639456,15,9,218,1,209
2328,245,512,193.21324263038548,195.76743764172335,15,17,289,3,267
2329,245,632,193.21324263038548,195.97641723356008,15,8,405,3,387
2330,231,6,194.83863945578233,196.04607709750567,14,34,231,1,225
2331,231,65,194.83863945578233,196.324716553288,14,36,178,1,166
2332,231,59,194.83863945578233,197.20707482993197,14,34,200,2,172
2333,231,228,194.83863945578233,196.92843537414967,14,17,90,2,3
2334,231,260,194.83863945578233,197.27673469387756,14,18,109,2,29
2335,231,567,194.83863945578233,196.6033560090703,14,15,344,2,336
2336,231,632,194.83863945578233,195.97641723356008,14,8,404,1,401
2337,231,698,194.83863945578233,196.62657596371884,14,9,473,2,467
2338,231,662,194.83863945578233,197.74113378684808,14,8,449,3,431
2339,224,59,195.76743764172335,197.20707482993197,29,34,176,1,165
2340,224,51,195.76743764172335,198.5538321995465,29,33,211,3,173
2341,224,228,195.76743764172335,196.92843537414967,29,17,50,1,4
2342,224,260,195.76743764172335,197.27673469387756,29,18,74,2,36
2343,224,205,195.76743764172335,198.4609523809524,29,24,118,3,19
2344,224,495,195.76743764172335,198.04299319727892,29,10,288,2,271
2345,224,452,195.76743764172335,198.08943310657597,29,11,249,2,228
2346,224,662,195.76743764172335,197.74113378684808,29,8,446,2,438
2347,228,51,196.92843537414967,198.5538321995465,17,33,190,2,177
2348,228,57,196.92843537414967,199.38975056689344,17,34,201,2,171
2349,228,205,196.92843537414967,198.4609523809524,17,24,70,2,23
2350,228,290,196.92843537414967,199.2968707482993,17,22,119,2,62
2351,228,495,196.92843537414967,198.04299319727892,17,10,271,1,267
2352,228,452,196.92843537414967,198.08943310657597,17,11,230,1,224
2353,228,473,196.92843537414967,199.6219501133787,17,10,271,3,245
2354,228,669,196.92843537414967,199.15755102040816,17,4,451,2,441
2355,260,51,197.27673469387756,198.5538321995465,18,33,216,1,209
2356,260,57,197.27673469387756,199.38975056689344,18,34,222,2,203
2357,260,205,197.27673469387756,198.4609523809524,18,24,75,1,55
2358,260,290,197.27673469387756,199.2968707482993,18,22,92,2,30
2359,260,473,197.27673469387756,199.6219501133787,18,10,236,2,213
2360,260,669,197.27673469387756,199.15755102040816,18,4,417,2,409
2361,205,73,198.4609523809524,200.75972789115647,24,35,165,2,132
2362,205,473,198.4609523809524,199.6219501133787,24,10,273,1,268
2363,205,488,198.4609523809524,200.4114285714286,24,13,295,2,283
2364,205,487,198.4609523809524,201.3402267573696,24,13,308,3,282
2365,205,636,198.4609523809524,201.17768707482995,24,13,447,3,431
2366,290,73,199.2968707482993,200.75972789115647,22,35,226,1,217
2367,290,36,199.2968707482993,201.82784580498867,22,33,276,3,254
2368,290,205,199.2968707482993,200.4346485260771,22,24,98,1,85
2369,290,205,199.2968707482993,201.29378684807256,22,16,121,2,85
2370,290,488,199.2968707482993,200.4114285714286,22,13,204,1,198
2371,290,487,199.2968707482993,201.3402267573696,22,13,216,2,197
2372,290,759,199.2968707482993,200.4114285714286,22,4,471,1,469
2373,290,636,199.2968707482993,201.17768707482995,22,13,355,2,346
2374,205,36,200.4346485260771,201.82784580498867,24,33,179,1,169
2375,205,6,200.4346485260771,202.98884353741497,24,34,227,3,199
2376,205,225,200.4346485260771,202.73342403628118,24,26,101,2,20
2377,205,517,200.4346485260771,202.61732426303854,24,14,326,2,312
2378,205,631,200.4346485260771,202.82630385487528,24,3,438,2,426
2379,205,6,201.29378684807256,202.98884353741497,16,34,212,2,199
2380,205,65,201.29378684807256,203.52290249433108,16,34,170,2,140
2381,205,57,201.29378684807256,204.2427210884354,16,35,195,3,148
2382,205,225,201.29378684807256,202.73342403628118,16,26,65,1,20
2383,205,227,201.29378684807256,203.84798185941042,16,20,112,3,22
2384,205,517,201.29378684807256,202.61732426303854,16,14,317,1,312
2385,205,610,201.29378684807256,204.0105215419501,16,10,422,3,405
2386,205,631,201.29378684807256,202.82630385487528,16,3,431,2,426
2387,225,57,202.73342403628118,204.2427210884354,26,35,180,2,168
2388,225,52,202.73342403628118,205.38049886621314,26,33,207,3,173
2389,225,227,202.73342403628118,203.84798185941042,26,20,48,1,2
2390,225,205,202.73342403628118,204.82321995464852,26,21,92,2,20
2391,225,242,202.73342403628118,205.241179138322,26,26,109,3,17
2392,225,610,202.73342403628118,204.0105215419501,26,10,389,1,385
2393,225,479,202.73342403628118,204.91609977324262,26,14,271,2,254
2394,225,455,202.73342403628118,205.1482993197279,26,10,252,2,230
2395,225,635,202.73342403628118,204.86965986394557,26,9,420,2,410
2396,225,616,202.73342403628118,205.3340589569161,26,2,407,3,391
2397,227,52,203.84798185941042,205.38049886621314,20,33,187,2,175
2398,227,57,203.84798185941042,206.58793650793652,20,36,207,3,170
2399,227,242,203.84798185941042,205.241179138322,20,26,62,1,15
2400,227,479,203.84798185941042,204.91609977324262,20,14,256,1,252
2401,227,455,203.84798185941042,205.1482993197279,20,10,235,1,228
2402,227,635,203.84798185941042,204.86965986394557,20,9,410,1,408
2403,227,616,203.84798185941042,205.3340589569161,20,2,394,1,389
2404,227,617,203.84798185941042,206.16997732426304,20,11,403,2,390
2405,205,57,204.82321995464852,206.58793650793652,21,36,166,2,148
2406,205,72,204.82321995464852,207.79537414965986,21,33,185,3,133
2407,205,245,204.82321995464852,207.07555555555555,21,17,105,2,40
2408,205,469,204.82321995464852,207.05233560090704,21,16,281,2,264
2409,205,448,204.82321995464852,207.0987755102041,21,14,262,2,243
2410,205,617,204.82321995464852,206.16997732426304,21,11,416,1,412
2411,205,641,204.82321995464852,207.07555555555555,21,12,447,2,436
2412,242,57,205.241179138322,206.58793650793652,26,36,194,1,185
2413,242,72,205.241179138322,207.79537414965986,26,33,202,3,170
2414,242,205,205.241179138322,206.88979591836735,26,22,80,2,37
2415,242,245,205.241179138322,207.07555555555555,26,17,79,2,3
2416,242,469,205.241179138322,207.05233560090704,26,16,240,2,227
2417,242,448,205.241179138322,207.0987755102041,26,14,221,2,206
2418,242,641,205.241179138322,207.07555555555555,26,12,407,2,399
2419,205,39,206.88979591836735,208.84027210884355,22,35,186,2,166
2420,205,64,206.88979591836735,209.6065306122449,22,35,183,3,141
2421,205,456,206.88979591836735,208.60807256235827,22,8,262,2,251
2422,205,497,206.88979591836735,209.81551020408165,22,12,318,3,292
2423,205,632,206.88979591836735,209.7922902494331,22,9,445,3,427
2424,245,39,207.07555555555555,208.84027210884355,17,35,220,2,206
2425,245,64,207.07555555555555,209.6065306122449,17,35,211,3,181
2426,245,205,207.07555555555555,208.37587301587303,17,19,69,1,40
2427,245,254,207.07555555555555,209.9548299319728,17,19,124,3,9
2428,245,456,207.07555555555555,208.60807256235827,17,8,221,2,211
2429,245,497,207.07555555555555,209.81551020408165,17,12,278,3,252
2430,245,632,207.07555555555555,209.7922902494331,17,9,404,3,387
2431,205,64,208.37587301587303,209.6065306122449,19,35,151,1,141
2432,205,64,208.37587301587303,210.8604081632653,19,35,177,2,141
2433,205,254,208.37587301587303,209.9548299319728,19,19,84,2,49
2434,205,222,208.37587301587303,210.46566893424037,19,25,92,2,17
2435,205,220,208.37587301587303,211.30158730158732,19,22,127,3,15
2436,205,497,208.37587301587303,209.81551020408165,19,12,299,1,292
2437,205,487,208.37587301587303,210.55854875283447,19,13,297,2,282
2438,205,632,208.37587301587303,209.7922902494331,19,9,431,1,427
2439,205,619,208.37587301587303,210.53532879818596,19,8,424,2,414
2440,254,14,209.9548299319728,211.5570068027211,19,35,250,2,240
2441,254,220,209.9548299319728,211.30158730158732,19,22,67,1,34
2442,254,236,209.9548299319728,212.23038548752834,19,25,100,2,18
2443,254,564,209.9548299319728,211.62666666666667,19,14,318,2,310
2444,254,455,209.9548299319728,212.11428571428573,19,9,221,2,201
2445,254,619,209.9548299319728,211.60344671201815,19,9,372,2,365
2446,254,618,209.9548299319728,212.8805442176871,19,4,385,3,364
2447,222,14,210.46566893424037,211.5570068027211,25,35,213,1,208
2448,222,58,210.46566893424037,212.9966439909297,25,35,197,3,164
2449,222,236,210.46566893424037,212.23038548752834,25,25,77,2,14
2450,222,564,210.46566893424037,211.62666666666667,25,14,346,1,342
2451,222,455,210.46566893424037,212.11428571428573,25,9,244,2,233
2452,222,572,210.46566893424037,213.36816326530612,25,14,372,3,350
2453,222,619,210.46566893424037,211.60344671201815,25,9,400,1,397
2454,222,618,210.46566893424037,212.8805442176871,25,4,409,2,396
2455,222,635,210.46566893424037,213.29850340136056,25,14,431,3,413
2456,220,58,211.30158730158732,212.9966439909297,22,35,178,2,162
2457,220,10,211.30158730158732,213.83256235827665,22,33,237,3,210
2458,220,51,211.30158730158732,214.11120181405897,22,34,208,3,169
2459,220,205,211.30158730158732,213.5307029478458,22,31,97,2,15
2460,220,572,211.30158730158732,213.36816326530612,22,14,363,2,352
2461,220,618,211.30158730158732,212.8805442176871,22,4,404,2,398
2462,220,635,211.30158730158732,213.29850340136056,22,14,424,2,415
2463,236,10,212.23038548752834,213.83256235827665,25,33,236,2,226
2464,236,51,212.23038548752834,214.11120181405897,25,34,202,2,185
2465,236,205,212.23038548752834,213.5307029478458,25,31,64,1,31
2466,236,240,212.23038548752834,215.04,25,18,121,3,4
2467,236,572,212.23038548752834,213.36816326530612,25,14,340,1,336
2468,236,530,212.23038548752834,215.06321995464853,25,10,318,3,294
2469,236,635,212.23038548752834,213.29850340136056,25,14,402,1,399
2470,236,618,212.23038548752834,215.06321995464853,25,3,401,3,382
2471,205,47,213.5307029478458,215.50439909297052,31,34,179,2,158
2472,205,240,213.5307029478458,215.04,31,18,74,2,35
2473,205,247,213.5307029478458,216.13133786848073,31,16,120,3,42
2474,205,530,213.5307029478458,215.06321995464853,31,10,332,2,325
2475,205,525,213.5307029478458,215.99201814058958,31,10,337,2,320
2476,205,526,213.5307029478458,216.22421768707483,31,11,341,3,321
2477,205,618,213.5307029478458,215.06321995464853,31,3,418,2,413
2478,205,700,213.5307029478458,215.99201814058958,31,5,506,2,495
2479,205,619,213.5307029478458,216.4564172335601,31,6,433,3,414
2480,240,48,215.04,217.06013605442178,18,34,211,2,192
2481,240,247,215.04,216.13133786848073,18,16,48,1,7
2482,240,263,215.04,217.57097505668935,18,21,111,3,23
2483,240,526,215.04,216.22421768707483,18,11,291,1,286
2484,240,613,215.04,217.73351473922904,18,15,391,3,373
2485,240,619,215.04,216.4564172335601,18,6,384,1,379
2486,240,654,215.04,217.75673469387755,18,13,430,3,414
2487,205,48,215.34185941043086,217.06013605442178,17,34,174,2,157
2488,205,43,215.34185941043086,218.05859410430838,17,35,200,3,162
2489,205,43,215.34185941043086,218.22113378684807,17,35,204,3,162
2490,205,263,215.34185941043086,217.57097505668935,17,21,112,2,58
2491,205,613,215.34185941043086,217.73351473922904,17,15,421,2,408
2492,205,619,215.34185941043086,216.4564172335601,17,6,417,1,414
2493,205,654,215.34185941043086,217.75673469387755,17,13,461,2,449
2494,247,43,216.13133786848073,218.05859410430838,16,35,220,2,204
2495,247,43,216.13133786848073,218.22113378684807,16,35,223,2,204
2496,247,263,216.13133786848073,217.57097505668935,16,21,64,1,16
2497,247,232,216.13133786848073,219.01061224489797,16,15,125,3,15
2498,247,613,216.13133786848073,217.73351473922904,16,15,372,2,366
2499,247,526,216.13133786848073,218.45333333333335,16,10,296,2,279
2500,247,654,216.13133786848073,217.75673469387755,16,13,413,2,407
2501,247,634,216.13133786848073,218.5229931972789,16,3,400,2,387
2502,263,68,217.57097505668935,219.54467120181405,21,30,213,2,195
2503,263,54,217.57097505668935,220.40380952380954,21,32,242,3,209
2504,263,232,217.57097505668935,219.01061224489797,21,15,69,1,31
2505,263,312,217.57097505668935,219.80009070294784,21,14,108,2,49
2506,263,523,217.57097505668935,219.33569160997732,21,12,271,2,260
2507,263,526,217.57097505668935,220.35736961451246,21,4,289,3,263
2508,263,653,217.57097505668935,219.80009070294784,21,11,402,2,390
2509,232,54,219.01061224489797,220.40380952380954,15,32,188,1,178
2510,232,38,219.01061224489797,221.47192743764174,15,33,221,2,194
2511,232,217,219.01061224489797,220.6360090702948,15,14,72,2,15
2512,232,526,219.01061224489797,220.35736961451246,15,4,300,1,294
2513,312,38,219.80009070294784,221.47192743764174,14,33,283,2,274
2514,312,39,219.80009070294784,222.21496598639456,14,30,292,2,273
2515,312,232,219.80009070294784,221.72734693877553,14,15,115,2,80
2516,312,329,219.80009070294784,222.14530612244897,14,12,102,2,17
2517,312,524,219.80009070294784,222.05242630385487,14,11,233,2,212
2518,312,525,219.80009070294784,222.2381859410431,14,8,237,2,213
2519,312,651,219.80009070294784,222.02920634920636,14,3,352,2,339
2520,217,39,220.6360090702948,222.21496598639456,14,30,191,2,178
2521,217,232,220.6360090702948,221.72734693877553,14,15,49,1,15
2522,217,329,220.6360090702948,222.14530612244897,14,12,129,2,112
2523,217,232,220.6360090702948,223.25986394557825,14,7,114,3,15
2524,217,524,220.6360090702948,222.05242630385487,14,11,313,1,307
2525,217,525,220.6360090702948,222.2381859410431,14,8,316,2,308
2526,217,651,220.6360090702948,222.02920634920636,14,3,438,1,434
2527,232,33,221.72734693877553,223.91002267573697,15,20,220,2,199
2528,232,26,221.72734693877553,224.69950113378684,15,20,243,3,206
2529,232,345,221.72734693877553,224.4673015873016,15,10,163,3,113
2530,329,33,222.14530612244897,223.91002267573697,12,20,306,2,296
2531,329,26,222.14530612244897,224.69950113378684,12,20,322,3,303
2532,329,232,222.14530612244897,223.25986394557825,12,7,108,1,97
2533,329,345,222.14530612244897,224.4673015873016,12,10,101,2,16
2534,329,349,222.14530612244897,225.1174603174603,12,10,130,3,20
2535,232,26,223.25986394557825,224.69950113378684,7,20,215,1,206
2536,232,34,223.25986394557825,225.2103401360544,7,22,215,2,198
2537,232,345,223.25986394557825,224.4673015873016,7,10,124,1,113
2538,232,349,223.25986394557825,225.1174603174603,7,10,142,2,117
2539,345,51,224.4673015873016,226.53387755102042,10,17,307,2,294
2540,345,358,224.4673015873016,226.53387755102042,10,9,90,2,13
2541,345,434,224.4673015873016,226.71963718820862,10,2,132,2,89
2542,349,51,225.1174603174603,226.53387755102042,10,17,304,1,298
2543,349,36,225.1174603174603,227.55555555555557,10,18,330,2,313
2544,349,358,225.1174603174603,226.53387755102042,10,9,62,1,9
2545,349,236,225.1174603174603,227.81097505668936,10,7,162,3,113
2546,349,434,225.1174603174603,226.71963718820862,10,2,109,2,85
2547,358,36,226.53387755102042,227.55555555555557,9,18,325,1,322
2548,358,44,226.53387755102042,228.27537414965988,9,19,323,2,314
2549,358,33,226.53387755102042,229.1112925170068,9,11,343,3,325
2550,358,236,226.53387755102042,227.81097505668936,9,7,134,1,122
2551,236,33,227.81097505668936,229.1112925170068,7,11,211,1,203
2552,346,33,231.03854875283446,232.1298866213152,2,18,317,1,313
2553,346,51,231.03854875283446,233.49986394557823,2,13,313,2,295
2554,346,357,231.03854875283446,232.87292517006804,2,3,80,2,11
2555,346,358,231.03854875283446,233.47664399092972,2,4,106,2,12
2556,345,51,231.41006802721088,233.49986394557823,6,13,307,2,294
2557,345,43,231.41006802721088,234.31256235827664,6,12,327,3,302
2558,345,357,231.41006802721088,232.87292517006804,6,3,64,1,12
2559,345,358,231.41006802721088,233.47664399092972,6,4,90,2,13
2560,357,43,232.87292517006804,234.31256235827664,3,12,320,1,314
2561,357,43,232.87292517006804,235.19492063492063,3,13,330,2,314
2562,358,43,233.47664399092972,235.19492063492063,4,13,324,2,315
2563,471,8,5.851428571428571,6.989206349206349,2,30,466,1,463
2564,471,13,5.851428571428571,8.266303854875284,2,31,470,2,458
2565,471,277,5.851428571428571,6.9195464852607715,2,14,199,1,194
2566,471,277,5.851428571428571,7.383945578231293,2,12,205,2,194
2567,471,205,5.851428571428571,8.219863945578231,2,12,285,2,266
2568,415,13,6.292607709750567,8.266303854875284,3,31,411,2,402
2569,415,277,6.292607709750567,7.383945578231293,3,12,146,1,138
2570,415,205,6.292607709750567,8.219863945578231,3,12,226,2,210
2571,415,24,13.235374149659863,14.55891156462585,4,34,395,1,391
2572,415,25,13.235374149659863,15.836009070294786,4,31,406,3,390
2573,415,26,13.235374149659863,16.091428571428573,4,31,408,3,389
2574,415,277,13.235374149659863,14.303492063492063,4,11,145,1,138
2575,415,206,13.235374149659863,15.603809523809524,4,9,233,2,209
2576,415,205,13.235374149659863,16.04498866213152,4,10,242,3,210
2577,415,437,13.235374149659863,15.301950113378686,4,4,92,2,22
2578,415,637,13.235374149659863,14.280272108843537,4,3,227,1,222
2579,520,25,14.09451247165533,15.836009070294786,7,31,501,2,495
2580,520,26,14.09451247165533,16.091428571428573,7,31,501,2,494
2581,520,206,14.09451247165533,15.603809523809524,7,9,321,2,314
2582,520,205,14.09451247165533,16.04498866213152,7,10,326,2,315
2583,520,437,14.09451247165533,15.301950113378686,7,4,98,1,83
2584,437,14,15.301950113378686,17.76326530612245,4,32,436,2,423
2585,437,10,15.301950113378686,18.204444444444444,4,33,445,3,427
2586,437,237,15.301950113378686,17.716825396825396,4,16,225,2,200
2587,437,755,15.301950113378686,17.531065759637187,4,6,332,2,318
2588,437,823,15.301950113378686,17.531065759637187,4,3,398,2,386
2589,437,5,17.46140589569161,19.551201814058956,8,29,441,2,432
2590,437,219,17.46140589569161,19.156462585034014,8,10,230,2,218
2591,437,480,17.46140589569161,18.599183673469387,8,6,65,1,43
2592,437,511,17.46140589569161,19.156462585034014,8,4,104,2,74
2593,437,699,17.46140589569161,18.599183673469387,8,3,267,1,262
2594,480,49,18.599183673469387,20.89795918367347,6,30,442,2,431
2595,480,8,18.599183673469387,21.24625850340136,6,30,486,3,472
2596,480,319,18.599183673469387,20.82829931972789,6,10,187,2,161
2597,480,494,18.599183673469387,20.48,6,5,82,2,14
2598,480,774,18.599183673469387,21.5481179138322,6,4,320,3,294
2599,511,49,19.156462585034014,20.89795918367347,4,30,468,2,462
2600,511,319,19.156462585034014,20.82829931972789,4,10,205,2,192
2601,511,245,19.156462585034014,21.966077097505668,4,19,292,3,266
2602,511,494,19.156462585034014,20.48,4,5,59,1,17
2603,511,493,19.156462585034014,21.91963718820862,4,8,120,3,18
2604,511,490,19.156462585034014,22.058956916099774,4,7,127,3,21
2605,511,774,19.156462585034014,21.5481179138322,4,4,282,2,263
2606,494,12,20.48,22.96453514739229,5,31,494,2,482
2607,494,12,20.48,22.98775510204082,5,31,494,3,482
2608,494,245,20.48,21.966077097505668,5,19,257,1,249
2609,494,246,20.48,22.360816326530614,5,23,261,2,248
2610,494,493,20.48,21.91963718820862,5,8,62,1,1
2611,494,490,20.48,22.058956916099774,5,7,68,2,4
2612,494,521,20.48,23.08063492063492,5,10,115,3,27
2613,494,774,20.48,21.5481179138322,5,4,284,1,280
2614,493,12,21.91963718820862,22.96453514739229,8,31,483,1,481
2615,493,12,21.91963718820862,22.98775510204082,8,31,483,1,481
2616,493,21,21.91963718820862,24.61315192743764,8,31,486,3,472
2617,493,271,21.91963718820862,23.84689342403628,8,10,237,2,222
2618,493,231,21.91963718820862,24.63637188208617,8,15,287,3,262
2619,493,521,21.91963718820862,23.08063492063492,8,10,57,1,28
2620,493,536,21.91963718820862,24.45061224489796,8,5,117,3,43
2621,493,696,21.91963718820862,24.380952380952383,8,9,229,2,203
2622,490,21,22.058956916099774,24.61315192743764,7,31,482,3,469
2623,490,271,22.058956916099774,23.84689342403628,7,10,232,2,219
2624,490,231,22.058956916099774,24.63637188208617,7,15,282,3,259
2625,490,521,22.058956916099774,23.08063492063492,7,10,54,1,31
2626,490,536,22.058956916099774,24.45061224489796,7,5,113,2,46
2627,490,696,22.058956916099774,24.380952380952383,7,9,229,2,206
2628,521,231,23.08063492063492,24.63637188208617,10,15,298,2,290
2629,521,221,23.08063492063492,25.332970521541952,10,12,315,2,300
2630,521,536,23.08063492063492,24.45061224489796,10,5,61,1,15
2631,521,460,23.08063492063492,25.541950113378686,10,8,122,2,61
2632,521,696,23.08063492063492,24.380952380952383,10,9,184,1,175
2633,521,623,23.08063492063492,25.170430839002268,10,5,136,2,102
2634,536,218,24.45061224489796,26.122448979591837,5,13,326,2,318
2635,536,460,24.45061224489796,25.541950113378686,5,8,89,1,76
2636,536,449,24.45061224489796,26.28498866213152,5,4,118,2,87
2637,536,643,24.45061224489796,26.33142857142857,5,6,134,2,107
2638,536,947,24.45061224489796,26.447528344671202,5,4,420,2,411
2639,460,16,25.541950113378686,27.631746031746033,8,33,453,2,444
2640,460,277,25.541950113378686,27.794285714285714,8,8,207,2,183
2641,460,277,25.541950113378686,28.23546485260771,8,9,217,3,183
2642,449,16,26.28498866213152,27.631746031746033,4,33,437,1,433
2643,449,6,26.28498866213152,28.65342403628118,4,32,455,2,443
2644,449,6,26.28498866213152,29.094603174603176,4,32,459,3,443
2645,449,277,26.28498866213152,27.794285714285714,4,8,184,2,172
2646,449,277,26.28498866213152,28.23546485260771,4,9,191,2,172
2647,449,410,26.28498866213152,29.071383219954647,4,3,126,3,39
2648,410,6,29.071383219954647,30.394920634920634,3,32,408,1,404
2649,410,6,29.071383219954647,31.2540589569161,3,31,415,2,404
2650,410,219,29.071383219954647,30.743219954648527,3,14,204,2,191
2651,410,219,29.071383219954647,31.277278911564625,3,13,213,2,191
2652,410,6,32.995555555555555,34.29587301587301,6,32,408,1,404
2653,410,6,32.995555555555555,35.619410430839004,6,31,420,3,404
2654,410,219,32.995555555555555,34.08689342403628,6,14,197,1,191
2655,410,219,32.995555555555555,35.45687074829932,6,13,218,2,191
2656,410,418,32.995555555555555,34.76027210884354,6,2,76,2,8
2657,418,6,34.76027210884354,36.47854875283447,2,31,419,2,412
2658,418,206,34.76027210884354,36.501768707482995,2,14,225,2,212
2659,418,232,34.76027210884354,37.05904761904762,2,13,211,2,186
2660,418,465,34.76027210884354,37.03582766439909,2,3,109,2,47
2661,465,6,37.03582766439909,38.22004535147392,3,31,462,1,459
2662,465,6,37.03582766439909,39.96154195011338,3,32,476,3,459
2663,465,368,37.03582766439909,38.98630385487528,3,18,128,2,97
2664,465,367,37.03582766439909,39.00952380952381,3,17,130,2,98
2665,465,585,37.03582766439909,38.54512471655329,3,3,136,2,120
2666,465,464,37.03582766439909,39.68290249433107,3,7,114,3,1
2667,465,616,37.03582766439909,39.3578231292517,3,5,181,2,151
2668,585,232,38.54512471655329,40.14730158730159,3,15,360,2,353
2669,585,464,38.54512471655329,39.68290249433107,3,7,131,1,121
2670,585,463,38.54512471655329,40.542040816326534,3,9,149,2,122
2671,585,617,38.54512471655329,40.51882086167801,3,3,91,2,32
2672,464,6,39.68290249433107,40.820680272108845,7,32,461,1,458
2673,464,6,39.68290249433107,41.26185941043084,7,31,463,2,458
2674,464,231,39.68290249433107,41.77269841269841,7,21,250,2,233
2675,464,217,39.68290249433107,42.237097505668935,7,20,270,3,247
2676,464,516,39.68290249433107,41.9352380952381,7,9,110,2,52
2677,464,583,39.68290249433107,42.074557823129254,7,7,157,2,119
2678,464,738,39.68290249433107,41.95845804988662,7,10,291,2,274
2679,464,657,39.68290249433107,42.09777777777778,7,7,219,2,193
2680,464,923,39.68290249433107,41.98167800453515,7,4,470,2,459
2681,464,835,39.68290249433107,42.074557823129254,7,6,385,2,371
2682,463,48,40.542040816326534,42.74793650793651,9,33,426,2,415
2683,463,231,40.542040816326534,41.77269841269841,9,21,238,1,232
2684,463,217,40.542040816326534,42.237097505668935,9,20,257,2,246
2685,463,317,40.542040816326534,43.18911564625851,9,14,185,3,146
2686,463,516,40.542040816326534,41.9352380952381,9,9,80,1,53
2687,463,583,40.542040816326534,42.074557823129254,9,7,137,2,120
2688,463,738,40.542040816326534,41.95845804988662,9,10,282,1,275
2689,463,657,40.542040816326534,42.09777777777778,9,7,205,2,194
2690,463,923,40.542040816326534,41.98167800453515,9,4,464,1,460
2691,463,835,40.542040816326534,42.074557823129254,9,6,378,2,372
2692,516,51,41.9352380952381,43.90893424036281,9,33,473,2,465
2693,516,317,41.9352380952381,43.18911564625851,9,14,206,1,199
2694,516,243,41.9352380952381,44.30367346938775,9,11,291,2,273
2695,516,484,41.9352380952381,43.86249433106576,9,11,89,2,32
2696,516,580,41.9352380952381,44.90739229024943,9,9,143,3,64
2697,516,643,41.9352380952381,44.860952380952384,9,7,179,3,127
2698,583,317,42.074557823129254,43.18911564625851,7,14,270,1,266
2699,583,243,42.074557823129254,44.30367346938775,7,11,353,2,340
2700,583,484,42.074557823129254,43.86249433106576,7,11,125,2,99
2701,583,580,42.074557823129254,44.90739229024943,7,9,122,3,3
2702,583,643,42.074557823129254,44.860952380952384,7,7,134,3,60
2703,583,823,42.074557823129254,44.93061224489796,7,2,270,3,240
2704,484,6,43.86249433106576,45.60399092970522,11,32,484,2,478
2705,484,22,43.86249433106576,46.09160997732426,11,32,472,2,462
2706,484,220,43.86249433106576,45.46467120181406,11,11,273,2,264
2707,484,580,43.86249433106576,44.90739229024943,11,9,106,1,96
2708,484,515,43.86249433106576,45.41823129251701,11,8,74,2,31
2709,484,648,43.86249433106576,45.39501133786848,11,4,177,2,164
2710,484,623,43.86249433106576,46.068390022675736,11,2,168,2,139
2711,484,823,43.86249433106576,44.93061224489796,11,2,342,1,339
2712,580,209,44.90739229024943,46.95074829931973,9,16,381,2,371
2713,580,241,44.90739229024943,47.3687074829932,9,14,355,2,339
2714,580,523,44.90739229024943,46.9275283446712,9,6,104,2,57
2715,580,501,44.90739229024943,47.484807256235825,9,8,136,3,79
2716,580,623,44.90739229024943,46.068390022675736,9,2,66,1,43
2717,580,641,44.90739229024943,47.50802721088436,9,7,128,3,61
2718,515,209,45.41823129251701,46.95074829931973,8,16,313,2,306
2719,515,241,45.41823129251701,47.3687074829932,8,14,287,2,274
2720,515,523,45.41823129251701,46.9275283446712,8,6,65,2,8
2721,515,501,45.41823129251701,47.484807256235825,8,8,90,2,14
2722,515,641,45.41823129251701,47.50802721088436,8,7,155,2,126
2723,523,73,46.9275283446712,49.87646258503401,6,33,468,3,450
2724,523,277,46.9275283446712,48.66902494331066,6,12,257,2,246
2725,523,225,46.9275283446712,49.179863945578234,6,11,313,2,298
2726,523,510,46.9275283446712,48.761904761904766,6,10,80,2,13
2727,523,601,46.9275283446712,49.179863945578234,6,6,124,2,78
2728,523,658,46.9275283446712,48.78512471655329,6,9,157,2,135
2729,523,639,46.9275283446712,49.179863945578234,6,4,151,2,116
2730,523,829,46.9275283446712,48.83156462585034,6,2,317,2,306
2731,501,73,47.484807256235825,49.87646258503401,8,33,440,2,428
2732,501,74,47.484807256235825,50.062222222222225,8,33,441,3,427
2733,501,277,47.484807256235825,48.66902494331066,8,12,230,1,224
2734,501,225,47.484807256235825,49.179863945578234,8,11,285,2,276
2735,501,510,47.484807256235825,48.761904761904766,8,10,56,1,9
2736,501,601,47.484807256235825,49.179863945578234,8,6,124,2,100
2737,501,658,47.484807256235825,48.78512471655329,8,9,167,1,157
2738,501,639,47.484807256235825,49.179863945578234,8,4,156,2,138
2739,501,829,47.484807256235825,48.83156462585034,8,2,333,1,328
2740,510,73,48.761904761904766,49.87646258503401,10,33,440,1,437
2741,510,74,48.761904761904766,50.062222222222225,10,33,440,1,436
2742,510,227,48.761904761904766,50.944580498866216,10,13,298,2,283
2743,510,236,48.761904761904766,51.478639455782314,10,11,298,3,274
2744,510,421,48.761904761904766,50.92136054421769,10,9,129,2,89
2745,510,526,48.761904761904766,51.06068027210885,10,9,100,2,16
2746,510,642,48.761904761904766,50.96780045351474,10,5,163,2,132
2747,510,615,48.761904761904766,51.06068027210885,10,2,144,2,105
2748,510,901,48.761904761904766,50.874920634920635,10,5,401,2,391
2749,601,227,49.179863945578234,50.944580498866216,6,13,382,2,374
2750,601,236,49.179863945578234,51.478639455782314,6,11,378,2,365
2751,601,421,49.179863945578234,50.92136054421769,6,9,195,2,180
2752,601,526,49.179863945578234,51.06068027210885,6,9,110,2,75
2753,601,642,49.179863945578234,50.96780045351474,6,5,87,2,41
2754,601,615,49.179863945578234,51.06068027210885,6,2,82,2,14
2755,601,901,49.179863945578234,50.874920634920635,6,5,309,2,300
2756,421,6,50.92136054421769,52.128798185941044,9,32,418,1,415
2757,421,19,50.92136054421769,53.84707482993198,9,31,421,3,402
2758,421,215,50.92136054421769,52.848616780045354,9,16,222,2,206
2759,421,229,50.92136054421769,53.173696145124715,9,13,215,2,192
2760,421,556,50.92136054421769,52.68607709750567,9,4,155,2,135
2761,421,484,50.92136054421769,53.498775510204084,9,7,128,3,63
2762,421,631,50.92136054421769,53.661315192743764,9,2,241,3,210
2763,526,215,51.06068027210885,52.848616780045354,9,16,320,2,311
2764,526,229,51.06068027210885,53.173696145124715,9,13,311,2,297
2765,526,556,51.06068027210885,52.68607709750567,9,4,76,2,30
2766,526,484,51.06068027210885,53.498775510204084,9,7,113,2,42
2767,526,631,51.06068027210885,53.661315192743764,9,2,154,3,105
2768,556,242,52.68607709750567,54.19537414965986,4,12,321,2,314
2769,556,512,52.68607709750567,54.9384126984127,4,6,107,2,44
2770,556,627,52.68607709750567,54.91519274376417,4,2,119,2,71
2771,484,44,53.498775510204084,54.543673469387755,7,31,442,1,440
2772,484,30,53.498775510204084,55.51891156462585,7,31,462,2,454
2773,484,260,53.498775510204084,55.843990929705214,7,19,246,2,224
2774,484,227,53.498775510204084,56.14585034013606,7,13,281,3,257
2775,484,512,53.498775510204084,54.9384126984127,7,6,68,1,28
2776,484,520,53.498775510204084,55.867210884353746,7,10,108,2,36
2777,484,519,53.498775510204084,56.14585034013606,7,5,119,3,35
2778,484,627,53.498775510204084,54.91519274376417,7,2,155,1,143
2779,512,65,54.9384126984127,56.65668934240363,6,33,453,2,447
2780,512,65,54.9384126984127,57.02820861678005,6,33,456,2,447
2781,512,227,54.9384126984127,56.14585034013606,6,13,290,1,285
2782,512,245,54.9384126984127,57.74802721088435,6,17,293,3,267
2783,512,519,54.9384126984127,56.14585034013606,6,5,52,1,7
2784,520,65,55.867210884353746,57.02820861678005,10,33,458,1,455
2785,520,29,55.867210884353746,58.02666666666667,10,31,500,2,491
2786,520,245,55.867210884353746,57.74802721088435,10,17,287,2,275
2787,520,232,55.867210884353746,58.28208616780046,10,30,306,2,288
2788,520,482,55.867210884353746,57.95700680272109,10,7,98,2,38
2789,520,519,55.867210884353746,58.42140589569161,10,12,110,3,1
2790,520,709,55.867210884353746,57.95700680272109,10,2,209,2,189
2791,520,782,55.867210884353746,58.51428571428571,10,5,286,3,262
2792,519,29,56.14585034013606,58.02666666666667,5,31,497,2,490
2793,519,245,56.14585034013606,57.74802721088435,5,17,283,2,274
2794,519,232,56.14585034013606,58.28208616780046,5,30,301,2,287
2795,519,482,56.14585034013606,57.95700680272109,5,7,86,2,37
2796,519,709,56.14585034013606,57.95700680272109,5,2,205,2,190
2797,519,782,56.14585034013606,58.51428571428571,5,5,282,2,263
2798,482,6,57.95700680272109,59.953922902494334,7,31,484,2,476
2799,482,58,57.95700680272109,60.070022675736965,7,31,434,2,424
2800,482,264,57.95700680272109,59.419863945578236,7,12,227,1,218
2801,482,234,57.95700680272109,60.20934240362812,7,11,266,2,248
2802,482,473,57.95700680272109,59.582403628117916,7,5,71,2,9
2803,482,599,57.95700680272109,60.46476190476191,7,5,159,3,117
2804,482,653,57.95700680272109,59.582403628117916,7,5,185,2,171
2805,482,685,57.95700680272109,60.48798185941043,7,9,230,3,203
2806,519,58,58.42140589569161,60.070022675736965,12,31,466,2,461
2807,519,234,58.42140589569161,60.20934240362812,12,11,295,2,285
2808,519,473,58.42140589569161,59.582403628117916,12,5,68,1,46
2809,519,599,58.42140589569161,60.46476190476191,12,5,119,2,80
2810,519,653,58.42140589569161,59.582403628117916,12,5,143,1,134
2811,519,685,58.42140589569161,60.48798185941043,12,9,188,2,166
2812,519,653,58.42140589569161,61.13814058956916,12,6,178,3,134
2813,473,6,59.582403628117916,61.25424036281179,5,31,473,2,467
2814,473,219,59.582403628117916,61.78829931972789,5,16,271,2,254
2815,473,510,59.582403628117916,61.811519274376415,5,8,103,2,37
2816,473,611,59.582403628117916,62.415238095238095,5,8,184,3,138
2817,473,653,59.582403628117916,61.13814058956916,5,6,192,2,180
2818,473,627,59.582403628117916,62.415238095238095,5,7,196,3,154
2819,599,219,60.46476190476191,61.78829931972789,5,16,384,1,380
2820,599,244,60.46476190476191,62.62421768707483,5,14,367,2,355
2821,599,242,60.46476190476191,63.25115646258504,5,18,377,3,357
2822,599,510,60.46476190476191,61.811519274376415,5,8,106,1,89
2823,599,611,60.46476190476191,62.415238095238095,5,8,85,2,12
2824,599,627,60.46476190476191,62.415238095238095,5,7,89,2,28
2825,599,697,60.46476190476191,63.41369614512472,5,2,160,3,98
2826,510,242,61.811519274376415,63.25115646258504,8,18,275,1,268
2827,510,226,61.811519274376415,64.17995464852608,8,9,302,2,284
2828,510,585,61.811519274376415,63.901315192743766,8,5,117,2,75
2829,510,537,61.811519274376415,64.57469387755103,8,10,122,3,27
2830,510,697,61.811519274376415,63.41369614512472,8,2,199,2,187
2831,510,683,61.811519274376415,64.78367346938775,8,5,215,3,173
2832,611,226,62.415238095238095,64.17995464852608,8,9,392,2,385
2833,611,261,62.415238095238095,65.24807256235827,8,10,371,3,350
2834,611,585,62.415238095238095,63.901315192743766,8,5,69,1,26
2835,611,537,62.415238095238095,64.57469387755103,8,10,119,2,74
2836,611,523,62.415238095238095,65.03909297052154,8,4,143,3,88
2837,611,683,62.415238095238095,64.78367346938775,8,5,125,2,72
2838,585,261,63.901315192743766,65.24807256235827,5,10,329,1,324
2839,585,253,63.901315192743766,66.71092970521542,5,11,353,3,332
2840,585,523,63.901315192743766,65.03909297052154,5,4,79,1,62
2841,537,253,64.57469387755103,66.71092970521542,10,11,299,2,284
2842,537,277,64.57469387755103,67.38430839002268,10,11,287,3,260
2843,537,525,64.57469387755103,66.98956916099773,10,5,105,2,12
2844,537,475,64.57469387755103,67.47718820861678,10,7,140,3,62
2845,537,655,64.57469387755103,67.47718820861678,10,8,172,3,118
2846,523,253,65.03909297052154,66.71092970521542,4,11,279,2,270
2847,523,277,65.03909297052154,67.38430839002268,4,11,266,2,246
2848,523,525,65.03909297052154,66.98956916099773,4,5,84,2,2
2849,523,475,65.03909297052154,67.47718820861678,4,7,115,2,48
2850,523,655,65.03909297052154,67.47718820861678,4,8,169,2,132
2851,525,226,66.98956916099773,68.82394557823129,5,13,309,2,299
2852,525,219,66.98956916099773,69.93850340136055,5,16,331,3,306
2853,525,467,66.98956916099773,68.82394557823129,5,8,98,2,58
2854,525,649,66.98956916099773,68.61496598639457,5,6,142,2,124
2855,475,6,67.47718820861678,69.52054421768707,7,30,477,2,469
2856,475,226,67.47718820861678,68.82394557823129,7,13,256,1,249
2857,475,219,67.47718820861678,69.93850340136055,7,16,277,2,256
2858,475,467,67.47718820861678,68.82394557823129,7,8,59,1,8
2859,475,649,67.47718820861678,68.61496598639457,7,6,181,1,174
2860,467,6,68.82394557823129,70.82086167800453,8,35,469,2,461
2861,467,5,68.82394557823129,71.26204081632653,8,34,474,2,462
2862,467,219,68.82394557823129,69.93850340136055,8,16,253,1,248
2863,467,256,68.82394557823129,70.54222222222222,8,28,224,2,211
2864,467,237,68.82394557823129,71.63356009070294,8,20,260,3,230
2865,467,512,68.82394557823129,70.54222222222222,8,16,87,2,45
2866,467,513,68.82394557823129,71.02984126984127,8,11,106,2,46
2867,467,815,68.82394557823129,70.70476190476191,8,9,357,2,348
2868,467,632,68.82394557823129,71.4942403628118,8,9,201,3,165
2869,467,846,68.82394557823129,70.6118820861678,8,8,387,2,379
2870,467,959,68.82394557823129,71.37814058956916,8,3,504,3,492
2871,512,237,70.54222222222222,71.63356009070294,16,20,279,1,275
2872,512,205,70.54222222222222,72.60879818594104,16,19,320,2,307
2873,512,257,70.54222222222222,73.30539682539683,16,23,281,3,255
2874,512,484,70.54222222222222,72.95709750566894,16,9,108,2,28
2875,512,486,70.54222222222222,73.04997732426304,16,7,111,3,26
2876,512,701,70.54222222222222,72.51591836734694,16,5,207,2,189
2877,513,205,71.02984126984127,72.60879818594104,11,19,315,2,308
2878,513,257,71.02984126984127,73.30539682539683,11,23,274,2,256
2879,513,484,71.02984126984127,72.95709750566894,11,9,88,2,29
2880,513,486,71.02984126984127,73.04997732426304,11,7,91,2,27
2881,513,701,71.02984126984127,72.51591836734694,11,5,199,1,188
2882,513,668,71.02984126984127,73.93233560090704,11,2,199,3,155
2883,484,5,72.95709750566894,74.30385487528345,9,34,482,1,479
2884,484,6,72.95709750566894,75.16299319727891,9,35,487,2,478
2885,484,233,72.95709750566894,74.32707482993197,9,21,258,1,251
2886,484,243,72.95709750566894,75.20943310657597,9,20,260,2,241
2887,484,512,72.95709750566894,74.7914739229025,9,8,84,2,28
2888,484,488,72.95709750566894,75.20943310657597,9,11,97,2,4
2889,486,5,73.04997732426304,74.30385487528345,7,34,484,1,481
2890,486,6,73.04997732426304,75.16299319727891,7,35,489,2,480
2891,486,233,73.04997732426304,74.32707482993197,7,21,259,1,253
2892,486,243,73.04997732426304,75.20943310657597,7,20,260,2,243
2893,486,512,73.04997732426304,74.7914739229025,7,8,79,2,26
2894,486,488,73.04997732426304,75.20943310657597,7,11,93,2,2
2895,486,665,73.04997732426304,75.9524716553288,7,4,218,3,179
2896,512,307,74.7914739229025,76.92770975056689,8,16,225,2,205
2897,512,225,74.7914739229025,77.53142857142858,8,30,310,3,287
2898,512,497,74.7914739229025,76.16145124716553,8,10,61,1,15
2899,512,516,74.7914739229025,77.41532879818594,8,12,113,3,4
2900,512,665,74.7914739229025,75.9524716553288,8,4,161,1,153
2901,512,642,74.7914739229025,76.20789115646258,8,6,144,1,130
2902,512,924,74.7914739229025,76.16145124716553,8,2,416,1,412
2903,488,6,75.20943310657597,76.90448979591837,11,35,487,2,482
2904,488,6,75.20943310657597,77.34566893424036,11,34,491,2,482
2905,488,307,75.20943310657597,76.92770975056689,11,16,196,2,181
2906,488,225,75.20943310657597,77.53142857142858,11,30,281,2,263
2907,488,516,75.20943310657597,77.41532879818594,11,12,99,2,28
2908,497,6,76.16145124716553,77.34566893424036,10,34,494,1,491
2909,497,58,76.16145124716553,78.99428571428571,10,36,456,3,439
2910,497,58,76.16145124716553,79.01750566893425,10,36,456,3,439
2911,497,225,76.16145124716553,77.53142857142858,10,30,278,1,272
2912,497,227,76.16145124716553,78.25124716553289,10,23,285,2,270
2913,497,516,76.16145124716553,77.41532879818594,10,12,57,1,19
2914,497,587,76.16145124716553,78.85496598639456,10,11,147,3,90
2915,497,649,76.16145124716553,78.76208616780046,10,9,189,3,152
2916,497,934,76.16145124716553,78.83174603174604,10,3,452,3,437
2917,516,58,77.41532879818594,78.99428571428571,12,36,463,2,458
2918,516,58,77.41532879818594,79.01750566893425,12,36,463,2,458
2919,516,240,77.41532879818594,79.92308390022676,12,29,296,3,276
2920,516,242,77.41532879818594,80.0391836734694,12,30,296,3,274
2921,516,587,77.41532879818594,78.85496598639456,12,11,94,1,71
2922,516,450,77.41532879818594,79.62122448979592,12,15,116,2,66
2923,516,649,77.41532879818594,78.76208616780046,12,9,145,1,133
2924,516,635,77.41532879818594,79.64444444444445,12,9,153,2,119
2925,516,934,77.41532879818594,78.83174603174604,12,3,422,1,418
2926,516,873,77.41532879818594,79.71410430839002,12,4,370,2,357
2927,587,240,78.85496598639456,79.92308390022676,11,29,350,1,347
2928,587,242,78.85496598639456,80.0391836734694,11,30,349,1,345
2929,587,225,78.85496598639456,81.75746031746031,11,24,383,3,362
2930,587,516,78.85496598639456,80.92154195011338,11,16,114,2,71
2931,587,679,78.85496598639456,80.89832199546485,11,8,127,2,92
2932,450,58,79.62122448979592,81.43238095238095,15,35,400,2,392
2933,450,225,79.62122448979592,81.75746031746031,15,24,243,2,225
2934,450,243,79.62122448979592,82.03609977324263,15,20,232,2,207
2935,450,516,79.62122448979592,80.92154195011338,15,16,87,1,66
2936,450,485,79.62122448979592,81.87356009070295,15,14,103,2,35
2937,450,484,79.62122448979592,82.08253968253969,15,6,111,2,34
2938,450,679,79.62122448979592,80.89832199546485,15,8,236,1,229
2939,450,622,79.62122448979592,81.85034013605443,15,9,197,2,172
2940,450,835,79.62122448979592,81.87356009070295,15,2,397,2,385
2941,516,243,80.92154195011338,82.03609977324263,16,20,277,1,273
2942,516,205,80.92154195011338,83.17387755102041,16,19,326,2,311
2943,516,484,80.92154195011338,82.08253968253969,16,6,59,1,32
2944,516,505,80.92154195011338,83.26675736961451,16,7,102,2,11
2945,516,953,80.92154195011338,83.08099773242631,16,2,447,2,437
2946,485,5,81.87356009070295,82.9881179138322,14,34,482,1,480
2947,485,6,81.87356009070295,83.4292970521542,14,35,484,2,479
2948,485,65,81.87356009070295,84.38131519274377,14,35,434,3,420
2949,485,205,81.87356009070295,83.17387755102041,14,19,286,1,280
2950,485,505,81.87356009070295,83.26675736961451,14,7,63,1,20
2951,485,478,81.87356009070295,84.65995464852608,14,14,120,3,7
2952,485,632,81.87356009070295,84.65995464852608,14,11,190,3,147
2953,485,953,81.87356009070295,83.08099773242631,14,2,471,1,468
2954,485,916,81.87356009070295,84.54385487528344,14,7,446,3,431
2955,484,6,82.08253968253969,83.4292970521542,6,35,482,1,478
2956,484,65,82.08253968253969,84.38131519274377,6,35,431,2,419
2957,484,205,82.08253968253969,83.17387755102041,6,19,283,1,279
2958,484,224,82.08253968253969,84.89215419501134,6,17,287,3,260
2959,484,505,82.08253968253969,83.26675736961451,6,7,55,1,21
2960,484,478,82.08253968253969,84.65995464852608,6,14,111,3,6
2961,484,632,82.08253968253969,84.65995464852608,6,11,185,3,148
2962,484,916,82.08253968253969,84.54385487528344,6,7,445,2,432
2963,505,65,83.26675736961451,84.38131519274377,7,35,443,1,440
2964,505,6,83.26675736961451,85.58875283446712,7,35,509,2,499
2965,505,224,83.26675736961451,84.89215419501134,7,17,290,2,281
2966,505,227,83.26675736961451,85.2172335600907,7,27,290,2,278
2967,505,478,83.26675736961451,84.65995464852608,7,14,66,1,27
2968,505,552,83.26675736961451,85.14757369614513,7,11,94,2,47
2969,505,632,83.26675736961451,84.65995464852608,7,11,140,1,127
2970,505,632,83.26675736961451,85.33333333333333,7,9,155,2,127
2971,505,916,83.26675736961451,84.54385487528344,7,7,415,1,411
2972,478,5,84.65995464852608,86.02993197278911,14,35,477,1,473
2973,478,205,84.65995464852608,86.49433106575964,14,18,284,2,273
2974,478,236,84.65995464852608,87.05160997732426,14,18,263,2,242
2975,478,511,84.65995464852608,86.44789115646259,14,13,84,2,33
2976,478,648,84.65995464852608,86.44789115646259,14,7,187,2,170
2977,552,205,85.14757369614513,86.49433106575964,11,18,352,1,347
2978,552,236,85.14757369614513,87.05160997732426,11,18,326,2,316
2979,552,511,85.14757369614513,86.44789115646259,11,13,69,1,41
2980,552,492,85.14757369614513,88.00362811791383,11,12,137,3,60
2981,552,648,85.14757369614513,86.44789115646259,11,7,111,1,96
2982,552,690,85.14757369614513,88.00362811791383,11,9,185,3,138
2983,552,644,85.14757369614513,88.07328798185941,11,11,156,3,92
2984,552,909,85.14757369614513,88.00362811791383,11,2,378,3,357
2985,552,886,85.14757369614513,88.09650793650793,11,3,357,3,334
2986,511,58,86.44789115646259,88.93242630385488,13,35,465,2,453
2987,511,227,86.44789115646259,88.25904761904762,13,26,295,2,284
2988,511,261,86.44789115646259,89.11818594104308,13,17,275,3,250
2989,511,492,86.44789115646259,88.00362811791383,13,12,70,2,19
2990,511,483,86.44789115646259,88.25904761904762,13,14,83,2,28
2991,511,599,86.44789115646259,89.39682539682539,13,11,155,3,88
2992,511,690,86.44789115646259,88.00362811791383,13,9,191,2,179
2993,511,644,86.44789115646259,88.07328798185941,13,11,150,2,133
2994,511,675,86.44789115646259,89.42004535147393,13,10,208,3,164
2995,511,909,86.44789115646259,88.00362811791383,13,2,404,2,398
2996,511,886,86.44789115646259,88.09650793650793,13,3,382,2,375
2997,492,6,88.00362811791383,89.07174603174603,12,36,488,1,486
2998,492,16,88.00362811791383,90.34884353741496,12,35,487,2,476
2999,492,261,88.00362811791383,89.11818594104308,12,17,236,1,231
3000,492,253,88.00362811791383,90.25596371882087,12,16,258,2,239
3001,492,599,88.00362811791383,89.39682539682539,12,11,123,1,107
3002,492,528,88.00362811791383,90.69714285714286,12,8,121,3,36
3003,492,675,88.00362811791383,89.42004535147393,12,10,193,1,183
3004,483,16,88.25904761904762,90.34884353741496,14,35,476,2,467
3005,483,253,88.25904761904762,90.25596371882087,14,16,246,2,230
3006,483,599,88.25904761904762,89.39682539682539,14,11,126,1,116
3007,483,528,88.25904761904762,90.69714285714286,14,8,114,2,45
3008,483,529,88.25904761904762,91.18476190476191,14,13,134,3,46
3009,483,675,88.25904761904762,89.42004535147393,14,10,198,1,192
3010,483,616,88.25904761904762,91.18476190476191,14,3,183,3,133
3011,599,232,89.39682539682539,91.78848072562359,11,20,381,2,367
3012,599,528,89.39682539682539,90.69714285714286,11,8,90,1,71
3013,599,529,89.39682539682539,91.18476190476191,11,13,104,2,70
3014,599,616,89.39682539682539,91.18476190476191,11,3,79,2,17
3015,528,232,90.69714285714286,91.78848072562359,8,20,300,1,296
3016,528,231,90.69714285714286,92.53151927437642,8,18,307,2,297
3017,528,205,90.69714285714286,93.59963718820862,8,18,346,3,323
3018,528,567,90.69714285714286,92.48507936507937,8,13,86,2,39
3019,528,439,90.69714285714286,93.25133786848073,8,8,141,3,89
3020,528,647,90.69714285714286,92.48507936507937,8,11,142,2,119
3021,528,856,90.69714285714286,92.46185941043085,8,2,337,2,328
3022,529,231,91.18476190476191,92.53151927437642,13,18,304,1,298
3023,529,205,91.18476190476191,93.59963718820862,13,18,340,2,324
3024,529,567,91.18476190476191,92.48507936507937,13,13,68,1,38
3025,529,439,91.18476190476191,93.25133786848073,13,8,127,2,90
3026,529,647,91.18476190476191,92.48507936507937,13,11,131,1,118
3027,529,856,91.18476190476191,92.46185941043085,13,2,332,1,327
3028,567,205,92.48507936507937,93.59963718820862,13,18,365,1,362
3029,567,220,92.48507936507937,94.8302947845805,13,15,361,2,347
3030,567,254,92.48507936507937,95.17859410430839,13,15,334,3,313
3031,567,482,92.48507936507937,94.57487528344672,13,14,124,2,85
3032,567,664,92.48507936507937,94.57487528344672,13,13,132,2,97
3033,567,828,92.48507936507937,94.57487528344672,13,2,276,2,261
3034,439,5,93.25133786848073,94.7374149659864,8,35,439,1,434
3035,439,55,93.25133786848073,95.06249433106576,8,35,392,2,384
3036,439,220,93.25133786848073,94.8302947845805,8,15,229,2,219
3037,439,254,93.25133786848073,95.17859410430839,8,15,203,2,185
3038,439,353,93.25133786848073,96.20027210884354,8,17,153,3,86
3039,439,482,93.25133786848073,94.57487528344672,8,14,71,1,43
3040,439,520,93.25133786848073,95.75909297052155,8,4,135,3,81
3041,439,664,93.25133786848073,94.57487528344672,8,13,232,1,225
3042,439,828,93.25133786848073,94.57487528344672,8,2,393,1,389
3043,482,6,94.57487528344672,96.89687074829932,14,35,486,2,476
3044,482,353,94.57487528344672,96.20027210884354,14,17,147,2,129
3045,482,232,94.57487528344672,97.500589569161,14,15,280,3,250
3046,482,520,94.57487528344672,95.75909297052155,14,4,64,1,38
3047,482,464,94.57487528344672,96.59501133786848,14,8,89,2,18
3048,482,618,94.57487528344672,96.71111111111111,14,3,164,2,136
3049,520,232,95.75909297052155,97.500589569161,4,15,298,2,288
3050,520,482,95.75909297052155,97.05941043083901,4,4,68,1,38
3051,520,488,95.75909297052155,98.47582766439909,4,7,121,3,32
3052,464,5,96.59501133786848,97.77922902494332,8,35,462,1,459
3053,464,6,96.59501133786848,98.2204081632653,8,35,463,2,458
3054,464,6,96.59501133786848,99.52072562358276,8,31,475,3,458
3055,464,216,96.59501133786848,98.82412698412699,8,18,266,2,248
3056,464,216,96.59501133786848,99.56716553287983,8,16,279,3,248
3057,464,488,96.59501133786848,98.47582766439909,8,7,84,2,24
3058,482,6,97.05941043083901,98.2204081632653,4,35,479,1,476
3059,482,6,97.05941043083901,99.52072562358276,4,31,488,2,476
3060,482,216,97.05941043083901,98.82412698412699,4,18,277,2,266
3061,482,216,97.05941043083901,99.56716553287983,4,16,287,3,266
3062,482,488,97.05941043083901,98.47582766439909,4,7,61,1,6
3063,482,429,97.05941043083901,99.6368253968254,4,15,123,3,53
3064,488,6,98.47582766439909,99.52072562358276,7,31,484,1,482
3065,488,6,98.47582766439909,100.82104308390024,7,31,492,2,482
3066,488,216,98.47582766439909,99.56716553287983,7,16,276,1,272
3067,488,343,98.47582766439909,100.84426303854876,7,20,177,2,145
3068,488,343,98.47582766439909,101.03002267573696,7,19,182,3,145
3069,488,429,98.47582766439909,99.6368253968254,7,15,77,1,59
3070,488,431,98.47582766439909,100.0780045351474,7,12,89,2,57
3071,429,6,99.6368253968254,100.82104308390024,15,31,426,1,423
3072,429,6,99.6368253968254,101.70340136054422,15,30,432,2,423
3073,429,6,99.6368253968254,102.1213605442177,15,31,436,2,423
3074,429,343,99.6368253968254,100.84426303854876,15,20,100,1,86
3075,429,343,99.6368253968254,101.03002267573696,15,19,105,1,86
3076,429,339,99.6368253968254,102.35356009070296,15,19,148,3,90
3077,429,412,99.6368253968254,101.72662131519274,15,12,92,2,17
3078,429,689,99.6368253968254,101.84272108843538,15,4,277,2,260
3079,429,824,99.6368253968254,101.7730612244898,15,3,406,2,395
3080,431,6,100.0780045351474,101.70340136054422,12,30,431,2,425
3081,431,6,100.0780045351474,102.1213605442177,12,31,434,2,425
3082,431,339,100.0780045351474,102.35356009070296,12,19,134,2,92
3083,431,412,100.0780045351474,101.72662131519274,12,12,73,2,19
3084,431,519,100.0780045351474,102.91083900226758,12,11,150,3,88
3085,431,689,100.0780045351474,101.84272108843538,12,4,269,2,258
3086,431,689,100.0780045351474,102.72507936507937,12,2,282,3,258
3087,431,683,100.0780045351474,103.05015873015873,12,3,283,3,252
3088,431,824,100.0780045351474,101.7730612244898,12,3,400,2,393
3089,431,825,100.0780045351474,102.63219954648527,12,4,409,3,394
3090,412,6,101.72662131519274,103.42167800453515,12,31,413,2,406
3091,412,7,101.72662131519274,104.28081632653061,12,30,420,3,405
3092,412,340,101.72662131519274,103.72353741496599,12,21,112,2,72
3093,412,519,101.72662131519274,102.91083900226758,12,11,119,1,107
3094,412,520,101.72662131519274,103.3752380952381,12,9,129,2,108
3095,412,520,101.72662131519274,104.25759637188209,12,7,153,3,108
3096,412,683,101.72662131519274,103.05015873015873,12,3,277,1,271
3097,412,733,101.72662131519274,104.32725623582766,12,4,340,3,321
3098,519,254,102.91083900226758,104.79165532879819,11,16,277,2,265
3099,519,309,102.91083900226758,105.74367346938776,11,19,243,3,210
3100,519,520,102.91083900226758,104.25759637188209,11,7,58,1,1
3101,519,520,102.91083900226758,105.55791383219955,11,15,114,3,1
3102,519,733,102.91083900226758,104.32725623582766,11,4,223,1,214
3103,520,254,103.3752380952381,104.79165532879819,9,16,273,1,266
3104,520,309,103.3752380952381,105.74367346938776,9,19,234,2,211
3105,520,309,104.25759637188209,105.74367346938776,7,19,220,1,211
3106,520,309,104.25759637188209,106.62603174603174,7,20,234,2,211
3107,520,433,104.25759637188209,106.53315192743764,7,11,131,2,87
3108,520,618,104.25759637188209,106.62603174603174,7,3,141,2,98
3109,520,309,105.55791383219955,106.62603174603174,15,20,216,1,211
3110,520,337,105.55791383219955,107.99600907029479,15,15,211,2,183
3111,520,459,105.55791383219955,107.25297052154195,15,14,95,2,61
3112,520,426,105.55791383219955,108.32108843537415,15,12,152,3,94
3113,520,618,105.55791383219955,106.62603174603174,15,3,108,1,98
3114,520,625,105.55791383219955,107.64770975056689,15,2,138,2,105
3115,433,6,106.53315192743764,108.20498866213153,11,31,433,2,427
3116,433,10,106.53315192743764,109.50530612244899,11,32,442,3,423
3117,433,337,106.53315192743764,107.99600907029479,11,15,115,1,96
3118,433,307,106.53315192743764,108.8087074829932,11,21,160,2,126
3119,433,426,106.53315192743764,108.32108843537415,11,12,77,2,7
3120,433,625,106.53315192743764,107.64770975056689,11,2,198,1,192
3121,459,10,107.25297052154195,109.50530612244899,14,32,459,2,449
3122,459,307,107.25297052154195,108.8087074829932,14,21,166,2,152
3123,459,308,107.25297052154195,109.62140589569161,14,26,182,2,151
3124,459,426,107.25297052154195,108.32108843537415,14,12,57,1,33
3125,459,518,107.25297052154195,109.8768253968254,14,10,127,3,59
3126,459,615,107.25297052154195,109.69106575963718,14,6,188,2,156
3127,426,10,108.32108843537415,109.50530612244899,12,32,419,1,416
3128,426,41,108.32108843537415,110.6895238095238,12,31,398,2,385
3129,426,308,108.32108843537415,109.62140589569161,12,26,131,1,118
3130,426,307,108.32108843537415,110.89850340136054,12,20,163,3,119
3131,426,518,108.32108843537415,109.8768253968254,12,10,114,2,92
3132,426,519,108.32108843537415,110.71274376417234,12,8,139,2,93
3133,426,518,108.32108843537415,111.08426303854876,12,7,150,3,92
3134,426,615,108.32108843537415,109.69106575963718,12,6,198,1,189
3135,426,617,108.32108843537415,110.48054421768708,12,7,212,2,191
3136,518,48,109.8768253968254,111.92018140589569,10,31,478,2,470
3137,518,73,109.8768253968254,112.75609977324264,10,31,462,3,445
3138,518,307,109.8768253968254,110.89850340136054,10,20,216,1,211
3139,518,307,109.8768253968254,111.78086167800454,10,17,226,2,211
3140,518,244,109.8768253968254,112.08272108843538,10,15,290,2,274
3141,518,628,109.8768253968254,111.45578231292517,10,4,129,2,110
3142,518,615,109.8768253968254,112.66321995464853,10,4,154,3,97
3143,519,48,110.71274376417234,111.92018140589569,8,31,474,1,471
3144,519,73,110.71274376417234,112.75609977324264,8,31,455,2,446
3145,519,307,110.71274376417234,111.78086167800454,8,17,217,1,212
3146,519,244,110.71274376417234,112.08272108843538,8,15,281,1,275
3147,519,462,110.71274376417234,113.01151927437643,8,8,114,2,57
3148,519,462,110.71274376417234,113.05795918367347,8,9,116,2,57
3149,519,615,110.71274376417234,112.66321995464853,8,4,128,2,96
3150,519,615,110.71274376417234,113.54557823129252,8,2,155,3,96
3151,518,73,111.08426303854876,112.75609977324264,7,31,451,2,445
3152,518,43,111.08426303854876,113.7081179138322,7,32,488,3,475
3153,518,261,111.08426303854876,113.89387755102041,7,14,284,3,257
3154,518,462,111.08426303854876,113.01151927437643,7,8,100,2,56
3155,518,462,111.08426303854876,113.05795918367347,7,9,102,2,56
3156,518,497,111.08426303854876,114.03319727891157,7,3,129,3,21
3157,518,615,111.08426303854876,112.66321995464853,7,4,118,2,97
3158,518,615,111.08426303854876,113.54557823129252,7,2,144,2,97
3159,462,14,113.01151927437643,114.89233560090703,8,32,455,2,448
3160,462,44,113.01151927437643,115.79791383219955,8,32,435,3,418
3161,462,245,113.01151927437643,114.35827664399093,8,13,225,1,217
3162,462,269,113.01151927437643,115.65859410430839,8,10,224,3,193
3163,462,497,113.01151927437643,114.03319727891157,8,3,56,1,35
3164,462,532,113.01151927437643,115.82113378684808,8,5,140,3,70
3165,462,705,113.01151927437643,115.5657142857143,8,4,267,3,243
3166,462,14,113.05795918367347,114.89233560090703,9,32,455,2,448
3167,462,44,113.05795918367347,115.79791383219955,9,32,434,3,418
3168,462,245,113.05795918367347,114.35827664399093,9,13,224,1,217
3169,462,269,113.05795918367347,115.65859410430839,9,10,223,3,193
3170,462,532,113.05795918367347,115.82113378684808,9,5,138,3,70
3171,462,705,113.05795918367347,115.5657142857143,9,4,266,3,243
3172,497,44,114.03319727891157,115.79791383219955,3,32,459,2,453
3173,497,38,114.03319727891157,116.28553287981859,3,31,469,2,459
3174,497,269,114.03319727891157,115.65859410430839,3,10,239,2,228
3175,497,269,114.03319727891157,116.09977324263039,3,12,245,2,228
3176,497,532,114.03319727891157,115.82113378684808,3,5,85,2,35
3177,497,496,114.03319727891157,116.51773242630385,3,5,107,2,1
3178,497,705,114.03319727891157,115.5657142857143,3,4,218,2,208
3179,497,721,114.03319727891157,116.19265306122449,3,7,243,2,224
3180,532,49,115.82113378684808,118.02702947845805,5,32,492,2,483
3181,532,48,115.82113378684808,118.46820861678005,5,31,497,3,484
3182,532,269,115.82113378684808,117.56263038548754,5,14,273,2,263
3183,532,270,115.82113378684808,118.25922902494331,5,10,282,2,262
3184,532,516,115.82113378684808,117.8877097505669,5,7,90,2,16
3185,532,626,115.82113378684808,117.60907029478459,5,5,122,2,94
3186,532,770,115.82113378684808,118.60752834467121,5,5,267,3,238
3187,496,49,116.51773242630385,118.02702947845805,5,32,452,2,447
3188,496,48,116.51773242630385,118.46820861678005,5,31,456,2,448
3189,496,269,116.51773242630385,117.56263038548754,5,14,231,1,227
3190,496,270,116.51773242630385,118.25922902494331,5,10,238,2,226
3191,496,516,116.51773242630385,117.8877097505669,5,7,62,1,20
3192,496,579,116.51773242630385,118.93260770975057,5,6,133,2,83
3193,496,533,116.51773242630385,119.25768707482993,5,7,124,3,37
3194,496,626,116.51773242630385,117.60907029478459,5,5,138,1,130
3195,496,770,116.51773242630385,118.60752834467121,5,5,288,2,274
3196,516,49,117.8877097505669,119.72208616780046,7,31,474,2,467
3197,516,52,117.8877097505669,120.2097052154195,7,31,475,2,464
3198,516,268,117.8877097505669,119.97750566893424,7,14,264,2,248
3199,516,270,117.8877097505669,120.6508843537415,7,11,273,3,246
3200,516,579,117.8877097505669,118.93260770975057,7,6,77,1,63
3201,516,533,117.8877097505669,119.25768707482993,7,7,61,1,17
3202,516,539,117.8877097505669,120.53478458049887,7,8,116,3,23
3203,516,656,117.8877097505669,120.51156462585034,7,3,180,3,140
3204,579,268,118.93260770975057,119.97750566893424,6,14,314,1,311
3205,579,270,118.93260770975057,120.6508843537415,6,11,318,2,309
3206,579,242,118.93260770975057,121.16172335600908,6,13,350,2,337
3207,579,539,118.93260770975057,120.53478458049887,6,8,80,2,40
3208,579,545,118.93260770975057,121.39392290249434,6,6,111,2,34
3209,579,656,118.93260770975057,120.51156462585034,6,3,103,2,77
3210,579,639,118.93260770975057,121.41714285714286,6,4,123,2,60
3211,579,820,118.93260770975057,121.39392290249434,6,3,263,2,241
3212,533,270,119.25768707482993,120.6508843537415,7,11,270,1,263
3213,533,242,119.25768707482993,121.16172335600908,7,13,302,2,291
3214,533,230,119.25768707482993,122.11374149659864,7,13,327,3,303
3215,533,539,119.25768707482993,120.53478458049887,7,8,55,1,6
3216,533,545,119.25768707482993,121.39392290249434,7,6,93,2,12
3217,533,656,119.25768707482993,120.51156462585034,7,3,134,1,123
3218,533,639,119.25768707482993,121.41714285714286,7,4,141,2,106
3219,533,820,119.25768707482993,121.39392290249434,7,3,301,2,287
3220,539,230,120.53478458049887,122.11374149659864,8,13,316,2,309
3221,539,269,120.53478458049887,123.04253968253968,8,12,291,3,270
3222,539,479,120.53478458049887,122.50848072562358,8,6,104,2,60
3223,539,689,120.53478458049887,122.50848072562358,8,3,172,2,150
3224,545,269,121.39392290249434,123.04253968253968,6,12,285,2,276
3225,545,247,121.39392290249434,124.18031746031747,6,13,321,3,298
3226,545,479,121.39392290249434,122.50848072562358,6,6,82,1,66
3227,545,540,121.39392290249434,123.92489795918368,6,5,109,3,5
3228,545,516,121.39392290249434,124.06421768707483,6,5,119,3,29
3229,545,689,121.39392290249434,122.50848072562358,6,3,152,1,144
3230,479,20,122.50848072562358,123.55337868480726,6,33,461,1,459
3231,479,44,122.50848072562358,124.50539682539683,6,32,443,2,435
3232,479,247,122.50848072562358,124.18031746031747,6,13,243,2,232
3233,479,540,122.50848072562358,123.92489795918368,6,5,86,1,61
3234,479,516,122.50848072562358,124.06421768707483,6,5,77,2,37
3235,540,65,123.92489795918368,126.4326530612245,5,34,487,3,475
3236,540,257,123.92489795918368,125.92181405895691,5,19,296,2,283
3237,540,206,123.92489795918368,126.45587301587302,5,16,351,3,334
3238,540,499,123.92489795918368,125.6431746031746,5,11,85,2,41
3239,540,480,123.92489795918368,126.89705215419501,5,8,141,3,60
3240,540,773,123.92489795918368,125.75927437641724,5,5,246,2,233
3241,540,826,123.92489795918368,125.75927437641724,5,2,297,2,286
3242,516,65,124.06421768707483,126.4326530612245,5,34,462,2,451
3243,516,257,124.06421768707483,125.92181405895691,5,19,271,2,259
3244,516,206,124.06421768707483,126.45587301587302,5,16,327,2,310
3245,516,499,124.06421768707483,125.6431746031746,5,11,70,2,17
3246,516,480,124.06421768707483,126.89705215419501,5,8,127,3,36
3247,516,773,124.06421768707483,125.75927437641724,5,5,267,2,257
3248,516,826,124.06421768707483,125.75927437641724,5,2,318,2,310
3249,499,6,125.6431746031746,127.33823129251701,11,35,498,2,493
3250,499,7,125.6431746031746,128.19736961451247,11,33,504,3,492
3251,499,233,125.6431746031746,128.03482993197278,11,22,285,2,266
3252,499,232,125.6431746031746,128.17414965986396,11,27,288,3,267
3253,499,480,125.6431746031746,126.89705215419501,11,8,57,1,19
3254,499,495,125.6431746031746,128.03482993197278,11,13,103,2,4
3255,499,519,125.6431746031746,128.10448979591837,11,15,108,2,20
3256,499,784,125.6431746031746,127.43111111111111,11,9,295,2,285
3257,499,754,125.6431746031746,128.19736961451247,11,2,278,3,255
3258,499,830,125.6431746031746,127.43111111111111,11,9,340,2,331
3259,480,7,126.89705215419501,128.19736961451247,8,33,476,1,473
3260,480,58,126.89705215419501,129.75310657596373,8,33,440,3,422
3261,480,233,126.89705215419501,128.03482993197278,8,22,252,1,247
3262,480,232,126.89705215419501,128.17414965986396,8,27,254,1,248
3263,480,495,126.89705215419501,128.03482993197278,8,13,51,1,15
3264,480,519,126.89705215419501,128.10448979591837,8,15,65,1,39
3265,480,452,126.89705215419501,129.49768707482994,8,12,115,3,28
3266,480,754,126.89705215419501,128.19736961451247,8,2,280,1,274
3267,495,58,128.03482993197278,129.75310657596373,13,33,443,2,437
3268,495,11,128.03482993197278,130.3568253968254,13,32,494,2,484
3269,495,232,128.03482993197278,129.96208616780046,13,16,276,2,263
3270,495,231,128.03482993197278,130.91410430839002,13,21,292,3,264
3271,495,452,128.03482993197278,129.49768707482994,13,12,76,1,43
3272,495,544,128.03482993197278,130.38004535147394,13,14,112,2,49
3273,495,752,128.03482993197278,130.2639455782313,13,9,274,2,257
3274,495,845,128.03482993197278,130.2871655328798,13,5,363,2,350
3275,519,58,128.10448979591837,129.75310657596373,15,33,466,2,461
3276,519,232,128.10448979591837,129.96208616780046,15,16,298,2,287
3277,519,231,128.10448979591837,130.91410430839002,15,21,312,3,288
3278,519,452,128.10448979591837,129.49768707482994,15,12,90,1,67
3279,519,544,128.10448979591837,130.38004535147394,15,14,101,2,25
3280,519,752,128.10448979591837,130.2639455782313,15,9,251,2,233
3281,519,845,128.10448979591837,130.2871655328798,15,5,339,2,326
3282,452,24,129.49768707482994,131.5178231292517,12,32,437,2,428
3283,452,231,129.49768707482994,130.91410430839002,12,21,229,1,221
3284,452,235,129.49768707482994,131.44816326530614,12,15,233,2,217
3285,452,437,129.49768707482994,131.65714285714287,12,12,94,2,15
3286,452,479,129.49768707482994,132.12154195011337,12,12,116,3,27
3287,452,627,129.49768707482994,131.81968253968253,12,10,202,2,175
3288,452,827,129.49768707482994,131.91256235827666,12,4,389,2,375
3289,544,48,130.38004535147394,132.84136054421768,14,33,507,2,496
3290,544,49,130.38004535147394,133.2825396825397,14,33,511,3,495
3291,544,235,130.38004535147394,131.44816326530614,14,15,312,1,309
3292,544,239,130.38004535147394,132.9342403628118,14,16,324,3,305
3293,544,437,130.38004535147394,131.65714285714287,14,12,120,1,107
3294,544,479,130.38004535147394,132.12154195011337,14,12,99,2,65
3295,544,627,130.38004535147394,131.81968253968253,14,10,104,1,83
3296,544,673,130.38004535147394,132.95746031746032,14,5,170,3,129
3297,544,677,130.38004535147394,133.2128798185941,14,6,180,3,133
3298,544,827,130.38004535147394,131.91256235827666,14,4,291,2,283
3299,544,830,130.38004535147394,132.4930612244898,14,4,300,2,286
3300,437,48,131.65714285714287,132.84136054421768,12,33,392,1,389
3301,437,49,131.65714285714287,133.2825396825397,12,33,394,2,388
3302,437,239,131.65714285714287,132.9342403628118,12,16,205,1,198
3303,437,206,131.65714285714287,133.67727891156463,12,16,247,2,231
3304,437,480,131.65714285714287,133.83981859410432,12,12,103,2,43
3305,437,590,131.65714285714287,134.48997732426304,12,11,196,3,153
3306,437,673,131.65714285714287,132.95746031746032,12,5,243,1,236
3307,437,677,131.65714285714287,133.2128798185941,12,6,249,2,240
3308,437,622,131.65714285714287,134.48997732426304,12,8,222,3,185
3309,437,841,131.65714285714287,134.2809977324263,12,8,420,3,404
3310,479,49,132.12154195011337,133.2825396825397,12,33,433,1,430
3311,479,7,132.12154195011337,134.7221768707483,12,32,485,3,472
3312,479,206,132.12154195011337,133.67727891156463,12,16,281,2,273
3313,479,349,132.12154195011337,134.67573696145126,12,17,170,3,130
3314,479,480,132.12154195011337,133.83981859410432,12,12,74,2,1
3315,479,590,132.12154195011337,134.48997732426304,12,11,151,2,111
3316,479,677,132.12154195011337,133.2128798185941,12,6,204,1,198
3317,479,622,132.12154195011337,134.48997732426304,12,8,176,2,143
3318,479,841,132.12154195011337,134.2809977324263,12,8,374,2,362
3319,480,14,133.83981859410432,135.58131519274377,12,34,472,2,466
3320,480,44,133.83981859410432,136.74231292517007,12,35,454,3,436
3321,480,355,133.83981859410432,135.65097505668933,12,15,147,2,125
3322,480,434,133.83981859410432,136.27791383219954,12,10,115,2,46
3323,480,619,133.83981859410432,136.4172335600907,12,5,178,3,139
3324,590,355,134.48997732426304,135.65097505668933,11,15,240,1,235
3325,590,291,134.48997732426304,137.0209523809524,11,16,318,3,299
3326,590,480,134.48997732426304,135.60453514739228,11,11,120,1,110
3327,590,434,134.48997732426304,136.27791383219954,11,10,174,2,156
3328,590,619,134.48997732426304,136.4172335600907,11,5,88,2,29
3329,480,44,135.60453514739228,136.74231292517007,11,35,439,1,436
3330,480,33,135.60453514739228,137.27637188208618,11,33,453,2,447
3331,480,38,135.60453514739228,138.06585034013605,11,33,455,2,442
3332,480,291,135.60453514739228,137.0209523809524,11,16,199,1,189
3333,480,268,135.60453514739228,137.9497505668934,11,18,235,2,212
3334,480,230,135.60453514739228,138.2748299319728,11,16,275,3,250
3335,480,459,135.60453514739228,138.34448979591838,11,6,120,3,21
3336,480,658,135.60453514739228,137.9497505668934,11,8,205,2,178
3337,434,38,136.27791383219954,138.06585034013605,10,33,403,2,396
3338,434,268,136.27791383219954,137.9497505668934,10,18,181,2,166
3339,434,230,136.27791383219954,138.2748299319728,10,16,221,2,204
3340,434,480,136.27791383219954,137.9961904761905,10,13,87,2,46
3341,434,459,136.27791383219954,138.34448979591838,10,6,92,2,25
3342,434,658,136.27791383219954,137.9497505668934,10,8,235,2,224
3343,480,6,137.9961904761905,139.94666666666666,13,33,481,2,474
3344,480,66,137.9961904761905,140.64326530612246,13,36,429,3,414
3345,480,223,137.9961904761905,140.0395464852608,13,29,272,2,257
3346,480,223,137.9961904761905,140.0627664399093,13,29,272,2,257
3347,480,510,137.9961904761905,140.0395464852608,13,13,93,2,30
3348,480,511,137.9961904761905,140.08598639455784,13,16,95,2,31
3349,480,765,137.9961904761905,140.0395464852608,13,8,298,2,285
3350,480,914,137.9961904761905,139.85378684807256,13,3,441,2,434
3351,459,6,138.34448979591838,139.94666666666666,6,33,458,2,453
3352,459,66,138.34448979591838,140.64326530612246,6,36,405,2,393
3353,459,223,138.34448979591838,140.0395464852608,6,29,247,2,236
3354,459,223,138.34448979591838,140.0627664399093,6,29,247,2,236
3355,459,239,138.34448979591838,141.20054421768708,6,18,252,3,220
3356,459,510,138.34448979591838,140.0395464852608,6,13,89,2,51
3357,459,511,138.34448979591838,140.08598639455784,6,16,91,2,52
3358,459,507,138.34448979591838,141.1308843537415,6,11,129,3,48
3359,459,765,138.34448979591838,140.0395464852608,6,8,315,2,306
3360,459,655,138.34448979591838,141.01478458049885,6,10,227,3,196
3361,459,914,138.34448979591838,139.85378684807256,6,3,460,2,455
3362,459,826,138.34448979591838,140.99156462585034,6,6,384,3,367
3363,510,59,140.0395464852608,141.54884353741497,13,35,456,2,451
3364,510,239,140.0395464852608,141.20054421768708,13,18,276,1,271
3365,510,256,140.0395464852608,142.918820861678,13,23,283,3,254
3366,510,507,140.0395464852608,141.1308843537415,13,11,47,1,3
3367,510,493,140.0395464852608,142.50086167800453,13,10,107,2,17
3368,510,616,140.0395464852608,141.33986394557823,13,3,120,1,106
3369,510,701,140.0395464852608,142.08290249433108,13,8,210,2,191
3370,511,59,140.08598639455784,141.54884353741497,16,35,456,1,452
3371,511,239,140.08598639455784,141.20054421768708,16,18,276,1,272
3372,511,256,140.08598639455784,142.918820861678,16,23,283,3,255
3373,511,507,140.08598639455784,141.1308843537415,16,11,45,1,4
3374,511,493,140.08598639455784,142.50086167800453,16,10,106,2,18
3375,511,616,140.08598639455784,141.33986394557823,16,3,118,1,105
3376,511,701,140.08598639455784,142.08290249433108,16,8,209,2,190
3377,507,56,141.1308843537415,143.5457596371882,11,35,463,2,451
3378,507,256,141.1308843537415,142.918820861678,11,23,263,2,251
3379,507,290,141.1308843537415,143.6386394557823,11,20,242,3,217
3380,507,493,141.1308843537415,142.50086167800453,11,10,61,1,14
3381,507,473,141.1308843537415,143.9637188208617,11,9,127,3,34
3382,507,668,141.1308843537415,143.49931972789116,11,4,191,2,161
3383,493,56,142.50086167800453,143.5457596371882,10,35,439,1,437
3384,493,5,142.50086167800453,144.72997732426305,10,35,497,2,488
3385,493,290,142.50086167800453,143.6386394557823,10,20,209,1,203
3386,493,205,142.50086167800453,144.7764172335601,10,24,304,2,288
3387,493,473,142.50086167800453,143.9637188208617,10,9,66,1,20
3388,493,487,142.50086167800453,144.7764172335601,10,11,98,2,6
3389,493,622,142.50086167800453,144.24235827664398,10,4,149,2,129
3390,473,6,143.9637188208617,146.0302947845805,9,34,475,2,467
3391,473,39,143.9637188208617,146.26249433106577,9,34,445,2,434
3392,473,205,143.9637188208617,145.63555555555556,9,17,278,2,268
3393,473,471,143.9637188208617,145.54267573696146,9,12,68,2,2
3394,473,665,143.9637188208617,145.6819954648526,9,12,206,2,192
3395,473,822,143.9637188208617,145.70521541950114,9,9,357,2,349
3396,487,6,144.7764172335601,146.0302947845805,11,34,484,1,481
3397,487,39,144.7764172335601,146.26249433106577,11,34,453,1,448
3398,487,223,144.7764172335601,147.02875283446713,11,24,281,2,264
3399,487,225,144.7764172335601,147.14485260770977,11,26,281,2,262
3400,487,516,144.7764172335601,146.98231292517008,11,13,99,2,29
3401,471,6,145.54267573696146,147.77179138321995,12,36,475,2,465
3402,471,223,145.54267573696146,147.02875283446713,12,24,256,1,248
3403,471,225,145.54267573696146,147.14485260770977,12,26,255,2,246
3404,471,229,145.54267573696146,148.05043083900227,12,20,265,3,242
3405,471,516,145.54267573696146,146.98231292517008,12,13,77,1,45
3406,471,576,145.54267573696146,148.00399092970522,12,9,149,2,105
3407,471,573,145.54267573696146,148.3522902494331,12,11,158,3,102
3408,471,621,145.54267573696146,147.84145124716554,12,7,180,2,150
3409,471,634,145.54267573696146,148.3522902494331,12,12,203,3,163
3410,471,846,145.54267573696146,148.37551020408165,12,2,394,3,375
3411,516,58,146.98231292517008,148.6077097505669,13,36,463,2,458
3412,516,229,146.98231292517008,148.05043083900227,13,20,291,1,287
3413,516,242,146.98231292517008,149.582947845805,13,26,296,3,274
3414,516,576,146.98231292517008,148.00399092970522,13,9,74,1,60
3415,516,573,146.98231292517008,148.3522902494331,13,11,82,1,57
3416,516,450,146.98231292517008,149.18820861678006,13,13,116,2,66
3417,516,634,146.98231292517008,148.3522902494331,13,12,132,1,118
3418,516,642,146.98231292517008,149.25786848072562,13,9,160,2,126
3419,516,846,146.98231292517008,148.37551020408165,13,2,335,1,330
3420,516,856,146.98231292517008,149.21142857142857,13,3,353,2,340
3421,576,242,148.00399092970522,149.582947845805,9,26,341,2,334
3422,576,205,148.00399092970522,150.90648526077098,9,21,391,3,371
3423,576,450,148.00399092970522,149.18820861678006,9,13,136,1,126
3424,576,611,148.00399092970522,150.4885260770975,9,12,113,2,35
3425,576,642,148.00399092970522,149.25786848072562,9,9,85,1,66
3426,576,619,148.00399092970522,150.51174603174604,9,10,116,3,43
3427,576,856,148.00399092970522,149.21142857142857,9,3,285,1,280
3428,573,242,148.3522902494331,149.582947845805,11,26,335,1,331
3429,573,205,148.3522902494331,150.90648526077098,11,21,384,3,368
3430,573,227,148.3522902494331,151.32444444444445,11,27,369,3,346
3431,573,611,148.3522902494331,150.4885260770975,11,12,100,2,38
3432,573,619,148.3522902494331,150.51174603174604,11,10,104,2,46
3433,450,58,149.18820861678006,150.95292517006803,13,36,399,2,392
3434,450,58,149.18820861678006,151.09224489795918,13,37,400,2,392
3435,450,205,149.18820861678006,150.90648526077098,13,21,256,2,245
3436,450,227,149.18820861678006,151.32444444444445,13,27,241,2,223
3437,450,611,149.18820861678006,150.4885260770975,13,12,170,1,161
3438,450,463,149.18820861678006,151.41732426303855,13,13,97,2,13
3439,450,619,149.18820861678006,150.51174603174604,13,10,178,1,169
3440,450,646,149.18820861678006,151.4405442176871,13,11,219,2,196
3441,611,205,150.4885260770975,152.57832199546485,12,18,416,2,406
3442,611,307,150.4885260770975,153.4374603174603,12,20,329,3,304
3443,611,496,150.4885260770975,152.92662131519273,12,4,156,2,115
3444,611,774,150.4885260770975,152.64798185941044,12,5,188,2,163
3445,463,6,151.41732426303855,152.99628117913832,13,34,462,2,457
3446,463,64,151.41732426303855,153.94829931972788,13,35,414,3,399
3447,463,5,151.41732426303855,154.2965986394558,13,33,474,3,458
3448,463,205,151.41732426303855,152.57832199546485,13,18,263,1,258
3449,463,307,151.41732426303855,153.4374603174603,13,20,179,2,156
3450,463,496,151.41732426303855,152.92662131519273,13,4,73,2,33
3451,463,423,151.41732426303855,154.041179138322,13,7,120,3,40
3452,463,774,151.41732426303855,152.64798185941044,13,5,315,1,311
3453,463,814,151.41732426303855,154.18049886621316,13,10,371,3,351
3454,463,834,151.41732426303855,154.18049886621316,13,5,390,3,371
3455,496,64,152.92662131519273,153.94829931972788,4,35,434,1,432
3456,496,5,152.92662131519273,154.2965986394558,4,33,495,1,491
3457,496,230,152.92662131519273,154.73777777777778,4,25,277,2,266
3458,496,423,152.92662131519273,154.041179138322,4,7,87,1,73
3459,496,486,152.92662131519273,154.90031746031747,4,14,86,2,10
3460,496,814,152.92662131519273,154.18049886621316,4,10,323,1,318
3461,496,834,152.92662131519273,154.18049886621316,4,5,342,1,338
3462,423,5,154.041179138322,156.03809523809525,7,35,427,2,418
3463,423,5,154.041179138322,156.47927437641724,7,34,431,2,418
3464,423,205,154.041179138322,156.03809523809525,7,20,234,2,218
3465,423,236,154.041179138322,156.57215419501134,7,22,216,3,187
3466,423,563,154.041179138322,155.9916553287982,7,14,163,2,140
3467,423,520,154.041179138322,156.6185941043084,7,9,147,3,97
3468,423,654,154.041179138322,156.0148752834467,7,8,246,2,231
3469,423,623,154.041179138322,156.06131519274376,7,3,218,2,200
3470,486,5,154.90031746031747,156.03809523809525,14,35,483,1,481
3471,486,5,154.90031746031747,156.47927437641724,14,34,486,2,481
3472,486,6,154.90031746031747,157.7795918367347,14,35,496,3,480
3473,486,205,154.90031746031747,156.03809523809525,14,20,285,1,281
3474,486,236,154.90031746031747,156.57215419501134,14,22,260,2,250
3475,486,205,154.90031746031747,157.8724716553288,14,31,309,3,281
3476,486,563,154.90031746031747,155.9916553287982,14,14,90,1,77
3477,486,520,154.90031746031747,156.6185941043084,14,9,81,2,34
3478,486,572,154.90031746031747,157.70993197278912,14,15,148,3,86
3479,486,654,154.90031746031747,156.0148752834467,14,8,175,1,168
3480,486,623,154.90031746031747,156.06131519274376,14,3,146,1,137
3481,486,635,154.90031746031747,157.64027210884353,14,14,190,3,149
3482,486,907,154.90031746031747,157.66349206349207,14,9,437,3,421
3483,563,205,155.9916553287982,157.8724716553288,14,31,367,2,358
3484,563,237,155.9916553287982,158.26721088435374,14,24,340,2,326
3485,563,572,155.9916553287982,157.70993197278912,14,15,75,2,9
3486,563,520,155.9916553287982,158.33687074829933,14,12,110,2,43
3487,563,635,155.9916553287982,157.64027210884353,14,14,101,2,72
3488,563,667,155.9916553287982,158.3136507936508,14,4,144,2,104
3489,563,907,155.9916553287982,157.66349206349207,14,9,351,2,344
3490,520,205,156.6185941043084,157.8724716553288,9,31,320,1,315
3491,520,237,156.6185941043084,158.26721088435374,9,24,292,2,283
3492,520,572,156.6185941043084,157.70993197278912,9,15,70,1,52
3493,520,529,156.6185941043084,159.381768707483,9,9,119,3,9
3494,520,635,156.6185941043084,157.64027210884353,9,14,123,1,115
3495,520,667,156.6185941043084,158.3136507936508,9,4,164,2,147
3496,520,617,156.6185941043084,159.381768707483,9,3,154,3,97
3497,520,907,156.6185941043084,157.66349206349207,9,9,390,1,387
3498,572,205,157.70993197278912,159.68362811791383,15,18,377,2,367
3499,572,246,157.70993197278912,160.47310657596373,15,15,347,3,326
3500,572,529,157.70993197278912,159.381768707483,15,9,84,2,43
3501,572,617,157.70993197278912,159.381768707483,15,3,85,2,45
3502,520,47,158.33687074829933,159.84616780045351,12,35,477,2,473
3503,520,205,158.33687074829933,159.68362811791383,12,18,320,1,315
3504,520,246,158.33687074829933,160.47310657596373,12,15,289,2,274
3505,520,529,158.33687074829933,159.381768707483,12,9,46,1,9
3506,520,575,158.33687074829933,160.86784580498866,12,10,122,3,55
3507,520,617,158.33687074829933,159.381768707483,12,3,107,1,97
3508,520,619,158.33687074829933,160.77496598639456,12,3,144,2,99
3509,529,246,159.381768707483,160.47310657596373,9,15,287,1,283
3510,529,263,159.381768707483,161.91274376417235,9,20,287,3,266
3511,529,575,159.381768707483,160.86784580498866,9,10,79,1,46
3512,529,506,159.381768707483,162.0520634920635,9,10,117,3,23
3513,529,510,159.381768707483,162.09850340136055,9,11,119,3,19
3514,529,619,159.381768707483,160.77496598639456,9,3,108,1,90
3515,529,635,159.381768707483,162.0520634920635,9,12,156,3,106
3516,529,630,159.381768707483,162.09850340136055,9,12,155,3,101
3517,575,263,160.86784580498866,161.91274376417235,10,20,315,1,312
3518,575,255,160.86784580498866,162.98086167800454,10,17,333,2,320
3519,575,205,160.86784580498866,163.16662131519274,10,19,383,2,370
3520,575,506,160.86784580498866,162.0520634920635,10,10,86,1,69
3521,575,510,160.86784580498866,162.09850340136055,10,11,84,1,65
3522,575,528,160.86784580498866,163.25950113378684,10,8,113,2,47
3523,575,635,160.86784580498866,162.0520634920635,10,12,79,1,60
3524,575,630,160.86784580498866,162.09850340136055,10,12,76,1,55
3525,575,654,160.86784580498866,163.72390022675737,10,3,146,3,79
3526,506,205,162.0520634920635,163.16662131519274,10,19,305,1,301
3527,506,205,162.0520634920635,164.79201814058956,10,16,323,3,301
3528,506,528,162.0520634920635,163.25950113378684,10,8,56,1,22
3529,506,597,162.0520634920635,164.16507936507938,10,11,129,2,91
3530,506,654,162.0520634920635,163.72390022675737,10,3,165,2,148
3531,506,656,162.0520634920635,164.11863945578233,10,12,174,2,150
3532,506,831,162.0520634920635,164.11863945578233,10,4,337,2,325
3533,510,205,162.09850340136055,163.16662131519274,11,19,308,1,305
3534,510,205,162.09850340136055,164.79201814058956,11,16,326,3,305
3535,510,528,162.09850340136055,163.25950113378684,11,8,53,1,18
3536,510,597,162.09850340136055,164.16507936507938,11,11,124,2,87
3537,510,654,162.09850340136055,163.72390022675737,11,3,160,2,144
3538,510,656,162.09850340136055,164.11863945578233,11,12,170,2,146
3539,510,831,162.09850340136055,164.11863945578233,11,4,333,2,321
3540,528,205,163.25950113378684,164.79201814058956,8,16,330,2,323
3541,528,205,163.25950113378684,165.67437641723356,8,14,339,2,323
3542,528,594,163.25950113378684,165.90657596371884,8,8,132,3,66
3543,528,619,163.25950113378684,165.99945578231294,8,3,149,3,91
3544,597,205,164.16507936507938,165.67437641723356,11,14,397,2,392
3545,597,205,164.16507936507938,166.5102947845805,11,19,405,2,392
3546,597,594,164.16507936507938,165.90657596371884,11,8,75,2,3
3547,597,456,164.16507936507938,166.9514739229025,11,8,185,3,141
3548,597,619,164.16507936507938,165.99945578231294,11,3,82,2,22
3549,597,618,164.16507936507938,166.27809523809523,11,5,93,2,21
3550,594,295,165.90657596371884,167.69451247165534,8,19,309,2,299
3551,594,456,165.90657596371884,166.9514739229025,8,8,145,1,138
3552,594,592,165.90657596371884,167.6712925170068,8,10,76,2,2
3553,594,474,165.90657596371884,168.50721088435375,8,7,164,3,120
3554,594,722,165.90657596371884,167.4855328798186,8,5,145,2,128
3555,594,616,165.90657596371884,168.13569160997733,8,3,98,2,22
3556,456,13,166.9514739229025,168.22857142857143,8,29,446,1,443
3557,456,51,166.9514739229025,169.11092970521543,8,26,416,2,405
3558,456,308,166.9514739229025,169.04126984126984,8,15,173,2,148
3559,456,231,166.9514739229025,169.3663492063492,8,14,248,2,225
3560,456,474,166.9514739229025,168.50721088435375,8,7,69,2,18
3561,456,473,166.9514739229025,169.3663492063492,8,7,105,2,17
3562,456,616,166.9514739229025,168.13569160997733,8,3,168,1,160
3563,456,696,166.9514739229025,169.34312925170067,8,3,261,2,240
3564,592,308,167.6712925170068,169.04126984126984,10,15,290,1,284
3565,592,231,167.6712925170068,169.3663492063492,10,14,368,2,361
3566,592,233,167.6712925170068,170.17904761904762,10,15,375,3,359
3567,592,473,167.6712925170068,169.3663492063492,10,7,140,2,119
3568,592,696,167.6712925170068,169.34312925170067,10,3,126,2,104
3569,474,16,168.50721088435375,170.80598639455783,7,26,469,2,458
3570,474,13,168.50721088435375,171.27038548752836,7,32,476,3,461
3571,474,233,168.50721088435375,170.17904761904762,7,15,252,2,241
3572,474,311,168.50721088435375,171.34004535147392,7,15,204,3,163
3573,474,472,168.50721088435375,170.75954648526078,7,7,97,2,2
3574,474,464,168.50721088435375,171.10784580498867,7,4,112,3,10
3575,474,619,168.50721088435375,171.27038548752836,7,2,188,3,145
3576,473,16,169.3663492063492,170.80598639455783,7,26,461,1,457
3577,473,13,169.3663492063492,171.27038548752836,7,32,467,2,460
3578,473,51,169.3663492063492,172.10630385487528,7,31,438,3,422
3579,473,311,169.3663492063492,171.34004535147392,7,15,183,2,162
3580,473,472,169.3663492063492,170.75954648526078,7,7,60,1,1
3581,473,464,169.3663492063492,171.10784580498867,7,4,76,2,9
3582,473,619,169.3663492063492,171.27038548752836,7,2,167,2,146
3583,473,616,169.3663492063492,172.12952380952382,7,3,186,3,143
3584,472,51,170.75954648526078,172.10630385487528,7,31,425,1,421
3585,472,16,170.75954648526078,173.22086167800452,7,28,468,2,456
3586,472,232,170.75954648526078,172.87256235827664,7,15,257,2,240
3587,472,465,170.75954648526078,172.80290249433108,7,3,88,2,7
3588,472,616,170.75954648526078,172.12952380952382,7,3,156,1,144
3589,464,16,171.10784580498867,173.22086167800452,4,28,457,2,448
3590,464,232,171.10784580498867,172.87256235827664,4,15,244,2,232
3591,464,231,171.10784580498867,173.8942403628118,4,17,262,3,233
3592,464,465,171.10784580498867,172.80290249433108,4,3,73,2,1
3593,464,616,171.10784580498867,172.12952380952382,4,3,158,1,152
3594,465,26,172.80290249433108,174.79981859410432,3,28,447,2,439
3595,465,26,172.80290249433108,175.35709750566895,3,31,453,3,439
3596,465,231,172.80290249433108,173.8942403628118,3,17,239,1,234
3597,465,232,172.80290249433108,174.38185941043085,3,15,243,2,233
3598,465,232,172.80290249433108,175.19455782312926,3,14,255,2,233
3599,465,464,172.80290249433108,173.94068027210884,3,3,49,1,1
3600,465,457,172.80290249433108,174.73015873015873,3,4,83,2,8
3601,465,416,172.80290249433108,175.17133786848072,3,2,113,2,49
3602,465,774,172.80290249433108,174.73015873015873,3,2,320,2,309
3603,464,26,173.94068027210884,175.35709750566895,3,31,442,1,438
3604,464,51,173.94068027210884,176.07691609977326,3,29,423,2,413
3605,464,232,173.94068027210884,175.19455782312926,3,14,238,1,232
3606,464,232,173.94068027210884,176.26267573696146,3,13,253,2,232
3607,464,416,173.94068027210884,175.17133786848072,3,2,72,1,48
3608,464,473,173.94068027210884,176.70385487528344,3,5,119,3,9
3609,457,51,174.73015873015873,176.07691609977326,4,29,410,1,406
3610,457,16,174.73015873015873,177.12181405895691,4,29,453,2,441
3611,457,232,174.73015873015873,176.26267573696146,4,13,234,2,225
3612,457,289,174.73015873015873,177.3772335600907,4,13,203,3,168
3613,457,473,174.73015873015873,176.70385487528344,4,5,86,2,16
3614,416,16,175.17133786848072,177.12181405895691,2,29,409,2,400
3615,416,232,175.17133786848072,176.26267573696146,2,13,190,1,184
3616,416,289,175.17133786848072,177.3772335600907,2,13,159,2,127
3617,416,473,175.17133786848072,176.70385487528344,2,5,87,2,57
3618,416,464,175.17133786848072,178.05061224489796,2,3,133,3,48
3619,416,464,175.17133786848072,178.0738321995465,2,5,134,3,48
3620,473,14,176.70385487528344,178.4221315192744,5,29,465,2,459
3621,473,14,176.70385487528344,179.5134693877551,5,28,475,3,459
3622,473,314,176.70385487528344,178.21315192743765,5,12,172,2,159
3623,473,239,176.70385487528344,179.420589569161,5,11,262,3,234
3624,473,464,176.70385487528344,178.05061224489796,5,3,59,1,9
3625,473,464,176.70385487528344,178.0738321995465,5,5,60,1,9
3626,473,534,176.70385487528344,179.1419501133787,5,2,121,2,61
3627,473,618,176.70385487528344,178.23637188208616,5,4,159,2,145
3628,464,14,178.05061224489796,179.5134693877551,3,28,454,1,450
3629,464,78,178.05061224489796,180.90666666666667,3,33,405,3,386
3630,464,239,178.05061224489796,179.420589569161,3,11,233,1,225
3631,464,222,178.05061224489796,180.51192743764173,3,14,264,2,242
3632,464,534,178.05061224489796,179.1419501133787,3,2,84,1,70
3633,464,457,178.05061224489796,180.79056689342403,3,10,118,3,7
3634,464,615,178.05061224489796,180.67446712018142,3,3,189,3,151
3635,464,14,178.0738321995465,179.5134693877551,5,28,454,1,450
3636,464,78,178.0738321995465,180.90666666666667,5,33,405,3,386
3637,464,239,178.0738321995465,179.420589569161,5,11,232,1,225
3638,464,222,178.0738321995465,180.51192743764173,5,14,264,2,242
3639,464,534,178.0738321995465,179.1419501133787,5,2,84,1,70
3640,464,457,178.0738321995465,180.79056689342403,5,10,117,3,7
3641,464,615,178.0738321995465,180.67446712018142,5,3,188,3,151
3642,534,78,179.1419501133787,180.90666666666667,2,33,462,2,456
3643,534,222,179.1419501133787,180.51192743764173,2,14,318,1,312
3644,534,255,179.1419501133787,181.32462585034014,2,13,294,2,279
3645,534,457,179.1419501133787,180.79056689342403,2,10,105,2,77
3646,534,445,179.1419501133787,181.3014058956916,2,10,129,2,89
3647,534,615,179.1419501133787,180.67446712018142,2,3,104,2,81
3648,457,6,180.79056689342403,182.11410430839004,10,36,455,1,451
3649,457,271,180.79056689342403,182.50884353741498,10,16,200,2,186
3650,457,539,180.79056689342403,182.48562358276644,10,2,110,2,82
3651,457,411,180.79056689342403,183.73950113378686,10,5,135,3,46
3652,445,6,181.3014058956916,183.85560090702947,10,34,453,3,439
3653,445,271,181.3014058956916,182.50884353741498,10,16,182,1,174
3654,445,206,181.3014058956916,184.0413605442177,10,16,267,3,239
3655,445,539,181.3014058956916,182.48562358276644,10,2,107,1,94
3656,445,411,181.3014058956916,183.73950113378686,10,5,110,2,34
3657,445,454,181.3014058956916,184.20390022675738,10,13,125,3,9
3658,539,206,182.48562358276644,184.0413605442177,2,16,340,2,333
3659,539,216,182.48562358276644,184.62185941043083,2,17,336,2,323
3660,539,226,182.48562358276644,185.36489795918368,2,15,337,3,313
3661,539,411,182.48562358276644,183.73950113378686,2,5,139,1,128
3662,539,454,182.48562358276644,184.20390022675738,2,13,113,2,85
3663,411,5,183.73950113378686,185.59709750566893,5,35,414,2,406
3664,411,58,183.73950113378686,186.47945578231293,5,34,372,3,353
3665,411,226,183.73950113378686,185.36489795918368,5,15,198,2,185
3666,411,291,183.73950113378686,186.59555555555556,5,17,172,3,120
3667,411,524,183.73950113378686,185.78285714285715,5,7,143,2,113
3668,411,459,183.73950113378686,186.43301587301588,5,2,126,3,48
3669,454,5,184.20390022675738,185.59709750566893,13,35,453,1,449
3670,454,58,184.20390022675738,186.47945578231293,13,34,408,2,396
3671,454,226,184.20390022675738,185.36489795918368,13,15,233,1,228
3672,454,291,184.20390022675738,186.59555555555556,13,17,193,2,163
3673,454,524,184.20390022675738,185.78285714285715,13,7,98,2,70
3674,454,459,184.20390022675738,186.43301587301588,13,2,96,2,5
3675,524,228,185.78285714285715,187.54757369614512,7,15,306,2,296
3676,524,456,185.78285714285715,187.73333333333335,7,11,108,2,68
3677,524,445,185.78285714285715,188.24417233560092,7,10,132,2,79
3678,459,5,186.43301587301588,187.7797732426304,2,34,458,1,454
3679,459,6,186.43301587301588,188.19773242630387,2,34,459,2,453
3680,459,228,186.43301587301588,187.54757369614512,2,15,236,1,231
3681,459,245,186.43301587301588,189.01043083900228,2,15,241,3,214
3682,459,243,186.43301587301588,189.26585034013607,2,18,248,3,216
3683,459,456,186.43301587301588,187.73333333333335,2,11,56,1,3
3684,459,445,186.43301587301588,188.24417233560092,2,10,79,2,14
3685,459,424,186.43301587301588,189.08009070294784,2,4,119,3,35
3686,456,65,187.73333333333335,189.9160090702948,11,35,402,2,391
3687,456,245,187.73333333333335,189.01043083900228,11,15,218,1,211
3688,456,243,187.73333333333335,189.26585034013607,11,18,223,2,213
3689,456,208,187.73333333333335,190.68226757369615,11,16,279,3,248
3690,456,424,187.73333333333335,189.08009070294784,11,4,66,1,32
3691,445,65,188.24417233560092,189.9160090702948,10,35,387,2,380
3692,445,6,188.24417233560092,190.8215873015873,10,34,453,3,439
3693,445,243,188.24417233560092,189.26585034013607,10,18,207,1,202
3694,445,208,188.24417233560092,190.68226757369615,10,16,259,2,237
3695,445,434,188.24417233560092,191.05378684807258,10,5,121,3,11
3696,445,453,188.24417233560092,191.14666666666668,10,14,125,3,8
3697,424,6,189.08009070294784,190.8215873015873,4,34,425,2,418
3698,424,6,189.08009070294784,191.2627664399093,4,35,428,2,418
3699,424,208,189.08009070294784,190.68226757369615,4,16,227,2,216
3700,424,232,189.08009070294784,191.58784580498866,4,19,220,3,192
3701,424,434,189.08009070294784,191.05378684807258,4,5,86,2,10
3702,424,453,189.08009070294784,191.14666666666668,4,14,94,2,29
3703,434,6,191.05378684807258,192.12190476190477,5,35,430,1,428
3704,434,6,191.05378684807258,193.86340136054423,5,35,445,3,428
3705,434,244,191.05378684807258,192.30766439909297,5,15,198,1,190
3706,434,245,191.05378684807258,193.21324263038548,5,15,211,2,189
3707,434,437,191.05378684807258,192.9578231292517,5,4,82,2,3
3708,434,437,191.05378684807258,193.8401814058957,5,2,120,3,3
3709,453,6,191.14666666666668,193.86340136054423,14,35,462,3,447
3710,453,244,191.14666666666668,192.30766439909297,14,15,215,1,209
3711,453,245,191.14666666666668,193.21324263038548,14,15,226,2,208
3712,453,437,191.14666666666668,192.9578231292517,14,4,80,2,16
3713,453,437,191.14666666666668,193.8401814058957,14,2,117,3,16
3714,437,8,192.9578231292517,194.18848072562358,4,34,432,1,429
3715,437,231,192.9578231292517,194.83863945578233,4,14,221,2,206
3716,437,224,192.9578231292517,195.76743764172335,4,29,245,3,213
3717,437,454,192.9578231292517,194.6296598639456,4,9,74,2,17
3718,437,512,192.9578231292517,195.76743764172335,4,17,142,3,75
3719,437,860,192.9578231292517,195.74421768707484,4,6,440,3,423
3720,437,6,193.8401814058957,196.04607709750567,2,34,441,2,431
3721,437,65,193.8401814058957,196.324716553288,2,36,387,2,372
3722,437,224,193.8401814058957,195.76743764172335,2,29,229,2,213
3723,437,512,193.8401814058957,195.76743764172335,2,17,112,2,75
3724,437,567,193.8401814058957,196.6033560090703,2,15,176,3,130
3725,437,632,193.8401814058957,195.97641723356008,2,8,216,2,195
3726,437,698,193.8401814058957,196.62657596371884,2,9,287,3,261
3727,437,860,193.8401814058957,195.74421768707484,2,6,431,2,423
3728,454,6,194.6296598639456,196.04607709750567,9,34,452,1,448
3729,454,65,194.6296598639456,196.324716553288,9,36,396,2,389
3730,454,59,194.6296598639456,197.20707482993197,9,34,410,3,395
3731,454,224,194.6296598639456,195.76743764172335,9,29,235,1,230
3732,454,228,194.6296598639456,196.92843537414967,9,17,247,2,226
3733,454,260,194.6296598639456,197.27673469387756,9,18,225,3,194
3734,454,512,194.6296598639456,195.76743764172335,9,17,76,1,58
3735,454,567,194.6296598639456,196.6033560090703,9,15,141,2,113
3736,454,632,194.6296598639456,195.97641723356008,9,8,187,1,178
3737,454,698,194.6296598639456,196.62657596371884,9,9,259,2,244
3738,454,860,194.6296598639456,195.74421768707484,9,6,409,1,406
3739,454,947,194.6296598639456,196.13895691609977,9,9,497,2,493
3740,512,59,195.76743764172335,197.20707482993197,17,34,457,1,453
3741,512,51,195.76743764172335,198.5538321995465,17,33,476,3,461
3742,512,228,195.76743764172335,196.92843537414967,17,17,288,1,284
3743,512,260,195.76743764172335,197.27673469387756,17,18,260,2,252
3744,512,205,195.76743764172335,198.4609523809524,17,24,328,3,307
3745,512,495,195.76743764172335,198.04299319727892,17,10,99,2,17
3746,512,452,195.76743764172335,198.08943310657597,17,11,117,2,60
3747,512,662,195.76743764172335,197.74113378684808,17,8,172,2,150
3748,567,205,196.6033560090703,198.4609523809524,15,24,371,2,362
3749,567,290,196.6033560090703,199.2968707482993,15,22,300,3,277
3750,567,495,196.6033560090703,198.04299319727892,15,10,95,1,72
3751,567,452,196.6033560090703,198.08943310657597,15,11,132,1,115
3752,567,662,196.6033560090703,197.74113378684808,15,8,107,1,95
3753,567,669,196.6033560090703,199.15755102040816,15,4,150,3,102
3754,495,57,198.04299319727892,199.38975056689344,10,34,442,1,438
3755,495,73,198.04299319727892,200.75972789115647,10,35,438,3,422
3756,495,290,198.04299319727892,199.2968707482993,10,22,212,1,205
3757,495,205,198.04299319727892,200.4346485260771,10,24,308,2,290
3758,495,473,198.04299319727892,199.6219501133787,10,10,71,2,22
3759,495,488,198.04299319727892,200.4114285714286,10,13,102,2,7
3760,495,669,198.04299319727892,199.15755102040816,10,4,180,1,174
3761,495,759,198.04299319727892,200.4114285714286,10,4,283,2,264
3762,452,57,198.08943310657597,199.38975056689344,11,34,399,1,395
3763,452,73,198.08943310657597,200.75972789115647,11,35,396,3,379
3764,452,290,198.08943310657597,199.2968707482993,11,22,170,1,162
3765,452,205,198.08943310657597,200.4346485260771,11,24,267,2,247
3766,452,473,198.08943310657597,199.6219501133787,11,10,69,2,21
3767,452,488,198.08943310657597,200.4114285714286,11,13,106,2,36
3768,452,669,198.08943310657597,199.15755102040816,11,4,222,1,217
3769,452,759,198.08943310657597,200.4114285714286,11,4,323,2,307
3770,473,73,199.6219501133787,200.75972789115647,10,35,403,1,400
3771,473,36,199.6219501133787,201.82784580498867,10,33,447,2,437
3772,473,205,199.6219501133787,201.29378684807256,10,16,278,2,268
3773,473,487,199.6219501133787,201.3402267573696,10,13,75,2,14
3774,473,636,199.6219501133787,201.17768707482995,10,13,176,2,163
3775,473,832,199.6219501133787,201.36344671201815,10,4,367,2,359
3776,488,36,200.4114285714286,201.82784580498867,13,33,456,1,452
3777,488,6,200.4114285714286,202.98884353741497,13,34,495,3,482
3778,488,225,200.4114285714286,202.73342403628118,13,26,281,2,263
3779,488,517,200.4114285714286,202.61732426303854,13,14,99,2,29
3780,488,631,200.4114285714286,202.82630385487528,13,3,177,2,143
3781,487,6,201.3402267573696,202.98884353741497,13,34,486,2,481
3782,487,65,201.3402267573696,203.52290249433108,13,34,432,2,422
3783,487,57,201.3402267573696,204.2427210884354,13,35,448,3,430
3784,487,225,201.3402267573696,202.73342403628118,13,26,269,1,262
3785,487,227,201.3402267573696,203.84798185941042,13,20,282,3,260
3786,487,517,201.3402267573696,202.61732426303854,13,14,63,1,30
3787,487,610,201.3402267573696,204.0105215419501,13,10,168,3,123
3788,487,631,201.3402267573696,202.82630385487528,13,3,158,1,144
3789,487,764,201.3402267573696,204.0105215419501,13,11,300,3,277
3790,487,828,201.3402267573696,204.05696145124716,13,4,361,3,341
3791,517,57,202.61732426303854,204.2427210884354,14,35,465,2,460
3792,517,52,202.61732426303854,205.38049886621314,14,33,480,3,465
3793,517,227,202.61732426303854,203.84798185941042,14,20,295,1,290
3794,517,205,202.61732426303854,204.82321995464852,14,21,326,2,312
3795,517,242,202.61732426303854,205.241179138322,14,26,297,3,275
3796,517,610,202.61732426303854,204.0105215419501,14,10,111,1,93
3797,517,479,202.61732426303854,204.91609977324262,14,14,106,2,38
3798,517,455,202.61732426303854,205.1482993197279,14,10,125,3,62
3799,517,764,202.61732426303854,204.0105215419501,14,11,254,1,247
3800,517,635,202.61732426303854,204.86965986394557,14,9,153,2,118
3801,517,616,202.61732426303854,205.3340589569161,14,2,153,3,99
3802,517,828,202.61732426303854,204.05696145124716,14,4,317,1,311
3803,517,847,202.61732426303854,204.91609977324262,14,4,345,2,330
3804,610,242,204.0105215419501,205.241179138322,10,26,372,1,368
3805,610,205,204.0105215419501,206.88979591836735,10,22,424,3,405
3806,610,455,204.0105215419501,205.1482993197279,10,10,163,1,155
3807,610,616,204.0105215419501,205.3340589569161,10,2,57,1,6
3808,610,617,204.0105215419501,206.16997732426304,10,11,93,2,7
3809,479,57,204.91609977324262,206.58793650793652,14,36,428,2,422
3810,479,72,204.91609977324262,207.79537414965986,14,33,425,3,407
3811,479,205,204.91609977324262,206.88979591836735,14,22,287,2,274
3812,479,245,204.91609977324262,207.07555555555555,14,17,252,2,234
3813,479,469,204.91609977324262,207.05233560090704,14,16,93,2,10
3814,479,448,204.91609977324262,207.0987755102041,14,14,99,2,31
3815,479,617,204.91609977324262,206.16997732426304,14,11,148,1,138
3816,479,641,204.91609977324262,207.07555555555555,14,12,187,2,162
3817,455,57,205.1482993197279,206.58793650793652,10,36,403,1,398
3818,455,72,205.1482993197279,207.79537414965986,10,33,400,3,383
3819,455,205,205.1482993197279,206.88979591836735,10,22,261,2,250
3820,455,245,205.1482993197279,207.07555555555555,10,17,226,2,210
3821,455,469,205.1482993197279,207.05233560090704,10,16,83,2,14
3822,455,448,205.1482993197279,207.0987755102041,10,14,84,2,7
3823,455,617,205.1482993197279,206.16997732426304,10,11,168,1,162
3824,455,641,205.1482993197279,207.07555555555555,10,12,204,2,186
3825,469,39,207.05233560090704,208.84027210884355,16,35,437,2,430
3826,469,64,207.05233560090704,209.6065306122449,16,35,420,3,405
3827,469,205,207.05233560090704,208.37587301587303,16,19,270,1,264
3828,469,254,207.05233560090704,209.9548299319728,16,19,249,3,215
3829,469,456,207.05233560090704,208.60807256235827,16,8,68,2,13
3830,469,497,207.05233560090704,209.81551020408165,16,12,122,3,28
3831,469,787,207.05233560090704,208.32943310657598,16,4,323,1,318
3832,469,632,207.05233560090704,209.7922902494331,16,9,201,3,163
3833,469,892,207.05233560090704,209.7922902494331,16,2,439,3,423
3834,448,39,207.0987755102041,208.84027210884355,14,35,416,2,409
3835,448,64,207.0987755102041,209.6065306122449,14,35,399,3,384
3836,448,205,207.0987755102041,208.37587301587303,14,19,249,1,243
3837,448,254,207.0987755102041,209.9548299319728,14,19,230,3,194
3838,448,456,207.0987755102041,208.60807256235827,14,8,65,2,8
3839,448,497,207.0987755102041,209.81551020408165,14,12,127,3,49
3840,448,787,207.0987755102041,208.32943310657598,14,4,343,1,339
3841,448,632,207.0987755102041,209.7922902494331,14,9,218,3,184
3842,448,892,207.0987755102041,209.7922902494331,14,2,459,3,444
3843,456,64,208.60807256235827,210.8604081632653,8,35,404,2,392
3844,456,14,208.60807256235827,211.5570068027211,8,35,460,3,442
3845,456,254,208.60807256235827,209.9548299319728,8,19,210,1,202
3846,456,222,208.60807256235827,210.46566893424037,8,25,247,2,234
3847,456,220,208.60807256235827,211.30158730158732,8,22,263,3,236
3848,456,497,208.60807256235827,209.81551020408165,8,12,66,1,41
3849,456,487,208.60807256235827,210.55854875283447,8,13,90,2,31
3850,456,632,208.60807256235827,209.7922902494331,8,9,183,1,176
3851,456,619,208.60807256235827,210.53532879818596,8,8,183,2,163
3852,456,892,208.60807256235827,209.7922902494331,8,2,439,1,436
3853,497,64,209.81551020408165,210.8604081632653,12,35,435,1,433
3854,497,14,209.81551020408165,211.5570068027211,12,35,489,2,483
3855,497,220,209.81551020408165,211.30158730158732,12,22,284,1,277
3856,497,236,209.81551020408165,212.23038548752834,12,25,281,2,261
3857,497,564,209.81551020408165,211.62666666666667,12,14,103,2,67
3858,497,455,209.81551020408165,212.11428571428573,12,9,108,2,42
3859,497,619,209.81551020408165,211.60344671201815,12,9,144,2,122
3860,487,58,210.55854875283447,212.9966439909297,13,35,442,2,429
3861,487,236,210.55854875283447,212.23038548752834,13,25,261,2,251
3862,487,205,210.55854875283447,213.5307029478458,13,31,310,3,282
3863,487,564,210.55854875283447,211.62666666666667,13,14,90,1,77
3864,487,455,210.55854875283447,212.11428571428573,13,9,74,2,32
3865,487,572,210.55854875283447,213.36816326530612,13,14,148,3,85
3866,487,619,210.55854875283447,211.60344671201815,13,9,139,1,132
3867,487,618,210.55854875283447,212.8805442176871,13,4,165,2,131
3868,487,635,210.55854875283447,213.29850340136056,13,14,189,3,148
3869,487,903,210.55854875283447,213.36816326530612,13,9,433,3,416
3870,564,205,211.62666666666667,213.5307029478458,14,31,368,2,359
3871,564,572,211.62666666666667,213.36816326530612,14,14,75,2,8
3872,564,618,211.62666666666667,212.8805442176871,14,4,76,1,54
3873,564,635,211.62666666666667,213.29850340136056,14,14,101,2,71
3874,564,903,211.62666666666667,213.36816326530612,14,9,347,2,339
3875,455,10,212.11428571428573,213.83256235827665,9,33,451,2,445
3876,455,51,212.11428571428573,214.11120181405897,9,34,413,2,404
3877,455,205,212.11428571428573,213.5307029478458,9,31,257,1,250
3878,455,240,212.11428571428573,215.04,9,18,249,3,215
3879,455,572,212.11428571428573,213.36816326530612,9,14,129,1,117
3880,455,530,212.11428571428573,215.06321995464853,9,10,147,3,75
3881,455,635,212.11428571428573,213.29850340136056,9,14,187,1,180
3882,455,618,212.11428571428573,215.06321995464853,9,3,207,3,163
3883,455,903,212.11428571428573,213.36816326530612,9,9,451,1,448
3884,572,240,213.36816326530612,215.04,14,18,340,2,332
3885,572,205,213.36816326530612,215.34185941043086,14,17,377,2,367
3886,572,247,213.36816326530612,216.13133786848073,14,16,346,3,325
3887,572,530,213.36816326530612,215.06321995464853,14,10,84,2,42
3888,572,525,213.36816326530612,215.99201814058958,14,10,122,3,47
3889,572,526,213.36816326530612,216.22421768707483,14,11,131,3,46
3890,572,618,213.36816326530612,215.06321995464853,14,3,86,2,46
3891,572,700,213.36816326530612,215.99201814058958,14,5,171,3,128
3892,530,48,215.06321995464853,217.06013605442178,10,34,490,2,482
3893,530,247,215.06321995464853,216.13133786848073,10,16,287,1,283
3894,530,263,215.06321995464853,217.57097505668935,10,21,288,3,267
3895,530,526,215.06321995464853,216.22421768707483,10,11,50,1,4
3896,530,613,215.06321995464853,217.73351473922904,10,15,142,3,83
3897,530,619,215.06321995464853,216.4564172335601,10,6,107,1,89
3898,530,654,215.06321995464853,217.75673469387755,10,13,170,3,124
3899,530,831,215.06321995464853,217.73351473922904,10,3,322,3,301
3900,525,48,215.99201814058958,217.06013605442178,10,34,479,1,477
3901,525,43,215.99201814058958,218.05859410430838,10,35,490,2,482
3902,525,43,215.99201814058958,218.22113378684807,10,35,491,2,482
3903,525,263,215.99201814058958,217.57097505668935,10,21,271,2,262
3904,525,613,215.99201814058958,217.73351473922904,10,15,116,2,88
3905,525,526,215.99201814058958,218.45333333333335,10,10,106,2,1
3906,525,654,215.99201814058958,217.75673469387755,10,13,150,2,129
3907,525,634,215.99201814058958,218.5229931972789,10,3,154,3,109
3908,525,831,215.99201814058958,217.73351473922904,10,3,315,2,306
3909,526,43,216.22421768707483,218.05859410430838,11,35,489,2,483
3910,526,43,216.22421768707483,218.22113378684807,11,35,491,2,483
3911,526,263,216.22421768707483,217.57097505668935,11,21,269,1,263
3912,526,232,216.22421768707483,219.01061224489797,11,15,318,3,294
3913,526,613,216.22421768707483,217.73351473922904,11,15,109,2,87
3914,526,654,216.22421768707483,217.75673469387755,11,13,144,2,128
3915,526,634,216.22421768707483,218.5229931972789,11,3,147,2,108
3916,526,831,216.22421768707483,217.73351473922904,11,3,312,2,305
3917,613,232,217.73351473922904,219.01061224489797,15,15,385,1,381
3918,613,312,217.73351473922904,219.80009070294784,15,14,314,2,301
3919,613,217,217.73351473922904,220.6360090702948,15,14,415,3,396
3920,613,523,217.73351473922904,219.33569160997732,15,12,113,2,90
3921,613,526,217.73351473922904,220.35736961451246,15,4,143,3,87
3922,613,653,217.73351473922904,219.80009070294784,15,11,98,2,40
3923,613,840,217.73351473922904,219.80009070294784,15,3,244,2,227
3924,526,68,218.45333333333335,219.54467120181405,10,30,460,1,458
3925,526,54,218.45333333333335,220.40380952380954,10,32,479,2,472
3926,526,312,218.45333333333335,219.80009070294784,10,14,222,1,214
3927,526,217,218.45333333333335,220.6360090702948,10,14,323,2,309
3928,526,653,218.45333333333335,219.80009070294784,10,11,140,1,127
3929,526,840,218.45333333333335,219.80009070294784,10,3,319,1,314
3930,523,54,219.33569160997732,220.40380952380954,12,32,471,1,469
3931,523,38,219.33569160997732,221.47192743764174,12,33,494,2,485
3932,523,39,219.33569160997732,222.21496598639456,12,30,500,3,484
3933,523,217,219.33569160997732,220.6360090702948,12,14,311,1,306
3934,523,232,219.33569160997732,221.72734693877553,12,15,309,2,291
3935,523,329,219.33569160997732,222.14530612244897,12,12,229,3,194
3936,523,526,219.33569160997732,220.35736961451246,12,4,44,1,3
3937,523,524,219.33569160997732,222.05242630385487,12,11,117,3,1
3938,523,525,219.33569160997732,222.2381859410431,12,8,125,3,2
3939,523,651,219.33569160997732,222.02920634920636,12,3,173,3,128
3940,526,38,220.35736961451246,221.47192743764174,4,33,490,1,488
3941,526,39,220.35736961451246,222.21496598639456,4,30,494,2,487
3942,526,232,220.35736961451246,221.72734693877553,4,15,300,1,294
3943,526,329,220.35736961451246,222.14530612244897,4,12,212,2,197
3944,526,232,220.35736961451246,223.25986394557825,4,7,319,3,294
3945,526,524,220.35736961451246,222.05242630385487,4,11,73,2,2
3946,526,525,220.35736961451246,222.2381859410431,4,8,81,2,1
3947,526,651,220.35736961451246,222.02920634920636,4,3,144,2,125
3948,524,33,222.05242630385487,223.91002267573697,11,20,497,2,491
3949,524,26,222.05242630385487,224.69950113378684,11,20,511,3,498
3950,524,232,222.05242630385487,223.25986394557825,11,7,297,1,292
3951,524,345,222.05242630385487,224.4673015873016,11,10,207,2,179
3952,525,33,222.2381859410431,223.91002267573697,8,20,497,2,492
3953,525,26,222.2381859410431,224.69950113378684,8,20,510,2,499
3954,525,34,222.2381859410431,225.2103401360544,8,22,507,3,491
3955,525,232,222.2381859410431,223.25986394557825,8,7,296,1,293
3956,525,345,222.2381859410431,224.4673015873016,8,10,204,2,180
3957,525,349,222.2381859410431,225.1174603174603,8,10,215,3,176
3958,434,44,226.71963718820862,228.27537414965988,2,19,396,2,390
3959,434,33,226.71963718820862,229.1112925170068,2,11,414,2,401
3960,434,236,226.71963718820862,227.81097505668936,2,7,204,1,198
3961,637,206,14.280272108843537,15.603809523809524,3,9,435,1,431
3962,637,205,14.280272108843537,16.04498866213152,3,10,439,2,432
3963,637,437,14.280272108843537,15.301950113378686,3,4,205,1,200
3964,755,480,17.531065759637187,18.599183673469387,6,6,279,1,275
3965,755,511,17.531065759637187,19.156462585034014,6,4,254,2,244
3966,755,494,17.531065759637187,20.48,6,5,290,3,261
3967,755,699,17.531065759637187,18.599183673469387,6,3,72,1,56
3968,699,319,18.599183673469387,20.82829931972789,3,10,392,2,380
3969,699,494,18.599183673469387,20.48,3,5,220,2,205
3970,699,774,18.599183673469387,21.5481179138322,3,4,147,3,75
3971,774,521,21.5481179138322,23.08063492063492,4,10,261,2,253
3972,774,536,21.5481179138322,24.45061224489796,4,5,269,3,238
3973,774,696,21.5481179138322,24.380952380952383,4,9,145,3,78
3974,696,218,24.380952380952383,26.122448979591837,9,13,484,2,478
3975,696,460,24.380952380952383,25.541950113378686,9,8,241,1,236
3976,696,449,24.380952380952383,26.28498866213152,9,4,260,2,247
3977,696,643,24.380952380952383,26.33142857142857,9,6,99,2,53
3978,696,947,24.380952380952383,26.447528344671202,9,4,266,2,251
3979,623,277,25.170430839002268,27.794285714285714,5,8,364,3,346
3980,623,449,25.170430839002268,26.28498866213152,5,4,180,1,174
3981,623,643,25.170430839002268,26.33142857142857,5,6,54,1,20
3982,623,947,25.170430839002268,26.447528344671202,5,4,329,1,324
3983,643,277,26.33142857142857,27.794285714285714,6,8,371,1,366
3984,643,277,26.33142857142857,28.23546485260771,6,9,375,2,366
3985,643,410,26.33142857142857,29.071383219954647,6,3,261,3,233
3986,616,231,39.3578231292517,41.77269841269841,5,21,399,2,385
3987,616,217,39.3578231292517,42.237097505668935,5,20,418,3,399
3988,616,463,39.3578231292517,40.542040816326534,5,9,161,1,153
3989,616,516,39.3578231292517,41.9352380952381,5,9,149,3,100
3990,616,583,39.3578231292517,42.074557823129254,5,7,122,3,33
3991,616,617,39.3578231292517,40.51882086167801,5,3,50,1,1
3992,616,738,39.3578231292517,41.95845804988662,5,10,166,3,122
3993,616,657,39.3578231292517,42.09777777777778,5,7,125,3,41
3994,616,923,39.3578231292517,41.98167800453515,5,4,327,3,307
3995,616,835,39.3578231292517,42.074557823129254,5,6,248,3,219
3996,617,231,40.51882086167801,41.77269841269841,3,21,390,1,386
3997,617,217,40.51882086167801,42.237097505668935,3,20,407,2,400
3998,617,317,40.51882086167801,43.18911564625851,3,14,321,3,300
3999,617,516,40.51882086167801,41.9352380952381,3,9,118,1,101
4000,617,583,40.51882086167801,42.074557823129254,3,7,75,2,34
4001,617,738,40.51882086167801,41.95845804988662,3,10,136,1,121
4002,617,657,40.51882086167801,42.09777777777778,3,7,79,2,40
4003,617,923,40.51882086167801,41.98167800453515,3,4,312,1,306
4004,617,835,40.51882086167801,42.074557823129254,3,6,228,2,218
4005,738,317,41.95845804988662,43.18911564625851,10,14,424,1,421
4006,738,243,41.95845804988662,44.30367346938775,10,11,505,2,495
4007,738,484,41.95845804988662,43.86249433106576,10,11,267,2,254
4008,738,580,41.95845804988662,44.90739229024943,10,9,203,3,158
4009,738,643,41.95845804988662,44.860952380952384,10,7,157,3,95
4010,738,823,41.95845804988662,44.93061224489796,10,2,154,3,85
4011,657,317,42.09777777777778,43.18911564625851,7,14,343,1,340
4012,657,243,42.09777777777778,44.30367346938775,7,11,425,2,414
4013,657,484,42.09777777777778,43.86249433106576,7,11,189,2,173
4014,657,580,42.09777777777778,44.90739229024943,7,9,143,3,77
4015,657,643,42.09777777777778,44.860952380952384,7,7,120,3,14
4016,657,823,42.09777777777778,44.93061224489796,7,2,206,3,166
4017,643,209,44.860952380952384,46.95074829931973,7,16,443,2,434
4018,643,241,44.860952380952384,47.3687074829932,7,14,416,3,402
4019,643,523,44.860952380952384,46.9275283446712,7,6,149,2,120
4020,643,501,44.860952380952384,47.484807256235825,7,8,181,3,142
4021,643,623,44.860952380952384,46.068390022675736,7,2,56,1,20
4022,643,641,44.860952380952384,47.50802721088436,7,7,114,3,2
4023,648,209,45.39501133786848,46.95074829931973,4,16,444,2,439
4024,648,241,45.39501133786848,47.3687074829932,4,14,416,2,407
4025,648,523,45.39501133786848,46.9275283446712,4,6,141,2,125
4026,648,501,45.39501133786848,47.484807256235825,4,8,172,2,147
4027,648,641,45.39501133786848,47.50802721088436,4,7,91,2,7
4028,623,241,46.068390022675736,47.3687074829932,2,14,386,1,382
4029,623,277,46.068390022675736,48.66902494331066,2,12,364,3,346
4030,623,501,46.068390022675736,47.484807256235825,2,8,136,1,122
4031,623,510,46.068390022675736,48.761904761904766,2,10,162,3,113
4032,623,641,46.068390022675736,47.50802721088436,2,7,65,1,18
4033,623,658,46.068390022675736,48.78512471655329,2,9,122,3,35
4034,623,829,46.068390022675736,48.83156462585034,2,2,238,3,206
4035,641,277,47.50802721088436,48.66902494331066,7,12,367,1,364
4036,641,225,47.50802721088436,49.179863945578234,7,11,422,2,416
4037,641,510,47.50802721088436,48.761904761904766,7,10,142,1,131
4038,641,601,47.50802721088436,49.179863945578234,7,6,82,2,40
4039,641,658,47.50802721088436,48.78512471655329,7,9,58,1,17
4040,641,639,47.50802721088436,49.179863945578234,7,4,72,2,2
4041,641,829,47.50802721088436,48.83156462585034,7,2,196,1,188
4042,658,227,48.78512471655329,50.944580498866216,9,13,441,2,431
4043,658,236,48.78512471655329,51.478639455782314,9,11,438,3,422
4044,658,421,48.78512471655329,50.92136054421769,9,9,254,2,237
4045,658,526,48.78512471655329,51.06068027210885,9,9,164,2,132
4046,658,642,48.78512471655329,50.96780045351474,9,5,95,2,16
4047,658,615,48.78512471655329,51.06068027210885,9,2,107,2,43
4048,658,901,48.78512471655329,50.874920634920635,9,5,259,2,243
4049,639,227,49.179863945578234,50.944580498866216,4,13,419,2,412
4050,639,236,49.179863945578234,51.478639455782314,4,11,415,2,403
4051,639,421,49.179863945578234,50.92136054421769,4,9,231,2,218
4052,639,526,49.179863945578234,51.06068027210885,4,9,139,2,113
4053,639,642,49.179863945578234,50.96780045351474,4,5,77,2,3
4054,639,615,49.179863945578234,51.06068027210885,4,2,84,2,24
4055,639,901,49.179863945578234,50.874920634920635,4,5,272,2,262
4056,642,215,50.96780045351474,52.848616780045354,5,16,435,2,427
4057,642,229,50.96780045351474,53.173696145124715,5,13,424,2,413
4058,642,556,50.96780045351474,52.68607709750567,5,4,113,2,86
4059,642,484,50.96780045351474,53.498775510204084,5,7,192,3,158
4060,642,631,50.96780045351474,53.661315192743764,5,2,117,3,11
4061,615,215,51.06068027210885,52.848616780045354,2,16,407,2,400
4062,615,229,51.06068027210885,53.173696145124715,2,13,397,2,386
4063,615,556,51.06068027210885,52.68607709750567,2,4,92,2,59
4064,615,484,51.06068027210885,53.498775510204084,2,7,168,2,131
4065,615,631,51.06068027210885,53.661315192743764,2,2,113,3,16
4066,631,260,53.661315192743764,55.843990929705214,2,19,383,2,371
4067,631,227,53.661315192743764,56.14585034013606,2,13,418,2,404
4068,631,512,53.661315192743764,54.9384126984127,2,6,131,1,119
4069,631,520,53.661315192743764,55.867210884353746,2,10,146,2,111
4070,631,519,53.661315192743764,56.14585034013606,2,5,155,2,112
4071,631,627,53.661315192743764,54.91519274376417,2,2,54,1,4
4072,627,227,54.91519274376417,56.14585034013606,2,13,403,1,400
4073,627,245,54.91519274376417,57.74802721088435,2,17,401,3,382
4074,627,519,54.91519274376417,56.14585034013606,2,5,120,1,108
4075,709,264,57.95700680272109,59.419863945578236,2,12,449,1,445
4076,709,234,57.95700680272109,60.20934240362812,2,11,485,2,475
4077,709,473,57.95700680272109,59.582403628117916,2,5,246,2,236
4078,709,599,57.95700680272109,60.46476190476191,2,5,154,3,110
4079,709,653,57.95700680272109,59.582403628117916,2,5,90,2,56
4080,709,685,57.95700680272109,60.48798185941043,2,9,112,3,24
4081,782,473,58.51428571428571,59.582403628117916,5,5,312,1,309
4082,782,599,58.51428571428571,60.46476190476191,5,5,201,2,183
4083,782,653,58.51428571428571,59.582403628117916,5,5,137,1,129
4084,782,685,58.51428571428571,60.48798185941043,5,9,129,2,97
4085,782,653,58.51428571428571,61.13814058956916,5,6,171,3,129
4086,653,219,59.582403628117916,61.78829931972789,5,16,444,2,434
4087,653,510,59.582403628117916,61.811519274376415,5,8,172,2,143
4088,653,611,59.582403628117916,62.415238095238095,5,8,129,3,42
4089,653,627,59.582403628117916,62.415238095238095,5,7,125,3,26
4090,685,219,60.48798185941043,61.78829931972789,9,16,469,1,466
4091,685,244,60.48798185941043,62.62421768707483,9,14,450,2,441
4092,685,242,60.48798185941043,63.25115646258504,9,18,459,3,443
4093,685,510,60.48798185941043,61.811519274376415,9,8,184,1,175
4094,685,611,60.48798185941043,62.415238095238095,9,8,111,2,74
4095,685,627,60.48798185941043,62.415238095238095,9,7,101,2,58
4096,685,697,60.48798185941043,63.41369614512472,9,2,127,3,12
4097,653,244,61.13814058956916,62.62421768707483,6,14,414,1,409
4098,653,242,61.13814058956916,63.25115646258504,6,18,421,2,411
4099,653,611,61.13814058956916,62.415238095238095,6,8,69,1,42
4100,653,585,61.13814058956916,63.901315192743766,6,5,137,3,68
4101,653,627,61.13814058956916,62.415238095238095,6,7,61,1,26
4102,653,697,61.13814058956916,63.41369614512472,6,2,107,2,44
4103,627,226,62.415238095238095,64.17995464852608,7,9,408,2,401
4104,627,261,62.415238095238095,65.24807256235827,7,10,386,3,366
4105,627,585,62.415238095238095,63.901315192743766,7,5,77,1,42
4106,627,537,62.415238095238095,64.57469387755103,7,10,129,2,90
4107,627,523,62.415238095238095,65.03909297052154,7,4,154,3,104
4108,627,683,62.415238095238095,64.78367346938775,7,5,116,2,56
4109,697,261,63.41369614512472,65.24807256235827,2,10,443,2,436
4110,697,537,63.41369614512472,64.57469387755103,2,10,168,1,160
4111,697,523,63.41369614512472,65.03909297052154,2,4,188,2,174
4112,697,683,63.41369614512472,64.78367346938775,2,5,61,1,14
4113,683,253,64.78367346938775,66.71092970521542,5,11,438,2,430
4114,683,277,64.78367346938775,67.38430839002268,5,11,421,3,406
4115,683,525,64.78367346938775,66.98956916099773,5,5,184,2,158
4116,683,475,64.78367346938775,67.47718820861678,5,7,238,3,208
4117,683,655,64.78367346938775,67.47718820861678,5,8,119,3,28
4118,655,226,67.47718820861678,68.82394557823129,8,13,433,1,429
4119,655,219,67.47718820861678,69.93850340136055,8,16,449,2,436
4120,655,467,67.47718820861678,68.82394557823129,8,8,197,1,188
4121,655,649,67.47718820861678,68.61496598639457,8,6,49,1,6
4122,649,219,68.61496598639457,69.93850340136055,6,16,434,1,430
4123,649,256,68.61496598639457,70.54222222222222,6,28,402,2,393
4124,649,512,68.61496598639457,70.54222222222222,6,16,160,2,137
4125,649,513,68.61496598639457,71.02984126984127,6,11,171,2,136
4126,649,815,68.61496598639457,70.70476190476191,6,9,189,2,166
4127,649,632,68.61496598639457,71.4942403628118,6,9,125,3,17
4128,649,846,68.61496598639457,70.6118820861678,6,8,215,2,197
4129,649,959,68.61496598639457,71.37814058956916,6,3,332,3,310
4130,815,484,70.70476190476191,72.95709750566894,9,9,345,2,331
4131,815,486,70.70476190476191,73.04997732426304,9,7,344,2,329
4132,815,701,70.70476190476191,72.51591836734694,9,5,138,2,114
4133,632,205,71.4942403628118,72.60879818594104,9,19,430,1,427
4134,632,257,71.4942403628118,73.30539682539683,9,23,383,2,375
4135,632,233,71.4942403628118,74.32707482993197,9,21,417,3,399
4136,632,484,71.4942403628118,72.95709750566894,9,9,161,1,148
4137,632,486,71.4942403628118,73.04997732426304,9,7,161,2,146
4138,632,701,71.4942403628118,72.51591836734694,9,5,82,1,69
4139,632,668,71.4942403628118,73.93233560090704,9,2,111,2,36
4140,701,233,72.51591836734694,74.32707482993197,5,21,474,2,468
4141,701,243,72.51591836734694,75.20943310657597,5,20,472,3,458
4142,701,512,72.51591836734694,74.7914739229025,5,8,213,2,189
4143,701,488,72.51591836734694,75.20943310657597,5,11,243,3,213
4144,701,668,72.51591836734694,73.93233560090704,5,2,69,1,33
4145,668,243,73.93233560090704,75.20943310657597,2,20,429,1,425
4146,668,488,73.93233560090704,75.20943310657597,2,11,188,1,180
4147,668,497,73.93233560090704,76.16145124716553,2,10,196,2,171
4148,668,665,73.93233560090704,75.9524716553288,2,4,87,2,3
4149,668,642,73.93233560090704,76.20789115646258,2,6,101,2,26
4150,668,924,73.93233560090704,76.16145124716553,2,2,273,2,256
4151,665,225,75.9524716553288,77.53142857142858,4,30,445,2,440
4152,665,227,75.9524716553288,78.25124716553289,4,23,449,2,438
4153,665,516,75.9524716553288,77.41532879818594,4,12,162,1,149
4154,665,587,75.9524716553288,78.85496598639456,4,11,147,3,78
4155,665,649,75.9524716553288,78.76208616780046,4,9,122,3,16
4156,665,934,75.9524716553288,78.83174603174604,4,3,296,3,269
4157,642,225,76.20789115646258,77.53142857142858,6,30,421,1,417
4158,642,227,76.20789115646258,78.25124716553289,6,23,424,2,415
4159,642,516,76.20789115646258,77.41532879818594,6,12,136,1,126
4160,642,587,76.20789115646258,78.85496598639456,6,11,127,3,55
4161,642,649,76.20789115646258,78.76208616780046,6,9,110,3,7
4162,642,934,76.20789115646258,78.83174603174604,6,3,313,3,292
4163,649,240,78.76208616780046,79.92308390022676,9,29,412,1,409
4164,649,242,78.76208616780046,80.0391836734694,9,30,411,1,407
4165,649,516,78.76208616780046,80.92154195011338,9,16,162,2,133
4166,649,679,78.76208616780046,80.89832199546485,9,8,97,2,30
4167,635,225,79.64444444444445,81.75746031746031,9,24,420,2,410
4168,635,243,79.64444444444445,82.03609977324263,9,20,405,2,392
4169,635,516,79.64444444444445,80.92154195011338,9,16,131,1,119
4170,635,485,79.64444444444445,81.87356009070295,9,14,178,2,150
4171,635,484,79.64444444444445,82.08253968253969,9,6,184,2,151
4172,635,679,79.64444444444445,80.89832199546485,9,8,70,1,44
4173,635,622,79.64444444444445,81.85034013605443,9,9,96,2,13
4174,635,835,79.64444444444445,81.87356009070295,9,2,222,2,200
4175,679,243,80.89832199546485,82.03609977324263,8,20,439,1,436
4176,679,205,80.89832199546485,83.17387755102041,8,19,484,2,474
4177,679,484,80.89832199546485,82.08253968253969,8,6,202,1,195
4178,679,505,80.89832199546485,83.26675736961451,8,7,202,2,174
4179,679,953,80.89832199546485,83.08099773242631,8,2,290,2,274
4180,622,205,81.85034013605443,83.17387755102041,9,19,421,1,417
4181,622,505,81.85034013605443,83.26675736961451,9,7,132,1,117
4182,622,478,81.85034013605443,84.65995464852608,9,14,188,3,144
4183,622,632,81.85034013605443,84.65995464852608,9,11,121,3,10
4184,622,953,81.85034013605443,83.08099773242631,9,2,335,1,331
4185,622,916,81.85034013605443,84.54385487528344,9,7,316,3,294
4186,632,205,84.65995464852608,86.49433106575964,11,18,434,2,427
4187,632,236,84.65995464852608,87.05160997732426,11,18,409,2,396
4188,632,511,84.65995464852608,86.44789115646259,11,13,143,2,121
4189,632,648,84.65995464852608,86.44789115646259,11,7,79,2,16
4190,632,205,85.33333333333333,86.49433106575964,9,18,430,1,427
4191,632,236,85.33333333333333,87.05160997732426,9,18,403,2,396
4192,632,227,85.33333333333333,88.25904761904762,9,26,424,3,405
4193,632,511,85.33333333333333,86.44789115646259,9,13,130,1,121
4194,632,492,85.33333333333333,88.00362811791383,9,12,181,3,140
4195,632,483,85.33333333333333,88.25904761904762,9,14,195,3,149
4196,632,648,85.33333333333333,86.44789115646259,9,7,51,1,16
4197,632,690,85.33333333333333,88.00362811791383,9,9,129,3,58
4198,632,644,85.33333333333333,88.07328798185941,9,11,119,3,12
4199,632,909,85.33333333333333,88.00362811791383,9,2,300,3,277
4200,632,886,85.33333333333333,88.09650793650793,9,3,280,3,254
4201,648,227,86.44789115646259,88.25904761904762,7,26,428,2,421
4202,648,261,86.44789115646259,89.11818594104308,7,17,404,3,387
4203,648,492,86.44789115646259,88.00362811791383,7,12,170,2,156
4204,648,483,86.44789115646259,88.25904761904762,7,14,183,2,165
4205,648,599,86.44789115646259,89.39682539682539,7,11,136,3,49
4206,648,690,86.44789115646259,88.00362811791383,7,9,79,2,42
4207,648,644,86.44789115646259,88.07328798185941,7,11,70,2,4
4208,648,675,86.44789115646259,89.42004535147393,7,10,131,3,27
4209,648,909,86.44789115646259,88.00362811791383,7,2,269,2,261
4210,648,886,86.44789115646259,88.09650793650793,7,3,248,2,238
4211,690,261,88.00362811791383,89.11818594104308,9,17,432,1,429
4212,690,253,88.00362811791383,90.25596371882087,9,16,448,2,437
4213,690,599,88.00362811791383,89.39682539682539,9,11,109,1,91
4214,690,528,88.00362811791383,90.69714285714286,9,8,199,3,162
4215,690,675,88.00362811791383,89.42004535147393,9,10,63,1,15
4216,644,261,88.07328798185941,89.11818594104308,11,17,386,1,383
4217,644,253,88.07328798185941,90.25596371882087,11,16,402,2,391
4218,644,599,88.07328798185941,89.39682539682539,11,11,73,1,45
4219,644,528,88.07328798185941,90.69714285714286,11,8,162,3,116
4220,644,675,88.07328798185941,89.42004535147393,11,10,66,1,31
4221,675,232,89.42004535147393,91.78848072562359,10,20,455,2,443
4222,675,528,89.42004535147393,90.69714285714286,10,8,157,1,147
4223,675,529,89.42004535147393,91.18476190476191,10,13,165,2,146
4224,675,616,89.42004535147393,91.18476190476191,10,3,96,2,59
4225,616,231,91.18476190476191,92.53151927437642,3,18,389,1,385
4226,616,205,91.18476190476191,93.59963718820862,3,18,424,2,411
4227,616,567,91.18476190476191,92.48507936507937,3,13,74,1,49
4228,616,439,91.18476190476191,93.25133786848073,3,8,198,2,177
4229,616,647,91.18476190476191,92.48507936507937,3,11,64,1,31
4230,616,856,91.18476190476191,92.46185941043085,3,2,246,1,240
4231,647,205,92.48507936507937,93.59963718820862,11,18,445,1,442
4232,647,220,92.48507936507937,94.8302947845805,11,15,439,2,427
4233,647,254,92.48507936507937,95.17859410430839,11,15,410,3,393
4234,647,482,92.48507936507937,94.57487528344672,11,14,188,2,165
4235,647,664,92.48507936507937,94.57487528344672,11,13,92,2,17
4236,647,828,92.48507936507937,94.57487528344672,11,2,202,2,181
4237,664,353,94.57487528344672,96.20027210884354,13,17,319,2,311
4238,664,232,94.57487528344672,97.500589569161,13,15,450,3,432
4239,664,520,94.57487528344672,95.75909297052155,13,4,153,1,144
4240,664,464,94.57487528344672,96.59501133786848,13,8,218,2,200
4241,664,482,94.57487528344672,97.05941043083901,13,4,211,2,182
4242,664,618,94.57487528344672,96.71111111111111,13,3,103,2,46
4243,618,216,96.71111111111111,98.82412698412699,3,18,412,2,402
4244,618,216,96.71111111111111,99.56716553287983,3,16,420,3,402
4245,618,488,96.71111111111111,98.47582766439909,3,7,151,2,130
4246,618,429,96.71111111111111,99.6368253968254,3,15,227,3,189
4247,689,340,101.84272108843538,103.72353741496599,4,21,358,2,349
4248,689,254,101.84272108843538,104.79165532879819,4,16,453,3,435
4249,689,519,101.84272108843538,102.91083900226758,4,11,176,1,170
4250,689,520,101.84272108843538,103.3752380952381,4,9,181,2,169
4251,689,520,101.84272108843538,104.25759637188209,4,7,198,2,169
4252,689,683,101.84272108843538,103.05015873015873,4,3,52,1,6
4253,689,733,101.84272108843538,104.32725623582766,4,4,116,2,44
4254,689,254,102.72507936507937,104.79165532879819,2,16,444,2,435
4255,689,520,102.72507936507937,104.25759637188209,2,7,181,2,169
4256,689,520,102.72507936507937,105.55791383219955,2,15,208,3,169
4257,689,733,102.72507936507937,104.32725623582766,2,4,82,2,44
4258,683,254,103.05015873015873,104.79165532879819,3,16,436,2,429
4259,683,309,103.05015873015873,105.74367346938776,3,19,392,3,374
4260,683,520,103.05015873015873,104.25759637188209,3,7,171,1,163
4261,683,520,103.05015873015873,105.55791383219955,3,15,196,3,163
4262,683,733,103.05015873015873,104.32725623582766,3,4,74,1,50
4263,733,309,104.32725623582766,105.74367346938776,4,19,428,1,424
4264,733,309,104.32725623582766,106.62603174603174,4,20,435,2,424
4265,733,520,104.32725623582766,105.55791383219955,4,15,219,1,213
4266,733,433,104.32725623582766,106.53315192743764,4,11,315,2,300
4267,733,459,104.32725623582766,107.25297052154195,4,14,302,3,274
4268,733,618,104.32725623582766,106.62603174603174,4,3,152,2,115
4269,618,337,106.62603174603174,107.99600907029479,3,15,287,1,281
4270,618,307,106.62603174603174,108.8087074829932,3,21,325,2,311
4271,618,426,106.62603174603174,108.32108843537415,3,12,205,2,192
4272,618,625,106.62603174603174,107.64770975056689,3,2,45,1,7
4273,625,307,107.64770975056689,108.8087074829932,2,21,322,1,318
4274,625,308,107.64770975056689,109.62140589569161,2,26,328,2,317
4275,625,518,107.64770975056689,109.8768253968254,2,10,144,2,107
4276,625,615,107.64770975056689,109.69106575963718,2,6,89,2,10
4277,625,617,107.64770975056689,110.48054421768708,2,7,122,3,8
4278,615,307,109.69106575963718,110.89850340136054,6,20,312,1,308
4279,615,307,109.69106575963718,111.78086167800454,6,17,321,2,308
4280,615,244,109.69106575963718,112.08272108843538,6,15,385,2,371
4281,615,519,109.69106575963718,110.71274376417234,6,8,106,1,96
4282,615,518,109.69106575963718,111.08426303854876,6,7,114,1,97
4283,615,628,109.69106575963718,111.45578231292517,6,4,77,2,13
4284,617,307,110.48054421768708,111.78086167800454,7,17,315,1,310
4285,617,244,110.48054421768708,112.08272108843538,7,15,379,2,373
4286,617,462,110.48054421768708,113.01151927437643,7,8,189,3,155
4287,617,462,110.48054421768708,113.05795918367347,7,9,191,3,155
4288,617,615,110.48054421768708,112.66321995464853,7,4,94,2,2
4289,628,261,111.45578231292517,113.89387755102041,4,14,382,2,367
4290,628,245,111.45578231292517,114.35827664399093,4,13,403,3,383
4291,628,462,111.45578231292517,113.01151927437643,4,8,179,2,166
4292,628,462,111.45578231292517,113.05795918367347,4,9,180,2,166
4293,628,497,111.45578231292517,114.03319727891157,4,3,172,3,131
4294,628,615,111.45578231292517,112.66321995464853,4,4,54,1,13
4295,628,615,111.45578231292517,113.54557823129252,4,2,91,2,13
4296,615,261,112.66321995464853,113.89387755102041,4,14,358,1,354
4297,615,245,112.66321995464853,114.35827664399093,4,13,377,2,370
4298,615,497,112.66321995464853,114.03319727891157,4,3,132,1,118
4299,615,705,112.66321995464853,115.5657142857143,4,4,154,3,90
4300,615,269,113.54557823129252,115.65859410430839,2,10,358,2,346
4301,615,269,113.54557823129252,116.09977324263039,2,12,363,3,346
4302,615,532,113.54557823129252,115.82113378684808,2,5,128,2,83
4303,615,496,113.54557823129252,116.51773242630385,2,5,175,3,119
4304,615,705,113.54557823129252,115.5657142857143,2,4,125,2,90
4305,615,721,113.54557823129252,116.19265306122449,2,7,156,3,106
4306,705,269,115.5657142857143,117.56263038548754,4,14,444,2,436
4307,705,270,115.5657142857143,118.25922902494331,4,10,450,3,435
4308,705,516,115.5657142857143,117.8877097505669,4,7,214,2,189
4309,705,626,115.5657142857143,117.60907029478459,4,5,118,2,79
4310,721,269,116.19265306122449,117.56263038548754,7,14,456,1,452
4311,721,270,116.19265306122449,118.25922902494331,7,10,460,2,451
4312,721,516,116.19265306122449,117.8877097505669,7,7,218,2,205
4313,721,579,116.19265306122449,118.93260770975057,7,6,185,3,142
4314,721,626,116.19265306122449,117.60907029478459,7,5,113,1,95
4315,721,770,116.19265306122449,118.60752834467121,7,5,115,2,49
4316,626,268,117.60907029478459,119.97750566893424,5,14,372,2,358
4317,626,579,117.60907029478459,118.93260770975057,5,6,74,1,47
4318,626,533,117.60907029478459,119.25768707482993,5,7,117,2,93
4319,626,539,117.60907029478459,120.53478458049887,5,8,153,3,87
4320,626,656,117.60907029478459,120.51156462585034,5,3,129,3,30
4321,770,539,118.60752834467121,120.53478458049887,5,8,245,2,231
4322,770,545,118.60752834467121,121.39392290249434,5,6,255,3,225
4323,770,656,118.60752834467121,120.51156462585034,5,3,140,2,114
4324,770,639,118.60752834467121,121.41714285714286,5,4,178,3,131
4325,770,820,118.60752834467121,121.39392290249434,5,3,130,3,50
4326,656,230,120.51156462585034,122.11374149659864,3,13,432,2,426
4327,656,269,120.51156462585034,123.04253968253968,3,12,402,3,387
4328,656,479,120.51156462585034,122.50848072562358,3,6,197,2,177
4329,656,689,120.51156462585034,122.50848072562358,3,3,92,2,33
4330,639,269,121.41714285714286,123.04253968253968,4,12,377,2,370
4331,639,247,121.41714285714286,124.18031746031747,4,13,410,3,392
4332,639,479,121.41714285714286,122.50848072562358,4,6,167,1,160
4333,639,540,121.41714285714286,123.92489795918368,4,5,147,3,99
4334,639,516,121.41714285714286,124.06421768707483,4,5,168,3,123
4335,639,689,121.41714285714286,122.50848072562358,4,3,69,1,50
4336,689,247,122.50848072562358,124.18031746031747,3,13,448,2,442
4337,689,540,122.50848072562358,123.92489795918368,3,5,161,1,149
4338,689,516,122.50848072562358,124.06421768707483,3,5,186,2,173
4339,773,480,125.75927437641724,126.89705215419501,5,8,297,1,293
4340,773,495,125.75927437641724,128.03482993197278,5,13,295,2,278
4341,773,519,125.75927437641724,128.10448979591837,5,15,273,2,254
4342,773,784,125.75927437641724,127.43111111111111,5,9,73,2,11
4343,773,754,125.75927437641724,128.19736961451247,5,2,107,2,19
4344,773,830,125.75927437641724,127.43111111111111,5,9,92,2,57
4345,784,452,127.43111111111111,129.49768707482994,9,12,344,2,332
4346,784,544,127.43111111111111,130.38004535147394,9,14,272,3,240
4347,784,752,127.43111111111111,130.2639455782313,9,9,126,3,32
4348,784,845,127.43111111111111,130.2871655328798,9,5,137,3,61
4349,754,452,128.19736961451247,129.49768707482994,2,12,307,1,302
4350,754,544,128.19736961451247,130.38004535147394,2,14,230,2,210
4351,754,752,128.19736961451247,130.2639455782313,2,9,89,2,2
4352,754,845,128.19736961451247,130.2871655328798,2,5,128,2,91
4353,752,437,130.2639455782313,131.65714285714287,9,12,321,1,315
4354,752,479,130.2639455782313,132.12154195011337,9,12,284,2,273
4355,752,627,130.2639455782313,131.81968253968253,9,10,142,2,125
4356,752,673,130.2639455782313,132.95746031746032,9,5,140,3,79
4357,752,677,130.2639455782313,133.2128798185941,9,6,147,3,75
4358,752,827,130.2639455782313,131.91256235827666,9,4,103,2,75
4359,752,830,130.2639455782313,132.4930612244898,9,4,124,2,78
4360,627,239,131.81968253968253,132.9342403628118,10,16,391,1,388
4361,627,206,131.81968253968253,133.67727891156463,10,16,429,2,421
4362,627,349,131.81968253968253,134.67573696145126,10,17,304,3,278
4363,627,480,131.81968253968253,133.83981859410432,10,12,171,2,147
4364,627,590,131.81968253968253,134.48997732426304,10,11,121,3,37
4365,627,673,131.81968253968253,132.95746031746032,10,5,67,1,46
4366,627,677,131.81968253968253,133.2128798185941,10,6,78,1,50
4367,627,622,131.81968253968253,134.48997732426304,10,8,115,3,5
4368,627,841,131.81968253968253,134.2809977324263,10,8,239,2,214
4369,673,349,132.95746031746032,134.67573696145126,5,17,332,2,324
4370,673,355,132.95746031746032,135.65097505668933,5,15,338,3,318
4371,673,590,132.95746031746032,134.48997732426304,5,11,106,2,83
4372,673,480,132.95746031746032,135.60453514739228,5,11,224,3,193
4373,673,622,132.95746031746032,134.48997732426304,5,8,83,2,51
4374,673,841,132.95746031746032,134.2809977324263,5,8,177,1,168
4375,677,349,133.2128798185941,134.67573696145126,6,17,334,1,328
4376,677,355,133.2128798185941,135.65097505668933,6,15,339,2,322
4377,677,590,133.2128798185941,134.48997732426304,6,11,103,1,87
4378,677,480,133.2128798185941,135.60453514739228,6,11,222,2,197
4379,677,622,133.2128798185941,134.48997732426304,6,8,78,1,55
4380,677,841,133.2128798185941,134.2809977324263,6,8,170,1,164
4381,622,355,134.48997732426304,135.65097505668933,8,15,272,1,267
4382,622,291,134.48997732426304,137.0209523809524,8,16,348,3,331
4383,622,480,134.48997732426304,135.60453514739228,8,11,150,1,142
4384,622,434,134.48997732426304,136.27791383219954,8,10,203,2,188
4385,622,619,134.48997732426304,136.4172335600907,8,5,83,2,3
4386,619,268,136.4172335600907,137.9497505668934,5,18,357,2,351
4387,619,230,136.4172335600907,138.2748299319728,5,16,397,2,389
4388,619,480,136.4172335600907,137.9961904761905,5,13,155,2,139
4389,619,459,136.4172335600907,138.34448979591838,5,6,180,2,160
4390,619,658,136.4172335600907,137.9497505668934,5,8,77,2,39
4391,658,223,137.9497505668934,140.0395464852608,8,29,444,2,435
4392,658,223,137.9497505668934,140.0627664399093,8,29,444,2,435
4393,658,510,137.9497505668934,140.0395464852608,8,13,173,2,148
4394,658,511,137.9497505668934,140.08598639455784,8,16,173,2,147
4395,658,765,137.9497505668934,140.0395464852608,8,8,140,2,107
4396,658,914,137.9497505668934,139.85378684807256,8,3,269,2,256
4397,765,507,140.0395464852608,141.1308843537415,8,11,262,1,258
4398,765,493,140.0395464852608,142.50086167800453,8,10,292,2,272
4399,765,616,140.0395464852608,141.33986394557823,8,3,159,1,149
4400,765,701,140.0395464852608,142.08290249433108,8,8,109,2,64
4401,655,256,141.01478458049885,142.918820861678,10,23,407,2,399
4402,655,290,141.01478458049885,143.6386394557823,10,20,382,3,365
4403,655,493,141.01478458049885,142.50086167800453,10,10,174,1,162
4404,655,473,141.01478458049885,143.9637188208617,10,9,222,3,182
4405,655,701,141.01478458049885,142.08290249433108,10,8,65,1,46
4406,655,668,141.01478458049885,143.49931972789116,10,4,108,2,13
4407,616,256,141.33986394557823,142.918820861678,3,23,366,2,360
4408,616,290,141.33986394557823,143.6386394557823,3,20,341,2,326
4409,616,493,141.33986394557823,142.50086167800453,3,10,133,1,123
4410,616,473,141.33986394557823,143.9637188208617,3,9,182,3,143
4411,616,668,141.33986394557823,143.49931972789116,3,4,107,2,52
4412,616,622,141.33986394557823,144.24235827664398,3,4,125,3,6
4413,701,290,142.08290249433108,143.6386394557823,8,20,416,2,411
4414,701,205,142.08290249433108,144.7764172335601,8,24,509,3,496
4415,701,473,142.08290249433108,143.9637188208617,8,9,242,2,228
4416,701,487,142.08290249433108,144.7764172335601,8,11,243,3,214
4417,701,668,142.08290249433108,143.49931972789116,8,4,69,1,33
4418,701,622,142.08290249433108,144.24235827664398,8,4,122,2,79
4419,668,205,143.49931972789116,144.7764172335601,4,24,466,1,463
4420,668,205,143.49931972789116,145.63555555555556,4,17,472,2,463
4421,668,487,143.49931972789116,144.7764172335601,4,11,189,1,181
4422,668,471,143.49931972789116,145.54267573696146,4,12,216,2,197
4423,668,665,143.49931972789116,145.6819954648526,4,12,94,2,3
4424,668,822,143.49931972789116,145.70521541950114,4,9,181,2,154
4425,622,205,144.24235827664398,145.63555555555556,4,17,421,1,417
4426,622,223,144.24235827664398,147.02875283446713,4,24,417,3,399
4427,622,225,144.24235827664398,147.14485260770977,4,26,416,3,397
4428,622,471,144.24235827664398,145.54267573696146,4,12,161,1,151
4429,622,516,144.24235827664398,146.98231292517008,4,13,159,3,106
4430,622,665,144.24235827664398,145.6819954648526,4,12,75,1,43
4431,622,822,144.24235827664398,145.70521541950114,4,9,210,1,200
4432,665,223,145.6819954648526,147.02875283446713,12,24,446,1,442
4433,665,225,145.6819954648526,147.14485260770977,12,26,444,1,440
4434,665,229,145.6819954648526,148.05043083900227,12,20,448,2,436
4435,665,516,145.6819954648526,146.98231292517008,12,13,159,1,149
4436,665,576,145.6819954648526,148.00399092970522,12,9,134,2,89
4437,665,573,145.6819954648526,148.3522902494331,12,11,147,3,92
4438,665,621,145.6819954648526,147.84145124716554,12,7,103,2,44
4439,665,634,145.6819954648526,148.3522902494331,12,12,119,3,31
4440,665,846,145.6819954648526,148.37551020408165,12,2,215,3,181
4441,621,242,147.84145124716554,149.582947845805,7,26,386,2,379
4442,621,450,147.84145124716554,149.18820861678006,7,13,181,1,171
4443,621,611,147.84145124716554,150.4885260770975,7,12,114,3,10
4444,621,642,147.84145124716554,149.25786848072562,7,9,65,1,21
4445,621,619,147.84145124716554,150.51174603174604,7,10,115,3,2
4446,621,856,147.84145124716554,149.21142857142857,7,3,242,1,235
4447,634,242,148.3522902494331,149.582947845805,12,26,396,1,392
4448,634,205,148.3522902494331,150.90648526077098,12,21,443,3,429
4449,634,227,148.3522902494331,151.32444444444445,12,27,427,3,407
4450,634,611,148.3522902494331,150.4885260770975,12,12,95,2,23
4451,634,619,148.3522902494331,150.51174603174604,12,10,94,2,15
4452,642,205,149.25786848072562,150.90648526077098,9,21,443,2,437
4453,642,227,149.25786848072562,151.32444444444445,9,27,424,2,415
4454,642,611,149.25786848072562,150.4885260770975,9,12,61,1,31
4455,642,463,149.25786848072562,151.41732426303855,9,13,202,2,179
4456,642,619,149.25786848072562,150.51174603174604,9,10,59,1,23
4457,642,646,149.25786848072562,151.4405442176871,9,11,94,2,4
4458,619,205,150.51174603174604,152.57832199546485,10,18,423,2,414
4459,619,307,150.51174603174604,153.4374603174603,10,20,336,3,312
4460,619,496,150.51174603174604,152.92662131519273,10,4,161,2,123
4461,619,774,150.51174603174604,152.64798185941044,10,5,180,2,155
4462,646,205,151.4405442176871,152.57832199546485,11,18,444,1,441
4463,646,307,151.4405442176871,153.4374603174603,11,20,350,2,339
4464,646,496,151.4405442176871,152.92662131519273,11,4,163,1,150
4465,646,423,151.4405442176871,154.041179138322,11,7,250,3,223
4466,646,774,151.4405442176871,152.64798185941044,11,5,138,1,128
4467,646,814,151.4405442176871,154.18049886621316,11,10,205,3,168
4468,646,834,151.4405442176871,154.18049886621316,11,5,222,3,188
4469,774,423,152.64798185941044,154.041179138322,5,7,356,1,351
4470,774,486,152.64798185941044,154.90031746031747,5,14,304,2,288
4471,774,814,152.64798185941044,154.18049886621316,5,10,77,2,40
4472,774,834,152.64798185941044,154.18049886621316,5,5,89,2,60
4473,814,563,154.18049886621316,155.9916553287982,10,14,263,2,251
4474,814,520,154.18049886621316,156.6185941043084,10,9,312,2,294
4475,814,654,154.18049886621316,156.0148752834467,10,8,178,2,160
4476,814,623,154.18049886621316,156.06131519274376,10,3,207,2,191
4477,654,205,156.0148752834467,157.8724716553288,8,31,456,2,449
4478,654,237,156.0148752834467,158.26721088435374,8,24,428,2,417
4479,654,572,156.0148752834467,157.70993197278912,8,15,110,2,82
4480,654,520,156.0148752834467,158.33687074829933,8,12,167,2,134
4481,654,635,156.0148752834467,157.64027210884353,8,14,73,2,19
4482,654,667,156.0148752834467,158.3136507936508,8,4,100,2,13
4483,654,907,156.0148752834467,157.66349206349207,8,9,263,2,253
4484,623,205,156.06131519274376,157.8724716553288,3,31,425,2,418
4485,623,237,156.06131519274376,158.26721088435374,3,24,398,2,386
4486,623,572,156.06131519274376,157.70993197278912,3,15,87,2,51
4487,623,520,156.06131519274376,158.33687074829933,3,12,142,2,103
4488,623,635,156.06131519274376,157.64027210884353,3,14,69,2,12
4489,623,667,156.06131519274376,158.3136507936508,3,4,107,2,44
4490,623,907,156.06131519274376,157.66349206349207,3,9,292,2,284
4491,635,205,157.64027210884353,159.68362811791383,14,18,439,2,430
4492,635,246,157.64027210884353,160.47310657596373,14,15,408,3,389
4493,635,529,157.64027210884353,159.381768707483,14,9,130,2,106
4494,635,617,157.64027210884353,159.381768707483,14,3,77,2,18
4495,667,205,158.3136507936508,159.68362811791383,4,18,466,1,462
4496,667,246,158.3136507936508,160.47310657596373,4,15,431,2,421
4497,667,529,158.3136507936508,159.381768707483,4,9,145,1,138
4498,667,575,158.3136507936508,160.86784580498866,4,10,143,3,92
4499,667,617,158.3136507936508,159.381768707483,4,3,68,1,50
4500,667,619,158.3136507936508,160.77496598639456,4,3,116,2,48
4501,617,246,159.381768707483,160.47310657596373,3,15,374,1,371
4502,617,263,159.381768707483,161.91274376417235,3,20,370,3,354
4503,617,575,159.381768707483,160.86784580498866,3,10,77,1,42
4504,617,506,159.381768707483,162.0520634920635,3,10,160,3,111
4505,617,510,159.381768707483,162.09850340136055,3,11,159,3,107
4506,617,619,159.381768707483,160.77496598639456,3,3,60,1,2
4507,617,635,159.381768707483,162.0520634920635,3,12,116,3,18
4508,617,630,159.381768707483,162.09850340136055,3,12,118,3,13
4509,619,263,160.77496598639456,161.91274376417235,3,20,359,1,356
4510,619,255,160.77496598639456,162.98086167800454,3,17,376,2,364
4511,619,205,160.77496598639456,163.16662131519274,3,19,427,2,414
4512,619,506,160.77496598639456,162.0520634920635,3,10,126,1,113
4513,619,510,160.77496598639456,162.09850340136055,3,11,123,1,109
4514,619,528,160.77496598639456,163.25950113378684,3,8,140,2,91
4515,619,635,160.77496598639456,162.0520634920635,3,12,57,1,16
4516,619,630,160.77496598639456,162.09850340136055,3,12,58,1,11
4517,619,654,160.77496598639456,163.72390022675737,3,3,132,3,35
4518,635,205,162.0520634920635,163.16662131519274,12,19,433,1,430
4519,635,205,162.0520634920635,164.79201814058956,12,16,446,3,430
4520,635,528,162.0520634920635,163.25950113378684,12,8,119,1,107
4521,635,597,162.0520634920635,164.16507936507938,12,11,99,2,38
4522,635,654,162.0520634920635,163.72390022675737,12,3,74,2,19
4523,635,656,162.0520634920635,164.11863945578233,12,12,91,2,21
4524,635,831,162.0520634920635,164.11863945578233,12,4,215,2,196
4525,630,205,162.09850340136055,163.16662131519274,12,19,427,1,425
4526,630,205,162.09850340136055,164.79201814058956,12,16,441,3,425
4527,630,528,162.09850340136055,163.25950113378684,12,8,114,1,102
4528,630,597,162.09850340136055,164.16507936507938,12,11,95,2,33
4529,630,654,162.09850340136055,163.72390022675737,12,3,74,2,24
4530,630,656,162.09850340136055,164.11863945578233,12,12,91,2,26
4531,630,831,162.09850340136055,164.11863945578233,12,4,219,2,201
4532,654,205,163.72390022675737,164.79201814058956,3,16,451,1,449
4533,654,205,163.72390022675737,165.67437641723356,3,14,457,2,449
4534,654,205,163.72390022675737,166.5102947845805,3,19,465,3,449
4535,654,594,163.72390022675737,165.90657596371884,3,8,112,2,60
4536,654,619,163.72390022675737,165.99945578231294,3,3,104,2,35
4537,654,618,163.72390022675737,166.27809523809523,3,5,116,3,36
4538,656,205,164.11863945578233,165.67437641723356,12,14,456,2,451
4539,656,205,164.11863945578233,166.5102947845805,12,19,463,2,451
4540,656,594,164.11863945578233,165.90657596371884,12,8,99,2,62
4541,656,456,164.11863945578233,166.9514739229025,12,8,234,3,200
4542,656,619,164.11863945578233,165.99945578231294,12,3,89,2,37
4543,656,618,164.11863945578233,166.27809523809523,12,5,100,2,38
4544,619,295,165.99945578231294,167.69451247165534,3,19,332,2,324
4545,619,592,165.99945578231294,167.6712925170068,3,10,77,2,27
4546,619,474,165.99945578231294,168.50721088435375,3,7,181,3,145
4547,619,722,165.99945578231294,167.4855328798186,3,5,121,1,103
4548,619,616,165.99945578231294,168.13569160997733,3,3,92,2,3
4549,618,295,166.27809523809523,167.69451247165534,5,19,329,1,323
4550,618,308,166.27809523809523,169.04126984126984,5,15,332,3,310
4551,618,592,166.27809523809523,167.6712925170068,5,10,65,1,26
4552,618,474,166.27809523809523,168.50721088435375,5,7,173,2,144
4553,618,722,166.27809523809523,167.4855328798186,5,5,116,1,104
4554,618,616,166.27809523809523,168.13569160997733,5,3,80,2,2
4555,722,308,167.4855328798186,169.04126984126984,5,15,419,2,414
4556,722,231,167.4855328798186,169.3663492063492,5,14,498,2,491
4557,722,233,167.4855328798186,170.17904761904762,5,15,503,3,489
4558,722,474,167.4855328798186,168.50721088435375,5,7,252,1,248
4559,722,473,167.4855328798186,169.3663492063492,5,7,262,2,249
4560,722,696,167.4855328798186,169.34312925170067,5,3,84,2,26
4561,616,231,168.13569160997733,169.3663492063492,3,14,389,1,385
4562,616,233,168.13569160997733,170.17904761904762,3,15,393,2,383
4563,616,473,168.13569160997733,169.3663492063492,3,7,153,1,143
4564,616,472,168.13569160997733,170.75954648526078,3,7,183,3,144
4565,616,464,168.13569160997733,171.10784580498867,3,4,199,3,152
4566,616,696,168.13569160997733,169.34312925170067,3,3,95,1,80
4567,696,311,169.34312925170067,171.34004535147392,3,15,394,2,385
4568,696,472,169.34312925170067,170.75954648526078,3,7,232,1,224
4569,696,464,169.34312925170067,171.10784580498867,3,4,244,2,232
4570,696,619,169.34312925170067,171.27038548752836,3,2,113,2,77
4571,696,616,169.34312925170067,172.12952380952382,3,3,144,3,80
4572,619,232,171.27038548752836,172.87256235827664,2,15,393,2,387
4573,619,231,171.27038548752836,173.8942403628118,2,17,404,3,388
4574,619,465,171.27038548752836,172.80290249433108,2,3,168,2,154
4575,619,464,171.27038548752836,173.94068027210884,2,3,193,3,155
4576,616,231,172.12952380952382,173.8942403628118,3,17,392,2,385
4577,616,232,172.12952380952382,174.38185941043085,3,15,396,2,384
4578,616,464,172.12952380952382,173.94068027210884,3,3,171,2,152
4579,616,457,172.12952380952382,174.73015873015873,3,4,194,3,159
4580,616,774,172.12952380952382,174.73015873015873,3,2,194,3,158
4581,774,289,174.73015873015873,177.3772335600907,2,13,498,3,485
4582,774,473,174.73015873015873,176.70385487528344,2,5,313,2,301
4583,618,239,178.23637188208616,179.420589569161,4,11,382,1,379
4584,618,222,178.23637188208616,180.51192743764173,4,14,408,2,396
4585,618,457,178.23637188208616,180.79056689342403,4,10,195,3,161
4586,618,615,178.23637188208616,180.67446712018142,4,3,105,2,3
4587,615,271,180.67446712018142,182.50884353741498,3,16,353,2,344
4588,615,539,180.67446712018142,182.48562358276644,3,2,109,2,76
4589,632,260,195.97641723356008,197.27673469387756,8,18,376,1,372
4590,632,205,195.97641723356008,198.4609523809524,8,24,440,2,427
4591,632,495,195.97641723356008,198.04299319727892,8,10,163,2,137
4592,632,452,195.97641723356008,198.08943310657597,8,11,202,2,180
4593,632,662,195.97641723356008,197.74113378684808,8,8,82,2,30
4594,698,205,196.62657596371884,198.4609523809524,9,24,499,2,493
4595,698,290,196.62657596371884,199.2968707482993,9,22,424,3,408
4596,698,495,196.62657596371884,198.04299319727892,9,10,212,1,203
4597,698,452,196.62657596371884,198.08943310657597,9,11,254,1,246
4598,698,662,196.62657596371884,197.74113378684808,9,8,60,1,36
4599,698,669,196.62657596371884,199.15755102040816,9,4,113,3,29
4600,662,290,197.74113378684808,199.2968707482993,8,22,378,2,372
4601,662,205,197.74113378684808,200.4346485260771,8,24,471,3,457
4602,662,473,197.74113378684808,199.6219501133787,8,10,206,2,189
4603,662,488,197.74113378684808,200.4114285714286,8,13,209,3,174
4604,662,669,197.74113378684808,199.15755102040816,8,4,61,1,7
4605,662,759,197.74113378684808,200.4114285714286,8,4,150,3,97
4606,669,205,199.15755102040816,200.4346485260771,4,24,467,1,464
4607,669,205,199.15755102040816,201.29378684807256,4,16,473,2,464
4608,669,488,199.15755102040816,200.4114285714286,4,13,189,1,181
4609,669,487,199.15755102040816,201.3402267573696,4,13,205,2,182
4610,669,759,199.15755102040816,200.4114285714286,4,4,105,1,90
4611,669,636,199.15755102040816,201.17768707482995,4,13,93,2,33
4612,669,832,199.15755102040816,201.36344671201815,4,4,189,2,163
4613,759,517,200.4114285714286,202.61732426303854,4,14,260,2,242
4614,759,631,200.4114285714286,202.82630385487528,4,3,165,2,128
4615,636,225,201.17768707482995,202.73342403628118,13,26,416,2,411
4616,636,227,201.17768707482995,203.84798185941042,13,20,425,3,409
4617,636,517,201.17768707482995,202.61732426303854,13,14,134,1,119
4618,636,610,201.17768707482995,204.0105215419501,13,10,125,3,26
4619,636,631,201.17768707482995,202.82630385487528,13,3,71,2,5
4620,636,764,201.17768707482995,204.0105215419501,13,11,177,3,128
4621,636,828,201.17768707482995,204.05696145124716,13,4,229,3,192
4622,631,227,202.82630385487528,203.84798185941042,3,20,406,1,404
4623,631,205,202.82630385487528,204.82321995464852,3,21,435,2,426
4624,631,242,202.82630385487528,205.241179138322,3,26,403,2,389
4625,631,610,202.82630385487528,204.0105215419501,3,10,55,1,21
4626,631,479,202.82630385487528,204.91609977324262,3,14,177,2,152
4627,631,455,202.82630385487528,205.1482993197279,3,10,202,2,176
4628,631,764,202.82630385487528,204.0105215419501,3,11,142,1,133
4629,631,635,202.82630385487528,204.86965986394557,3,9,88,2,4
4630,631,616,202.82630385487528,205.3340589569161,3,2,109,3,15
4631,631,828,202.82630385487528,204.05696145124716,3,4,204,1,197
4632,631,847,202.82630385487528,204.91609977324262,3,4,234,2,216
4633,764,455,204.0105215419501,205.1482993197279,11,10,313,1,309
4634,764,616,204.0105215419501,205.3340589569161,11,2,159,1,148
4635,764,617,204.0105215419501,206.16997732426304,11,11,174,2,147
4636,635,205,204.86965986394557,206.88979591836735,9,22,439,2,430
4637,635,245,204.86965986394557,207.07555555555555,9,17,401,2,390
4638,635,469,204.86965986394557,207.05233560090704,9,16,191,2,166
4639,635,448,204.86965986394557,207.0987755102041,9,14,210,2,187
4640,635,617,204.86965986394557,206.16997732426304,9,11,59,1,18
4641,635,641,204.86965986394557,207.07555555555555,9,12,95,2,6
4642,616,205,205.3340589569161,206.88979591836735,2,22,416,2,411
4643,616,245,205.3340589569161,207.07555555555555,2,17,379,2,371
4644,616,469,205.3340589569161,207.05233560090704,2,16,165,2,147
4645,616,448,205.3340589569161,207.0987755102041,2,14,184,2,168
4646,616,641,205.3340589569161,207.07555555555555,2,12,79,2,25
4647,617,205,206.16997732426304,208.37587301587303,11,19,423,2,412
4648,617,456,206.16997732426304,208.60807256235827,11,8,192,2,161
4649,617,787,206.16997732426304,208.32943310657598,11,4,194,2,170
4650,641,205,207.07555555555555,208.37587301587303,12,19,440,1,436
4651,641,254,207.07555555555555,209.9548299319728,12,19,406,3,387
4652,641,456,207.07555555555555,208.60807256235827,12,8,196,2,185
4653,641,497,207.07555555555555,209.81551020408165,12,12,186,3,144
4654,641,787,207.07555555555555,208.32943310657598,12,4,156,1,146
4655,641,632,207.07555555555555,209.7922902494331,12,9,117,3,9
4656,641,892,207.07555555555555,209.7922902494331,12,2,277,3,251
4657,787,497,208.32943310657598,209.81551020408165,4,12,297,1,290
4658,787,487,208.32943310657598,210.55854875283447,4,13,315,2,300
4659,787,632,208.32943310657598,209.7922902494331,4,9,167,1,155
4660,787,619,208.32943310657598,210.53532879818596,4,8,193,2,168
4661,787,892,208.32943310657598,209.7922902494331,4,2,122,1,105
4662,632,220,209.7922902494331,211.30158730158732,9,22,417,2,412
4663,632,236,209.7922902494331,212.23038548752834,9,25,410,2,396
4664,632,564,209.7922902494331,211.62666666666667,9,14,104,2,68
4665,632,455,209.7922902494331,212.11428571428573,9,9,203,2,177
4666,632,619,209.7922902494331,211.60344671201815,9,9,79,2,13
4667,619,236,210.53532879818596,212.23038548752834,8,25,390,2,383
4668,619,564,210.53532879818596,211.62666666666667,8,14,72,1,55
4669,619,455,210.53532879818596,212.11428571428573,8,9,178,2,164
4670,619,572,210.53532879818596,213.36816326530612,8,14,131,3,47
4671,619,618,210.53532879818596,212.8805442176871,8,4,101,2,1
4672,619,635,210.53532879818596,213.29850340136056,8,14,120,3,16
4673,619,903,210.53532879818596,213.36816326530612,8,9,309,3,284
4674,619,205,211.60344671201815,213.5307029478458,9,31,422,2,414
4675,619,572,211.60344671201815,213.36816326530612,9,14,89,2,47
4676,619,618,211.60344671201815,212.8805442176871,9,4,55,1,1
4677,619,635,211.60344671201815,213.29850340136056,9,14,75,2,16
4678,619,903,211.60344671201815,213.36816326530612,9,9,294,2,284
4679,618,240,212.8805442176871,215.04,4,18,389,2,378
4680,618,205,212.8805442176871,215.34185941043086,4,17,426,2,413
4681,618,530,212.8805442176871,215.06321995464853,4,10,129,2,88
4682,635,240,213.29850340136056,215.04,14,18,402,2,395
4683,635,205,213.29850340136056,215.34185941043086,14,17,439,2,430
4684,635,247,213.29850340136056,216.13133786848073,14,16,407,3,388
4685,635,530,213.29850340136056,215.06321995464853,14,10,130,2,105
4686,635,525,213.29850340136056,215.99201814058958,14,10,160,3,110
4687,635,526,213.29850340136056,216.22421768707483,14,11,167,3,109
4688,635,618,213.29850340136056,215.06321995464853,14,3,78,2,17
4689,635,700,213.29850340136056,215.99201814058958,14,5,133,3,65
4690,618,247,215.06321995464853,216.13133786848073,3,16,374,1,371
4691,618,263,215.06321995464853,217.57097505668935,3,21,371,3,355
4692,618,526,215.06321995464853,216.22421768707483,3,11,105,1,92
4693,618,613,215.06321995464853,217.73351473922904,3,15,115,3,5
4694,618,619,215.06321995464853,216.4564172335601,3,6,60,1,1
4695,618,654,215.06321995464853,217.75673469387755,3,13,121,3,36
4696,618,831,215.06321995464853,217.73351473922904,3,3,242,3,213
4697,700,263,215.99201814058958,217.57097505668935,5,21,442,2,437
4698,700,613,215.99201814058958,217.73351473922904,5,15,115,2,87
4699,700,526,215.99201814058958,218.45333333333335,5,10,204,2,174
4700,700,654,215.99201814058958,217.75673469387755,5,13,89,2,46
4701,700,634,215.99201814058958,218.5229931972789,5,3,127,3,66
4702,700,831,215.99201814058958,217.73351473922904,5,3,151,2,131
4703,619,263,216.4564172335601,217.57097505668935,6,21,359,1,356
4704,619,232,216.4564172335601,219.01061224489797,6,15,402,3,387
4705,619,613,216.4564172335601,217.73351473922904,6,15,55,1,6
4706,619,526,216.4564172335601,218.45333333333335,6,10,127,2,93
4707,619,523,216.4564172335601,219.33569160997732,6,12,157,3,96
4708,619,654,216.4564172335601,217.75673469387755,6,13,66,1,35
4709,619,634,216.4564172335601,218.5229931972789,6,3,90,2,15
4710,619,831,216.4564172335601,217.73351473922904,6,3,219,1,212
4711,654,232,217.75673469387755,219.01061224489797,13,15,425,1,422
4712,654,312,217.75673469387755,219.80009070294784,13,14,353,2,342
4713,654,217,217.75673469387755,220.6360090702948,13,14,454,3,437
4714,654,523,217.75673469387755,219.33569160997732,13,12,148,2,131
4715,654,526,217.75673469387755,220.35736961451246,13,4,170,3,128
4716,654,653,217.75673469387755,219.80009070294784,13,11,88,2,1
4717,654,840,217.75673469387755,219.80009070294784,13,3,206,2,186
4718,634,312,218.5229931972789,219.80009070294784,3,14,327,1,322
4719,634,217,218.5229931972789,220.6360090702948,3,14,427,2,417
4720,634,526,218.5229931972789,220.35736961451246,3,4,134,2,108
4721,634,653,218.5229931972789,219.80009070294784,3,11,58,1,19
4722,634,840,218.5229931972789,219.80009070294784,3,3,213,1,206
4723,653,232,219.80009070294784,221.72734693877553,11,15,429,2,421
4724,653,329,219.80009070294784,222.14530612244897,11,12,339,2,324
4725,653,524,219.80009070294784,222.05242630385487,11,11,161,2,129
4726,653,525,219.80009070294784,222.2381859410431,11,8,166,2,128
4727,653,651,219.80009070294784,222.02920634920636,11,3,96,2,2
4728,651,232,222.02920634920636,223.25986394557825,3,7,422,1,419
4729,651,345,222.02920634920636,224.4673015873016,3,10,324,2,306
4730,911,437,14.09451247165533,15.301950113378686,6,4,477,1,474
4731,823,480,17.531065759637187,18.599183673469387,3,6,346,1,343
4732,823,511,17.531065759637187,19.156462585034014,3,4,320,2,312
4733,823,494,17.531065759637187,20.48,3,5,353,3,329
4734,823,699,17.531065759637187,18.599183673469387,3,3,132,1,124
4735,923,484,41.98167800453515,43.86249433106576,4,11,446,2,439
4736,923,580,41.98167800453515,44.90739229024943,4,9,365,3,343
4737,923,643,41.98167800453515,44.860952380952384,4,7,306,3,280
4738,923,823,41.98167800453515,44.93061224489796,4,2,162,3,100
4739,835,484,42.074557823129254,43.86249433106576,6,11,359,2,351
4740,835,580,42.074557823129254,44.90739229024943,6,9,283,3,255
4741,835,643,42.074557823129254,44.860952380952384,6,7,226,3,192
4742,835,823,42.074557823129254,44.93061224489796,6,2,124,3,12
4743,823,523,44.93061224489796,46.9275283446712,2,6,312,2,300
4744,823,501,44.93061224489796,47.484807256235825,2,8,340,3,322
4745,823,623,44.93061224489796,46.068390022675736,2,2,206,1,200
4746,823,641,44.93061224489796,47.50802721088436,2,7,213,3,182
4747,829,421,48.83156462585034,50.92136054421769,2,9,418,2,408
4748,829,526,48.83156462585034,51.06068027210885,2,9,318,2,303
4749,829,642,48.83156462585034,50.96780045351474,2,5,208,2,187
4750,829,615,48.83156462585034,51.06068027210885,2,2,235,2,214
4751,829,901,48.83156462585034,50.874920634920635,2,5,114,2,72
4752,901,556,50.874920634920635,52.68607709750567,5,4,354,2,345
4753,901,484,50.874920634920635,53.498775510204084,5,7,432,3,417
4754,901,631,50.874920634920635,53.661315192743764,5,2,295,3,270
4755,846,484,70.6118820861678,72.95709750566894,8,9,376,2,362
4756,846,486,70.6118820861678,73.04997732426304,8,7,375,2,360
4757,846,701,70.6118820861678,72.51591836734694,8,5,167,2,145
4758,959,484,71.37814058956916,72.95709750566894,3,9,480,2,475
4759,959,486,71.37814058956916,73.04997732426304,3,7,478,2,473
4760,959,701,71.37814058956916,72.51591836734694,3,5,263,1,258
4761,959,668,71.37814058956916,73.93233560090704,3,2,311,3,291
4762,924,516,76.16145124716553,77.41532879818594,2,12,412,1,408
4763,924,587,76.16145124716553,78.85496598639456,2,11,356,3,337
4764,924,649,76.16145124716553,78.76208616780046,2,9,297,3,275
4765,924,934,76.16145124716553,78.83174603174604,2,3,115,3,10
4766,934,516,78.83174603174604,80.92154195011338,3,16,428,2,418
4767,934,679,78.83174603174604,80.89832199546485,3,8,270,2,255
4768,873,516,79.71410430839002,80.92154195011338,4,16,361,1,357
4769,873,485,79.71410430839002,81.87356009070295,4,14,399,2,388
4770,873,484,79.71410430839002,82.08253968253969,4,6,402,2,389
4771,873,679,79.71410430839002,80.89832199546485,4,8,201,1,194
4772,873,622,79.71410430839002,81.85034013605443,4,9,267,2,251
4773,873,835,79.71410430839002,81.87356009070295,4,2,100,2,38
4774,835,505,81.87356009070295,83.26675736961451,2,7,335,1,330
4775,835,478,81.87356009070295,84.65995464852608,2,14,377,3,357
4776,835,632,81.87356009070295,84.65995464852608,2,11,236,3,203
4777,835,953,81.87356009070295,83.08099773242631,2,2,129,1,118
4778,835,916,81.87356009070295,84.54385487528344,2,7,141,3,81
4779,953,478,83.08099773242631,84.65995464852608,2,14,480,2,475
4780,953,552,83.08099773242631,85.14757369614513,2,11,411,2,401
4781,953,632,83.08099773242631,84.65995464852608,2,11,328,2,321
4782,953,632,83.08099773242631,85.33333333333333,2,9,335,2,321
4783,953,916,83.08099773242631,84.54385487528344,2,7,73,1,37
4784,916,511,84.54385487528344,86.44789115646259,7,13,413,2,405
4785,916,648,84.54385487528344,86.44789115646259,7,7,280,2,268
4786,909,599,88.00362811791383,89.39682539682539,2,11,316,1,310
4787,909,528,88.00362811791383,90.69714285714286,2,8,398,3,381
4788,909,675,88.00362811791383,89.42004535147393,2,10,242,1,234
4789,886,599,88.09650793650793,89.39682539682539,3,11,292,1,287
4790,886,528,88.09650793650793,90.69714285714286,3,8,375,3,358
4791,886,675,88.09650793650793,89.42004535147393,3,10,219,1,211
4792,856,482,92.46185941043085,94.57487528344672,2,14,385,2,374
4793,856,664,92.46185941043085,94.57487528344672,2,13,212,2,192
4794,856,828,92.46185941043085,94.57487528344672,2,2,95,2,28
4795,828,353,94.57487528344672,96.20027210884354,2,17,480,2,475
4796,828,520,94.57487528344672,95.75909297052155,2,4,312,1,308
4797,828,464,94.57487528344672,96.59501133786848,2,8,374,2,364
4798,828,482,94.57487528344672,97.05941043083901,2,4,362,2,346
4799,828,618,94.57487528344672,96.71111111111111,2,3,229,2,210
4800,824,340,101.7730612244898,103.72353741496599,3,21,491,2,484
4801,824,519,101.7730612244898,102.91083900226758,3,11,309,1,305
4802,824,520,101.7730612244898,103.3752380952381,3,9,312,2,304
4803,824,520,101.7730612244898,104.25759637188209,3,7,322,2,304
4804,824,683,101.7730612244898,103.05015873015873,3,3,151,1,141
4805,824,733,101.7730612244898,104.32725623582766,3,4,143,3,91
4806,825,340,102.63219954648527,103.72353741496599,4,21,487,1,485
4807,825,520,102.63219954648527,104.25759637188209,4,7,313,2,305
4808,825,520,102.63219954648527,105.55791383219955,4,15,330,3,305
4809,825,733,102.63219954648527,104.32725623582766,4,4,117,2,92
4810,820,479,121.39392290249434,122.50848072562358,3,6,344,1,341
4811,820,540,121.39392290249434,123.92489795918368,3,5,300,3,280
4812,820,516,121.39392290249434,124.06421768707483,3,5,325,3,304
4813,820,689,121.39392290249434,122.50848072562358,3,3,140,1,131
4814,826,480,125.75927437641724,126.89705215419501,2,8,349,1,346
4815,826,495,125.75927437641724,128.03482993197278,2,13,345,2,331
4816,826,519,125.75927437641724,128.10448979591837,2,15,323,2,307
4817,826,784,125.75927437641724,127.43111111111111,2,9,83,2,42
4818,826,754,125.75927437641724,128.19736961451247,2,2,127,2,72
4819,826,830,125.75927437641724,127.43111111111111,2,9,72,2,4
4820,830,452,127.43111111111111,129.49768707482994,9,12,388,2,378
4821,830,544,127.43111111111111,130.38004535147394,9,14,313,3,286
4822,830,752,127.43111111111111,130.2639455782313,9,9,145,3,78
4823,830,845,127.43111111111111,130.2871655328798,9,5,124,3,15
4824,845,437,130.2871655328798,131.65714285714287,5,12,412,1,408
4825,845,479,130.2871655328798,132.12154195011337,5,12,374,2,366
4826,845,627,130.2871655328798,131.81968253968253,5,10,228,2,218
4827,845,673,130.2871655328798,132.95746031746032,5,5,207,3,172
4828,845,677,130.2871655328798,133.2128798185941,5,6,210,3,168
4829,845,827,130.2871655328798,131.91256235827666,5,4,72,2,18
4830,845,830,130.2871655328798,132.4930612244898,5,4,96,2,15
4831,827,349,131.91256235827666,134.67573696145126,4,17,493,3,478
4832,827,480,131.91256235827666,133.83981859410432,4,12,357,2,347
4833,827,590,131.91256235827666,134.48997732426304,4,11,262,3,237
4834,827,673,131.91256235827666,132.95746031746032,4,5,160,1,154
4835,827,677,131.91256235827666,133.2128798185941,4,6,160,1,150
4836,827,622,131.91256235827666,134.48997732426304,4,8,233,3,205
4837,827,841,131.91256235827666,134.2809977324263,4,8,103,2,14
4838,830,349,132.4930612244898,134.67573696145126,4,17,490,2,481
4839,830,480,132.4930612244898,133.83981859410432,4,12,355,1,350
4840,830,590,132.4930612244898,134.48997732426304,4,11,255,2,240
4841,830,622,132.4930612244898,134.48997732426304,4,8,225,2,208
4842,830,841,132.4930612244898,134.2809977324263,4,8,78,2,11
4843,841,355,134.2809977324263,135.65097505668933,8,15,490,1,486
4844,841,480,134.2809977324263,135.60453514739228,8,11,365,1,361
4845,841,434,134.2809977324263,136.27791383219954,8,10,416,2,407
4846,841,619,134.2809977324263,136.4172335600907,8,5,240,2,222
4847,914,507,139.85378684807256,141.1308843537415,3,11,411,1,407
4848,914,493,139.85378684807256,142.50086167800453,3,10,436,3,421
4849,914,655,139.85378684807256,141.01478458049885,3,10,264,1,259
4850,914,616,139.85378684807256,141.33986394557823,3,3,305,1,298
4851,914,701,139.85378684807256,142.08290249433108,3,8,234,2,213
4852,914,826,139.85378684807256,140.99156462585034,3,6,101,1,88
4853,826,493,140.99156462585034,142.50086167800453,6,10,339,2,333
4854,826,473,140.99156462585034,143.9637188208617,6,9,375,3,353
4855,826,701,140.99156462585034,142.08290249433108,6,8,134,1,125
4856,826,668,140.99156462585034,143.49931972789116,6,4,191,3,158
4857,822,516,145.70521541950114,146.98231292517008,9,13,311,1,306
4858,822,576,145.70521541950114,148.00399092970522,9,9,265,2,246
4859,822,573,145.70521541950114,148.3522902494331,9,11,274,3,249
4860,822,621,145.70521541950114,147.84145124716554,9,7,221,2,201
4861,822,634,145.70521541950114,148.3522902494331,9,12,220,3,188
4862,822,846,145.70521541950114,148.37551020408165,9,2,117,3,24
4863,846,611,148.37551020408165,150.4885260770975,2,12,252,2,235
4864,846,619,148.37551020408165,150.51174603174604,2,10,245,2,227
4865,856,611,149.21142857142857,150.4885260770975,3,12,251,1,245
4866,856,463,149.21142857142857,151.41732426303855,3,13,404,2,393
4867,856,619,149.21142857142857,150.51174603174604,3,10,244,1,237
4868,856,646,149.21142857142857,151.4405442176871,3,11,231,2,210
4869,834,563,154.18049886621316,155.9916553287982,5,14,282,2,271
4870,834,520,154.18049886621316,156.6185941043084,5,9,331,2,314
4871,834,654,154.18049886621316,156.0148752834467,5,8,197,2,180
4872,834,623,154.18049886621316,156.06131519274376,5,3,226,2,211
4873,907,529,157.66349206349207,159.381768707483,9,9,385,2,378
4874,907,617,157.66349206349207,159.381768707483,9,3,299,2,290
4875,831,594,164.11863945578233,165.90657596371884,4,8,249,2,237
4876,831,456,164.11863945578233,166.9514739229025,4,8,394,3,375
4877,831,619,164.11863945578233,165.99945578231294,4,3,227,2,212
4878,831,618,164.11863945578233,166.27809523809523,4,5,232,2,213
4879,860,495,195.74421768707484,198.04299319727892,6,10,378,2,365
4880,860,452,195.74421768707484,198.08943310657597,6,11,420,2,408
4881,860,662,195.74421768707484,197.74113378684808,6,8,216,2,198
4882,947,495,196.13895691609977,198.04299319727892,9,10,459,2,452
4883,947,452,196.13895691609977,198.08943310657597,9,11,502,2,495
4884,947,662,196.13895691609977,197.74113378684808,9,8,293,2,285
4885,832,517,201.36344671201815,202.61732426303854,4,14,320,1,315
4886,832,610,201.36344671201815,204.0105215419501,4,10,250,3,222
4887,832,631,201.36344671201815,202.82630385487528,4,3,211,1,201
4888,832,764,201.36344671201815,204.0105215419501,4,11,133,3,68
4889,832,828,201.36344671201815,204.05696145124716,4,4,116,3,4
4890,828,455,204.05696145124716,205.1482993197279,4,10,376,1,373
4891,828,616,204.05696145124716,205.3340589569161,4,2,219,1,212
4892,828,617,204.05696145124716,206.16997732426304,4,11,230,2,211
4893,847,469,204.91609977324262,207.05233560090704,4,16,389,2,378
4894,847,448,204.91609977324262,207.0987755102041,4,14,410,2,399
4895,847,617,204.91609977324262,206.16997732426304,4,11,236,1,230
4896,847,641,204.91609977324262,207.07555555555555,4,12,226,2,206
4897,892,564,209.7922902494331,211.62666666666667,2,14,337,2,328
4898,892,455,209.7922902494331,212.11428571428573,2,9,448,2,437
4899,892,619,209.7922902494331,211.60344671201815,2,9,284,2,273
4900,903,530,213.36816326530612,215.06321995464853,9,10,380,2,373
4901,903,525,213.36816326530612,215.99201814058958,9,10,395,3,378
4902,903,526,213.36816326530612,216.22421768707483,9,11,397,3,377
4903,903,618,213.36816326530612,215.06321995464853,9,3,294,2,285
4904,903,700,213.36816326530612,215.99201814058958,9,5,232,3,203
4905,831,523,217.73351473922904,219.33569160997732,3,12,316,2,308
4906,831,526,217.73351473922904,220.35736961451246,3,4,325,3,305
4907,831,653,217.73351473922904,219.80009070294784,3,11,199,2,178
4908,831,840,217.73351473922904,219.80009070294784,3,3,89,2,9
4909,840,524,219.80009070294784,222.05242630385487,3,11,331,2,316
4910,840,525,219.80009070294784,222.2381859410431,3,8,332,2,315
4911,840,651,219.80009070294784,222.02920634920636,3,3,212,2,189
